,artist,chart_date,key,lag_1,lag_2,next_pos,peak,position,title,total_weeks,weeks_on_chart,next_delta,delta_1,delta_2,move,move_2,debut
0,Ohio Players,1975-01-04,Ohio Players - Fire,51,51,1,1.0,1,Fire,22.0,0,0,50,0,0,stay,1975-01-04
1,Ohio Players,1975-01-11,Ohio Players - Fire,1,51,1,1.0,1,Fire,22.0,1,0,0,50,0,stay,1975-01-04
2,Ohio Players,1975-01-18,Ohio Players - Fire,1,1,1,1.0,1,Fire,22.0,2,0,0,0,0,stay,1975-01-04
3,Ohio Players,1975-01-25,Ohio Players - Fire,1,1,1,1.0,1,Fire,22.0,3,0,0,0,0,stay,1975-01-04
4,Ohio Players,1975-02-01,Ohio Players - Fire,1,1,4,1.0,1,Fire,22.0,4,-3,0,0,1,down,1975-01-04
5,Ohio Players,1975-02-08,Ohio Players - Fire,1,1,4,1.0,4,Fire,22.0,5,0,-3,0,0,stay,1975-01-04
6,Ohio Players,1975-02-15,Ohio Players - Fire,4,1,3,1.0,4,Fire,22.0,6,1,0,-3,1,up,1975-01-04
7,Ohio Players,1975-02-22,Ohio Players - Fire,4,4,2,1.0,3,Fire,22.0,7,1,1,0,1,up,1975-01-04
8,Ohio Players,1975-03-01,Ohio Players - Fire,3,4,2,1.0,2,Fire,22.0,8,0,1,1,0,stay,1975-01-04
9,Ohio Players,1975-03-08,Ohio Players - Fire,2,3,2,1.0,2,Fire,22.0,9,0,0,1,0,stay,1975-01-04
10,Ohio Players,1975-03-15,Ohio Players - Fire,2,2,2,1.0,2,Fire,22.0,10,0,0,0,0,stay,1975-01-04
11,Ohio Players,1975-03-22,Ohio Players - Fire,2,2,4,1.0,2,Fire,22.0,11,-2,0,0,1,down,1975-01-04
12,Ohio Players,1975-03-29,Ohio Players - Fire,2,2,3,1.0,4,Fire,22.0,12,1,-2,0,1,up,1975-01-04
13,Ohio Players,1975-04-05,Ohio Players - Fire,4,2,8,1.0,3,Fire,22.0,13,-5,1,-2,1,down,1975-01-04
14,Ohio Players,1975-04-12,Ohio Players - Fire,3,4,7,1.0,8,Fire,22.0,14,1,-5,1,1,up,1975-01-04
15,Ohio Players,1975-04-19,Ohio Players - Fire,8,3,7,1.0,7,Fire,22.0,15,0,1,-5,0,stay,1975-01-04
16,Ohio Players,1975-04-26,Ohio Players - Fire,7,8,9,1.0,7,Fire,22.0,16,-2,0,1,1,down,1975-01-04
17,Ohio Players,1975-05-03,Ohio Players - Fire,7,7,17,1.0,9,Fire,22.0,17,-8,-2,0,1,down,1975-01-04
18,Ohio Players,1975-05-10,Ohio Players - Fire,9,7,14,1.0,17,Fire,22.0,18,3,-8,-2,1,up,1975-01-04
19,Ohio Players,1975-05-17,Ohio Players - Fire,17,9,10,1.0,14,Fire,22.0,19,4,3,-8,1,up,1975-01-04
20,Ohio Players,1975-05-24,Ohio Players - Fire,14,17,8,1.0,10,Fire,22.0,20,2,4,3,1,up,1975-01-04
21,Ohio Players,1975-05-31,Ohio Players - Fire,10,14,26,1.0,8,Fire,22.0,21,-18,2,4,1,down,1975-01-04
22,Ohio Players,1975-06-07,Ohio Players - Fire,8,10,51,1.0,26,Fire,22.0,22,-25,-18,2,1,down,1975-01-04
23,Al Green,1975-01-04,Al Green - Explores Your Mind,51,51,2,1.0,2,Explores Your Mind,26.0,0,0,49,0,0,stay,1975-01-04
24,Al Green,1975-01-11,Al Green - Explores Your Mind,2,51,3,1.0,2,Explores Your Mind,26.0,1,-1,0,49,1,down,1975-01-04
25,Al Green,1975-01-18,Al Green - Explores Your Mind,2,2,2,1.0,3,Explores Your Mind,26.0,2,1,-1,0,1,up,1975-01-04
26,Al Green,1975-01-25,Al Green - Explores Your Mind,3,2,12,1.0,2,Explores Your Mind,26.0,3,-10,1,-1,1,down,1975-01-04
27,Al Green,1975-02-01,Al Green - Explores Your Mind,2,3,13,1.0,12,Explores Your Mind,26.0,4,-1,-10,1,1,down,1975-01-04
28,Al Green,1975-02-08,Al Green - Explores Your Mind,12,2,11,1.0,13,Explores Your Mind,26.0,5,2,-1,-10,1,up,1975-01-04
29,Al Green,1975-02-15,Al Green - Explores Your Mind,13,12,10,1.0,11,Explores Your Mind,26.0,6,1,2,-1,1,up,1975-01-04
30,Al Green,1975-02-22,Al Green - Explores Your Mind,11,13,4,1.0,10,Explores Your Mind,26.0,7,6,1,2,1,up,1975-01-04
31,Al Green,1975-03-01,Al Green - Explores Your Mind,10,11,4,1.0,4,Explores Your Mind,26.0,8,0,6,1,0,stay,1975-01-04
32,Al Green,1975-03-08,Al Green - Explores Your Mind,4,10,3,1.0,4,Explores Your Mind,26.0,9,1,0,6,1,up,1975-01-04
33,Al Green,1975-03-15,Al Green - Explores Your Mind,4,4,1,1.0,3,Explores Your Mind,26.0,10,2,1,0,1,up,1975-01-04
34,Al Green,1975-03-22,Al Green - Explores Your Mind,3,4,2,1.0,1,Explores Your Mind,26.0,11,-1,2,1,1,down,1975-01-04
35,Al Green,1975-03-29,Al Green - Explores Your Mind,1,3,4,1.0,2,Explores Your Mind,26.0,12,-2,-1,2,1,down,1975-01-04
36,Al Green,1975-04-05,Al Green - Explores Your Mind,2,1,3,1.0,4,Explores Your Mind,26.0,13,1,-2,-1,1,up,1975-01-04
37,Al Green,1975-04-12,Al Green - Explores Your Mind,4,2,6,1.0,3,Explores Your Mind,26.0,14,-3,1,-2,1,down,1975-01-04
38,Al Green,1975-04-19,Al Green - Explores Your Mind,3,4,11,1.0,6,Explores Your Mind,26.0,15,-5,-3,1,1,down,1975-01-04
39,Al Green,1975-04-26,Al Green - Explores Your Mind,6,3,16,1.0,11,Explores Your Mind,26.0,16,-5,-5,-3,1,down,1975-01-04
40,Al Green,1975-05-03,Al Green - Explores Your Mind,11,6,13,1.0,16,Explores Your Mind,26.0,17,3,-5,-5,1,up,1975-01-04
41,Al Green,1975-05-10,Al Green - Explores Your Mind,16,11,10,1.0,13,Explores Your Mind,26.0,18,3,3,-5,1,up,1975-01-04
42,Al Green,1975-05-17,Al Green - Explores Your Mind,13,16,9,1.0,10,Explores Your Mind,26.0,19,1,3,3,1,up,1975-01-04
43,Al Green,1975-05-24,Al Green - Explores Your Mind,10,13,9,1.0,9,Explores Your Mind,26.0,20,0,1,3,0,stay,1975-01-04
44,Al Green,1975-05-31,Al Green - Explores Your Mind,9,10,6,1.0,9,Explores Your Mind,26.0,21,3,0,1,1,up,1975-01-04
45,Al Green,1975-06-07,Al Green - Explores Your Mind,9,9,5,1.0,6,Explores Your Mind,26.0,22,1,3,0,1,up,1975-01-04
46,Al Green,1975-06-14,Al Green - Explores Your Mind,6,9,9,1.0,5,Explores Your Mind,26.0,23,-4,1,3,1,down,1975-01-04
47,Al Green,1975-06-21,Al Green - Explores Your Mind,5,6,21,1.0,9,Explores Your Mind,26.0,24,-12,-4,1,1,down,1975-01-04
48,Al Green,1975-06-28,Al Green - Explores Your Mind,9,5,40,1.0,21,Explores Your Mind,26.0,25,-19,-12,-4,1,down,1975-01-04
49,Al Green,1975-07-05,Al Green - Explores Your Mind,21,9,51,1.0,40,Explores Your Mind,26.0,26,-11,-19,-12,1,down,1975-01-04
50,The Crusaders,1975-01-04,The Crusaders - Southern Comfort,51,51,3,3.0,3,Southern Comfort,16.0,0,0,48,0,0,stay,1975-01-04
51,The Crusaders,1975-01-11,The Crusaders - Southern Comfort,3,51,4,3.0,3,Southern Comfort,16.0,1,-1,0,48,1,down,1975-01-04
52,The Crusaders,1975-01-18,The Crusaders - Southern Comfort,3,3,20,3.0,4,Southern Comfort,16.0,2,-16,-1,0,1,down,1975-01-04
53,The Crusaders,1975-01-25,The Crusaders - Southern Comfort,4,3,30,3.0,20,Southern Comfort,16.0,3,-10,-16,-1,1,down,1975-01-04
54,The Crusaders,1975-02-01,The Crusaders - Southern Comfort,20,4,36,3.0,30,Southern Comfort,16.0,4,-6,-10,-16,1,down,1975-01-04
55,The Crusaders,1975-02-08,The Crusaders - Southern Comfort,30,20,32,3.0,36,Southern Comfort,16.0,5,4,-6,-10,1,up,1975-01-04
56,The Crusaders,1975-02-15,The Crusaders - Southern Comfort,36,30,28,3.0,32,Southern Comfort,16.0,6,4,4,-6,1,up,1975-01-04
57,The Crusaders,1975-02-22,The Crusaders - Southern Comfort,32,36,18,3.0,28,Southern Comfort,16.0,7,10,4,4,1,up,1975-01-04
58,The Crusaders,1975-03-01,The Crusaders - Southern Comfort,28,32,13,3.0,18,Southern Comfort,16.0,8,5,10,4,1,up,1975-01-04
59,The Crusaders,1975-03-08,The Crusaders - Southern Comfort,18,28,11,3.0,13,Southern Comfort,16.0,9,2,5,10,1,up,1975-01-04
60,The Crusaders,1975-03-15,The Crusaders - Southern Comfort,13,18,7,3.0,11,Southern Comfort,16.0,10,4,2,5,1,up,1975-01-04
61,The Crusaders,1975-03-22,The Crusaders - Southern Comfort,11,13,6,3.0,7,Southern Comfort,16.0,11,1,4,2,1,up,1975-01-04
62,The Crusaders,1975-03-29,The Crusaders - Southern Comfort,7,11,16,3.0,6,Southern Comfort,16.0,12,-10,1,4,1,down,1975-01-04
63,The Crusaders,1975-04-05,The Crusaders - Southern Comfort,6,7,19,3.0,16,Southern Comfort,16.0,13,-3,-10,1,1,down,1975-01-04
64,The Crusaders,1975-04-12,The Crusaders - Southern Comfort,16,6,35,3.0,19,Southern Comfort,16.0,14,-16,-3,-10,1,down,1975-01-04
65,The Crusaders,1975-04-19,The Crusaders - Southern Comfort,19,16,43,3.0,35,Southern Comfort,16.0,15,-8,-16,-3,1,down,1975-01-04
66,The Crusaders,1975-04-26,The Crusaders - Southern Comfort,35,19,51,3.0,43,Southern Comfort,16.0,16,-8,-8,-16,1,down,1975-01-04
67,Gladys Knight And The Pips,1975-01-04,Gladys Knight And The Pips - I Feel A Song,51,51,8,4.0,4,I Feel A Song,23.0,0,-4,47,0,1,down,1975-01-04
68,Gladys Knight And The Pips,1975-01-11,Gladys Knight And The Pips - I Feel A Song,4,51,6,4.0,8,I Feel A Song,23.0,1,2,-4,47,1,up,1975-01-04
69,Gladys Knight And The Pips,1975-01-18,Gladys Knight And The Pips - I Feel A Song,8,4,10,4.0,6,I Feel A Song,23.0,2,-4,2,-4,1,down,1975-01-04
70,Gladys Knight And The Pips,1975-01-25,Gladys Knight And The Pips - I Feel A Song,6,8,17,4.0,10,I Feel A Song,23.0,3,-7,-4,2,1,down,1975-01-04
71,Gladys Knight And The Pips,1975-02-01,Gladys Knight And The Pips - I Feel A Song,10,6,28,4.0,17,I Feel A Song,23.0,4,-11,-7,-4,1,down,1975-01-04
72,Gladys Knight And The Pips,1975-02-08,Gladys Knight And The Pips - I Feel A Song,17,10,24,4.0,28,I Feel A Song,23.0,5,4,-11,-7,1,up,1975-01-04
73,Gladys Knight And The Pips,1975-02-15,Gladys Knight And The Pips - I Feel A Song,28,17,23,4.0,24,I Feel A Song,23.0,6,1,4,-11,1,up,1975-01-04
74,Gladys Knight And The Pips,1975-02-22,Gladys Knight And The Pips - I Feel A Song,24,28,21,4.0,23,I Feel A Song,23.0,7,2,1,4,1,up,1975-01-04
75,Gladys Knight And The Pips,1975-03-01,Gladys Knight And The Pips - I Feel A Song,23,24,25,4.0,21,I Feel A Song,23.0,8,-4,2,1,1,down,1975-01-04
76,Gladys Knight And The Pips,1975-03-08,Gladys Knight And The Pips - I Feel A Song,21,23,37,4.0,25,I Feel A Song,23.0,9,-12,-4,2,1,down,1975-01-04
77,Gladys Knight And The Pips,1975-03-15,Gladys Knight And The Pips - I Feel A Song,25,21,32,4.0,37,I Feel A Song,23.0,10,5,-12,-4,1,up,1975-01-04
78,Gladys Knight And The Pips,1975-03-22,Gladys Knight And The Pips - I Feel A Song,37,25,30,4.0,32,I Feel A Song,23.0,11,2,5,-12,1,up,1975-01-04
79,Gladys Knight And The Pips,1975-03-29,Gladys Knight And The Pips - I Feel A Song,32,37,26,4.0,30,I Feel A Song,23.0,12,4,2,5,1,up,1975-01-04
80,Gladys Knight And The Pips,1975-04-05,Gladys Knight And The Pips - I Feel A Song,30,32,24,4.0,26,I Feel A Song,23.0,13,2,4,2,1,up,1975-01-04
81,Gladys Knight And The Pips,1975-04-12,Gladys Knight And The Pips - I Feel A Song,26,30,19,4.0,24,I Feel A Song,23.0,14,5,2,4,1,up,1975-01-04
82,Gladys Knight And The Pips,1975-04-19,Gladys Knight And The Pips - I Feel A Song,24,26,14,4.0,19,I Feel A Song,23.0,15,5,5,2,1,up,1975-01-04
83,Gladys Knight And The Pips,1975-04-26,Gladys Knight And The Pips - I Feel A Song,19,24,12,4.0,14,I Feel A Song,23.0,16,2,5,5,1,up,1975-01-04
84,Gladys Knight And The Pips,1975-05-03,Gladys Knight And The Pips - I Feel A Song,14,19,7,4.0,12,I Feel A Song,23.0,17,5,2,5,1,up,1975-01-04
85,Gladys Knight And The Pips,1975-05-10,Gladys Knight And The Pips - I Feel A Song,12,14,7,4.0,7,I Feel A Song,23.0,18,0,5,2,0,stay,1975-01-04
86,Gladys Knight And The Pips,1975-05-17,Gladys Knight And The Pips - I Feel A Song,7,12,6,4.0,7,I Feel A Song,23.0,19,1,0,5,1,up,1975-01-04
87,Gladys Knight And The Pips,1975-05-24,Gladys Knight And The Pips - I Feel A Song,7,7,14,4.0,6,I Feel A Song,23.0,20,-8,1,0,1,down,1975-01-04
88,Gladys Knight And The Pips,1975-05-31,Gladys Knight And The Pips - I Feel A Song,6,7,29,4.0,14,I Feel A Song,23.0,21,-15,-8,1,1,down,1975-01-04
89,Gladys Knight And The Pips,1975-06-07,Gladys Knight And The Pips - I Feel A Song,14,6,50,4.0,29,I Feel A Song,23.0,22,-21,-15,-8,1,down,1975-01-04
90,Gladys Knight And The Pips,1975-10-18,Gladys Knight And The Pips - I Feel A Song,29,14,51,4.0,50,I Feel A Song,23.0,23,-1,-21,-15,1,down,1975-01-04
91,The Isley Brothers,1975-01-04,The Isley Brothers - Live It Up,51,51,7,5.0,5,Live It Up,14.0,0,-2,46,0,1,down,1975-01-04
92,The Isley Brothers,1975-01-11,The Isley Brothers - Live It Up,5,51,10,5.0,7,Live It Up,14.0,1,-3,-2,46,1,down,1975-01-04
93,The Isley Brothers,1975-01-18,The Isley Brothers - Live It Up,7,5,21,5.0,10,Live It Up,14.0,2,-11,-3,-2,1,down,1975-01-04
94,The Isley Brothers,1975-01-25,The Isley Brothers - Live It Up,10,7,31,5.0,21,Live It Up,14.0,3,-10,-11,-3,1,down,1975-01-04
95,The Isley Brothers,1975-02-01,The Isley Brothers - Live It Up,21,10,37,5.0,31,Live It Up,14.0,4,-6,-10,-11,1,down,1975-01-04
96,The Isley Brothers,1975-02-08,The Isley Brothers - Live It Up,31,21,35,5.0,37,Live It Up,14.0,5,2,-6,-10,1,up,1975-01-04
97,The Isley Brothers,1975-02-15,The Isley Brothers - Live It Up,37,31,35,5.0,35,Live It Up,14.0,6,0,2,-6,0,stay,1975-01-04
98,The Isley Brothers,1975-02-22,The Isley Brothers - Live It Up,35,37,34,5.0,35,Live It Up,14.0,7,1,0,2,1,up,1975-01-04
99,The Isley Brothers,1975-03-01,The Isley Brothers - Live It Up,35,35,32,5.0,34,Live It Up,14.0,8,2,1,0,1,up,1975-01-04
100,The Isley Brothers,1975-03-08,The Isley Brothers - Live It Up,34,35,20,5.0,32,Live It Up,14.0,9,12,2,1,1,up,1975-01-04
101,The Isley Brothers,1975-03-15,The Isley Brothers - Live It Up,32,34,15,5.0,20,Live It Up,14.0,10,5,12,2,1,up,1975-01-04
102,The Isley Brothers,1975-03-22,The Isley Brothers - Live It Up,20,32,13,5.0,15,Live It Up,14.0,11,2,5,12,1,up,1975-01-04
103,The Isley Brothers,1975-03-29,The Isley Brothers - Live It Up,15,20,24,5.0,13,Live It Up,14.0,12,-11,2,5,1,down,1975-01-04
104,The Isley Brothers,1975-04-05,The Isley Brothers - Live It Up,13,15,39,5.0,24,Live It Up,14.0,13,-15,-11,2,1,down,1975-01-04
105,The Isley Brothers,1975-04-12,The Isley Brothers - Live It Up,24,13,51,5.0,39,Live It Up,14.0,14,-12,-15,-11,1,down,1975-01-04
106,B.B. King And Bobby Bland,1975-01-04,B.B. King And Bobby Bland - Together For The First Time...Live,51,51,4,2.0,6,Together For The First Time...Live,5.0,0,2,45,0,1,up,1975-01-04
107,B.B. King And Bobby Bland,1975-01-11,B.B. King And Bobby Bland - Together For The First Time...Live,6,51,2,2.0,4,Together For The First Time...Live,5.0,1,2,2,45,1,up,1975-01-04
108,B.B. King And Bobby Bland,1975-01-18,B.B. King And Bobby Bland - Together For The First Time...Live,4,6,3,2.0,2,Together For The First Time...Live,5.0,2,-1,2,2,1,down,1975-01-04
109,B.B. King And Bobby Bland,1975-01-25,B.B. King And Bobby Bland - Together For The First Time...Live,2,4,13,2.0,3,Together For The First Time...Live,5.0,3,-10,-1,2,1,down,1975-01-04
110,B.B. King And Bobby Bland,1975-02-01,B.B. King And Bobby Bland - Together For The First Time...Live,3,2,26,2.0,13,Together For The First Time...Live,5.0,4,-13,-10,-1,1,down,1975-01-04
111,B.B. King And Bobby Bland,1975-02-08,B.B. King And Bobby Bland - Together For The First Time...Live,13,3,51,2.0,26,Together For The First Time...Live,5.0,5,-25,-13,-10,1,down,1975-01-04
112,Millie Jackson,1975-01-04,Millie Jackson - Caught Up,51,51,5,4.0,7,Caught Up,10.0,0,2,44,0,1,up,1975-01-04
113,Millie Jackson,1975-01-11,Millie Jackson - Caught Up,7,51,5,4.0,5,Caught Up,10.0,1,0,2,44,0,stay,1975-01-04
114,Millie Jackson,1975-01-18,Millie Jackson - Caught Up,5,7,4,4.0,5,Caught Up,10.0,2,1,0,2,1,up,1975-01-04
115,Millie Jackson,1975-01-25,Millie Jackson - Caught Up,5,5,4,4.0,4,Caught Up,10.0,3,0,1,0,0,stay,1975-01-04
116,Millie Jackson,1975-02-01,Millie Jackson - Caught Up,4,5,17,4.0,4,Caught Up,10.0,4,-13,0,1,1,down,1975-01-04
117,Millie Jackson,1975-02-08,Millie Jackson - Caught Up,4,4,23,4.0,17,Caught Up,10.0,5,-6,-13,0,1,down,1975-01-04
118,Millie Jackson,1975-02-15,Millie Jackson - Caught Up,17,4,22,4.0,23,Caught Up,10.0,6,1,-6,-13,1,up,1975-01-04
119,Millie Jackson,1975-02-22,Millie Jackson - Caught Up,23,17,20,4.0,22,Caught Up,10.0,7,2,1,-6,1,up,1975-01-04
120,Millie Jackson,1975-03-01,Millie Jackson - Caught Up,22,23,30,4.0,20,Caught Up,10.0,8,-10,2,1,1,down,1975-01-04
121,Millie Jackson,1975-03-08,Millie Jackson - Caught Up,20,22,38,4.0,30,Caught Up,10.0,9,-8,-10,2,1,down,1975-01-04
122,Millie Jackson,1975-03-15,Millie Jackson - Caught Up,30,20,51,4.0,38,Caught Up,10.0,10,-13,-8,-10,1,down,1975-01-04
123,B.T. Express,1975-01-04,B.T. Express - Do It 'til You're Satisfied,51,51,6,1.0,8,Do It 'til You're Satisfied,19.0,0,2,43,0,1,up,1975-01-04
124,B.T. Express,1975-01-11,B.T. Express - Do It 'til You're Satisfied,8,51,9,1.0,6,Do It 'til You're Satisfied,19.0,1,-3,2,43,1,down,1975-01-04
125,B.T. Express,1975-01-18,B.T. Express - Do It 'til You're Satisfied,6,8,5,1.0,9,Do It 'til You're Satisfied,19.0,2,4,-3,2,1,up,1975-01-04
126,B.T. Express,1975-01-25,B.T. Express - Do It 'til You're Satisfied,9,6,3,1.0,5,Do It 'til You're Satisfied,19.0,3,2,4,-3,1,up,1975-01-04
127,B.T. Express,1975-02-01,B.T. Express - Do It 'til You're Satisfied,5,9,3,1.0,3,Do It 'til You're Satisfied,19.0,4,0,2,4,0,stay,1975-01-04
128,B.T. Express,1975-02-08,B.T. Express - Do It 'til You're Satisfied,3,5,2,1.0,3,Do It 'til You're Satisfied,19.0,5,1,0,2,1,up,1975-01-04
129,B.T. Express,1975-02-15,B.T. Express - Do It 'til You're Satisfied,3,3,1,1.0,2,Do It 'til You're Satisfied,19.0,6,1,1,0,1,up,1975-01-04
130,B.T. Express,1975-02-22,B.T. Express - Do It 'til You're Satisfied,2,3,7,1.0,1,Do It 'til You're Satisfied,19.0,7,-6,1,1,1,down,1975-01-04
131,B.T. Express,1975-03-01,B.T. Express - Do It 'til You're Satisfied,1,2,12,1.0,7,Do It 'til You're Satisfied,19.0,8,-5,-6,1,1,down,1975-01-04
132,B.T. Express,1975-03-08,B.T. Express - Do It 'til You're Satisfied,7,1,16,1.0,12,Do It 'til You're Satisfied,19.0,9,-4,-5,-6,1,down,1975-01-04
133,B.T. Express,1975-03-15,B.T. Express - Do It 'til You're Satisfied,12,7,28,1.0,16,Do It 'til You're Satisfied,19.0,10,-12,-4,-5,1,down,1975-01-04
134,B.T. Express,1975-03-22,B.T. Express - Do It 'til You're Satisfied,16,12,39,1.0,28,Do It 'til You're Satisfied,19.0,11,-11,-12,-4,1,down,1975-01-04
135,B.T. Express,1975-03-29,B.T. Express - Do It 'til You're Satisfied,28,16,33,1.0,39,Do It 'til You're Satisfied,19.0,12,6,-11,-12,1,up,1975-01-04
136,B.T. Express,1975-04-05,B.T. Express - Do It 'til You're Satisfied,39,28,30,1.0,33,Do It 'til You're Satisfied,19.0,13,3,6,-11,1,up,1975-01-04
137,B.T. Express,1975-04-12,B.T. Express - Do It 'til You're Satisfied,33,39,28,1.0,30,Do It 'til You're Satisfied,19.0,14,2,3,6,1,up,1975-01-04
138,B.T. Express,1975-04-19,B.T. Express - Do It 'til You're Satisfied,30,33,27,1.0,28,Do It 'til You're Satisfied,19.0,15,1,2,3,1,up,1975-01-04
139,B.T. Express,1975-04-26,B.T. Express - Do It 'til You're Satisfied,28,30,23,1.0,27,Do It 'til You're Satisfied,19.0,16,4,1,2,1,up,1975-01-04
140,B.T. Express,1975-05-03,B.T. Express - Do It 'til You're Satisfied,27,28,20,1.0,23,Do It 'til You're Satisfied,19.0,17,3,4,1,1,up,1975-01-04
141,B.T. Express,1975-05-10,B.T. Express - Do It 'til You're Satisfied,23,27,42,1.0,20,Do It 'til You're Satisfied,19.0,18,-22,3,4,1,down,1975-01-04
142,B.T. Express,1975-05-17,B.T. Express - Do It 'til You're Satisfied,20,23,51,1.0,42,Do It 'til You're Satisfied,19.0,19,-9,-22,3,1,down,1975-01-04
143,The Stylistics,1975-01-04,The Stylistics - Heavy,51,51,19,9.0,9,Heavy,6.0,0,-10,42,0,1,down,1975-01-04
144,The Stylistics,1975-01-11,The Stylistics - Heavy,9,51,24,9.0,19,Heavy,6.0,1,-5,-10,42,1,down,1975-01-04
145,The Stylistics,1975-01-18,The Stylistics - Heavy,19,9,27,9.0,24,Heavy,6.0,2,-3,-5,-10,1,down,1975-01-04
146,The Stylistics,1975-01-25,The Stylistics - Heavy,24,19,38,9.0,27,Heavy,6.0,3,-11,-3,-5,1,down,1975-01-04
147,The Stylistics,1975-02-01,The Stylistics - Heavy,27,24,43,9.0,38,Heavy,6.0,4,-5,-11,-3,1,down,1975-01-04
148,The Stylistics,1975-02-08,The Stylistics - Heavy,38,27,46,9.0,43,Heavy,6.0,5,-3,-5,-11,1,down,1975-01-04
149,The Stylistics,1975-02-15,The Stylistics - Heavy,43,38,51,9.0,46,Heavy,6.0,6,-5,-3,-5,1,down,1975-01-04
150,Stevie Wonder,1975-01-04,Stevie Wonder - Fullfillingness First Finale,51,51,25,8.0,10,Fullfillingness First Finale,16.0,0,-15,41,0,1,down,1975-01-04
151,Stevie Wonder,1975-01-11,Stevie Wonder - Fullfillingness First Finale,10,51,23,8.0,25,Fullfillingness First Finale,16.0,1,2,-15,41,1,up,1975-01-04
152,Stevie Wonder,1975-01-18,Stevie Wonder - Fullfillingness First Finale,25,10,13,8.0,23,Fullfillingness First Finale,16.0,2,10,2,-15,1,up,1975-01-04
153,Stevie Wonder,1975-01-25,Stevie Wonder - Fullfillingness First Finale,23,25,8,8.0,13,Fullfillingness First Finale,16.0,3,5,10,2,1,up,1975-01-04
154,Stevie Wonder,1975-02-01,Stevie Wonder - Fullfillingness First Finale,13,23,8,8.0,8,Fullfillingness First Finale,16.0,4,0,5,10,0,stay,1975-01-04
155,Stevie Wonder,1975-02-08,Stevie Wonder - Fullfillingness First Finale,8,13,18,8.0,8,Fullfillingness First Finale,16.0,5,-10,0,5,1,down,1975-01-04
156,Stevie Wonder,1975-02-15,Stevie Wonder - Fullfillingness First Finale,8,8,31,8.0,18,Fullfillingness First Finale,16.0,6,-13,-10,0,1,down,1975-01-04
157,Stevie Wonder,1975-02-22,Stevie Wonder - Fullfillingness First Finale,18,8,45,8.0,31,Fullfillingness First Finale,16.0,7,-14,-13,-10,1,down,1975-01-04
158,Stevie Wonder,1975-03-01,Stevie Wonder - Fullfillingness First Finale,31,18,50,8.0,45,Fullfillingness First Finale,16.0,8,-5,-14,-13,1,down,1975-01-04
159,Stevie Wonder,1975-03-15,Stevie Wonder - Fullfillingness First Finale,45,31,35,8.0,50,Fullfillingness First Finale,16.0,9,15,-5,-14,1,up,1975-01-04
160,Stevie Wonder,1975-03-22,Stevie Wonder - Fullfillingness First Finale,50,45,23,8.0,35,Fullfillingness First Finale,16.0,10,12,15,-5,1,up,1975-01-04
161,Stevie Wonder,1975-03-29,Stevie Wonder - Fullfillingness First Finale,35,50,19,8.0,23,Fullfillingness First Finale,16.0,11,4,12,15,1,up,1975-01-04
162,Stevie Wonder,1975-04-05,Stevie Wonder - Fullfillingness First Finale,23,35,17,8.0,19,Fullfillingness First Finale,16.0,12,2,4,12,1,up,1975-01-04
163,Stevie Wonder,1975-04-12,Stevie Wonder - Fullfillingness First Finale,19,23,18,8.0,17,Fullfillingness First Finale,16.0,13,-1,2,4,1,down,1975-01-04
164,Stevie Wonder,1975-04-19,Stevie Wonder - Fullfillingness First Finale,17,19,24,8.0,18,Fullfillingness First Finale,16.0,14,-6,-1,2,1,down,1975-01-04
165,Stevie Wonder,1975-04-26,Stevie Wonder - Fullfillingness First Finale,18,17,32,8.0,24,Fullfillingness First Finale,16.0,15,-8,-6,-1,1,down,1975-01-04
166,Stevie Wonder,1975-05-03,Stevie Wonder - Fullfillingness First Finale,24,18,51,8.0,32,Fullfillingness First Finale,16.0,16,-19,-8,-6,1,down,1975-01-04
167,Billy Preston,1975-01-04,Billy Preston - The Kids & Me,51,51,27,11.0,11,The Kids & Me,4.0,0,-16,40,0,1,down,1975-01-04
168,Billy Preston,1975-01-11,Billy Preston - The Kids & Me,11,51,30,11.0,27,The Kids & Me,4.0,1,-3,-16,40,1,down,1975-01-04
169,Billy Preston,1975-01-18,Billy Preston - The Kids & Me,27,11,36,11.0,30,The Kids & Me,4.0,2,-6,-3,-16,1,down,1975-01-04
170,Billy Preston,1975-01-25,Billy Preston - The Kids & Me,30,27,44,11.0,36,The Kids & Me,4.0,3,-8,-6,-3,1,down,1975-01-04
171,Billy Preston,1975-02-01,Billy Preston - The Kids & Me,36,30,51,11.0,44,The Kids & Me,4.0,4,-7,-8,-6,1,down,1975-01-04
172,Love Unlimited Orchestra,1975-01-04,Love Unlimited Orchestra - White Gold,51,51,10,10.0,12,White Gold,17.0,0,2,39,0,1,up,1975-01-04
173,Love Unlimited Orchestra,1975-01-11,Love Unlimited Orchestra - White Gold,12,51,13,10.0,10,White Gold,17.0,1,-3,2,39,1,down,1975-01-04
174,Love Unlimited Orchestra,1975-01-18,Love Unlimited Orchestra - White Gold,10,12,15,10.0,13,White Gold,17.0,2,-2,-3,2,1,down,1975-01-04
175,Love Unlimited Orchestra,1975-01-25,Love Unlimited Orchestra - White Gold,13,10,23,10.0,15,White Gold,17.0,3,-8,-2,-3,1,down,1975-01-04
176,Love Unlimited Orchestra,1975-02-01,Love Unlimited Orchestra - White Gold,15,13,29,10.0,23,White Gold,17.0,4,-6,-8,-2,1,down,1975-01-04
177,Love Unlimited Orchestra,1975-02-08,Love Unlimited Orchestra - White Gold,23,15,25,10.0,29,White Gold,17.0,5,4,-6,-8,1,up,1975-01-04
178,Love Unlimited Orchestra,1975-02-15,Love Unlimited Orchestra - White Gold,29,23,36,10.0,25,White Gold,17.0,6,-11,4,-6,1,down,1975-01-04
179,Love Unlimited Orchestra,1975-02-22,Love Unlimited Orchestra - White Gold,25,29,35,10.0,36,White Gold,17.0,7,1,-11,4,1,up,1975-01-04
180,Love Unlimited Orchestra,1975-03-01,Love Unlimited Orchestra - White Gold,36,25,29,10.0,35,White Gold,17.0,8,6,1,-11,1,up,1975-01-04
181,Love Unlimited Orchestra,1975-03-08,Love Unlimited Orchestra - White Gold,35,36,21,10.0,29,White Gold,17.0,9,8,6,1,1,up,1975-01-04
182,Love Unlimited Orchestra,1975-03-15,Love Unlimited Orchestra - White Gold,29,35,17,10.0,21,White Gold,17.0,10,4,8,6,1,up,1975-01-04
183,Love Unlimited Orchestra,1975-03-22,Love Unlimited Orchestra - White Gold,21,29,17,10.0,17,White Gold,17.0,11,0,4,8,0,stay,1975-01-04
184,Love Unlimited Orchestra,1975-03-29,Love Unlimited Orchestra - White Gold,17,21,17,10.0,17,White Gold,17.0,12,0,0,4,0,stay,1975-01-04
185,Love Unlimited Orchestra,1975-04-05,Love Unlimited Orchestra - White Gold,17,17,22,10.0,17,White Gold,17.0,13,-5,0,0,1,down,1975-01-04
186,Love Unlimited Orchestra,1975-04-12,Love Unlimited Orchestra - White Gold,17,17,36,10.0,22,White Gold,17.0,14,-14,-5,0,1,down,1975-01-04
187,Love Unlimited Orchestra,1975-04-19,Love Unlimited Orchestra - White Gold,22,17,49,10.0,36,White Gold,17.0,15,-13,-14,-5,1,down,1975-01-04
188,Love Unlimited Orchestra,1975-04-26,Love Unlimited Orchestra - White Gold,36,22,48,10.0,49,White Gold,17.0,16,1,-13,-14,1,up,1975-01-04
189,Love Unlimited Orchestra,1975-05-03,Love Unlimited Orchestra - White Gold,49,36,51,10.0,48,White Gold,17.0,17,-3,1,-13,1,down,1975-01-04
190,The Blackbyrds,1975-01-04,The Blackbyrds - Flying Start,51,51,9,5.0,13,Flying Start,31.0,0,4,38,0,1,up,1975-01-04
191,The Blackbyrds,1975-01-11,The Blackbyrds - Flying Start,13,51,7,5.0,9,Flying Start,31.0,1,2,4,38,1,up,1975-01-04
192,The Blackbyrds,1975-01-18,The Blackbyrds - Flying Start,9,13,6,5.0,7,Flying Start,31.0,2,1,2,4,1,up,1975-01-04
193,The Blackbyrds,1975-01-25,The Blackbyrds - Flying Start,7,9,5,5.0,6,Flying Start,31.0,3,1,1,2,1,up,1975-01-04
194,The Blackbyrds,1975-02-01,The Blackbyrds - Flying Start,6,7,5,5.0,5,Flying Start,31.0,4,0,1,1,0,stay,1975-01-04
195,The Blackbyrds,1975-02-08,The Blackbyrds - Flying Start,5,6,6,5.0,5,Flying Start,31.0,5,-1,0,1,1,down,1975-01-04
196,The Blackbyrds,1975-02-15,The Blackbyrds - Flying Start,5,5,8,5.0,6,Flying Start,31.0,6,-2,-1,0,1,down,1975-01-04
197,The Blackbyrds,1975-02-22,The Blackbyrds - Flying Start,6,5,10,5.0,8,Flying Start,31.0,7,-2,-2,-1,1,down,1975-01-04
198,The Blackbyrds,1975-03-01,The Blackbyrds - Flying Start,8,6,9,5.0,10,Flying Start,31.0,8,1,-2,-2,1,up,1975-01-04
199,The Blackbyrds,1975-03-08,The Blackbyrds - Flying Start,10,8,15,5.0,9,Flying Start,31.0,9,-6,1,-2,1,down,1975-01-04
200,The Blackbyrds,1975-03-15,The Blackbyrds - Flying Start,9,10,18,5.0,15,Flying Start,31.0,10,-3,-6,1,1,down,1975-01-04
201,The Blackbyrds,1975-03-22,The Blackbyrds - Flying Start,15,9,15,5.0,18,Flying Start,31.0,11,3,-3,-6,1,up,1975-01-04
202,The Blackbyrds,1975-03-29,The Blackbyrds - Flying Start,18,15,13,5.0,15,Flying Start,31.0,12,2,3,-3,1,up,1975-01-04
203,The Blackbyrds,1975-04-05,The Blackbyrds - Flying Start,15,18,9,5.0,13,Flying Start,31.0,13,4,2,3,1,up,1975-01-04
204,The Blackbyrds,1975-04-12,The Blackbyrds - Flying Start,13,15,9,5.0,9,Flying Start,31.0,14,0,4,2,0,stay,1975-01-04
205,The Blackbyrds,1975-04-19,The Blackbyrds - Flying Start,9,13,12,5.0,9,Flying Start,31.0,15,-3,0,4,1,down,1975-01-04
206,The Blackbyrds,1975-04-26,The Blackbyrds - Flying Start,9,9,17,5.0,12,Flying Start,31.0,16,-5,-3,0,1,down,1975-01-04
207,The Blackbyrds,1975-05-03,The Blackbyrds - Flying Start,12,9,14,5.0,17,Flying Start,31.0,17,3,-5,-3,1,up,1975-01-04
208,The Blackbyrds,1975-05-10,The Blackbyrds - Flying Start,17,12,12,5.0,14,Flying Start,31.0,18,2,3,-5,1,up,1975-01-04
209,The Blackbyrds,1975-05-17,The Blackbyrds - Flying Start,14,17,8,5.0,12,Flying Start,31.0,19,4,2,3,1,up,1975-01-04
210,The Blackbyrds,1975-05-24,The Blackbyrds - Flying Start,12,14,7,5.0,8,Flying Start,31.0,20,1,4,2,1,up,1975-01-04
211,The Blackbyrds,1975-05-31,The Blackbyrds - Flying Start,8,12,16,5.0,7,Flying Start,31.0,21,-9,1,4,1,down,1975-01-04
212,The Blackbyrds,1975-06-07,The Blackbyrds - Flying Start,7,8,23,5.0,16,Flying Start,31.0,22,-7,-9,1,1,down,1975-01-04
213,The Blackbyrds,1975-06-14,The Blackbyrds - Flying Start,16,7,21,5.0,23,Flying Start,31.0,23,2,-7,-9,1,up,1975-01-04
214,The Blackbyrds,1975-06-21,The Blackbyrds - Flying Start,23,16,30,5.0,21,Flying Start,31.0,24,-9,2,-7,1,down,1975-01-04
215,The Blackbyrds,1975-06-28,The Blackbyrds - Flying Start,21,23,48,5.0,30,Flying Start,31.0,25,-18,-9,2,1,down,1975-01-04
216,The Blackbyrds,1975-07-05,The Blackbyrds - Flying Start,30,21,35,5.0,48,Flying Start,31.0,26,13,-18,-9,1,up,1975-01-04
217,The Blackbyrds,1975-07-12,The Blackbyrds - Flying Start,48,30,29,5.0,35,Flying Start,31.0,27,6,13,-18,1,up,1975-01-04
218,The Blackbyrds,1975-07-19,The Blackbyrds - Flying Start,35,48,27,5.0,29,Flying Start,31.0,28,2,6,13,1,up,1975-01-04
219,The Blackbyrds,1975-07-26,The Blackbyrds - Flying Start,29,35,23,5.0,27,Flying Start,31.0,29,4,2,6,1,up,1975-01-04
220,The Blackbyrds,1975-08-02,The Blackbyrds - Flying Start,27,29,35,5.0,23,Flying Start,31.0,30,-12,4,2,1,down,1975-01-04
221,The Blackbyrds,1975-08-09,The Blackbyrds - Flying Start,23,27,51,5.0,35,Flying Start,31.0,31,-16,-12,4,1,down,1975-01-04
222,Richard Pryor,1975-01-04,Richard Pryor - That Nigger's Crazy,51,51,11,11.0,14,That Nigger's Crazy,13.0,0,3,37,0,1,up,1975-01-04
223,Richard Pryor,1975-01-11,Richard Pryor - That Nigger's Crazy,14,51,21,11.0,11,That Nigger's Crazy,13.0,1,-10,3,37,1,down,1975-01-04
224,Richard Pryor,1975-01-18,Richard Pryor - That Nigger's Crazy,11,14,28,11.0,21,That Nigger's Crazy,13.0,2,-7,-10,3,1,down,1975-01-04
225,Richard Pryor,1975-01-25,Richard Pryor - That Nigger's Crazy,21,11,28,11.0,28,That Nigger's Crazy,13.0,3,0,-7,-10,0,stay,1975-01-04
226,Richard Pryor,1975-02-01,Richard Pryor - That Nigger's Crazy,28,21,35,11.0,28,That Nigger's Crazy,13.0,4,-7,0,-7,1,down,1975-01-04
227,Richard Pryor,1975-02-08,Richard Pryor - That Nigger's Crazy,28,28,49,11.0,35,That Nigger's Crazy,13.0,5,-14,-7,0,1,down,1975-01-04
228,Richard Pryor,1975-02-15,Richard Pryor - That Nigger's Crazy,35,28,46,11.0,49,That Nigger's Crazy,13.0,6,3,-14,-7,1,up,1975-01-04
229,Richard Pryor,1975-12-20,Richard Pryor - That Nigger's Crazy,49,35,46,11.0,46,That Nigger's Crazy,13.0,7,0,3,-14,0,stay,1975-01-04
230,Richard Pryor,1975-12-27,Richard Pryor - That Nigger's Crazy,46,49,35,11.0,46,That Nigger's Crazy,13.0,8,11,0,3,1,up,1975-01-04
231,Richard Pryor,1976-01-03,Richard Pryor - That Nigger's Crazy,46,46,28,11.0,35,That Nigger's Crazy,13.0,9,7,11,0,1,up,1975-01-04
232,Richard Pryor,1976-01-10,Richard Pryor - That Nigger's Crazy,35,46,22,11.0,28,That Nigger's Crazy,13.0,10,6,7,11,1,up,1975-01-04
233,Richard Pryor,1976-01-17,Richard Pryor - That Nigger's Crazy,28,35,22,11.0,22,That Nigger's Crazy,13.0,11,0,6,7,0,stay,1975-01-04
234,Richard Pryor,1976-01-24,Richard Pryor - That Nigger's Crazy,22,28,24,11.0,22,That Nigger's Crazy,13.0,12,-2,0,6,1,down,1975-01-04
235,Richard Pryor,1976-01-31,Richard Pryor - That Nigger's Crazy,22,22,51,11.0,24,That Nigger's Crazy,13.0,13,-27,-2,0,1,down,1975-01-04
236,Rufus,1975-01-04,Rufus - Rags To Rufus,51,51,14,14.0,15,Rags To Rufus,6.0,0,1,36,0,1,up,1975-01-04
237,Rufus,1975-01-11,Rufus - Rags To Rufus,15,51,29,14.0,14,Rags To Rufus,6.0,1,-15,1,36,1,down,1975-01-04
238,Rufus,1975-01-18,Rufus - Rags To Rufus,14,15,35,14.0,29,Rags To Rufus,6.0,2,-6,-15,1,1,down,1975-01-04
239,Rufus,1975-01-25,Rufus - Rags To Rufus,29,14,39,14.0,35,Rags To Rufus,6.0,3,-4,-6,-15,1,down,1975-01-04
240,Rufus,1975-02-01,Rufus - Rags To Rufus,35,29,38,14.0,39,Rags To Rufus,6.0,4,1,-4,-6,1,up,1975-01-04
241,Rufus,1975-02-08,Rufus - Rags To Rufus,39,35,43,14.0,38,Rags To Rufus,6.0,5,-5,1,-4,1,down,1975-01-04
242,Rufus,1975-02-15,Rufus - Rags To Rufus,38,39,51,14.0,43,Rags To Rufus,6.0,6,-8,-5,1,1,down,1975-01-04
243,Bobbi Humphrey,1975-01-04,Bobbi Humphrey - Satin Doll,51,51,13,5.0,16,Satin Doll,12.0,0,3,35,0,1,up,1975-01-04
244,Bobbi Humphrey,1975-01-11,Bobbi Humphrey - Satin Doll,16,51,12,5.0,13,Satin Doll,12.0,1,1,3,35,1,up,1975-01-04
245,Bobbi Humphrey,1975-01-18,Bobbi Humphrey - Satin Doll,13,16,12,5.0,12,Satin Doll,12.0,2,0,1,3,0,stay,1975-01-04
246,Bobbi Humphrey,1975-01-25,Bobbi Humphrey - Satin Doll,12,13,11,5.0,12,Satin Doll,12.0,3,1,0,1,1,up,1975-01-04
247,Bobbi Humphrey,1975-02-01,Bobbi Humphrey - Satin Doll,12,12,11,5.0,11,Satin Doll,12.0,4,0,1,0,0,stay,1975-01-04
248,Bobbi Humphrey,1975-02-08,Bobbi Humphrey - Satin Doll,11,12,8,5.0,11,Satin Doll,12.0,5,3,0,1,1,up,1975-01-04
249,Bobbi Humphrey,1975-02-15,Bobbi Humphrey - Satin Doll,11,11,7,5.0,8,Satin Doll,12.0,6,1,3,0,1,up,1975-01-04
250,Bobbi Humphrey,1975-02-22,Bobbi Humphrey - Satin Doll,8,11,5,5.0,7,Satin Doll,12.0,7,2,1,3,1,up,1975-01-04
251,Bobbi Humphrey,1975-03-01,Bobbi Humphrey - Satin Doll,7,8,7,5.0,5,Satin Doll,12.0,8,-2,2,1,1,down,1975-01-04
252,Bobbi Humphrey,1975-03-08,Bobbi Humphrey - Satin Doll,5,7,19,5.0,7,Satin Doll,12.0,9,-12,-2,2,1,down,1975-01-04
253,Bobbi Humphrey,1975-03-15,Bobbi Humphrey - Satin Doll,7,5,31,5.0,19,Satin Doll,12.0,10,-12,-12,-2,1,down,1975-01-04
254,Bobbi Humphrey,1975-03-22,Bobbi Humphrey - Satin Doll,19,7,43,5.0,31,Satin Doll,12.0,11,-12,-12,-12,1,down,1975-01-04
255,Bobbi Humphrey,1975-03-29,Bobbi Humphrey - Satin Doll,31,19,51,5.0,43,Satin Doll,12.0,12,-8,-12,-12,1,down,1975-01-04
256,Herbie Hancock,1975-01-04,Herbie Hancock - Thrust,51,51,31,17.0,17,Thrust,12.0,0,-14,34,0,1,down,1975-01-04
257,Herbie Hancock,1975-01-11,Herbie Hancock - Thrust,17,51,46,17.0,31,Thrust,12.0,1,-15,-14,34,1,down,1975-01-04
258,Herbie Hancock,1975-01-18,Herbie Hancock - Thrust,31,17,41,17.0,46,Thrust,12.0,2,5,-15,-14,1,up,1975-01-04
259,Herbie Hancock,1975-01-25,Herbie Hancock - Thrust,46,31,36,17.0,41,Thrust,12.0,3,5,5,-15,1,up,1975-01-04
260,Herbie Hancock,1975-02-01,Herbie Hancock - Thrust,41,46,32,17.0,36,Thrust,12.0,4,4,5,5,1,up,1975-01-04
261,Herbie Hancock,1975-02-08,Herbie Hancock - Thrust,36,41,28,17.0,32,Thrust,12.0,5,4,4,5,1,up,1975-01-04
262,Herbie Hancock,1975-02-15,Herbie Hancock - Thrust,32,36,21,17.0,28,Thrust,12.0,6,7,4,4,1,up,1975-01-04
263,Herbie Hancock,1975-02-22,Herbie Hancock - Thrust,28,32,19,17.0,21,Thrust,12.0,7,2,7,4,1,up,1975-01-04
264,Herbie Hancock,1975-03-01,Herbie Hancock - Thrust,21,28,17,17.0,19,Thrust,12.0,8,2,2,7,1,up,1975-01-04
265,Herbie Hancock,1975-03-08,Herbie Hancock - Thrust,19,21,18,17.0,17,Thrust,12.0,9,-1,2,2,1,down,1975-01-04
266,Herbie Hancock,1975-03-15,Herbie Hancock - Thrust,17,19,30,17.0,18,Thrust,12.0,10,-12,-1,2,1,down,1975-01-04
267,Herbie Hancock,1975-03-22,Herbie Hancock - Thrust,18,17,46,17.0,30,Thrust,12.0,11,-16,-12,-1,1,down,1975-01-04
268,Herbie Hancock,1975-03-29,Herbie Hancock - Thrust,30,18,51,17.0,46,Thrust,12.0,12,-5,-16,-12,1,down,1975-01-04
269,Stanley Turrentine,1975-01-04,Stanley Turrentine - Pieces Of Dreams,51,51,15,14.0,18,Pieces Of Dreams,18.0,0,3,33,0,1,up,1975-01-04
270,Stanley Turrentine,1975-01-11,Stanley Turrentine - Pieces Of Dreams,18,51,14,14.0,15,Pieces Of Dreams,18.0,1,1,3,33,1,up,1975-01-04
271,Stanley Turrentine,1975-01-18,Stanley Turrentine - Pieces Of Dreams,15,18,22,14.0,14,Pieces Of Dreams,18.0,2,-8,1,3,1,down,1975-01-04
272,Stanley Turrentine,1975-01-25,Stanley Turrentine - Pieces Of Dreams,14,15,22,14.0,22,Pieces Of Dreams,18.0,3,0,-8,1,0,stay,1975-01-04
273,Stanley Turrentine,1975-02-01,Stanley Turrentine - Pieces Of Dreams,22,14,24,14.0,22,Pieces Of Dreams,18.0,4,-2,0,-8,1,down,1975-01-04
274,Stanley Turrentine,1975-02-08,Stanley Turrentine - Pieces Of Dreams,22,22,21,14.0,24,Pieces Of Dreams,18.0,5,3,-2,0,1,up,1975-01-04
275,Stanley Turrentine,1975-02-15,Stanley Turrentine - Pieces Of Dreams,24,22,24,14.0,21,Pieces Of Dreams,18.0,6,-3,3,-2,1,down,1975-01-04
276,Stanley Turrentine,1975-02-22,Stanley Turrentine - Pieces Of Dreams,21,24,22,14.0,24,Pieces Of Dreams,18.0,7,2,-3,3,1,up,1975-01-04
277,Stanley Turrentine,1975-03-01,Stanley Turrentine - Pieces Of Dreams,24,21,38,14.0,22,Pieces Of Dreams,18.0,8,-16,2,-3,1,down,1975-01-04
278,Stanley Turrentine,1975-03-08,Stanley Turrentine - Pieces Of Dreams,22,24,48,14.0,38,Pieces Of Dreams,18.0,9,-10,-16,2,1,down,1975-01-04
279,Stanley Turrentine,1975-03-29,Stanley Turrentine - Pieces Of Dreams,38,22,46,14.0,48,Pieces Of Dreams,18.0,10,2,-10,-16,1,up,1975-01-04
280,Stanley Turrentine,1975-04-05,Stanley Turrentine - Pieces Of Dreams,48,38,38,14.0,46,Pieces Of Dreams,18.0,11,8,2,-10,1,up,1975-01-04
281,Stanley Turrentine,1975-04-12,Stanley Turrentine - Pieces Of Dreams,46,48,33,14.0,38,Pieces Of Dreams,18.0,12,5,8,2,1,up,1975-01-04
282,Stanley Turrentine,1975-04-19,Stanley Turrentine - Pieces Of Dreams,38,46,30,14.0,33,Pieces Of Dreams,18.0,13,3,5,8,1,up,1975-01-04
283,Stanley Turrentine,1975-04-26,Stanley Turrentine - Pieces Of Dreams,33,38,26,14.0,30,Pieces Of Dreams,18.0,14,4,3,5,1,up,1975-01-04
284,Stanley Turrentine,1975-05-03,Stanley Turrentine - Pieces Of Dreams,30,33,24,14.0,26,Pieces Of Dreams,18.0,15,2,4,3,1,up,1975-01-04
285,Stanley Turrentine,1975-05-10,Stanley Turrentine - Pieces Of Dreams,26,30,37,14.0,24,Pieces Of Dreams,18.0,16,-13,2,4,1,down,1975-01-04
286,Stanley Turrentine,1975-05-17,Stanley Turrentine - Pieces Of Dreams,24,26,44,14.0,37,Pieces Of Dreams,18.0,17,-7,-13,2,1,down,1975-01-04
287,Stanley Turrentine,1975-05-24,Stanley Turrentine - Pieces Of Dreams,37,24,51,14.0,44,Pieces Of Dreams,18.0,18,-7,-7,-13,1,down,1975-01-04
288,Barry White,1975-01-04,Barry White - Can't Get Enough,51,51,16,9.0,19,Can't Get Enough,19.0,0,3,32,0,1,up,1975-01-04
289,Barry White,1975-01-11,Barry White - Can't Get Enough,19,51,16,9.0,16,Can't Get Enough,19.0,1,0,3,32,0,stay,1975-01-04
290,Barry White,1975-01-18,Barry White - Can't Get Enough,16,19,16,9.0,16,Can't Get Enough,19.0,2,0,0,3,0,stay,1975-01-04
291,Barry White,1975-01-25,Barry White - Can't Get Enough,16,16,14,9.0,16,Can't Get Enough,19.0,3,2,0,0,1,up,1975-01-04
292,Barry White,1975-02-01,Barry White - Can't Get Enough,16,16,10,9.0,14,Can't Get Enough,19.0,4,4,2,0,1,up,1975-01-04
293,Barry White,1975-02-08,Barry White - Can't Get Enough,14,16,9,9.0,10,Can't Get Enough,19.0,5,1,4,2,1,up,1975-01-04
294,Barry White,1975-02-15,Barry White - Can't Get Enough,10,14,15,9.0,9,Can't Get Enough,19.0,6,-6,1,4,1,down,1975-01-04
295,Barry White,1975-02-22,Barry White - Can't Get Enough,9,10,31,9.0,15,Can't Get Enough,19.0,7,-16,-6,1,1,down,1975-01-04
296,Barry White,1975-03-01,Barry White - Can't Get Enough,15,9,41,9.0,31,Can't Get Enough,19.0,8,-10,-16,-6,1,down,1975-01-04
297,Barry White,1975-03-08,Barry White - Can't Get Enough,31,15,44,9.0,41,Can't Get Enough,19.0,9,-3,-10,-16,1,down,1975-01-04
298,Barry White,1975-03-15,Barry White - Can't Get Enough,41,31,39,9.0,44,Can't Get Enough,19.0,10,5,-3,-10,1,up,1975-01-04
299,Barry White,1975-03-22,Barry White - Can't Get Enough,44,41,50,9.0,39,Can't Get Enough,19.0,11,-11,5,-3,1,down,1975-01-04
300,Barry White,1975-04-05,Barry White - Can't Get Enough,39,44,41,9.0,50,Can't Get Enough,19.0,12,9,-11,5,1,up,1975-01-04
301,Barry White,1975-04-12,Barry White - Can't Get Enough,50,39,27,9.0,41,Can't Get Enough,19.0,13,14,9,-11,1,up,1975-01-04
302,Barry White,1975-04-19,Barry White - Can't Get Enough,41,50,21,9.0,27,Can't Get Enough,19.0,14,6,14,9,1,up,1975-01-04
303,Barry White,1975-04-26,Barry White - Can't Get Enough,27,41,20,9.0,21,Can't Get Enough,19.0,15,1,6,14,1,up,1975-01-04
304,Barry White,1975-05-03,Barry White - Can't Get Enough,21,27,25,9.0,20,Can't Get Enough,19.0,16,-5,1,6,1,down,1975-01-04
305,Barry White,1975-05-10,Barry White - Can't Get Enough,20,21,29,9.0,25,Can't Get Enough,19.0,17,-4,-5,1,1,down,1975-01-04
306,Barry White,1975-05-17,Barry White - Can't Get Enough,25,20,38,9.0,29,Can't Get Enough,19.0,18,-9,-4,-5,1,down,1975-01-04
307,Barry White,1975-05-24,Barry White - Can't Get Enough,29,25,51,9.0,38,Can't Get Enough,19.0,19,-13,-9,-4,1,down,1975-01-04
308,Ohio Players,1975-01-04,Ohio Players - Skin Tight,51,51,40,14.0,20,Skin Tight,10.0,0,-20,31,0,1,down,1975-01-04
309,Ohio Players,1975-01-11,Ohio Players - Skin Tight,20,51,35,14.0,40,Skin Tight,10.0,1,5,-20,31,1,up,1975-01-04
310,Ohio Players,1975-01-18,Ohio Players - Skin Tight,40,20,40,14.0,35,Skin Tight,10.0,2,-5,5,-20,1,down,1975-01-04
311,Ohio Players,1975-01-25,Ohio Players - Skin Tight,35,40,34,14.0,40,Skin Tight,10.0,3,6,-5,5,1,up,1975-01-04
312,Ohio Players,1975-02-01,Ohio Players - Skin Tight,40,35,25,14.0,34,Skin Tight,10.0,4,9,6,-5,1,up,1975-01-04
313,Ohio Players,1975-02-08,Ohio Players - Skin Tight,34,40,20,14.0,25,Skin Tight,10.0,5,5,9,6,1,up,1975-01-04
314,Ohio Players,1975-02-15,Ohio Players - Skin Tight,25,34,19,14.0,20,Skin Tight,10.0,6,1,5,9,1,up,1975-01-04
315,Ohio Players,1975-02-22,Ohio Players - Skin Tight,20,25,15,14.0,19,Skin Tight,10.0,7,4,1,5,1,up,1975-01-04
316,Ohio Players,1975-03-01,Ohio Players - Skin Tight,19,20,14,14.0,15,Skin Tight,10.0,8,1,4,1,1,up,1975-01-04
317,Ohio Players,1975-03-08,Ohio Players - Skin Tight,15,19,34,14.0,14,Skin Tight,10.0,9,-20,1,4,1,down,1975-01-04
318,Ohio Players,1975-03-15,Ohio Players - Skin Tight,14,15,51,14.0,34,Skin Tight,10.0,10,-17,-20,1,1,down,1975-01-04
319,Nancy Wilson,1975-01-04,Nancy Wilson - All In Love Is Fair,51,51,18,11.0,21,All In Love Is Fair,11.0,0,3,30,0,1,up,1975-01-04
320,Nancy Wilson,1975-01-11,Nancy Wilson - All In Love Is Fair,21,51,26,11.0,18,All In Love Is Fair,11.0,1,-8,3,30,1,down,1975-01-04
321,Nancy Wilson,1975-01-18,Nancy Wilson - All In Love Is Fair,18,21,26,11.0,26,All In Love Is Fair,11.0,2,0,-8,3,0,stay,1975-01-04
322,Nancy Wilson,1975-01-25,Nancy Wilson - All In Love Is Fair,26,18,19,11.0,26,All In Love Is Fair,11.0,3,7,0,-8,1,up,1975-01-04
323,Nancy Wilson,1975-02-01,Nancy Wilson - All In Love Is Fair,26,26,15,11.0,19,All In Love Is Fair,11.0,4,4,7,0,1,up,1975-01-04
324,Nancy Wilson,1975-02-08,Nancy Wilson - All In Love Is Fair,19,26,13,11.0,15,All In Love Is Fair,11.0,5,2,4,7,1,up,1975-01-04
325,Nancy Wilson,1975-02-15,Nancy Wilson - All In Love Is Fair,15,19,12,11.0,13,All In Love Is Fair,11.0,6,1,2,4,1,up,1975-01-04
326,Nancy Wilson,1975-02-22,Nancy Wilson - All In Love Is Fair,13,15,11,11.0,12,All In Love Is Fair,11.0,7,1,1,2,1,up,1975-01-04
327,Nancy Wilson,1975-03-01,Nancy Wilson - All In Love Is Fair,12,13,18,11.0,11,All In Love Is Fair,11.0,8,-7,1,1,1,down,1975-01-04
328,Nancy Wilson,1975-03-08,Nancy Wilson - All In Love Is Fair,11,12,28,11.0,18,All In Love Is Fair,11.0,9,-10,-7,1,1,down,1975-01-04
329,Nancy Wilson,1975-03-15,Nancy Wilson - All In Love Is Fair,18,11,44,11.0,28,All In Love Is Fair,11.0,10,-16,-10,-7,1,down,1975-01-04
330,Nancy Wilson,1975-03-22,Nancy Wilson - All In Love Is Fair,28,18,51,11.0,44,All In Love Is Fair,11.0,11,-7,-16,-10,1,down,1975-01-04
331,The Hues Corporation,1975-01-04,The Hues Corporation - Rockin' Soul,51,51,20,20.0,22,Rockin' Soul,5.0,0,2,29,0,1,up,1975-01-04
332,The Hues Corporation,1975-01-11,The Hues Corporation - Rockin' Soul,22,51,27,20.0,20,Rockin' Soul,5.0,1,-7,2,29,1,down,1975-01-04
333,The Hues Corporation,1975-01-18,The Hues Corporation - Rockin' Soul,20,22,34,20.0,27,Rockin' Soul,5.0,2,-7,-7,2,1,down,1975-01-04
334,The Hues Corporation,1975-01-25,The Hues Corporation - Rockin' Soul,27,20,42,20.0,34,Rockin' Soul,5.0,3,-8,-7,-7,1,down,1975-01-04
335,The Hues Corporation,1975-02-01,The Hues Corporation - Rockin' Soul,34,27,48,20.0,42,Rockin' Soul,5.0,4,-6,-8,-7,1,down,1975-01-04
336,The Hues Corporation,1975-02-08,The Hues Corporation - Rockin' Soul,42,34,51,20.0,48,Rockin' Soul,5.0,5,-3,-6,-8,1,down,1975-01-04
337,Spinners,1975-01-04,Spinners - New And Improved,51,51,12,1.0,23,New And Improved,29.0,0,11,28,0,1,up,1975-01-04
338,Spinners,1975-01-11,Spinners - New And Improved,23,51,8,1.0,12,New And Improved,29.0,1,4,11,28,1,up,1975-01-04
339,Spinners,1975-01-18,Spinners - New And Improved,12,23,8,1.0,8,New And Improved,29.0,2,0,4,11,0,stay,1975-01-04
340,Spinners,1975-01-25,Spinners - New And Improved,8,12,6,1.0,8,New And Improved,29.0,3,2,0,4,1,up,1975-01-04
341,Spinners,1975-02-01,Spinners - New And Improved,8,8,2,1.0,6,New And Improved,29.0,4,4,2,0,1,up,1975-01-04
342,Spinners,1975-02-08,Spinners - New And Improved,6,8,1,1.0,2,New And Improved,29.0,5,1,4,2,1,up,1975-01-04
343,Spinners,1975-02-15,Spinners - New And Improved,2,6,5,1.0,1,New And Improved,29.0,6,-4,1,4,1,down,1975-01-04
344,Spinners,1975-02-22,Spinners - New And Improved,1,2,9,1.0,5,New And Improved,29.0,7,-4,-4,1,1,down,1975-01-04
345,Spinners,1975-03-01,Spinners - New And Improved,5,1,8,1.0,9,New And Improved,29.0,8,1,-4,-4,1,up,1975-01-04
346,Spinners,1975-03-08,Spinners - New And Improved,9,5,9,1.0,8,New And Improved,29.0,9,-1,1,-4,1,down,1975-01-04
347,Spinners,1975-03-15,Spinners - New And Improved,8,9,14,1.0,9,New And Improved,29.0,10,-5,-1,1,1,down,1975-01-04
348,Spinners,1975-03-22,Spinners - New And Improved,9,8,12,1.0,14,New And Improved,29.0,11,2,-5,-1,1,up,1975-01-04
349,Spinners,1975-03-29,Spinners - New And Improved,14,9,11,1.0,12,New And Improved,29.0,12,1,2,-5,1,up,1975-01-04
350,Spinners,1975-04-05,Spinners - New And Improved,12,14,14,1.0,11,New And Improved,29.0,13,-3,1,2,1,down,1975-01-04
351,Spinners,1975-04-12,Spinners - New And Improved,11,12,12,1.0,14,New And Improved,29.0,14,2,-3,1,1,up,1975-01-04
352,Spinners,1975-04-19,Spinners - New And Improved,14,11,19,1.0,12,New And Improved,29.0,15,-7,2,-3,1,down,1975-01-04
353,Spinners,1975-04-26,Spinners - New And Improved,12,14,28,1.0,19,New And Improved,29.0,16,-9,-7,2,1,down,1975-01-04
354,Spinners,1975-05-03,Spinners - New And Improved,19,12,45,1.0,28,New And Improved,29.0,17,-17,-9,-7,1,down,1975-01-04
355,Spinners,1975-05-10,Spinners - New And Improved,28,19,40,1.0,45,New And Improved,29.0,18,5,-17,-9,1,up,1975-01-04
356,Spinners,1975-05-17,Spinners - New And Improved,45,28,30,1.0,40,New And Improved,29.0,19,10,5,-17,1,up,1975-01-04
357,Spinners,1975-05-24,Spinners - New And Improved,40,45,24,1.0,30,New And Improved,29.0,20,6,10,5,1,up,1975-01-04
358,Spinners,1975-05-31,Spinners - New And Improved,30,40,20,1.0,24,New And Improved,29.0,21,4,6,10,1,up,1975-01-04
359,Spinners,1975-06-07,Spinners - New And Improved,24,30,16,1.0,20,New And Improved,29.0,22,4,4,6,1,up,1975-01-04
360,Spinners,1975-06-14,Spinners - New And Improved,20,24,14,1.0,16,New And Improved,29.0,23,2,4,4,1,up,1975-01-04
361,Spinners,1975-06-21,Spinners - New And Improved,16,20,19,1.0,14,New And Improved,29.0,24,-5,2,4,1,down,1975-01-04
362,Spinners,1975-06-28,Spinners - New And Improved,14,16,36,1.0,19,New And Improved,29.0,25,-17,-5,2,1,down,1975-01-04
363,Spinners,1975-07-05,Spinners - New And Improved,19,14,47,1.0,36,New And Improved,29.0,26,-11,-17,-5,1,down,1975-01-04
364,Spinners,1975-07-12,Spinners - New And Improved,36,19,46,1.0,47,New And Improved,29.0,27,1,-11,-17,1,up,1975-01-04
365,Spinners,1975-07-26,Spinners - New And Improved,47,36,43,1.0,46,New And Improved,29.0,28,3,1,-11,1,up,1975-01-04
366,Spinners,1975-08-02,Spinners - New And Improved,46,47,51,1.0,43,New And Improved,29.0,29,-8,3,1,1,down,1975-01-04
367,Kool & The Gang,1975-01-04,Kool & The Gang - Light Of Worlds,51,51,29,24.0,24,Light Of Worlds,4.0,0,-5,27,0,1,down,1975-01-04
368,Kool & The Gang,1975-01-11,Kool & The Gang - Light Of Worlds,24,51,42,24.0,29,Light Of Worlds,4.0,1,-13,-5,27,1,down,1975-01-04
369,Kool & The Gang,1975-01-18,Kool & The Gang - Light Of Worlds,29,24,44,24.0,42,Light Of Worlds,4.0,2,-2,-13,-5,1,down,1975-01-04
370,Kool & The Gang,1975-01-25,Kool & The Gang - Light Of Worlds,42,29,47,24.0,44,Light Of Worlds,4.0,3,-3,-2,-13,1,down,1975-01-04
371,Kool & The Gang,1975-02-01,Kool & The Gang - Light Of Worlds,44,42,51,24.0,47,Light Of Worlds,4.0,4,-4,-3,-2,1,down,1975-01-04
372,The Miracles,1975-01-04,The Miracles - Do It Baby,51,51,35,25.0,25,Do It Baby,7.0,0,-10,26,0,1,down,1975-01-04
373,The Miracles,1975-01-11,The Miracles - Do It Baby,25,51,32,25.0,35,Do It Baby,7.0,1,3,-10,26,1,up,1975-01-04
374,The Miracles,1975-01-18,The Miracles - Do It Baby,35,25,39,25.0,32,Do It Baby,7.0,2,-7,3,-10,1,down,1975-01-04
375,The Miracles,1975-01-25,The Miracles - Do It Baby,32,35,35,25.0,39,Do It Baby,7.0,3,4,-7,3,1,up,1975-01-04
376,The Miracles,1975-02-01,The Miracles - Do It Baby,39,32,31,25.0,35,Do It Baby,7.0,4,4,4,-7,1,up,1975-01-04
377,The Miracles,1975-02-08,The Miracles - Do It Baby,35,39,37,25.0,31,Do It Baby,7.0,5,-6,4,4,1,down,1975-01-04
378,The Miracles,1975-02-15,The Miracles - Do It Baby,31,35,45,25.0,37,Do It Baby,7.0,6,-8,-6,4,1,down,1975-01-04
379,The Miracles,1975-02-22,The Miracles - Do It Baby,37,31,51,25.0,45,Do It Baby,7.0,7,-6,-8,-6,1,down,1975-01-04
380,Love Unlimited,1975-01-04,Love Unlimited - In Heat,51,51,33,25.0,26,In Heat,13.0,0,-7,25,0,1,down,1975-01-04
381,Love Unlimited,1975-01-11,Love Unlimited - In Heat,26,51,50,25.0,33,In Heat,13.0,1,-17,-7,25,1,down,1975-01-04
382,Love Unlimited,1975-02-01,Love Unlimited - In Heat,33,26,47,25.0,50,In Heat,13.0,2,3,-17,-7,1,up,1975-01-04
383,Love Unlimited,1975-02-08,Love Unlimited - In Heat,50,33,45,25.0,47,In Heat,13.0,3,2,3,-17,1,up,1975-01-04
384,Love Unlimited,1975-02-15,Love Unlimited - In Heat,47,50,41,25.0,45,In Heat,13.0,4,4,2,3,1,up,1975-01-04
385,Love Unlimited,1975-02-22,Love Unlimited - In Heat,45,47,36,25.0,41,In Heat,13.0,5,5,4,2,1,up,1975-01-04
386,Love Unlimited,1975-03-01,Love Unlimited - In Heat,41,45,35,25.0,36,In Heat,13.0,6,1,5,4,1,up,1975-01-04
387,Love Unlimited,1975-03-08,Love Unlimited - In Heat,36,41,29,25.0,35,In Heat,13.0,7,6,1,5,1,up,1975-01-04
388,Love Unlimited,1975-03-15,Love Unlimited - In Heat,35,36,26,25.0,29,In Heat,13.0,8,3,6,1,1,up,1975-01-04
389,Love Unlimited,1975-03-22,Love Unlimited - In Heat,29,35,25,25.0,26,In Heat,13.0,9,1,3,6,1,up,1975-01-04
390,Love Unlimited,1975-03-29,Love Unlimited - In Heat,26,29,27,25.0,25,In Heat,13.0,10,-2,1,3,1,down,1975-01-04
391,Love Unlimited,1975-04-05,Love Unlimited - In Heat,25,26,32,25.0,27,In Heat,13.0,11,-5,-2,1,1,down,1975-01-04
392,Love Unlimited,1975-04-12,Love Unlimited - In Heat,27,25,39,25.0,32,In Heat,13.0,12,-7,-5,-2,1,down,1975-01-04
393,Love Unlimited,1975-04-19,Love Unlimited - In Heat,32,27,51,25.0,39,In Heat,13.0,13,-12,-7,-5,1,down,1975-01-04
394,Curtis Mayfield,1975-01-04,Curtis Mayfield - Got To Find A Way,51,51,41,27.0,27,Got To Find A Way,2.0,0,-14,24,0,1,down,1975-01-04
395,Curtis Mayfield,1975-01-11,Curtis Mayfield - Got To Find A Way,27,51,49,27.0,41,Got To Find A Way,2.0,1,-8,-14,24,1,down,1975-01-04
396,Curtis Mayfield,1975-01-18,Curtis Mayfield - Got To Find A Way,41,27,51,27.0,49,Got To Find A Way,2.0,2,-2,-8,-14,1,down,1975-01-04
397,Santana,1975-01-04,Santana - Borboletta,51,51,34,28.0,28,Borboletta,4.0,0,-6,23,0,1,down,1975-01-04
398,Santana,1975-01-11,Santana - Borboletta,28,51,43,28.0,34,Borboletta,4.0,1,-9,-6,23,1,down,1975-01-04
399,Santana,1975-01-18,Santana - Borboletta,34,28,46,28.0,43,Borboletta,4.0,2,-3,-9,-6,1,down,1975-01-04
400,Santana,1975-01-25,Santana - Borboletta,43,34,44,28.0,46,Borboletta,4.0,3,2,-3,-9,1,up,1975-01-04
401,Santana,1975-02-08,Santana - Borboletta,46,43,51,28.0,44,Borboletta,4.0,4,-7,2,-3,1,down,1975-01-04
402,Stanley Turrentine,1975-01-04,Stanley Turrentine - The Baddest Turrentine,51,51,26,18.0,29,The Baddest Turrentine,7.0,0,3,22,0,1,up,1975-01-04
403,Stanley Turrentine,1975-01-11,Stanley Turrentine - The Baddest Turrentine,29,51,20,18.0,26,The Baddest Turrentine,7.0,1,6,3,22,1,up,1975-01-04
404,Stanley Turrentine,1975-01-18,Stanley Turrentine - The Baddest Turrentine,26,29,19,18.0,20,The Baddest Turrentine,7.0,2,1,6,3,1,up,1975-01-04
405,Stanley Turrentine,1975-01-25,Stanley Turrentine - The Baddest Turrentine,20,26,18,18.0,19,The Baddest Turrentine,7.0,3,1,1,6,1,up,1975-01-04
406,Stanley Turrentine,1975-02-01,Stanley Turrentine - The Baddest Turrentine,19,20,22,18.0,18,The Baddest Turrentine,7.0,4,-4,1,1,1,down,1975-01-04
407,Stanley Turrentine,1975-02-08,Stanley Turrentine - The Baddest Turrentine,18,19,34,18.0,22,The Baddest Turrentine,7.0,5,-12,-4,1,1,down,1975-01-04
408,Stanley Turrentine,1975-02-15,Stanley Turrentine - The Baddest Turrentine,22,18,46,18.0,34,The Baddest Turrentine,7.0,6,-12,-12,-4,1,down,1975-01-04
409,Stanley Turrentine,1975-02-22,Stanley Turrentine - The Baddest Turrentine,34,22,51,18.0,46,The Baddest Turrentine,7.0,7,-5,-12,-12,1,down,1975-01-04
410,Bobby Womack,1975-01-04,Bobby Womack - Bobby Womack's Greatest Hits,51,51,30,30.0,30,Bobby Womack's Greatest Hits,4.0,0,0,21,0,0,stay,1975-01-04
411,Bobby Womack,1975-01-11,Bobby Womack - Bobby Womack's Greatest Hits,30,51,39,30.0,30,Bobby Womack's Greatest Hits,4.0,1,-9,0,21,1,down,1975-01-04
412,Bobby Womack,1975-01-18,Bobby Womack - Bobby Womack's Greatest Hits,30,30,47,30.0,39,Bobby Womack's Greatest Hits,4.0,2,-8,-9,0,1,down,1975-01-04
413,Bobby Womack,1975-01-25,Bobby Womack - Bobby Womack's Greatest Hits,39,30,48,30.0,47,Bobby Womack's Greatest Hits,4.0,3,-1,-8,-9,1,down,1975-01-04
414,Bobby Womack,1975-02-01,Bobby Womack - Bobby Womack's Greatest Hits,47,39,51,30.0,48,Bobby Womack's Greatest Hits,4.0,4,-3,-1,-8,1,down,1975-01-04
415,Aretha Franklin,1975-01-04,Aretha Franklin - With Everything I Feel In Me,51,51,17,6.0,31,With Everything I Feel In Me,10.0,0,14,20,0,1,up,1975-01-04
416,Aretha Franklin,1975-01-11,Aretha Franklin - With Everything I Feel In Me,31,51,11,6.0,17,With Everything I Feel In Me,10.0,1,6,14,20,1,up,1975-01-04
417,Aretha Franklin,1975-01-18,Aretha Franklin - With Everything I Feel In Me,17,31,9,6.0,11,With Everything I Feel In Me,10.0,2,2,6,14,1,up,1975-01-04
418,Aretha Franklin,1975-01-25,Aretha Franklin - With Everything I Feel In Me,11,17,7,6.0,9,With Everything I Feel In Me,10.0,3,2,2,6,1,up,1975-01-04
419,Aretha Franklin,1975-02-01,Aretha Franklin - With Everything I Feel In Me,9,11,6,6.0,7,With Everything I Feel In Me,10.0,4,1,2,2,1,up,1975-01-04
420,Aretha Franklin,1975-02-08,Aretha Franklin - With Everything I Feel In Me,7,9,10,6.0,6,With Everything I Feel In Me,10.0,5,-4,1,2,1,down,1975-01-04
421,Aretha Franklin,1975-02-15,Aretha Franklin - With Everything I Feel In Me,6,7,13,6.0,10,With Everything I Feel In Me,10.0,6,-3,-4,1,1,down,1975-01-04
422,Aretha Franklin,1975-02-22,Aretha Franklin - With Everything I Feel In Me,10,6,14,6.0,13,With Everything I Feel In Me,10.0,7,-1,-3,-4,1,down,1975-01-04
423,Aretha Franklin,1975-03-01,Aretha Franklin - With Everything I Feel In Me,13,10,34,6.0,14,With Everything I Feel In Me,10.0,8,-20,-1,-3,1,down,1975-01-04
424,Aretha Franklin,1975-03-08,Aretha Franklin - With Everything I Feel In Me,14,13,43,6.0,34,With Everything I Feel In Me,10.0,9,-9,-20,-1,1,down,1975-01-04
425,Aretha Franklin,1975-03-15,Aretha Franklin - With Everything I Feel In Me,34,14,51,6.0,43,With Everything I Feel In Me,10.0,10,-8,-9,-20,1,down,1975-01-04
426,Average White Band,1975-01-04,Average White Band - AWB,51,51,22,1.0,32,AWB,22.0,0,10,19,0,1,up,1975-01-04
427,Average White Band,1975-01-11,Average White Band - AWB,32,51,15,1.0,22,AWB,22.0,1,7,10,19,1,up,1975-01-04
428,Average White Band,1975-01-18,Average White Band - AWB,22,32,14,1.0,15,AWB,22.0,2,1,7,10,1,up,1975-01-04
429,Average White Band,1975-01-25,Average White Band - AWB,15,22,10,1.0,14,AWB,22.0,3,4,1,7,1,up,1975-01-04
430,Average White Band,1975-02-01,Average White Band - AWB,14,15,9,1.0,10,AWB,22.0,4,1,4,1,1,up,1975-01-04
431,Average White Band,1975-02-08,Average White Band - AWB,10,14,5,1.0,9,AWB,22.0,5,4,1,4,1,up,1975-01-04
432,Average White Band,1975-02-15,Average White Band - AWB,9,10,2,1.0,5,AWB,22.0,6,3,4,1,1,up,1975-01-04
433,Average White Band,1975-02-22,Average White Band - AWB,5,9,1,1.0,2,AWB,22.0,7,1,3,4,1,up,1975-01-04
434,Average White Band,1975-03-01,Average White Band - AWB,2,5,1,1.0,1,AWB,22.0,8,0,1,3,0,stay,1975-01-04
435,Average White Band,1975-03-08,Average White Band - AWB,1,2,1,1.0,1,AWB,22.0,9,0,0,1,0,stay,1975-01-04
436,Average White Band,1975-03-15,Average White Band - AWB,1,1,3,1.0,1,AWB,22.0,10,-2,0,0,1,down,1975-01-04
437,Average White Band,1975-03-22,Average White Band - AWB,1,1,14,1.0,3,AWB,22.0,11,-11,-2,0,1,down,1975-01-04
438,Average White Band,1975-03-29,Average White Band - AWB,3,1,15,1.0,14,AWB,22.0,12,-1,-11,-2,1,down,1975-01-04
439,Average White Band,1975-04-05,Average White Band - AWB,14,3,25,1.0,15,AWB,22.0,13,-10,-1,-11,1,down,1975-01-04
440,Average White Band,1975-04-12,Average White Band - AWB,15,14,21,1.0,25,AWB,22.0,14,4,-10,-1,1,up,1975-01-04
441,Average White Band,1975-04-19,Average White Band - AWB,25,15,17,1.0,21,AWB,22.0,15,4,4,-10,1,up,1975-01-04
442,Average White Band,1975-04-26,Average White Band - AWB,21,25,13,1.0,17,AWB,22.0,16,4,4,4,1,up,1975-01-04
443,Average White Band,1975-05-03,Average White Band - AWB,17,21,11,1.0,13,AWB,22.0,17,2,4,4,1,up,1975-01-04
444,Average White Band,1975-05-10,Average White Band - AWB,13,17,16,1.0,11,AWB,22.0,18,-5,2,4,1,down,1975-01-04
445,Average White Band,1975-05-17,Average White Band - AWB,11,13,14,1.0,16,AWB,22.0,19,2,-5,2,1,up,1975-01-04
446,Average White Band,1975-05-24,Average White Band - AWB,16,11,29,1.0,14,AWB,22.0,20,-15,2,-5,1,down,1975-01-04
447,Average White Band,1975-05-31,Average White Band - AWB,14,16,41,1.0,29,AWB,22.0,21,-12,-15,2,1,down,1975-01-04
448,Average White Band,1975-06-07,Average White Band - AWB,29,14,51,1.0,41,AWB,22.0,22,-10,-12,-15,1,down,1975-01-04
449,Eddie Kendricks,1975-01-04,Eddie Kendricks - For You,51,51,21,8.0,33,For You,24.0,0,12,18,0,1,up,1975-01-04
450,Eddie Kendricks,1975-01-11,Eddie Kendricks - For You,33,51,18,8.0,21,For You,24.0,1,3,12,18,1,up,1975-01-04
451,Eddie Kendricks,1975-01-18,Eddie Kendricks - For You,21,33,24,8.0,18,For You,24.0,2,-6,3,12,1,down,1975-01-04
452,Eddie Kendricks,1975-01-25,Eddie Kendricks - For You,18,21,33,8.0,24,For You,24.0,3,-9,-6,3,1,down,1975-01-04
453,Eddie Kendricks,1975-02-01,Eddie Kendricks - For You,24,18,40,8.0,33,For You,24.0,4,-7,-9,-6,1,down,1975-01-04
454,Eddie Kendricks,1975-02-08,Eddie Kendricks - For You,33,24,30,8.0,40,For You,24.0,5,10,-7,-9,1,up,1975-01-04
455,Eddie Kendricks,1975-02-15,Eddie Kendricks - For You,40,33,20,8.0,30,For You,24.0,6,10,10,-7,1,up,1975-01-04
456,Eddie Kendricks,1975-02-22,Eddie Kendricks - For You,30,40,16,8.0,20,For You,24.0,7,4,10,10,1,up,1975-01-04
457,Eddie Kendricks,1975-03-01,Eddie Kendricks - For You,20,30,10,8.0,16,For You,24.0,8,6,4,10,1,up,1975-01-04
458,Eddie Kendricks,1975-03-08,Eddie Kendricks - For You,16,20,8,8.0,10,For You,24.0,9,2,6,4,1,up,1975-01-04
459,Eddie Kendricks,1975-03-15,Eddie Kendricks - For You,10,16,16,8.0,8,For You,24.0,10,-8,2,6,1,down,1975-01-04
460,Eddie Kendricks,1975-03-22,Eddie Kendricks - For You,8,10,26,8.0,16,For You,24.0,11,-10,-8,2,1,down,1975-01-04
461,Eddie Kendricks,1975-03-29,Eddie Kendricks - For You,16,8,30,8.0,26,For You,24.0,12,-4,-10,-8,1,down,1975-01-04
462,Eddie Kendricks,1975-04-05,Eddie Kendricks - For You,26,16,29,8.0,30,For You,24.0,13,1,-4,-10,1,up,1975-01-04
463,Eddie Kendricks,1975-04-12,Eddie Kendricks - For You,30,26,22,8.0,29,For You,24.0,14,7,1,-4,1,up,1975-01-04
464,Eddie Kendricks,1975-04-19,Eddie Kendricks - For You,29,30,16,8.0,22,For You,24.0,15,6,7,1,1,up,1975-01-04
465,Eddie Kendricks,1975-04-26,Eddie Kendricks - For You,22,29,11,8.0,16,For You,24.0,16,5,6,7,1,up,1975-01-04
466,Eddie Kendricks,1975-05-03,Eddie Kendricks - For You,16,22,10,8.0,11,For You,24.0,17,1,5,6,1,up,1975-01-04
467,Eddie Kendricks,1975-05-10,Eddie Kendricks - For You,11,16,18,8.0,10,For You,24.0,18,-8,1,5,1,down,1975-01-04
468,Eddie Kendricks,1975-05-17,Eddie Kendricks - For You,10,11,33,8.0,18,For You,24.0,19,-15,-8,1,1,down,1975-01-04
469,Eddie Kendricks,1975-05-24,Eddie Kendricks - For You,18,10,30,8.0,33,For You,24.0,20,3,-15,-8,1,up,1975-01-04
470,Eddie Kendricks,1975-05-31,Eddie Kendricks - For You,33,18,28,8.0,30,For You,24.0,21,2,3,-15,1,up,1975-01-04
471,Eddie Kendricks,1975-06-07,Eddie Kendricks - For You,30,33,26,8.0,28,For You,24.0,22,2,2,3,1,up,1975-01-04
472,Eddie Kendricks,1975-06-14,Eddie Kendricks - For You,28,30,41,8.0,26,For You,24.0,23,-15,2,2,1,down,1975-01-04
473,Eddie Kendricks,1975-06-21,Eddie Kendricks - For You,26,28,51,8.0,41,For You,24.0,24,-10,-15,2,1,down,1975-01-04
474,Freddie Hubbard,1975-01-04,Freddie Hubbard - The Baddest Hubbard,51,51,28,16.0,34,The Baddest Hubbard,8.0,0,6,17,0,1,up,1975-01-04
475,Freddie Hubbard,1975-01-11,Freddie Hubbard - The Baddest Hubbard,34,51,22,16.0,28,The Baddest Hubbard,8.0,1,6,6,17,1,up,1975-01-04
476,Freddie Hubbard,1975-01-18,Freddie Hubbard - The Baddest Hubbard,28,34,17,16.0,22,The Baddest Hubbard,8.0,2,5,6,6,1,up,1975-01-04
477,Freddie Hubbard,1975-01-25,Freddie Hubbard - The Baddest Hubbard,22,28,16,16.0,17,The Baddest Hubbard,8.0,3,1,5,6,1,up,1975-01-04
478,Freddie Hubbard,1975-02-01,Freddie Hubbard - The Baddest Hubbard,17,22,16,16.0,16,The Baddest Hubbard,8.0,4,0,1,5,0,stay,1975-01-04
479,Freddie Hubbard,1975-02-08,Freddie Hubbard - The Baddest Hubbard,16,17,22,16.0,16,The Baddest Hubbard,8.0,5,-6,0,1,1,down,1975-01-04
480,Freddie Hubbard,1975-02-15,Freddie Hubbard - The Baddest Hubbard,16,16,38,16.0,22,The Baddest Hubbard,8.0,6,-16,-6,0,1,down,1975-01-04
481,Freddie Hubbard,1975-02-22,Freddie Hubbard - The Baddest Hubbard,22,16,48,16.0,38,The Baddest Hubbard,8.0,7,-10,-16,-6,1,down,1975-01-04
482,Freddie Hubbard,1975-03-01,Freddie Hubbard - The Baddest Hubbard,38,22,51,16.0,48,The Baddest Hubbard,8.0,8,-3,-10,-16,1,down,1975-01-04
483,Rufus And Chaka Khan,1975-01-04,Rufus And Chaka Khan - Rufusized,51,51,24,2.0,35,Rufusized,28.0,0,11,16,0,1,up,1975-01-04
484,Rufus And Chaka Khan,1975-01-11,Rufus And Chaka Khan - Rufusized,35,51,19,2.0,24,Rufusized,28.0,1,5,11,16,1,up,1975-01-04
485,Rufus And Chaka Khan,1975-01-18,Rufus And Chaka Khan - Rufusized,24,35,11,2.0,19,Rufusized,28.0,2,8,5,11,1,up,1975-01-04
486,Rufus And Chaka Khan,1975-01-25,Rufus And Chaka Khan - Rufusized,19,24,9,2.0,11,Rufusized,28.0,3,2,8,5,1,up,1975-01-04
487,Rufus And Chaka Khan,1975-02-01,Rufus And Chaka Khan - Rufusized,11,19,7,2.0,9,Rufusized,28.0,4,2,2,8,1,up,1975-01-04
488,Rufus And Chaka Khan,1975-02-08,Rufus And Chaka Khan - Rufusized,9,11,7,2.0,7,Rufusized,28.0,5,0,2,2,0,stay,1975-01-04
489,Rufus And Chaka Khan,1975-02-15,Rufus And Chaka Khan - Rufusized,7,9,4,2.0,7,Rufusized,28.0,6,3,0,2,1,up,1975-01-04
490,Rufus And Chaka Khan,1975-02-22,Rufus And Chaka Khan - Rufusized,7,7,3,2.0,4,Rufusized,28.0,7,1,3,0,1,up,1975-01-04
491,Rufus And Chaka Khan,1975-03-01,Rufus And Chaka Khan - Rufusized,4,7,3,2.0,3,Rufusized,28.0,8,0,1,3,0,stay,1975-01-04
492,Rufus And Chaka Khan,1975-03-08,Rufus And Chaka Khan - Rufusized,3,4,6,2.0,3,Rufusized,28.0,9,-3,0,1,1,down,1975-01-04
493,Rufus And Chaka Khan,1975-03-15,Rufus And Chaka Khan - Rufusized,3,3,4,2.0,6,Rufusized,28.0,10,2,-3,0,1,up,1975-01-04
494,Rufus And Chaka Khan,1975-03-22,Rufus And Chaka Khan - Rufusized,6,3,3,2.0,4,Rufusized,28.0,11,1,2,-3,1,up,1975-01-04
495,Rufus And Chaka Khan,1975-03-29,Rufus And Chaka Khan - Rufusized,4,6,2,2.0,3,Rufusized,28.0,12,1,1,2,1,up,1975-01-04
496,Rufus And Chaka Khan,1975-04-05,Rufus And Chaka Khan - Rufusized,3,4,2,2.0,2,Rufusized,28.0,13,0,1,1,0,stay,1975-01-04
497,Rufus And Chaka Khan,1975-04-12,Rufus And Chaka Khan - Rufusized,2,3,3,2.0,2,Rufusized,28.0,14,-1,0,1,1,down,1975-01-04
498,Rufus And Chaka Khan,1975-04-19,Rufus And Chaka Khan - Rufusized,2,2,9,2.0,3,Rufusized,28.0,15,-6,-1,0,1,down,1975-01-04
499,Rufus And Chaka Khan,1975-04-26,Rufus And Chaka Khan - Rufusized,3,2,15,2.0,9,Rufusized,28.0,16,-6,-6,-1,1,down,1975-01-04
500,Rufus And Chaka Khan,1975-05-03,Rufus And Chaka Khan - Rufusized,9,3,22,2.0,15,Rufusized,28.0,17,-7,-6,-6,1,down,1975-01-04
501,Rufus And Chaka Khan,1975-05-10,Rufus And Chaka Khan - Rufusized,15,9,19,2.0,22,Rufusized,28.0,18,3,-7,-6,1,up,1975-01-04
502,Rufus And Chaka Khan,1975-05-17,Rufus And Chaka Khan - Rufusized,22,15,16,2.0,19,Rufusized,28.0,19,3,3,-7,1,up,1975-01-04
503,Rufus And Chaka Khan,1975-05-24,Rufus And Chaka Khan - Rufusized,19,22,10,2.0,16,Rufusized,28.0,20,6,3,3,1,up,1975-01-04
504,Rufus And Chaka Khan,1975-05-31,Rufus And Chaka Khan - Rufusized,16,19,9,2.0,10,Rufusized,28.0,21,1,6,3,1,up,1975-01-04
505,Rufus And Chaka Khan,1975-06-07,Rufus And Chaka Khan - Rufusized,10,16,17,2.0,9,Rufusized,28.0,22,-8,1,6,1,down,1975-01-04
506,Rufus And Chaka Khan,1975-06-14,Rufus And Chaka Khan - Rufusized,9,10,15,2.0,17,Rufusized,28.0,23,2,-8,1,1,up,1975-01-04
507,Rufus And Chaka Khan,1975-06-21,Rufus And Chaka Khan - Rufusized,17,9,10,2.0,15,Rufusized,28.0,24,5,2,-8,1,up,1975-01-04
508,Rufus And Chaka Khan,1975-06-28,Rufus And Chaka Khan - Rufusized,15,17,9,2.0,10,Rufusized,28.0,25,1,5,2,1,up,1975-01-04
509,Rufus And Chaka Khan,1975-07-05,Rufus And Chaka Khan - Rufusized,10,15,21,2.0,9,Rufusized,28.0,26,-12,1,5,1,down,1975-01-04
510,Rufus And Chaka Khan,1975-07-12,Rufus And Chaka Khan - Rufusized,9,10,43,2.0,21,Rufusized,28.0,27,-22,-12,1,1,down,1975-01-04
511,Rufus And Chaka Khan,1975-07-19,Rufus And Chaka Khan - Rufusized,21,9,51,2.0,43,Rufusized,28.0,28,-8,-22,-12,1,down,1975-01-04
512,Carl Douglas,1975-01-04,Carl Douglas - Kung Fu Fighting And Other Great Love Songs,51,51,23,1.0,36,Kung Fu Fighting And Other Great Love Songs,10.0,0,13,15,0,1,up,1975-01-04
513,Carl Douglas,1975-01-11,Carl Douglas - Kung Fu Fighting And Other Great Love Songs,36,51,17,1.0,23,Kung Fu Fighting And Other Great Love Songs,10.0,1,6,13,15,1,up,1975-01-04
514,Carl Douglas,1975-01-18,Carl Douglas - Kung Fu Fighting And Other Great Love Songs,23,36,7,1.0,17,Kung Fu Fighting And Other Great Love Songs,10.0,2,10,6,13,1,up,1975-01-04
515,Carl Douglas,1975-01-25,Carl Douglas - Kung Fu Fighting And Other Great Love Songs,17,23,2,1.0,7,Kung Fu Fighting And Other Great Love Songs,10.0,3,5,10,6,1,up,1975-01-04
516,Carl Douglas,1975-02-01,Carl Douglas - Kung Fu Fighting And Other Great Love Songs,7,17,1,1.0,2,Kung Fu Fighting And Other Great Love Songs,10.0,4,1,5,10,1,up,1975-01-04
517,Carl Douglas,1975-02-08,Carl Douglas - Kung Fu Fighting And Other Great Love Songs,2,7,3,1.0,1,Kung Fu Fighting And Other Great Love Songs,10.0,5,-2,1,5,1,down,1975-01-04
518,Carl Douglas,1975-02-15,Carl Douglas - Kung Fu Fighting And Other Great Love Songs,1,2,6,1.0,3,Kung Fu Fighting And Other Great Love Songs,10.0,6,-3,-2,1,1,down,1975-01-04
519,Carl Douglas,1975-02-22,Carl Douglas - Kung Fu Fighting And Other Great Love Songs,3,1,13,1.0,6,Kung Fu Fighting And Other Great Love Songs,10.0,7,-7,-3,-2,1,down,1975-01-04
520,Carl Douglas,1975-03-01,Carl Douglas - Kung Fu Fighting And Other Great Love Songs,6,3,24,1.0,13,Kung Fu Fighting And Other Great Love Songs,10.0,8,-11,-7,-3,1,down,1975-01-04
521,Carl Douglas,1975-03-08,Carl Douglas - Kung Fu Fighting And Other Great Love Songs,13,6,36,1.0,24,Kung Fu Fighting And Other Great Love Songs,10.0,9,-12,-11,-7,1,down,1975-01-04
522,Carl Douglas,1975-03-15,Carl Douglas - Kung Fu Fighting And Other Great Love Songs,24,13,51,1.0,36,Kung Fu Fighting And Other Great Love Songs,10.0,10,-15,-12,-11,1,down,1975-01-04
523,Quincy Jones,1975-01-04,Quincy Jones - Body Heat,51,51,44,14.0,37,Body Heat,8.0,0,-7,14,0,1,down,1975-01-04
524,Quincy Jones,1975-01-11,Quincy Jones - Body Heat,37,51,38,14.0,44,Body Heat,8.0,1,6,-7,14,1,up,1975-01-04
525,Quincy Jones,1975-01-18,Quincy Jones - Body Heat,44,37,30,14.0,38,Body Heat,8.0,2,8,6,-7,1,up,1975-01-04
526,Quincy Jones,1975-01-25,Quincy Jones - Body Heat,38,44,27,14.0,30,Body Heat,8.0,3,3,8,6,1,up,1975-01-04
527,Quincy Jones,1975-02-01,Quincy Jones - Body Heat,30,38,20,14.0,27,Body Heat,8.0,4,7,3,8,1,up,1975-01-04
528,Quincy Jones,1975-02-08,Quincy Jones - Body Heat,27,30,16,14.0,20,Body Heat,8.0,5,4,7,3,1,up,1975-01-04
529,Quincy Jones,1975-02-15,Quincy Jones - Body Heat,20,27,14,14.0,16,Body Heat,8.0,6,2,4,7,1,up,1975-01-04
530,Quincy Jones,1975-02-22,Quincy Jones - Body Heat,16,20,30,14.0,14,Body Heat,8.0,7,-16,2,4,1,down,1975-01-04
531,Quincy Jones,1975-03-01,Quincy Jones - Body Heat,14,16,51,14.0,30,Body Heat,8.0,8,-21,-16,2,1,down,1975-01-04
532,Herbie Hancock,1975-01-04,Herbie Hancock - Death Wish,51,51,42,38.0,38,Death Wish,3.0,0,-4,13,0,1,down,1975-01-04
533,Herbie Hancock,1975-01-11,Herbie Hancock - Death Wish,38,51,41,38.0,42,Death Wish,3.0,1,1,-4,13,1,up,1975-01-04
534,Herbie Hancock,1975-01-18,Herbie Hancock - Death Wish,42,38,50,38.0,41,Death Wish,3.0,2,-9,1,-4,1,down,1975-01-04
535,Herbie Hancock,1975-01-25,Herbie Hancock - Death Wish,41,42,51,38.0,50,Death Wish,3.0,3,-1,-9,1,1,down,1975-01-04
536,Ohio Players,1975-01-04,Ohio Players - Climax,51,51,50,39.0,39,Climax,1.0,0,-11,12,0,1,down,1975-01-04
537,Ohio Players,1975-01-11,Ohio Players - Climax,39,51,51,39.0,50,Climax,1.0,1,-1,-11,12,1,down,1975-01-04
538,David Ruffin,1975-01-04,David Ruffin - Me 'N Rock 'N Roll Are Here To Stay,51,51,38,37.0,40,Me 'N Rock 'N Roll Are Here To Stay,4.0,0,2,11,0,1,up,1975-01-04
539,David Ruffin,1975-01-11,David Ruffin - Me 'N Rock 'N Roll Are Here To Stay,40,51,37,37.0,38,Me 'N Rock 'N Roll Are Here To Stay,4.0,1,1,2,11,1,up,1975-01-04
540,David Ruffin,1975-01-18,David Ruffin - Me 'N Rock 'N Roll Are Here To Stay,38,40,43,37.0,37,Me 'N Rock 'N Roll Are Here To Stay,4.0,2,-6,1,2,1,down,1975-01-04
541,David Ruffin,1975-01-25,David Ruffin - Me 'N Rock 'N Roll Are Here To Stay,37,38,46,37.0,43,Me 'N Rock 'N Roll Are Here To Stay,4.0,3,-3,-6,1,1,down,1975-01-04
542,David Ruffin,1975-02-01,David Ruffin - Me 'N Rock 'N Roll Are Here To Stay,43,37,51,37.0,46,Me 'N Rock 'N Roll Are Here To Stay,4.0,4,-5,-3,-6,1,down,1975-01-04
543,James Brown,1975-01-04,James Brown - Hell,51,51,47,41.0,41,Hell,1.0,0,-6,10,0,1,down,1975-01-04
544,James Brown,1975-01-18,James Brown - Hell,41,51,51,41.0,47,Hell,1.0,1,-4,-6,10,1,down,1975-01-04
545,Freddie Hubbard,1975-01-04,Freddie Hubbard - High Energy,51,51,37,23.0,42,High Energy,7.0,0,5,9,0,1,up,1975-01-04
546,Freddie Hubbard,1975-01-11,Freddie Hubbard - High Energy,42,51,34,23.0,37,High Energy,7.0,1,3,5,9,1,up,1975-01-04
547,Freddie Hubbard,1975-01-18,Freddie Hubbard - High Energy,37,42,31,23.0,34,High Energy,7.0,2,3,3,5,1,up,1975-01-04
548,Freddie Hubbard,1975-01-25,Freddie Hubbard - High Energy,34,37,25,23.0,31,High Energy,7.0,3,6,3,3,1,up,1975-01-04
549,Freddie Hubbard,1975-02-01,Freddie Hubbard - High Energy,31,34,23,23.0,25,High Energy,7.0,4,2,6,3,1,up,1975-01-04
550,Freddie Hubbard,1975-02-08,Freddie Hubbard - High Energy,25,31,33,23.0,23,High Energy,7.0,5,-10,2,6,1,down,1975-01-04
551,Freddie Hubbard,1975-02-15,Freddie Hubbard - High Energy,23,25,42,23.0,33,High Energy,7.0,6,-9,-10,2,1,down,1975-01-04
552,Freddie Hubbard,1975-02-22,Freddie Hubbard - High Energy,33,23,51,23.0,42,High Energy,7.0,7,-9,-9,-10,1,down,1975-01-04
553,Marvin Gaye,1975-01-04,Marvin Gaye - Marvin Gaye Live!,51,51,50,33.0,43,Marvin Gaye Live!,6.0,0,-7,8,0,1,down,1975-01-04
554,Marvin Gaye,1975-01-18,Marvin Gaye - Marvin Gaye Live!,43,51,45,33.0,50,Marvin Gaye Live!,6.0,1,5,-7,8,1,up,1975-01-04
555,Marvin Gaye,1975-01-25,Marvin Gaye - Marvin Gaye Live!,50,43,47,33.0,45,Marvin Gaye Live!,6.0,2,-2,5,-7,1,down,1975-01-04
556,Marvin Gaye,1975-02-15,Marvin Gaye - Marvin Gaye Live!,45,50,37,33.0,47,Marvin Gaye Live!,6.0,3,10,-2,5,1,up,1975-01-04
557,Marvin Gaye,1975-02-22,Marvin Gaye - Marvin Gaye Live!,47,45,33,33.0,37,Marvin Gaye Live!,6.0,4,4,10,-2,1,up,1975-01-04
558,Marvin Gaye,1975-03-01,Marvin Gaye - Marvin Gaye Live!,37,47,42,33.0,33,Marvin Gaye Live!,6.0,5,-9,4,10,1,down,1975-01-04
559,Marvin Gaye,1975-03-08,Marvin Gaye - Marvin Gaye Live!,33,37,51,33.0,42,Marvin Gaye Live!,6.0,6,-9,-9,4,1,down,1975-01-04
560,Miles Davis,1975-01-04,Miles Davis - Get Up With It,51,51,36,33.0,44,Get Up With It,5.0,0,8,7,0,1,up,1975-01-04
561,Miles Davis,1975-01-11,Miles Davis - Get Up With It,44,51,33,33.0,36,Get Up With It,5.0,1,3,8,7,1,up,1975-01-04
562,Miles Davis,1975-01-18,Miles Davis - Get Up With It,36,44,38,33.0,33,Get Up With It,5.0,2,-5,3,8,1,down,1975-01-04
563,Miles Davis,1975-01-25,Miles Davis - Get Up With It,33,36,43,33.0,38,Get Up With It,5.0,3,-5,-5,3,1,down,1975-01-04
564,Miles Davis,1975-02-01,Miles Davis - Get Up With It,38,33,49,33.0,43,Get Up With It,5.0,4,-6,-5,-5,1,down,1975-01-04
565,Miles Davis,1975-02-08,Miles Davis - Get Up With It,43,38,51,33.0,49,Get Up With It,5.0,5,-2,-6,-5,1,down,1975-01-04
566,Cannonball Adderley,1975-01-04,Cannonball Adderley - Pyramid,51,51,48,45.0,45,Pyramid,1.0,0,-3,6,0,1,down,1975-01-04
567,Cannonball Adderley,1975-01-11,Cannonball Adderley - Pyramid,45,51,51,45.0,48,Pyramid,1.0,1,-3,-3,6,1,down,1975-01-04
568,Ramsey Lewis,1975-01-04,Ramsey Lewis - Sun Goddess,51,51,32,1.0,46,Sun Goddess,32.0,0,14,5,0,1,up,1975-01-04
569,Ramsey Lewis,1975-01-11,Ramsey Lewis - Sun Goddess,46,51,25,1.0,32,Sun Goddess,32.0,1,7,14,5,1,up,1975-01-04
570,Ramsey Lewis,1975-01-18,Ramsey Lewis - Sun Goddess,32,46,23,1.0,25,Sun Goddess,32.0,2,2,7,14,1,up,1975-01-04
571,Ramsey Lewis,1975-01-25,Ramsey Lewis - Sun Goddess,25,32,21,1.0,23,Sun Goddess,32.0,3,2,2,7,1,up,1975-01-04
572,Ramsey Lewis,1975-02-01,Ramsey Lewis - Sun Goddess,23,25,18,1.0,21,Sun Goddess,32.0,4,3,2,2,1,up,1975-01-04
573,Ramsey Lewis,1975-02-08,Ramsey Lewis - Sun Goddess,21,23,12,1.0,18,Sun Goddess,32.0,5,6,3,2,1,up,1975-01-04
574,Ramsey Lewis,1975-02-15,Ramsey Lewis - Sun Goddess,18,21,9,1.0,12,Sun Goddess,32.0,6,3,6,3,1,up,1975-01-04
575,Ramsey Lewis,1975-02-22,Ramsey Lewis - Sun Goddess,12,18,6,1.0,9,Sun Goddess,32.0,7,3,3,6,1,up,1975-01-04
576,Ramsey Lewis,1975-03-01,Ramsey Lewis - Sun Goddess,9,12,6,1.0,6,Sun Goddess,32.0,8,0,3,3,0,stay,1975-01-04
577,Ramsey Lewis,1975-03-08,Ramsey Lewis - Sun Goddess,6,9,4,1.0,6,Sun Goddess,32.0,9,2,0,3,1,up,1975-01-04
578,Ramsey Lewis,1975-03-15,Ramsey Lewis - Sun Goddess,6,6,8,1.0,4,Sun Goddess,32.0,10,-4,2,0,1,down,1975-01-04
579,Ramsey Lewis,1975-03-22,Ramsey Lewis - Sun Goddess,4,6,10,1.0,8,Sun Goddess,32.0,11,-2,-4,2,1,down,1975-01-04
580,Ramsey Lewis,1975-03-29,Ramsey Lewis - Sun Goddess,8,4,18,1.0,10,Sun Goddess,32.0,12,-8,-2,-4,1,down,1975-01-04
581,Ramsey Lewis,1975-04-05,Ramsey Lewis - Sun Goddess,10,8,16,1.0,18,Sun Goddess,32.0,13,2,-8,-2,1,up,1975-01-04
582,Ramsey Lewis,1975-04-12,Ramsey Lewis - Sun Goddess,18,10,16,1.0,16,Sun Goddess,32.0,14,0,2,-8,0,stay,1975-01-04
583,Ramsey Lewis,1975-04-19,Ramsey Lewis - Sun Goddess,16,18,10,1.0,16,Sun Goddess,32.0,15,6,0,2,1,up,1975-01-04
584,Ramsey Lewis,1975-04-26,Ramsey Lewis - Sun Goddess,16,16,7,1.0,10,Sun Goddess,32.0,16,3,6,0,1,up,1975-01-04
585,Ramsey Lewis,1975-05-03,Ramsey Lewis - Sun Goddess,10,16,4,1.0,7,Sun Goddess,32.0,17,3,3,6,1,up,1975-01-04
586,Ramsey Lewis,1975-05-10,Ramsey Lewis - Sun Goddess,7,10,2,1.0,4,Sun Goddess,32.0,18,2,3,3,1,up,1975-01-04
587,Ramsey Lewis,1975-05-17,Ramsey Lewis - Sun Goddess,4,7,1,1.0,2,Sun Goddess,32.0,19,1,2,3,1,up,1975-01-04
588,Ramsey Lewis,1975-05-24,Ramsey Lewis - Sun Goddess,2,4,3,1.0,1,Sun Goddess,32.0,20,-2,1,2,1,down,1975-01-04
589,Ramsey Lewis,1975-05-31,Ramsey Lewis - Sun Goddess,1,2,3,1.0,3,Sun Goddess,32.0,21,0,-2,1,0,stay,1975-01-04
590,Ramsey Lewis,1975-06-07,Ramsey Lewis - Sun Goddess,3,1,2,1.0,3,Sun Goddess,32.0,22,1,0,-2,1,up,1975-01-04
591,Ramsey Lewis,1975-06-14,Ramsey Lewis - Sun Goddess,3,3,5,1.0,2,Sun Goddess,32.0,23,-3,1,0,1,down,1975-01-04
592,Ramsey Lewis,1975-06-21,Ramsey Lewis - Sun Goddess,2,3,7,1.0,5,Sun Goddess,32.0,24,-2,-3,1,1,down,1975-01-04
593,Ramsey Lewis,1975-06-28,Ramsey Lewis - Sun Goddess,5,2,5,1.0,7,Sun Goddess,32.0,25,2,-2,-3,1,up,1975-01-04
594,Ramsey Lewis,1975-07-05,Ramsey Lewis - Sun Goddess,7,5,3,1.0,5,Sun Goddess,32.0,26,2,2,-2,1,up,1975-01-04
595,Ramsey Lewis,1975-07-12,Ramsey Lewis - Sun Goddess,5,7,5,1.0,3,Sun Goddess,32.0,27,-2,2,2,1,down,1975-01-04
596,Ramsey Lewis,1975-07-19,Ramsey Lewis - Sun Goddess,3,5,13,1.0,5,Sun Goddess,32.0,28,-8,-2,2,1,down,1975-01-04
597,Ramsey Lewis,1975-07-26,Ramsey Lewis - Sun Goddess,5,3,17,1.0,13,Sun Goddess,32.0,29,-4,-8,-2,1,down,1975-01-04
598,Ramsey Lewis,1975-08-02,Ramsey Lewis - Sun Goddess,13,5,23,1.0,17,Sun Goddess,32.0,30,-6,-4,-8,1,down,1975-01-04
599,Ramsey Lewis,1975-08-09,Ramsey Lewis - Sun Goddess,17,13,37,1.0,23,Sun Goddess,32.0,31,-14,-6,-4,1,down,1975-01-04
600,Ramsey Lewis,1975-08-16,Ramsey Lewis - Sun Goddess,23,17,51,1.0,37,Sun Goddess,32.0,32,-14,-14,-6,1,down,1975-01-04
601,The Independents,1975-01-04,The Independents - Discs Of Gold,51,51,51,47.0,47,Discs Of Gold,0.0,0,-4,4,0,1,down,1975-01-04
602,The Tymes,1975-01-04,The Tymes - Trustmaker,51,51,46,46.0,48,Trustmaker,1.0,0,2,3,0,1,up,1975-01-04
603,The Tymes,1975-01-11,The Tymes - Trustmaker,48,51,51,46.0,46,Trustmaker,1.0,1,-5,2,3,1,down,1975-01-04
604,Bobby Bland,1975-01-04,Bobby Bland - Dreamer,51,51,45,26.0,49,Dreamer,5.0,0,4,2,0,1,up,1975-01-04
605,Bobby Bland,1975-01-11,Bobby Bland - Dreamer,49,51,36,26.0,45,Dreamer,5.0,1,9,4,2,1,up,1975-01-04
606,Bobby Bland,1975-01-18,Bobby Bland - Dreamer,45,49,29,26.0,36,Dreamer,5.0,2,7,9,4,1,up,1975-01-04
607,Bobby Bland,1975-01-25,Bobby Bland - Dreamer,36,45,26,26.0,29,Dreamer,5.0,3,3,7,9,1,up,1975-01-04
608,Bobby Bland,1975-02-01,Bobby Bland - Dreamer,29,36,34,26.0,26,Dreamer,5.0,4,-8,3,7,1,down,1975-01-04
609,Bobby Bland,1975-02-08,Bobby Bland - Dreamer,26,29,51,26.0,34,Dreamer,5.0,5,-17,-8,3,1,down,1975-01-04
610,Willie Hutch,1975-01-04,Willie Hutch - The Mark Of The Beast,51,51,49,41.0,50,The Mark Of The Beast,8.0,0,1,1,0,1,up,1975-01-04
611,Willie Hutch,1975-01-11,Willie Hutch - The Mark Of The Beast,50,51,47,41.0,49,The Mark Of The Beast,8.0,1,2,1,1,1,up,1975-01-04
612,Willie Hutch,1975-03-22,Willie Hutch - The Mark Of The Beast,49,50,41,41.0,47,The Mark Of The Beast,8.0,2,6,2,1,1,up,1975-01-04
613,Willie Hutch,1975-03-29,Willie Hutch - The Mark Of The Beast,47,49,41,41.0,41,The Mark Of The Beast,8.0,3,0,6,2,0,stay,1975-01-04
614,Willie Hutch,1975-04-05,Willie Hutch - The Mark Of The Beast,41,47,48,41.0,41,The Mark Of The Beast,8.0,4,-7,0,6,1,down,1975-01-04
615,Willie Hutch,1975-04-12,Willie Hutch - The Mark Of The Beast,41,41,50,41.0,48,The Mark Of The Beast,8.0,5,-2,-7,0,1,down,1975-01-04
616,Willie Hutch,1975-05-17,Willie Hutch - The Mark Of The Beast,48,41,47,41.0,50,The Mark Of The Beast,8.0,6,3,-2,-7,1,up,1975-01-04
617,Willie Hutch,1975-05-24,Willie Hutch - The Mark Of The Beast,50,48,47,41.0,47,The Mark Of The Beast,8.0,7,0,3,-2,0,stay,1975-01-04
618,Willie Hutch,1975-05-31,Willie Hutch - The Mark Of The Beast,47,50,51,41.0,47,The Mark Of The Beast,8.0,8,-4,0,3,1,down,1975-01-04
619,Billy Cobham,1975-01-11,Billy Cobham - Total Eclipse,51,51,28,12.0,39,Total Eclipse,8.0,0,11,12,0,1,up,1975-01-11
620,Billy Cobham,1975-01-18,Billy Cobham - Total Eclipse,39,51,18,12.0,28,Total Eclipse,8.0,1,10,11,12,1,up,1975-01-11
621,Billy Cobham,1975-01-25,Billy Cobham - Total Eclipse,28,39,15,12.0,18,Total Eclipse,8.0,2,3,10,11,1,up,1975-01-11
622,Billy Cobham,1975-02-01,Billy Cobham - Total Eclipse,18,28,12,12.0,15,Total Eclipse,8.0,3,3,3,10,1,up,1975-01-11
623,Billy Cobham,1975-02-08,Billy Cobham - Total Eclipse,15,18,19,12.0,12,Total Eclipse,8.0,4,-7,3,3,1,down,1975-01-11
624,Billy Cobham,1975-02-15,Billy Cobham - Total Eclipse,12,15,17,12.0,19,Total Eclipse,8.0,5,2,-7,3,1,up,1975-01-11
625,Billy Cobham,1975-02-22,Billy Cobham - Total Eclipse,19,12,17,12.0,17,Total Eclipse,8.0,6,0,2,-7,0,stay,1975-01-11
626,Billy Cobham,1975-03-01,Billy Cobham - Total Eclipse,17,19,40,12.0,17,Total Eclipse,8.0,7,-23,0,2,1,down,1975-01-11
627,Billy Cobham,1975-03-08,Billy Cobham - Total Eclipse,17,17,51,12.0,40,Total Eclipse,8.0,8,-11,-23,0,1,down,1975-01-11
628,Blue Magic,1975-01-11,Blue Magic - The Magic Of The Blue,51,51,31,14.0,43,The Magic Of The Blue,13.0,0,12,8,0,1,up,1975-01-11
629,Blue Magic,1975-01-18,Blue Magic - The Magic Of The Blue,43,51,25,14.0,31,The Magic Of The Blue,13.0,1,6,12,8,1,up,1975-01-11
630,Blue Magic,1975-01-25,Blue Magic - The Magic Of The Blue,31,43,20,14.0,25,The Magic Of The Blue,13.0,2,5,6,12,1,up,1975-01-11
631,Blue Magic,1975-02-01,Blue Magic - The Magic Of The Blue,25,31,14,14.0,20,The Magic Of The Blue,13.0,3,6,5,6,1,up,1975-01-11
632,Blue Magic,1975-02-08,Blue Magic - The Magic Of The Blue,20,25,14,14.0,14,The Magic Of The Blue,13.0,4,0,6,5,0,stay,1975-01-11
633,Blue Magic,1975-02-15,Blue Magic - The Magic Of The Blue,14,20,18,14.0,14,The Magic Of The Blue,13.0,5,-4,0,6,1,down,1975-01-11
634,Blue Magic,1975-02-22,Blue Magic - The Magic Of The Blue,14,14,32,14.0,18,The Magic Of The Blue,13.0,6,-14,-4,0,1,down,1975-01-11
635,Blue Magic,1975-03-01,Blue Magic - The Magic Of The Blue,18,14,28,14.0,32,The Magic Of The Blue,13.0,7,4,-14,-4,1,up,1975-01-11
636,Blue Magic,1975-03-08,Blue Magic - The Magic Of The Blue,32,18,26,14.0,28,The Magic Of The Blue,13.0,8,2,4,-14,1,up,1975-01-11
637,Blue Magic,1975-03-15,Blue Magic - The Magic Of The Blue,28,32,19,14.0,26,The Magic Of The Blue,13.0,9,7,2,4,1,up,1975-01-11
638,Blue Magic,1975-03-22,Blue Magic - The Magic Of The Blue,26,28,18,14.0,19,The Magic Of The Blue,13.0,10,1,7,2,1,up,1975-01-11
639,Blue Magic,1975-03-29,Blue Magic - The Magic Of The Blue,19,26,22,14.0,18,The Magic Of The Blue,13.0,11,-4,1,7,1,down,1975-01-11
640,Blue Magic,1975-04-05,Blue Magic - The Magic Of The Blue,18,19,33,14.0,22,The Magic Of The Blue,13.0,12,-11,-4,1,1,down,1975-01-11
641,Blue Magic,1975-04-12,Blue Magic - The Magic Of The Blue,22,18,51,14.0,33,The Magic Of The Blue,13.0,13,-18,-11,-4,1,down,1975-01-11
642,Lamont Dozier,1975-01-11,Lamont Dozier - Black Bach,51,51,48,27.0,47,Black Bach,5.0,0,-1,4,0,1,down,1975-01-11
643,Lamont Dozier,1975-01-25,Lamont Dozier - Black Bach,47,51,37,27.0,48,Black Bach,5.0,1,11,-1,4,1,up,1975-01-11
644,Lamont Dozier,1975-02-01,Lamont Dozier - Black Bach,48,47,33,27.0,37,Black Bach,5.0,2,4,11,-1,1,up,1975-01-11
645,Lamont Dozier,1975-02-08,Lamont Dozier - Black Bach,37,48,27,27.0,33,Black Bach,5.0,3,6,4,11,1,up,1975-01-11
646,Lamont Dozier,1975-02-15,Lamont Dozier - Black Bach,33,37,39,27.0,27,Black Bach,5.0,4,-12,6,4,1,down,1975-01-11
647,Lamont Dozier,1975-02-22,Lamont Dozier - Black Bach,27,33,51,27.0,39,Black Bach,5.0,5,-12,-12,6,1,down,1975-01-11
648,Carl Carlton,1975-01-18,Carl Carlton - Everlasting Love,51,51,32,22.0,40,Everlasting Love,9.0,0,8,11,0,1,up,1975-01-18
649,Carl Carlton,1975-01-25,Carl Carlton - Everlasting Love,40,51,29,22.0,32,Everlasting Love,9.0,1,3,8,11,1,up,1975-01-18
650,Carl Carlton,1975-02-01,Carl Carlton - Everlasting Love,32,40,27,22.0,29,Everlasting Love,9.0,2,2,3,8,1,up,1975-01-18
651,Carl Carlton,1975-02-08,Carl Carlton - Everlasting Love,29,32,26,22.0,27,Everlasting Love,9.0,3,1,2,3,1,up,1975-01-18
652,Carl Carlton,1975-02-15,Carl Carlton - Everlasting Love,27,29,25,22.0,26,Everlasting Love,9.0,4,1,1,2,1,up,1975-01-18
653,Carl Carlton,1975-02-22,Carl Carlton - Everlasting Love,26,27,24,22.0,25,Everlasting Love,9.0,5,1,1,1,1,up,1975-01-18
654,Carl Carlton,1975-03-01,Carl Carlton - Everlasting Love,25,26,23,22.0,24,Everlasting Love,9.0,6,1,1,1,1,up,1975-01-18
655,Carl Carlton,1975-03-08,Carl Carlton - Everlasting Love,24,25,22,22.0,23,Everlasting Love,9.0,7,1,1,1,1,up,1975-01-18
656,Carl Carlton,1975-03-15,Carl Carlton - Everlasting Love,23,24,27,22.0,22,Everlasting Love,9.0,8,-5,1,1,1,down,1975-01-18
657,Carl Carlton,1975-03-22,Carl Carlton - Everlasting Love,22,23,51,22.0,27,Everlasting Love,9.0,9,-24,-5,1,1,down,1975-01-18
658,Ahmad Jamal,1975-01-18,Ahmad Jamal - Jamal Plays Jamal,51,51,42,41.0,44,Jamal Plays Jamal,2.0,0,2,7,0,1,up,1975-01-18
659,Ahmad Jamal,1975-01-25,Ahmad Jamal - Jamal Plays Jamal,44,51,41,41.0,42,Jamal Plays Jamal,2.0,1,1,2,7,1,up,1975-01-18
660,Ahmad Jamal,1975-02-01,Ahmad Jamal - Jamal Plays Jamal,42,44,51,41.0,41,Jamal Plays Jamal,2.0,2,-10,1,2,1,down,1975-01-18
661,Spinners,1975-01-18,Spinners - Mighty Love,51,51,33,17.0,45,Mighty Love,6.0,0,12,6,0,1,up,1975-01-18
662,Spinners,1975-01-25,Spinners - Mighty Love,45,51,24,17.0,33,Mighty Love,6.0,1,9,12,6,1,up,1975-01-18
663,Spinners,1975-02-01,Spinners - Mighty Love,33,45,19,17.0,24,Mighty Love,6.0,2,5,9,12,1,up,1975-01-18
664,Spinners,1975-02-08,Spinners - Mighty Love,24,33,17,17.0,19,Mighty Love,6.0,3,2,5,9,1,up,1975-01-18
665,Spinners,1975-02-15,Spinners - Mighty Love,19,24,26,17.0,17,Mighty Love,6.0,4,-9,2,5,1,down,1975-01-18
666,Spinners,1975-02-22,Spinners - Mighty Love,17,19,42,17.0,26,Mighty Love,6.0,5,-16,-9,2,1,down,1975-01-18
667,Spinners,1975-03-01,Spinners - Mighty Love,26,17,51,17.0,42,Mighty Love,6.0,6,-9,-16,-9,1,down,1975-01-18
668,Funk Inc,1975-01-18,Funk Inc - Priced To Sell,51,51,37,30.0,48,Priced To Sell,4.0,0,11,3,0,1,up,1975-01-18
669,Funk Inc,1975-01-25,Funk Inc - Priced To Sell,48,51,32,30.0,37,Priced To Sell,4.0,1,5,11,3,1,up,1975-01-18
670,Funk Inc,1975-02-01,Funk Inc - Priced To Sell,37,48,30,30.0,32,Priced To Sell,4.0,2,2,5,11,1,up,1975-01-18
671,Funk Inc,1975-02-08,Funk Inc - Priced To Sell,32,37,39,30.0,30,Priced To Sell,4.0,3,-9,2,5,1,down,1975-01-18
672,Funk Inc,1975-02-15,Funk Inc - Priced To Sell,30,32,51,30.0,39,Priced To Sell,4.0,4,-12,-9,2,1,down,1975-01-18
673,L.T.D.,1975-01-25,L.T.D. - Gittin' Down,51,51,45,40.0,49,Gittin' Down,4.0,0,4,2,0,1,up,1975-01-25
674,L.T.D.,1975-02-01,L.T.D. - Gittin' Down,49,51,42,40.0,45,Gittin' Down,4.0,1,3,4,2,1,up,1975-01-25
675,L.T.D.,1975-02-08,L.T.D. - Gittin' Down,45,49,41,40.0,42,Gittin' Down,4.0,2,1,3,4,1,up,1975-01-25
676,L.T.D.,1975-02-15,L.T.D. - Gittin' Down,42,45,40,40.0,41,Gittin' Down,4.0,3,1,1,3,1,up,1975-01-25
677,L.T.D.,1975-02-22,L.T.D. - Gittin' Down,41,42,51,40.0,40,Gittin' Down,4.0,4,-11,1,1,1,down,1975-01-25
678,James Brown,1975-02-01,James Brown - Reality,51,51,21,5.0,40,Reality,9.0,0,19,11,0,1,up,1975-02-01
679,James Brown,1975-02-08,James Brown - Reality,40,51,15,5.0,21,Reality,9.0,1,6,19,11,1,up,1975-02-01
680,James Brown,1975-02-15,James Brown - Reality,21,40,11,5.0,15,Reality,9.0,2,4,6,19,1,up,1975-02-01
681,James Brown,1975-02-22,James Brown - Reality,15,21,8,5.0,11,Reality,9.0,3,3,4,6,1,up,1975-02-01
682,James Brown,1975-03-01,James Brown - Reality,11,15,5,5.0,8,Reality,9.0,4,3,3,4,1,up,1975-02-01
683,James Brown,1975-03-08,James Brown - Reality,8,11,5,5.0,5,Reality,9.0,5,0,3,3,0,stay,1975-02-01
684,James Brown,1975-03-15,James Brown - Reality,5,8,13,5.0,5,Reality,9.0,6,-8,0,3,1,down,1975-02-01
685,James Brown,1975-03-22,James Brown - Reality,5,5,27,5.0,13,Reality,9.0,7,-14,-8,0,1,down,1975-02-01
686,James Brown,1975-03-29,James Brown - Reality,13,5,42,5.0,27,Reality,9.0,8,-15,-14,-8,1,down,1975-02-01
687,James Brown,1975-04-05,James Brown - Reality,27,13,51,5.0,42,Reality,9.0,9,-9,-15,-14,1,down,1975-02-01
688,Fred & The New J.B.'s,1975-02-01,Fred & The New J.B.'s - Breakin' Bread,51,51,39,36.0,49,Breakin' Bread,3.0,0,10,2,0,1,up,1975-02-01
689,Fred & The New J.B.'s,1975-02-08,Fred & The New J.B.'s - Breakin' Bread,49,51,36,36.0,39,Breakin' Bread,3.0,1,3,10,2,1,up,1975-02-01
690,Fred & The New J.B.'s,1975-02-15,Fred & The New J.B.'s - Breakin' Bread,39,49,43,36.0,36,Breakin' Bread,3.0,2,-7,3,10,1,down,1975-02-01
691,Fred & The New J.B.'s,1975-02-22,Fred & The New J.B.'s - Breakin' Bread,36,39,51,36.0,43,Breakin' Bread,3.0,3,-8,-7,3,1,down,1975-02-01
692,Michael Jackson,1975-02-08,"Michael Jackson - Forever, Michael",51,51,31,10.0,41,"Forever, Michael",11.0,0,10,10,0,1,up,1975-02-08
693,Michael Jackson,1975-02-15,"Michael Jackson - Forever, Michael",41,51,27,10.0,31,"Forever, Michael",11.0,1,4,10,10,1,up,1975-02-08
694,Michael Jackson,1975-02-22,"Michael Jackson - Forever, Michael",31,41,25,10.0,27,"Forever, Michael",11.0,2,2,4,10,1,up,1975-02-08
695,Michael Jackson,1975-03-01,"Michael Jackson - Forever, Michael",27,31,16,10.0,25,"Forever, Michael",11.0,3,9,2,4,1,up,1975-02-08
696,Michael Jackson,1975-03-08,"Michael Jackson - Forever, Michael",25,27,13,10.0,16,"Forever, Michael",11.0,4,3,9,2,1,up,1975-02-08
697,Michael Jackson,1975-03-15,"Michael Jackson - Forever, Michael",16,25,11,10.0,13,"Forever, Michael",11.0,5,2,3,9,1,up,1975-02-08
698,Michael Jackson,1975-03-22,"Michael Jackson - Forever, Michael",13,16,11,10.0,11,"Forever, Michael",11.0,6,0,2,3,0,stay,1975-02-08
699,Michael Jackson,1975-03-29,"Michael Jackson - Forever, Michael",11,13,10,10.0,11,"Forever, Michael",11.0,7,1,0,2,1,up,1975-02-08
700,Michael Jackson,1975-04-05,"Michael Jackson - Forever, Michael",11,11,15,10.0,10,"Forever, Michael",11.0,8,-5,1,0,1,down,1975-02-08
701,Michael Jackson,1975-04-12,"Michael Jackson - Forever, Michael",10,11,26,10.0,15,"Forever, Michael",11.0,9,-11,-5,1,1,down,1975-02-08
702,Michael Jackson,1975-04-19,"Michael Jackson - Forever, Michael",15,10,37,10.0,26,"Forever, Michael",11.0,10,-11,-11,-5,1,down,1975-02-08
703,Michael Jackson,1975-04-26,"Michael Jackson - Forever, Michael",26,15,51,10.0,37,"Forever, Michael",11.0,11,-14,-11,-11,1,down,1975-02-08
704,Shirley Brown,1975-02-08,Shirley Brown - Woman To Woman,51,51,29,11.0,45,Woman To Woman,11.0,0,16,6,0,1,up,1975-02-08
705,Shirley Brown,1975-02-15,Shirley Brown - Woman To Woman,45,51,16,11.0,29,Woman To Woman,11.0,1,13,16,6,1,up,1975-02-08
706,Shirley Brown,1975-02-22,Shirley Brown - Woman To Woman,29,45,12,11.0,16,Woman To Woman,11.0,2,4,13,16,1,up,1975-02-08
707,Shirley Brown,1975-03-01,Shirley Brown - Woman To Woman,16,29,11,11.0,12,Woman To Woman,11.0,3,1,4,13,1,up,1975-02-08
708,Shirley Brown,1975-03-08,Shirley Brown - Woman To Woman,12,16,24,11.0,11,Woman To Woman,11.0,4,-13,1,4,1,down,1975-02-08
709,Shirley Brown,1975-03-15,Shirley Brown - Woman To Woman,11,12,43,11.0,24,Woman To Woman,11.0,5,-19,-13,1,1,down,1975-02-08
710,Shirley Brown,1975-03-22,Shirley Brown - Woman To Woman,24,11,45,11.0,43,Woman To Woman,11.0,6,-2,-19,-13,1,down,1975-02-08
711,Shirley Brown,1975-04-05,Shirley Brown - Woman To Woman,43,24,31,11.0,45,Woman To Woman,11.0,7,14,-2,-19,1,up,1975-02-08
712,Shirley Brown,1975-04-12,Shirley Brown - Woman To Woman,45,43,29,11.0,31,Woman To Woman,11.0,8,2,14,-2,1,up,1975-02-08
713,Shirley Brown,1975-04-19,Shirley Brown - Woman To Woman,31,45,35,11.0,29,Woman To Woman,11.0,9,-6,2,14,1,down,1975-02-08
714,Shirley Brown,1975-04-26,Shirley Brown - Woman To Woman,29,31,36,11.0,35,Woman To Woman,11.0,10,-1,-6,2,1,down,1975-02-08
715,Shirley Brown,1975-05-03,Shirley Brown - Woman To Woman,35,29,51,11.0,36,Woman To Woman,11.0,11,-15,-1,-6,1,down,1975-02-08
716,Gil Scott-Heron & Brian Jackson,1975-02-08,Gil Scott-Heron & Brian Jackson - The First Minute Of A New Day,51,51,42,8.0,46,The First Minute Of A New Day,12.0,0,4,5,0,1,up,1975-02-08
717,Gil Scott-Heron & Brian Jackson,1975-02-15,Gil Scott-Heron & Brian Jackson - The First Minute Of A New Day,46,51,33,8.0,42,The First Minute Of A New Day,12.0,1,9,4,5,1,up,1975-02-08
718,Gil Scott-Heron & Brian Jackson,1975-02-22,Gil Scott-Heron & Brian Jackson - The First Minute Of A New Day,42,46,27,8.0,33,The First Minute Of A New Day,12.0,2,6,9,4,1,up,1975-02-08
719,Gil Scott-Heron & Brian Jackson,1975-03-01,Gil Scott-Heron & Brian Jackson - The First Minute Of A New Day,33,42,21,8.0,27,The First Minute Of A New Day,12.0,3,6,6,9,1,up,1975-02-08
720,Gil Scott-Heron & Brian Jackson,1975-03-08,Gil Scott-Heron & Brian Jackson - The First Minute Of A New Day,27,33,17,8.0,21,The First Minute Of A New Day,12.0,4,4,6,6,1,up,1975-02-08
721,Gil Scott-Heron & Brian Jackson,1975-03-15,Gil Scott-Heron & Brian Jackson - The First Minute Of A New Day,21,27,12,8.0,17,The First Minute Of A New Day,12.0,5,5,4,6,1,up,1975-02-08
722,Gil Scott-Heron & Brian Jackson,1975-03-22,Gil Scott-Heron & Brian Jackson - The First Minute Of A New Day,17,21,9,8.0,12,The First Minute Of A New Day,12.0,6,3,5,4,1,up,1975-02-08
723,Gil Scott-Heron & Brian Jackson,1975-03-29,Gil Scott-Heron & Brian Jackson - The First Minute Of A New Day,12,17,8,8.0,9,The First Minute Of A New Day,12.0,7,1,3,5,1,up,1975-02-08
724,Gil Scott-Heron & Brian Jackson,1975-04-05,Gil Scott-Heron & Brian Jackson - The First Minute Of A New Day,9,12,12,8.0,8,The First Minute Of A New Day,12.0,8,-4,1,3,1,down,1975-02-08
725,Gil Scott-Heron & Brian Jackson,1975-04-12,Gil Scott-Heron & Brian Jackson - The First Minute Of A New Day,8,9,20,8.0,12,The First Minute Of A New Day,12.0,9,-8,-4,1,1,down,1975-02-08
726,Gil Scott-Heron & Brian Jackson,1975-04-19,Gil Scott-Heron & Brian Jackson - The First Minute Of A New Day,12,8,26,8.0,20,The First Minute Of A New Day,12.0,10,-6,-8,-4,1,down,1975-02-08
727,Gil Scott-Heron & Brian Jackson,1975-04-26,Gil Scott-Heron & Brian Jackson - The First Minute Of A New Day,20,12,34,8.0,26,The First Minute Of A New Day,12.0,11,-8,-6,-8,1,down,1975-02-08
728,Gil Scott-Heron & Brian Jackson,1975-05-03,Gil Scott-Heron & Brian Jackson - The First Minute Of A New Day,26,20,51,8.0,34,The First Minute Of A New Day,12.0,12,-17,-8,-6,1,down,1975-02-08
729,The Temptations,1975-02-08,The Temptations - A Song For You,51,51,38,1.0,50,A Song For You,34.0,0,12,1,0,1,up,1975-02-08
730,The Temptations,1975-02-15,The Temptations - A Song For You,50,51,30,1.0,38,A Song For You,34.0,1,8,12,1,1,up,1975-02-08
731,The Temptations,1975-02-22,The Temptations - A Song For You,38,50,28,1.0,30,A Song For You,34.0,2,2,8,12,1,up,1975-02-08
732,The Temptations,1975-03-01,The Temptations - A Song For You,30,38,22,1.0,28,A Song For You,34.0,3,6,2,8,1,up,1975-02-08
733,The Temptations,1975-03-08,The Temptations - A Song For You,28,30,12,1.0,22,A Song For You,34.0,4,10,6,2,1,up,1975-02-08
734,The Temptations,1975-03-15,The Temptations - A Song For You,22,28,9,1.0,12,A Song For You,34.0,5,3,10,6,1,up,1975-02-08
735,The Temptations,1975-03-22,The Temptations - A Song For You,12,22,7,1.0,9,A Song For You,34.0,6,2,3,10,1,up,1975-02-08
736,The Temptations,1975-03-29,The Temptations - A Song For You,9,12,6,1.0,7,A Song For You,34.0,7,1,2,3,1,up,1975-02-08
737,The Temptations,1975-04-05,The Temptations - A Song For You,7,9,5,1.0,6,A Song For You,34.0,8,1,1,2,1,up,1975-02-08
738,The Temptations,1975-04-12,The Temptations - A Song For You,6,7,4,1.0,5,A Song For You,34.0,9,1,1,1,1,up,1975-02-08
739,The Temptations,1975-04-19,The Temptations - A Song For You,5,6,2,1.0,4,A Song For You,34.0,10,2,1,1,1,up,1975-02-08
740,The Temptations,1975-04-26,The Temptations - A Song For You,4,5,1,1.0,2,A Song For You,34.0,11,1,2,1,1,up,1975-02-08
741,The Temptations,1975-05-03,The Temptations - A Song For You,2,4,12,1.0,1,A Song For You,34.0,12,-11,1,2,1,down,1975-02-08
742,The Temptations,1975-05-10,The Temptations - A Song For You,1,2,13,1.0,12,A Song For You,34.0,13,-1,-11,1,1,down,1975-02-08
743,The Temptations,1975-05-17,The Temptations - A Song For You,12,1,21,1.0,13,A Song For You,34.0,14,-8,-1,-11,1,down,1975-02-08
744,The Temptations,1975-05-24,The Temptations - A Song For You,13,12,18,1.0,21,A Song For You,34.0,15,3,-8,-1,1,up,1975-02-08
745,The Temptations,1975-05-31,The Temptations - A Song For You,21,13,14,1.0,18,A Song For You,34.0,16,4,3,-8,1,up,1975-02-08
746,The Temptations,1975-06-07,The Temptations - A Song For You,18,21,8,1.0,14,A Song For You,34.0,17,6,4,3,1,up,1975-02-08
747,The Temptations,1975-06-14,The Temptations - A Song For You,14,18,4,1.0,8,A Song For You,34.0,18,4,6,4,1,up,1975-02-08
748,The Temptations,1975-06-21,The Temptations - A Song For You,8,14,4,1.0,4,A Song For You,34.0,19,0,4,6,0,stay,1975-02-08
749,The Temptations,1975-06-28,The Temptations - A Song For You,4,8,6,1.0,4,A Song For You,34.0,20,-2,0,4,1,down,1975-02-08
750,The Temptations,1975-07-05,The Temptations - A Song For You,4,4,18,1.0,6,A Song For You,34.0,21,-12,-2,0,1,down,1975-02-08
751,The Temptations,1975-07-12,The Temptations - A Song For You,6,4,18,1.0,18,A Song For You,34.0,22,0,-12,-2,0,stay,1975-02-08
752,The Temptations,1975-07-19,The Temptations - A Song For You,18,6,14,1.0,18,A Song For You,34.0,23,4,0,-12,1,up,1975-02-08
753,The Temptations,1975-07-26,The Temptations - A Song For You,18,18,10,1.0,14,A Song For You,34.0,24,4,4,0,1,up,1975-02-08
754,The Temptations,1975-08-02,The Temptations - A Song For You,14,18,10,1.0,10,A Song For You,34.0,25,0,4,4,0,stay,1975-02-08
755,The Temptations,1975-08-09,The Temptations - A Song For You,10,14,8,1.0,10,A Song For You,34.0,26,2,0,4,1,up,1975-02-08
756,The Temptations,1975-08-16,The Temptations - A Song For You,10,10,6,1.0,8,A Song For You,34.0,27,2,2,0,1,up,1975-02-08
757,The Temptations,1975-08-23,The Temptations - A Song For You,8,10,6,1.0,6,A Song For You,34.0,28,0,2,2,0,stay,1975-02-08
758,The Temptations,1975-08-30,The Temptations - A Song For You,6,8,16,1.0,6,A Song For You,34.0,29,-10,0,2,1,down,1975-02-08
759,The Temptations,1975-09-06,The Temptations - A Song For You,6,6,20,1.0,16,A Song For You,34.0,30,-4,-10,0,1,down,1975-02-08
760,The Temptations,1975-09-13,The Temptations - A Song For You,16,6,21,1.0,20,A Song For You,34.0,31,-1,-4,-10,1,down,1975-02-08
761,The Temptations,1975-09-20,The Temptations - A Song For You,20,16,29,1.0,21,A Song For You,34.0,32,-8,-1,-4,1,down,1975-02-08
762,The Temptations,1975-09-27,The Temptations - A Song For You,21,20,37,1.0,29,A Song For You,34.0,33,-8,-8,-1,1,down,1975-02-08
763,The Temptations,1975-10-04,The Temptations - A Song For You,29,21,51,1.0,37,A Song For You,34.0,34,-14,-8,-8,1,down,1975-02-08
764,Patti LaBelle,1975-02-15,Patti LaBelle - Nightbirds,51,51,29,4.0,40,Nightbirds,23.0,0,11,11,0,1,up,1975-02-15
765,Patti LaBelle,1975-02-22,Patti LaBelle - Nightbirds,40,51,23,4.0,29,Nightbirds,23.0,1,6,11,11,1,up,1975-02-15
766,Patti LaBelle,1975-03-01,Patti LaBelle - Nightbirds,29,40,15,4.0,23,Nightbirds,23.0,2,8,6,11,1,up,1975-02-15
767,Patti LaBelle,1975-03-08,Patti LaBelle - Nightbirds,23,29,10,4.0,15,Nightbirds,23.0,3,5,8,6,1,up,1975-02-15
768,Patti LaBelle,1975-03-15,Patti LaBelle - Nightbirds,15,23,6,4.0,10,Nightbirds,23.0,4,4,5,8,1,up,1975-02-15
769,Patti LaBelle,1975-03-22,Patti LaBelle - Nightbirds,10,15,5,4.0,6,Nightbirds,23.0,5,1,4,5,1,up,1975-02-15
770,Patti LaBelle,1975-03-29,Patti LaBelle - Nightbirds,6,10,5,4.0,5,Nightbirds,23.0,6,0,1,4,0,stay,1975-02-15
771,Patti LaBelle,1975-04-05,Patti LaBelle - Nightbirds,5,6,4,4.0,5,Nightbirds,23.0,7,1,0,1,1,up,1975-02-15
772,Patti LaBelle,1975-04-12,Patti LaBelle - Nightbirds,5,5,10,4.0,4,Nightbirds,23.0,8,-6,1,0,1,down,1975-02-15
773,Patti LaBelle,1975-04-19,Patti LaBelle - Nightbirds,4,5,15,4.0,10,Nightbirds,23.0,9,-5,-6,1,1,down,1975-02-15
774,Patti LaBelle,1975-04-26,Patti LaBelle - Nightbirds,10,4,24,4.0,15,Nightbirds,23.0,10,-9,-5,-6,1,down,1975-02-15
775,Patti LaBelle,1975-05-03,Patti LaBelle - Nightbirds,15,10,32,4.0,24,Nightbirds,23.0,11,-8,-9,-5,1,down,1975-02-15
776,Patti LaBelle,1975-05-10,Patti LaBelle - Nightbirds,24,15,43,4.0,32,Nightbirds,23.0,12,-11,-8,-9,1,down,1975-02-15
777,Patti LaBelle,1975-05-17,Patti LaBelle - Nightbirds,32,24,40,4.0,43,Nightbirds,23.0,13,3,-11,-8,1,up,1975-02-15
778,Patti LaBelle,1975-05-24,Patti LaBelle - Nightbirds,43,32,31,4.0,40,Nightbirds,23.0,14,9,3,-11,1,up,1975-02-15
779,Patti LaBelle,1975-05-31,Patti LaBelle - Nightbirds,40,43,24,4.0,31,Nightbirds,23.0,15,7,9,3,1,up,1975-02-15
780,Patti LaBelle,1975-06-07,Patti LaBelle - Nightbirds,31,40,22,4.0,24,Nightbirds,23.0,16,2,7,9,1,up,1975-02-15
781,Patti LaBelle,1975-06-14,Patti LaBelle - Nightbirds,24,31,16,4.0,22,Nightbirds,23.0,17,6,2,7,1,up,1975-02-15
782,Patti LaBelle,1975-06-21,Patti LaBelle - Nightbirds,22,24,12,4.0,16,Nightbirds,23.0,18,4,6,2,1,up,1975-02-15
783,Patti LaBelle,1975-06-28,Patti LaBelle - Nightbirds,16,22,10,4.0,12,Nightbirds,23.0,19,2,4,6,1,up,1975-02-15
784,Patti LaBelle,1975-07-05,Patti LaBelle - Nightbirds,12,16,19,4.0,10,Nightbirds,23.0,20,-9,2,4,1,down,1975-02-15
785,Patti LaBelle,1975-07-12,Patti LaBelle - Nightbirds,10,12,21,4.0,19,Nightbirds,23.0,21,-2,-9,2,1,down,1975-02-15
786,Patti LaBelle,1975-07-19,Patti LaBelle - Nightbirds,19,10,41,4.0,21,Nightbirds,23.0,22,-20,-2,-9,1,down,1975-02-15
787,Patti LaBelle,1975-07-26,Patti LaBelle - Nightbirds,21,19,51,4.0,41,Nightbirds,23.0,23,-10,-20,-2,1,down,1975-02-15
788,Jimmy Witherspoon,1975-02-15,Jimmy Witherspoon - Love Is A Five Letter Word,51,51,34,26.0,44,Love Is A Five Letter Word,4.0,0,10,7,0,1,up,1975-02-15
789,Jimmy Witherspoon,1975-02-22,Jimmy Witherspoon - Love Is A Five Letter Word,44,51,29,26.0,34,Love Is A Five Letter Word,4.0,1,5,10,7,1,up,1975-02-15
790,Jimmy Witherspoon,1975-03-01,Jimmy Witherspoon - Love Is A Five Letter Word,34,44,26,26.0,29,Love Is A Five Letter Word,4.0,2,3,5,10,1,up,1975-02-15
791,Jimmy Witherspoon,1975-03-08,Jimmy Witherspoon - Love Is A Five Letter Word,29,34,33,26.0,26,Love Is A Five Letter Word,4.0,3,-7,3,5,1,down,1975-02-15
792,Jimmy Witherspoon,1975-03-15,Jimmy Witherspoon - Love Is A Five Letter Word,26,29,51,26.0,33,Love Is A Five Letter Word,4.0,4,-18,-7,3,1,down,1975-02-15
793,Gene Page,1975-02-15,Gene Page - Hot City,51,51,44,41.0,48,Hot City,2.0,0,4,3,0,1,up,1975-02-15
794,Gene Page,1975-02-22,Gene Page - Hot City,48,51,41,41.0,44,Hot City,2.0,1,3,4,3,1,up,1975-02-15
795,Gene Page,1975-03-01,Gene Page - Hot City,44,48,51,41.0,41,Hot City,2.0,2,-10,3,4,1,down,1975-02-15
796,The Miracles,1975-02-15,The Miracles - Don't Cha Love It,51,51,32,7.0,50,Don't Cha Love It,10.0,0,18,1,0,1,up,1975-02-15
797,The Miracles,1975-02-22,The Miracles - Don't Cha Love It,50,51,26,7.0,32,Don't Cha Love It,10.0,1,6,18,1,1,up,1975-02-15
798,The Miracles,1975-03-01,The Miracles - Don't Cha Love It,32,50,20,7.0,26,Don't Cha Love It,10.0,2,6,6,18,1,up,1975-02-15
799,The Miracles,1975-03-08,The Miracles - Don't Cha Love It,26,32,14,7.0,20,Don't Cha Love It,10.0,3,6,6,6,1,up,1975-02-15
800,The Miracles,1975-03-15,The Miracles - Don't Cha Love It,20,26,10,7.0,14,Don't Cha Love It,10.0,4,4,6,6,1,up,1975-02-15
801,The Miracles,1975-03-22,The Miracles - Don't Cha Love It,14,20,8,7.0,10,Don't Cha Love It,10.0,5,2,4,6,1,up,1975-02-15
802,The Miracles,1975-03-29,The Miracles - Don't Cha Love It,10,14,7,7.0,8,Don't Cha Love It,10.0,6,1,2,4,1,up,1975-02-15
803,The Miracles,1975-04-05,The Miracles - Don't Cha Love It,8,10,7,7.0,7,Don't Cha Love It,10.0,7,0,1,2,0,stay,1975-02-15
804,The Miracles,1975-04-12,The Miracles - Don't Cha Love It,7,8,14,7.0,7,Don't Cha Love It,10.0,8,-7,0,1,1,down,1975-02-15
805,The Miracles,1975-04-19,The Miracles - Don't Cha Love It,7,7,32,7.0,14,Don't Cha Love It,10.0,9,-18,-7,0,1,down,1975-02-15
806,The Miracles,1975-04-26,The Miracles - Don't Cha Love It,14,7,51,7.0,32,Don't Cha Love It,10.0,10,-19,-18,-7,1,down,1975-02-15
807,Zulema,1975-02-22,Zulema - Zulema,51,51,43,43.0,47,Zulema,2.0,0,4,4,0,1,up,1975-02-22
808,Zulema,1975-03-01,Zulema - Zulema,47,51,43,43.0,43,Zulema,2.0,1,0,4,4,0,stay,1975-02-22
809,Zulema,1975-03-08,Zulema - Zulema,43,47,51,43.0,43,Zulema,2.0,2,-8,0,4,1,down,1975-02-22
810,Minnie Riperton,1975-02-22,Minnie Riperton - Perfect Angel,51,51,38,1.0,48,Perfect Angel,14.0,0,10,3,0,1,up,1975-02-22
811,Minnie Riperton,1975-03-01,Minnie Riperton - Perfect Angel,48,51,19,1.0,38,Perfect Angel,14.0,1,19,10,3,1,up,1975-02-22
812,Minnie Riperton,1975-03-08,Minnie Riperton - Perfect Angel,38,48,7,1.0,19,Perfect Angel,14.0,2,12,19,10,1,up,1975-02-22
813,Minnie Riperton,1975-03-15,Minnie Riperton - Perfect Angel,19,38,5,1.0,7,Perfect Angel,14.0,3,2,12,19,1,up,1975-02-22
814,Minnie Riperton,1975-03-22,Minnie Riperton - Perfect Angel,7,19,1,1.0,5,Perfect Angel,14.0,4,4,2,12,1,up,1975-02-22
815,Minnie Riperton,1975-03-29,Minnie Riperton - Perfect Angel,5,7,1,1.0,1,Perfect Angel,14.0,5,0,4,2,0,stay,1975-02-22
816,Minnie Riperton,1975-04-05,Minnie Riperton - Perfect Angel,1,5,1,1.0,1,Perfect Angel,14.0,6,0,0,4,0,stay,1975-02-22
817,Minnie Riperton,1975-04-12,Minnie Riperton - Perfect Angel,1,1,2,1.0,1,Perfect Angel,14.0,7,-1,0,0,1,down,1975-02-22
818,Minnie Riperton,1975-04-19,Minnie Riperton - Perfect Angel,1,1,6,1.0,2,Perfect Angel,14.0,8,-4,-1,0,1,down,1975-02-22
819,Minnie Riperton,1975-04-26,Minnie Riperton - Perfect Angel,2,1,8,1.0,6,Perfect Angel,14.0,9,-2,-4,-1,1,down,1975-02-22
820,Minnie Riperton,1975-05-03,Minnie Riperton - Perfect Angel,6,2,15,1.0,8,Perfect Angel,14.0,10,-7,-2,-4,1,down,1975-02-22
821,Minnie Riperton,1975-05-10,Minnie Riperton - Perfect Angel,8,6,15,1.0,15,Perfect Angel,14.0,11,0,-7,-2,0,stay,1975-02-22
822,Minnie Riperton,1975-05-17,Minnie Riperton - Perfect Angel,15,8,26,1.0,15,Perfect Angel,14.0,12,-11,0,-7,1,down,1975-02-22
823,Minnie Riperton,1975-05-24,Minnie Riperton - Perfect Angel,15,15,33,1.0,26,Perfect Angel,14.0,13,-7,-11,0,1,down,1975-02-22
824,Minnie Riperton,1975-05-31,Minnie Riperton - Perfect Angel,26,15,51,1.0,33,Perfect Angel,14.0,14,-18,-7,-11,1,down,1975-02-22
825,The Three Degrees,1975-02-22,The Three Degrees - The Three Degrees,51,51,40,33.0,49,The Three Degrees,5.0,0,9,2,0,1,up,1975-02-22
826,The Three Degrees,1975-03-01,The Three Degrees - The Three Degrees,49,51,37,33.0,40,The Three Degrees,5.0,1,3,9,2,1,up,1975-02-22
827,The Three Degrees,1975-03-08,The Three Degrees - The Three Degrees,40,49,35,33.0,37,The Three Degrees,5.0,2,2,3,9,1,up,1975-02-22
828,The Three Degrees,1975-03-15,The Three Degrees - The Three Degrees,37,40,33,33.0,35,The Three Degrees,5.0,3,2,2,3,1,up,1975-02-22
829,The Three Degrees,1975-03-22,The Three Degrees - The Three Degrees,35,37,33,33.0,33,The Three Degrees,5.0,4,0,2,2,0,stay,1975-02-22
830,The Three Degrees,1975-03-29,The Three Degrees - The Three Degrees,33,35,51,33.0,33,The Three Degrees,5.0,5,-18,0,2,1,down,1975-02-22
831,Tavares,1975-02-22,Tavares - Hard Core Poetry,51,51,39,21.0,50,Hard Core Poetry,13.0,0,11,1,0,1,up,1975-02-22
832,Tavares,1975-03-01,Tavares - Hard Core Poetry,50,51,31,21.0,39,Hard Core Poetry,13.0,1,8,11,1,1,up,1975-02-22
833,Tavares,1975-03-08,Tavares - Hard Core Poetry,39,50,25,21.0,31,Hard Core Poetry,13.0,2,6,8,11,1,up,1975-02-22
834,Tavares,1975-03-15,Tavares - Hard Core Poetry,31,39,21,21.0,25,Hard Core Poetry,13.0,3,4,6,8,1,up,1975-02-22
835,Tavares,1975-03-22,Tavares - Hard Core Poetry,25,31,24,21.0,21,Hard Core Poetry,13.0,4,-3,4,6,1,down,1975-02-22
836,Tavares,1975-03-29,Tavares - Hard Core Poetry,21,25,34,21.0,24,Hard Core Poetry,13.0,5,-10,-3,4,1,down,1975-02-22
837,Tavares,1975-04-05,Tavares - Hard Core Poetry,24,21,47,21.0,34,Hard Core Poetry,13.0,6,-13,-10,-3,1,down,1975-02-22
838,Tavares,1975-04-19,Tavares - Hard Core Poetry,34,24,42,21.0,47,Hard Core Poetry,13.0,7,5,-13,-10,1,up,1975-02-22
839,Tavares,1975-04-26,Tavares - Hard Core Poetry,47,34,38,21.0,42,Hard Core Poetry,13.0,8,4,5,-13,1,up,1975-02-22
840,Tavares,1975-05-03,Tavares - Hard Core Poetry,42,47,28,21.0,38,Hard Core Poetry,13.0,9,10,4,5,1,up,1975-02-22
841,Tavares,1975-05-10,Tavares - Hard Core Poetry,38,42,25,21.0,28,Hard Core Poetry,13.0,10,3,10,4,1,up,1975-02-22
842,Tavares,1975-05-17,Tavares - Hard Core Poetry,28,38,27,21.0,25,Hard Core Poetry,13.0,11,-2,3,10,1,down,1975-02-22
843,Tavares,1975-05-24,Tavares - Hard Core Poetry,25,28,34,21.0,27,Hard Core Poetry,13.0,12,-7,-2,3,1,down,1975-02-22
844,Tavares,1975-05-31,Tavares - Hard Core Poetry,27,25,51,21.0,34,Hard Core Poetry,13.0,13,-17,-7,-2,1,down,1975-02-22
845,Ohio Players,1975-03-01,Ohio Players - Ohio Players Greatest Hits,51,51,27,22.0,37,Ohio Players Greatest Hits,4.0,0,10,14,0,1,up,1975-03-01
846,Ohio Players,1975-03-08,Ohio Players - Ohio Players Greatest Hits,37,51,23,22.0,27,Ohio Players Greatest Hits,4.0,1,4,10,14,1,up,1975-03-01
847,Ohio Players,1975-03-15,Ohio Players - Ohio Players Greatest Hits,27,37,22,22.0,23,Ohio Players Greatest Hits,4.0,2,1,4,10,1,up,1975-03-01
848,Ohio Players,1975-03-22,Ohio Players - Ohio Players Greatest Hits,23,27,37,22.0,22,Ohio Players Greatest Hits,4.0,3,-15,1,4,1,down,1975-03-01
849,Ohio Players,1975-03-29,Ohio Players - Ohio Players Greatest Hits,22,23,51,22.0,37,Ohio Players Greatest Hits,4.0,4,-14,-15,1,1,down,1975-03-01
850,Bloodstone,1975-03-01,Bloodstone - Riddle Of The Sphinx,51,51,33,22.0,44,Riddle Of The Sphinx,7.0,0,11,7,0,1,up,1975-03-01
851,Bloodstone,1975-03-08,Bloodstone - Riddle Of The Sphinx,44,51,27,22.0,33,Riddle Of The Sphinx,7.0,1,6,11,7,1,up,1975-03-01
852,Bloodstone,1975-03-15,Bloodstone - Riddle Of The Sphinx,33,44,23,22.0,27,Riddle Of The Sphinx,7.0,2,4,6,11,1,up,1975-03-01
853,Bloodstone,1975-03-22,Bloodstone - Riddle Of The Sphinx,27,33,22,22.0,23,Riddle Of The Sphinx,7.0,3,1,4,6,1,up,1975-03-01
854,Bloodstone,1975-03-29,Bloodstone - Riddle Of The Sphinx,23,27,31,22.0,22,Riddle Of The Sphinx,7.0,4,-9,1,4,1,down,1975-03-01
855,Bloodstone,1975-04-05,Bloodstone - Riddle Of The Sphinx,22,23,42,22.0,31,Riddle Of The Sphinx,7.0,5,-11,-9,1,1,down,1975-03-01
856,Bloodstone,1975-04-12,Bloodstone - Riddle Of The Sphinx,31,22,45,22.0,42,Riddle Of The Sphinx,7.0,6,-3,-11,-9,1,down,1975-03-01
857,Bloodstone,1975-04-19,Bloodstone - Riddle Of The Sphinx,42,31,51,22.0,45,Riddle Of The Sphinx,7.0,7,-6,-3,-11,1,down,1975-03-01
858,Billy Paul,1975-03-01,Billy Paul - Got My Head On Straight,51,51,36,20.0,46,Got My Head On Straight,9.0,0,10,5,0,1,up,1975-03-01
859,Billy Paul,1975-03-08,Billy Paul - Got My Head On Straight,46,51,32,20.0,36,Got My Head On Straight,9.0,1,4,10,5,1,up,1975-03-01
860,Billy Paul,1975-03-15,Billy Paul - Got My Head On Straight,36,46,29,20.0,32,Got My Head On Straight,9.0,2,3,4,10,1,up,1975-03-01
861,Billy Paul,1975-03-22,Billy Paul - Got My Head On Straight,32,36,28,20.0,29,Got My Head On Straight,9.0,3,1,3,4,1,up,1975-03-01
862,Billy Paul,1975-03-29,Billy Paul - Got My Head On Straight,29,32,23,20.0,28,Got My Head On Straight,9.0,4,5,1,3,1,up,1975-03-01
863,Billy Paul,1975-04-05,Billy Paul - Got My Head On Straight,28,29,20,20.0,23,Got My Head On Straight,9.0,5,3,5,1,1,up,1975-03-01
864,Billy Paul,1975-04-12,Billy Paul - Got My Head On Straight,23,28,24,20.0,20,Got My Head On Straight,9.0,6,-4,3,5,1,down,1975-03-01
865,Billy Paul,1975-04-19,Billy Paul - Got My Head On Straight,20,23,29,20.0,24,Got My Head On Straight,9.0,7,-5,-4,3,1,down,1975-03-01
866,Billy Paul,1975-04-26,Billy Paul - Got My Head On Straight,24,20,35,20.0,29,Got My Head On Straight,9.0,8,-6,-5,-4,1,down,1975-03-01
867,Billy Paul,1975-05-03,Billy Paul - Got My Head On Straight,29,24,51,20.0,35,Got My Head On Straight,9.0,9,-16,-6,-5,1,down,1975-03-01
868,Harold Melvin And The Blue Notes,1975-03-01,Harold Melvin And The Blue Notes - To Be True,51,51,39,1.0,47,To Be True,32.0,0,8,4,0,1,up,1975-03-01
869,Harold Melvin And The Blue Notes,1975-03-08,Harold Melvin And The Blue Notes - To Be True,47,51,31,1.0,39,To Be True,32.0,1,8,8,4,1,up,1975-03-01
870,Harold Melvin And The Blue Notes,1975-03-15,Harold Melvin And The Blue Notes - To Be True,39,47,25,1.0,31,To Be True,32.0,2,6,8,8,1,up,1975-03-01
871,Harold Melvin And The Blue Notes,1975-03-22,Harold Melvin And The Blue Notes - To Be True,31,39,16,1.0,25,To Be True,32.0,3,9,6,8,1,up,1975-03-01
872,Harold Melvin And The Blue Notes,1975-03-29,Harold Melvin And The Blue Notes - To Be True,25,31,12,1.0,16,To Be True,32.0,4,4,9,6,1,up,1975-03-01
873,Harold Melvin And The Blue Notes,1975-04-05,Harold Melvin And The Blue Notes - To Be True,16,25,10,1.0,12,To Be True,32.0,5,2,4,9,1,up,1975-03-01
874,Harold Melvin And The Blue Notes,1975-04-12,Harold Melvin And The Blue Notes - To Be True,12,16,8,1.0,10,To Be True,32.0,6,2,2,4,1,up,1975-03-01
875,Harold Melvin And The Blue Notes,1975-04-19,Harold Melvin And The Blue Notes - To Be True,10,12,3,1.0,8,To Be True,32.0,7,5,2,2,1,up,1975-03-01
876,Harold Melvin And The Blue Notes,1975-04-26,Harold Melvin And The Blue Notes - To Be True,8,10,2,1.0,3,To Be True,32.0,8,1,5,2,1,up,1975-03-01
877,Harold Melvin And The Blue Notes,1975-05-03,Harold Melvin And The Blue Notes - To Be True,3,8,1,1.0,2,To Be True,32.0,9,1,1,5,1,up,1975-03-01
878,Harold Melvin And The Blue Notes,1975-05-10,Harold Melvin And The Blue Notes - To Be True,2,3,4,1.0,1,To Be True,32.0,10,-3,1,1,1,down,1975-03-01
879,Harold Melvin And The Blue Notes,1975-05-17,Harold Melvin And The Blue Notes - To Be True,1,2,4,1.0,4,To Be True,32.0,11,0,-3,1,0,stay,1975-03-01
880,Harold Melvin And The Blue Notes,1975-05-24,Harold Melvin And The Blue Notes - To Be True,4,1,5,1.0,4,To Be True,32.0,12,-1,0,-3,1,down,1975-03-01
881,Harold Melvin And The Blue Notes,1975-05-31,Harold Melvin And The Blue Notes - To Be True,4,4,11,1.0,5,To Be True,32.0,13,-6,-1,0,1,down,1975-03-01
882,Harold Melvin And The Blue Notes,1975-06-07,Harold Melvin And The Blue Notes - To Be True,5,4,11,1.0,11,To Be True,32.0,14,0,-6,-1,0,stay,1975-03-01
883,Harold Melvin And The Blue Notes,1975-06-14,Harold Melvin And The Blue Notes - To Be True,11,5,11,1.0,11,To Be True,32.0,15,0,0,-6,0,stay,1975-03-01
884,Harold Melvin And The Blue Notes,1975-06-21,Harold Melvin And The Blue Notes - To Be True,11,11,17,1.0,11,To Be True,32.0,16,-6,0,0,1,down,1975-03-01
885,Harold Melvin And The Blue Notes,1975-06-28,Harold Melvin And The Blue Notes - To Be True,11,11,13,1.0,17,To Be True,32.0,17,4,-6,0,1,up,1975-03-01
886,Harold Melvin And The Blue Notes,1975-07-05,Harold Melvin And The Blue Notes - To Be True,17,11,8,1.0,13,To Be True,32.0,18,5,4,-6,1,up,1975-03-01
887,Harold Melvin And The Blue Notes,1975-07-12,Harold Melvin And The Blue Notes - To Be True,13,17,7,1.0,8,To Be True,32.0,19,1,5,4,1,up,1975-03-01
888,Harold Melvin And The Blue Notes,1975-07-19,Harold Melvin And The Blue Notes - To Be True,8,13,6,1.0,7,To Be True,32.0,20,1,1,5,1,up,1975-03-01
889,Harold Melvin And The Blue Notes,1975-07-26,Harold Melvin And The Blue Notes - To Be True,7,8,6,1.0,6,To Be True,32.0,21,0,1,1,0,stay,1975-03-01
890,Harold Melvin And The Blue Notes,1975-08-02,Harold Melvin And The Blue Notes - To Be True,6,7,12,1.0,6,To Be True,32.0,22,-6,0,1,1,down,1975-03-01
891,Harold Melvin And The Blue Notes,1975-08-09,Harold Melvin And The Blue Notes - To Be True,6,6,12,1.0,12,To Be True,32.0,23,0,-6,0,0,stay,1975-03-01
892,Harold Melvin And The Blue Notes,1975-08-16,Harold Melvin And The Blue Notes - To Be True,12,6,21,1.0,12,To Be True,32.0,24,-9,0,-6,1,down,1975-03-01
893,Harold Melvin And The Blue Notes,1975-08-23,Harold Melvin And The Blue Notes - To Be True,12,12,25,1.0,21,To Be True,32.0,25,-4,-9,0,1,down,1975-03-01
894,Harold Melvin And The Blue Notes,1975-08-30,Harold Melvin And The Blue Notes - To Be True,21,12,22,1.0,25,To Be True,32.0,26,3,-4,-9,1,up,1975-03-01
895,Harold Melvin And The Blue Notes,1975-09-06,Harold Melvin And The Blue Notes - To Be True,25,21,17,1.0,22,To Be True,32.0,27,5,3,-4,1,up,1975-03-01
896,Harold Melvin And The Blue Notes,1975-09-13,Harold Melvin And The Blue Notes - To Be True,22,25,16,1.0,17,To Be True,32.0,28,1,5,3,1,up,1975-03-01
897,Harold Melvin And The Blue Notes,1975-09-20,Harold Melvin And The Blue Notes - To Be True,17,22,21,1.0,16,To Be True,32.0,29,-5,1,5,1,down,1975-03-01
898,Harold Melvin And The Blue Notes,1975-09-27,Harold Melvin And The Blue Notes - To Be True,16,17,31,1.0,21,To Be True,32.0,30,-10,-5,1,1,down,1975-03-01
899,Harold Melvin And The Blue Notes,1975-10-04,Harold Melvin And The Blue Notes - To Be True,21,16,35,1.0,31,To Be True,32.0,31,-4,-10,-5,1,down,1975-03-01
900,Harold Melvin And The Blue Notes,1975-10-11,Harold Melvin And The Blue Notes - To Be True,31,21,51,1.0,35,To Be True,32.0,32,-16,-4,-10,1,down,1975-03-01
901,Tower Of Power,1975-03-01,Tower Of Power - Urban Renewal,51,51,46,19.0,49,Urban Renewal,13.0,0,3,2,0,1,up,1975-03-01
902,Tower Of Power,1975-03-08,Tower Of Power - Urban Renewal,49,51,41,19.0,46,Urban Renewal,13.0,1,5,3,2,1,up,1975-03-01
903,Tower Of Power,1975-03-15,Tower Of Power - Urban Renewal,46,49,36,19.0,41,Urban Renewal,13.0,2,5,5,3,1,up,1975-03-01
904,Tower Of Power,1975-03-22,Tower Of Power - Urban Renewal,41,46,34,19.0,36,Urban Renewal,13.0,3,2,5,5,1,up,1975-03-01
905,Tower Of Power,1975-03-29,Tower Of Power - Urban Renewal,36,41,44,19.0,34,Urban Renewal,13.0,4,-10,2,5,1,down,1975-03-01
906,Tower Of Power,1975-04-05,Tower Of Power - Urban Renewal,34,36,34,19.0,44,Urban Renewal,13.0,5,10,-10,2,1,up,1975-03-01
907,Tower Of Power,1975-04-12,Tower Of Power - Urban Renewal,44,34,30,19.0,34,Urban Renewal,13.0,6,4,10,-10,1,up,1975-03-01
908,Tower Of Power,1975-04-19,Tower Of Power - Urban Renewal,34,44,28,19.0,30,Urban Renewal,13.0,7,2,4,10,1,up,1975-03-01
909,Tower Of Power,1975-04-26,Tower Of Power - Urban Renewal,30,34,19,19.0,28,Urban Renewal,13.0,8,9,2,4,1,up,1975-03-01
910,Tower Of Power,1975-05-03,Tower Of Power - Urban Renewal,28,30,19,19.0,19,Urban Renewal,13.0,9,0,9,2,0,stay,1975-03-01
911,Tower Of Power,1975-05-10,Tower Of Power - Urban Renewal,19,28,23,19.0,19,Urban Renewal,13.0,10,-4,0,9,1,down,1975-03-01
912,Tower Of Power,1975-05-17,Tower Of Power - Urban Renewal,19,19,35,19.0,23,Urban Renewal,13.0,11,-12,-4,0,1,down,1975-03-01
913,Tower Of Power,1975-05-24,Tower Of Power - Urban Renewal,23,19,45,19.0,35,Urban Renewal,13.0,12,-10,-12,-4,1,down,1975-03-01
914,Tower Of Power,1975-05-31,Tower Of Power - Urban Renewal,35,23,51,19.0,45,Urban Renewal,13.0,13,-6,-10,-12,1,down,1975-03-01
915,Percy Sledge,1975-03-01,Percy Sledge - I'll Be Your Everything,51,51,49,48.0,50,I'll Be Your Everything,2.0,0,1,1,0,1,up,1975-03-01
916,Percy Sledge,1975-03-08,Percy Sledge - I'll Be Your Everything,50,51,48,48.0,49,I'll Be Your Everything,2.0,1,1,1,1,1,up,1975-03-01
917,Percy Sledge,1975-03-15,Percy Sledge - I'll Be Your Everything,49,50,51,48.0,48,I'll Be Your Everything,2.0,2,-3,1,1,1,down,1975-03-01
918,Dynamic Superiors,1975-03-08,Dynamic Superiors - The Dynamic Superiors,51,51,40,36.0,44,The Dynamic Superiors,5.0,0,4,7,0,1,up,1975-03-08
919,Dynamic Superiors,1975-03-15,Dynamic Superiors - The Dynamic Superiors,44,51,37,36.0,40,The Dynamic Superiors,5.0,1,3,4,7,1,up,1975-03-08
920,Dynamic Superiors,1975-03-22,Dynamic Superiors - The Dynamic Superiors,40,44,36,36.0,37,The Dynamic Superiors,5.0,2,1,3,4,1,up,1975-03-08
921,Dynamic Superiors,1975-03-29,Dynamic Superiors - The Dynamic Superiors,37,40,36,36.0,36,The Dynamic Superiors,5.0,3,0,1,3,0,stay,1975-03-08
922,Dynamic Superiors,1975-04-05,Dynamic Superiors - The Dynamic Superiors,36,37,45,36.0,36,The Dynamic Superiors,5.0,4,-9,0,1,1,down,1975-03-08
923,Dynamic Superiors,1975-04-12,Dynamic Superiors - The Dynamic Superiors,36,36,51,36.0,45,The Dynamic Superiors,5.0,5,-6,-9,0,1,down,1975-03-08
924,The Stylistics,1975-03-08,The Stylistics - The Best Of The Stylistics,51,51,30,13.0,45,The Best Of The Stylistics,9.0,0,15,6,0,1,up,1975-03-08
925,The Stylistics,1975-03-15,The Stylistics - The Best Of The Stylistics,45,51,20,13.0,30,The Best Of The Stylistics,9.0,1,10,15,6,1,up,1975-03-08
926,The Stylistics,1975-03-22,The Stylistics - The Best Of The Stylistics,30,45,19,13.0,20,The Best Of The Stylistics,9.0,2,1,10,15,1,up,1975-03-08
927,The Stylistics,1975-03-29,The Stylistics - The Best Of The Stylistics,20,30,14,13.0,19,The Best Of The Stylistics,9.0,3,5,1,10,1,up,1975-03-08
928,The Stylistics,1975-04-05,The Stylistics - The Best Of The Stylistics,19,20,13,13.0,14,The Best Of The Stylistics,9.0,4,1,5,1,1,up,1975-03-08
929,The Stylistics,1975-04-12,The Stylistics - The Best Of The Stylistics,14,19,13,13.0,13,The Best Of The Stylistics,9.0,5,0,1,5,0,stay,1975-03-08
930,The Stylistics,1975-04-19,The Stylistics - The Best Of The Stylistics,13,14,18,13.0,13,The Best Of The Stylistics,9.0,6,-5,0,1,1,down,1975-03-08
931,The Stylistics,1975-04-26,The Stylistics - The Best Of The Stylistics,13,13,25,13.0,18,The Best Of The Stylistics,9.0,7,-7,-5,0,1,down,1975-03-08
932,The Stylistics,1975-05-03,The Stylistics - The Best Of The Stylistics,18,13,33,13.0,25,The Best Of The Stylistics,9.0,8,-8,-7,-5,1,down,1975-03-08
933,The Stylistics,1975-05-10,The Stylistics - The Best Of The Stylistics,25,18,51,13.0,33,The Best Of The Stylistics,9.0,9,-18,-8,-7,1,down,1975-03-08
934,Barbara Mason,1975-03-08,Barbara Mason - Love's The Thing,51,51,42,42.0,47,Love's The Thing,2.0,0,5,4,0,1,up,1975-03-08
935,Barbara Mason,1975-03-15,Barbara Mason - Love's The Thing,47,51,42,42.0,42,Love's The Thing,2.0,1,0,5,4,0,stay,1975-03-08
936,Barbara Mason,1975-03-22,Barbara Mason - Love's The Thing,42,47,51,42.0,42,Love's The Thing,2.0,2,-9,0,5,1,down,1975-03-08
937,Oliver Sain,1975-03-08,Oliver Sain - Bus Stop,51,51,45,45.0,48,Bus Stop,1.0,0,3,3,0,1,up,1975-03-08
938,Oliver Sain,1975-03-15,Oliver Sain - Bus Stop,48,51,51,45.0,45,Bus Stop,1.0,1,-6,3,3,1,down,1975-03-08
939,Vernon Burch,1975-03-08,Vernon Burch - I'll Be Your Sunshine,51,51,47,46.0,50,I'll Be Your Sunshine,3.0,0,3,1,0,1,up,1975-03-08
940,Vernon Burch,1975-03-15,Vernon Burch - I'll Be Your Sunshine,50,51,46,46.0,47,I'll Be Your Sunshine,3.0,1,1,3,1,1,up,1975-03-08
941,Vernon Burch,1975-03-22,Vernon Burch - I'll Be Your Sunshine,47,50,49,46.0,46,I'll Be Your Sunshine,3.0,2,-3,1,3,1,down,1975-03-08
942,Vernon Burch,1975-03-29,Vernon Burch - I'll Be Your Sunshine,46,47,51,46.0,49,I'll Be Your Sunshine,3.0,3,-2,-3,1,1,down,1975-03-08
943,Gloria Gaynor,1975-03-15,Gloria Gaynor - Never Can Say Goodbye,51,51,24,21.0,39,Never Can Say Goodbye,4.0,0,15,12,0,1,up,1975-03-15
944,Gloria Gaynor,1975-03-22,Gloria Gaynor - Never Can Say Goodbye,39,51,21,21.0,24,Never Can Say Goodbye,4.0,1,3,15,12,1,up,1975-03-15
945,Gloria Gaynor,1975-03-29,Gloria Gaynor - Never Can Say Goodbye,24,39,28,21.0,21,Never Can Say Goodbye,4.0,2,-7,3,15,1,down,1975-03-15
946,Gloria Gaynor,1975-04-05,Gloria Gaynor - Never Can Say Goodbye,21,24,43,21.0,28,Never Can Say Goodbye,4.0,3,-15,-7,3,1,down,1975-03-15
947,Gloria Gaynor,1975-04-12,Gloria Gaynor - Never Can Say Goodbye,28,21,51,21.0,43,Never Can Say Goodbye,4.0,4,-8,-15,-7,1,down,1975-03-15
948,Dionne Warwick,1975-03-15,Dionne Warwick - Then Came You,51,51,40,35.0,46,Then Came You,5.0,0,6,5,0,1,up,1975-03-15
949,Dionne Warwick,1975-03-22,Dionne Warwick - Then Came You,46,51,38,35.0,40,Then Came You,5.0,1,2,6,5,1,up,1975-03-15
950,Dionne Warwick,1975-03-29,Dionne Warwick - Then Came You,40,46,37,35.0,38,Then Came You,5.0,2,1,2,6,1,up,1975-03-15
951,Dionne Warwick,1975-04-05,Dionne Warwick - Then Came You,38,40,35,35.0,37,Then Came You,5.0,3,2,1,2,1,up,1975-03-15
952,Dionne Warwick,1975-04-12,Dionne Warwick - Then Came You,37,38,43,35.0,35,Then Came You,5.0,4,-8,2,1,1,down,1975-03-15
953,Dionne Warwick,1975-04-19,Dionne Warwick - Then Came You,35,37,51,35.0,43,Then Came You,5.0,5,-8,-8,2,1,down,1975-03-15
954,The Dells,1975-03-15,The Dells - The Dells Greatest Hits Volume 2,51,51,48,47.0,49,The Dells Greatest Hits Volume 2,3.0,0,1,2,0,1,up,1975-03-15
955,The Dells,1975-03-22,The Dells - The Dells Greatest Hits Volume 2,49,51,47,47.0,48,The Dells Greatest Hits Volume 2,3.0,1,1,1,2,1,up,1975-03-15
956,The Dells,1975-03-29,The Dells - The Dells Greatest Hits Volume 2,48,49,49,47.0,47,The Dells Greatest Hits Volume 2,3.0,2,-2,1,1,1,down,1975-03-15
957,The Dells,1975-04-05,The Dells - The Dells Greatest Hits Volume 2,47,48,51,47.0,49,The Dells Greatest Hits Volume 2,3.0,3,-2,-2,1,1,down,1975-03-15
958,"Earth, Wind & Fire",1975-03-22,"Earth, Wind & Fire - That's The Way Of The World (Soundtrack)",51,51,20,1.0,34,That's The Way Of The World (Soundtrack),32.0,0,14,17,0,1,up,1975-03-22
959,"Earth, Wind & Fire",1975-03-29,"Earth, Wind & Fire - That's The Way Of The World (Soundtrack)",34,51,9,1.0,20,That's The Way Of The World (Soundtrack),32.0,1,11,14,17,1,up,1975-03-22
960,"Earth, Wind & Fire",1975-04-05,"Earth, Wind & Fire - That's The Way Of The World (Soundtrack)",20,34,6,1.0,9,That's The Way Of The World (Soundtrack),32.0,2,3,11,14,1,up,1975-03-22
961,"Earth, Wind & Fire",1975-04-12,"Earth, Wind & Fire - That's The Way Of The World (Soundtrack)",9,20,1,1.0,6,That's The Way Of The World (Soundtrack),32.0,3,5,3,11,1,up,1975-03-22
962,"Earth, Wind & Fire",1975-04-19,"Earth, Wind & Fire - That's The Way Of The World (Soundtrack)",6,9,1,1.0,1,That's The Way Of The World (Soundtrack),32.0,4,0,5,3,0,stay,1975-03-22
963,"Earth, Wind & Fire",1975-04-26,"Earth, Wind & Fire - That's The Way Of The World (Soundtrack)",1,6,5,1.0,1,That's The Way Of The World (Soundtrack),32.0,5,-4,0,5,1,down,1975-03-22
964,"Earth, Wind & Fire",1975-05-03,"Earth, Wind & Fire - That's The Way Of The World (Soundtrack)",1,1,6,1.0,5,That's The Way Of The World (Soundtrack),32.0,6,-1,-4,0,1,down,1975-03-22
965,"Earth, Wind & Fire",1975-05-10,"Earth, Wind & Fire - That's The Way Of The World (Soundtrack)",5,1,8,1.0,6,That's The Way Of The World (Soundtrack),32.0,7,-2,-1,-4,1,down,1975-03-22
966,"Earth, Wind & Fire",1975-05-17,"Earth, Wind & Fire - That's The Way Of The World (Soundtrack)",6,5,15,1.0,8,That's The Way Of The World (Soundtrack),32.0,8,-7,-2,-1,1,down,1975-03-22
967,"Earth, Wind & Fire",1975-05-24,"Earth, Wind & Fire - That's The Way Of The World (Soundtrack)",8,6,12,1.0,15,That's The Way Of The World (Soundtrack),32.0,9,3,-7,-2,1,up,1975-03-22
968,"Earth, Wind & Fire",1975-05-31,"Earth, Wind & Fire - That's The Way Of The World (Soundtrack)",15,8,8,1.0,12,That's The Way Of The World (Soundtrack),32.0,10,4,3,-7,1,up,1975-03-22
969,"Earth, Wind & Fire",1975-06-07,"Earth, Wind & Fire - That's The Way Of The World (Soundtrack)",12,15,4,1.0,8,That's The Way Of The World (Soundtrack),32.0,11,4,4,3,1,up,1975-03-22
970,"Earth, Wind & Fire",1975-06-14,"Earth, Wind & Fire - That's The Way Of The World (Soundtrack)",8,12,1,1.0,4,That's The Way Of The World (Soundtrack),32.0,12,3,4,4,1,up,1975-03-22
971,"Earth, Wind & Fire",1975-06-21,"Earth, Wind & Fire - That's The Way Of The World (Soundtrack)",4,8,1,1.0,1,That's The Way Of The World (Soundtrack),32.0,13,0,3,4,0,stay,1975-03-22
972,"Earth, Wind & Fire",1975-06-28,"Earth, Wind & Fire - That's The Way Of The World (Soundtrack)",1,4,1,1.0,1,That's The Way Of The World (Soundtrack),32.0,14,0,0,3,0,stay,1975-03-22
973,"Earth, Wind & Fire",1975-07-05,"Earth, Wind & Fire - That's The Way Of The World (Soundtrack)",1,1,2,1.0,1,That's The Way Of The World (Soundtrack),32.0,15,-1,0,0,1,down,1975-03-22
974,"Earth, Wind & Fire",1975-07-12,"Earth, Wind & Fire - That's The Way Of The World (Soundtrack)",1,1,2,1.0,2,That's The Way Of The World (Soundtrack),32.0,16,0,-1,0,0,stay,1975-03-22
975,"Earth, Wind & Fire",1975-07-19,"Earth, Wind & Fire - That's The Way Of The World (Soundtrack)",2,1,2,1.0,2,That's The Way Of The World (Soundtrack),32.0,17,0,0,-1,0,stay,1975-03-22
976,"Earth, Wind & Fire",1975-07-26,"Earth, Wind & Fire - That's The Way Of The World (Soundtrack)",2,2,7,1.0,2,That's The Way Of The World (Soundtrack),32.0,18,-5,0,0,1,down,1975-03-22
977,"Earth, Wind & Fire",1975-08-02,"Earth, Wind & Fire - That's The Way Of The World (Soundtrack)",2,2,7,1.0,7,That's The Way Of The World (Soundtrack),32.0,19,0,-5,0,0,stay,1975-03-22
978,"Earth, Wind & Fire",1975-08-09,"Earth, Wind & Fire - That's The Way Of The World (Soundtrack)",7,2,5,1.0,7,That's The Way Of The World (Soundtrack),32.0,20,2,0,-5,1,up,1975-03-22
979,"Earth, Wind & Fire",1975-08-16,"Earth, Wind & Fire - That's The Way Of The World (Soundtrack)",7,7,5,1.0,5,That's The Way Of The World (Soundtrack),32.0,21,0,2,0,0,stay,1975-03-22
980,"Earth, Wind & Fire",1975-08-23,"Earth, Wind & Fire - That's The Way Of The World (Soundtrack)",5,7,4,1.0,5,That's The Way Of The World (Soundtrack),32.0,22,1,0,2,1,up,1975-03-22
981,"Earth, Wind & Fire",1975-08-30,"Earth, Wind & Fire - That's The Way Of The World (Soundtrack)",5,5,3,1.0,4,That's The Way Of The World (Soundtrack),32.0,23,1,1,0,1,up,1975-03-22
982,"Earth, Wind & Fire",1975-09-06,"Earth, Wind & Fire - That's The Way Of The World (Soundtrack)",4,5,5,1.0,3,That's The Way Of The World (Soundtrack),32.0,24,-2,1,1,1,down,1975-03-22
983,"Earth, Wind & Fire",1975-09-13,"Earth, Wind & Fire - That's The Way Of The World (Soundtrack)",3,4,8,1.0,5,That's The Way Of The World (Soundtrack),32.0,25,-3,-2,1,1,down,1975-03-22
984,"Earth, Wind & Fire",1975-09-20,"Earth, Wind & Fire - That's The Way Of The World (Soundtrack)",5,3,11,1.0,8,That's The Way Of The World (Soundtrack),32.0,26,-3,-3,-2,1,down,1975-03-22
985,"Earth, Wind & Fire",1975-09-27,"Earth, Wind & Fire - That's The Way Of The World (Soundtrack)",8,5,12,1.0,11,That's The Way Of The World (Soundtrack),32.0,27,-1,-3,-3,1,down,1975-03-22
986,"Earth, Wind & Fire",1975-10-04,"Earth, Wind & Fire - That's The Way Of The World (Soundtrack)",11,8,19,1.0,12,That's The Way Of The World (Soundtrack),32.0,28,-7,-1,-3,1,down,1975-03-22
987,"Earth, Wind & Fire",1975-10-11,"Earth, Wind & Fire - That's The Way Of The World (Soundtrack)",12,11,23,1.0,19,That's The Way Of The World (Soundtrack),32.0,29,-4,-7,-1,1,down,1975-03-22
988,"Earth, Wind & Fire",1975-10-18,"Earth, Wind & Fire - That's The Way Of The World (Soundtrack)",19,12,23,1.0,23,That's The Way Of The World (Soundtrack),32.0,30,0,-4,-7,0,stay,1975-03-22
989,"Earth, Wind & Fire",1975-10-25,"Earth, Wind & Fire - That's The Way Of The World (Soundtrack)",23,19,39,1.0,23,That's The Way Of The World (Soundtrack),32.0,31,-16,0,-4,1,down,1975-03-22
990,"Earth, Wind & Fire",1975-11-01,"Earth, Wind & Fire - That's The Way Of The World (Soundtrack)",23,23,51,1.0,39,That's The Way Of The World (Soundtrack),32.0,32,-12,-16,0,1,down,1975-03-22
991,"Grover Washington, Jr.",1975-03-22,"Grover Washington, Jr. - Mister Magic",51,51,29,1.0,38,Mister Magic,32.0,0,9,13,0,1,up,1975-03-22
992,"Grover Washington, Jr.",1975-03-29,"Grover Washington, Jr. - Mister Magic",38,51,21,1.0,29,Mister Magic,32.0,1,8,9,13,1,up,1975-03-22
993,"Grover Washington, Jr.",1975-04-05,"Grover Washington, Jr. - Mister Magic",29,38,18,1.0,21,Mister Magic,32.0,2,3,8,9,1,up,1975-03-22
994,"Grover Washington, Jr.",1975-04-12,"Grover Washington, Jr. - Mister Magic",21,29,11,1.0,18,Mister Magic,32.0,3,7,3,8,1,up,1975-03-22
995,"Grover Washington, Jr.",1975-04-19,"Grover Washington, Jr. - Mister Magic",18,21,5,1.0,11,Mister Magic,32.0,4,6,7,3,1,up,1975-03-22
996,"Grover Washington, Jr.",1975-04-26,"Grover Washington, Jr. - Mister Magic",11,18,4,1.0,5,Mister Magic,32.0,5,1,6,7,1,up,1975-03-22
997,"Grover Washington, Jr.",1975-05-03,"Grover Washington, Jr. - Mister Magic",5,11,2,1.0,4,Mister Magic,32.0,6,2,1,6,1,up,1975-03-22
998,"Grover Washington, Jr.",1975-05-10,"Grover Washington, Jr. - Mister Magic",4,5,1,1.0,2,Mister Magic,32.0,7,1,2,1,1,up,1975-03-22
999,"Grover Washington, Jr.",1975-05-17,"Grover Washington, Jr. - Mister Magic",2,4,2,1.0,1,Mister Magic,32.0,8,-1,1,2,1,down,1975-03-22
1000,"Grover Washington, Jr.",1975-05-24,"Grover Washington, Jr. - Mister Magic",1,2,4,1.0,2,Mister Magic,32.0,9,-2,-1,1,1,down,1975-03-22
1001,"Grover Washington, Jr.",1975-05-31,"Grover Washington, Jr. - Mister Magic",2,1,4,1.0,4,Mister Magic,32.0,10,0,-2,-1,0,stay,1975-03-22
1002,"Grover Washington, Jr.",1975-06-07,"Grover Washington, Jr. - Mister Magic",4,2,6,1.0,4,Mister Magic,32.0,11,-2,0,-2,1,down,1975-03-22
1003,"Grover Washington, Jr.",1975-06-14,"Grover Washington, Jr. - Mister Magic",4,4,6,1.0,6,Mister Magic,32.0,12,0,-2,0,0,stay,1975-03-22
1004,"Grover Washington, Jr.",1975-06-21,"Grover Washington, Jr. - Mister Magic",6,4,5,1.0,6,Mister Magic,32.0,13,1,0,-2,1,up,1975-03-22
1005,"Grover Washington, Jr.",1975-06-28,"Grover Washington, Jr. - Mister Magic",6,6,3,1.0,5,Mister Magic,32.0,14,2,1,0,1,up,1975-03-22
1006,"Grover Washington, Jr.",1975-07-05,"Grover Washington, Jr. - Mister Magic",5,6,9,1.0,3,Mister Magic,32.0,15,-6,2,1,1,down,1975-03-22
1007,"Grover Washington, Jr.",1975-07-12,"Grover Washington, Jr. - Mister Magic",3,5,9,1.0,9,Mister Magic,32.0,16,0,-6,2,0,stay,1975-03-22
1008,"Grover Washington, Jr.",1975-07-19,"Grover Washington, Jr. - Mister Magic",9,3,18,1.0,9,Mister Magic,32.0,17,-9,0,-6,1,down,1975-03-22
1009,"Grover Washington, Jr.",1975-07-26,"Grover Washington, Jr. - Mister Magic",9,9,33,1.0,18,Mister Magic,32.0,18,-15,-9,0,1,down,1975-03-22
1010,"Grover Washington, Jr.",1975-08-02,"Grover Washington, Jr. - Mister Magic",18,9,33,1.0,33,Mister Magic,32.0,19,0,-15,-9,0,stay,1975-03-22
1011,"Grover Washington, Jr.",1975-08-09,"Grover Washington, Jr. - Mister Magic",33,18,28,1.0,33,Mister Magic,32.0,20,5,0,-15,1,up,1975-03-22
1012,"Grover Washington, Jr.",1975-08-16,"Grover Washington, Jr. - Mister Magic",33,33,26,1.0,28,Mister Magic,32.0,21,2,5,0,1,up,1975-03-22
1013,"Grover Washington, Jr.",1975-08-23,"Grover Washington, Jr. - Mister Magic",28,33,26,1.0,26,Mister Magic,32.0,22,0,2,5,0,stay,1975-03-22
1014,"Grover Washington, Jr.",1975-08-30,"Grover Washington, Jr. - Mister Magic",26,28,21,1.0,26,Mister Magic,32.0,23,5,0,2,1,up,1975-03-22
1015,"Grover Washington, Jr.",1975-09-06,"Grover Washington, Jr. - Mister Magic",26,26,19,1.0,21,Mister Magic,32.0,24,2,5,0,1,up,1975-03-22
1016,"Grover Washington, Jr.",1975-09-13,"Grover Washington, Jr. - Mister Magic",21,26,15,1.0,19,Mister Magic,32.0,25,4,2,5,1,up,1975-03-22
1017,"Grover Washington, Jr.",1975-09-20,"Grover Washington, Jr. - Mister Magic",19,21,15,1.0,15,Mister Magic,32.0,26,0,4,2,0,stay,1975-03-22
1018,"Grover Washington, Jr.",1975-09-27,"Grover Washington, Jr. - Mister Magic",15,19,18,1.0,15,Mister Magic,32.0,27,-3,0,4,1,down,1975-03-22
1019,"Grover Washington, Jr.",1975-10-04,"Grover Washington, Jr. - Mister Magic",15,15,22,1.0,18,Mister Magic,32.0,28,-4,-3,0,1,down,1975-03-22
1020,"Grover Washington, Jr.",1975-10-11,"Grover Washington, Jr. - Mister Magic",18,15,28,1.0,22,Mister Magic,32.0,29,-6,-4,-3,1,down,1975-03-22
1021,"Grover Washington, Jr.",1975-10-18,"Grover Washington, Jr. - Mister Magic",22,18,32,1.0,28,Mister Magic,32.0,30,-4,-6,-4,1,down,1975-03-22
1022,"Grover Washington, Jr.",1975-10-25,"Grover Washington, Jr. - Mister Magic",28,22,48,1.0,32,Mister Magic,32.0,31,-16,-4,-6,1,down,1975-03-22
1023,"Grover Washington, Jr.",1975-11-01,"Grover Washington, Jr. - Mister Magic",32,28,51,1.0,48,Mister Magic,32.0,32,-3,-16,-4,1,down,1975-03-22
1024,Kool & The Gang,1975-03-22,Kool & The Gang - Kool & The Gang Greatest Hits!,51,51,31,21.0,41,Kool & The Gang Greatest Hits!,5.0,0,10,10,0,1,up,1975-03-22
1025,Kool & The Gang,1975-03-29,Kool & The Gang - Kool & The Gang Greatest Hits!,41,51,25,21.0,31,Kool & The Gang Greatest Hits!,5.0,1,6,10,10,1,up,1975-03-22
1026,Kool & The Gang,1975-04-05,Kool & The Gang - Kool & The Gang Greatest Hits!,31,41,21,21.0,25,Kool & The Gang Greatest Hits!,5.0,2,4,6,10,1,up,1975-03-22
1027,Kool & The Gang,1975-04-12,Kool & The Gang - Kool & The Gang Greatest Hits!,25,31,34,21.0,21,Kool & The Gang Greatest Hits!,5.0,3,-13,4,6,1,down,1975-03-22
1028,Kool & The Gang,1975-04-19,Kool & The Gang - Kool & The Gang Greatest Hits!,21,25,40,21.0,34,Kool & The Gang Greatest Hits!,5.0,4,-6,-13,4,1,down,1975-03-22
1029,Kool & The Gang,1975-04-26,Kool & The Gang - Kool & The Gang Greatest Hits!,34,21,51,21.0,40,Kool & The Gang Greatest Hits!,5.0,5,-11,-6,-13,1,down,1975-03-22
1030,Stanley Turrentine,1975-03-22,Stanley Turrentine - The Sugar Man,51,51,32,21.0,45,The Sugar Man,9.0,0,13,6,0,1,up,1975-03-22
1031,Stanley Turrentine,1975-03-29,Stanley Turrentine - The Sugar Man,45,51,29,21.0,32,The Sugar Man,9.0,1,3,13,6,1,up,1975-03-22
1032,Stanley Turrentine,1975-04-05,Stanley Turrentine - The Sugar Man,32,45,26,21.0,29,The Sugar Man,9.0,2,3,3,13,1,up,1975-03-22
1033,Stanley Turrentine,1975-04-12,Stanley Turrentine - The Sugar Man,29,32,23,21.0,26,The Sugar Man,9.0,3,3,3,3,1,up,1975-03-22
1034,Stanley Turrentine,1975-04-19,Stanley Turrentine - The Sugar Man,26,29,22,21.0,23,The Sugar Man,9.0,4,1,3,3,1,up,1975-03-22
1035,Stanley Turrentine,1975-04-26,Stanley Turrentine - The Sugar Man,23,26,22,21.0,22,The Sugar Man,9.0,5,0,1,3,0,stay,1975-03-22
1036,Stanley Turrentine,1975-05-03,Stanley Turrentine - The Sugar Man,22,23,21,21.0,22,The Sugar Man,9.0,6,1,0,1,1,up,1975-03-22
1037,Stanley Turrentine,1975-05-10,Stanley Turrentine - The Sugar Man,22,22,33,21.0,21,The Sugar Man,9.0,7,-12,1,0,1,down,1975-03-22
1038,Stanley Turrentine,1975-05-17,Stanley Turrentine - The Sugar Man,21,22,39,21.0,33,The Sugar Man,9.0,8,-6,-12,1,1,down,1975-03-22
1039,Stanley Turrentine,1975-05-24,Stanley Turrentine - The Sugar Man,33,21,51,21.0,39,The Sugar Man,9.0,9,-12,-6,-12,1,down,1975-03-22
1040,Carol Douglas,1975-03-22,Carol Douglas - The Carol Douglas Album,51,51,44,37.0,49,The Carol Douglas Album,3.0,0,5,2,0,1,up,1975-03-22
1041,Carol Douglas,1975-03-29,Carol Douglas - The Carol Douglas Album,49,51,40,37.0,44,The Carol Douglas Album,3.0,1,4,5,2,1,up,1975-03-22
1042,Carol Douglas,1975-04-05,Carol Douglas - The Carol Douglas Album,44,49,37,37.0,40,The Carol Douglas Album,3.0,2,3,4,5,1,up,1975-03-22
1043,Carol Douglas,1975-04-12,Carol Douglas - The Carol Douglas Album,40,44,51,37.0,37,The Carol Douglas Album,3.0,3,-14,3,4,1,down,1975-03-22
1044,Major Harris,1975-03-22,Major Harris - My Way,51,51,42,12.0,50,My Way,16.0,0,8,1,0,1,up,1975-03-22
1045,Major Harris,1975-03-29,Major Harris - My Way,50,51,38,12.0,42,My Way,16.0,1,4,8,1,1,up,1975-03-22
1046,Major Harris,1975-04-05,Major Harris - My Way,42,50,36,12.0,38,My Way,16.0,2,2,4,8,1,up,1975-03-22
1047,Major Harris,1975-04-12,Major Harris - My Way,38,42,32,12.0,36,My Way,16.0,3,4,2,4,1,up,1975-03-22
1048,Major Harris,1975-04-19,Major Harris - My Way,36,38,31,12.0,32,My Way,16.0,4,1,4,2,1,up,1975-03-22
1049,Major Harris,1975-04-26,Major Harris - My Way,32,36,27,12.0,31,My Way,16.0,5,4,1,4,1,up,1975-03-22
1050,Major Harris,1975-05-03,Major Harris - My Way,31,32,26,12.0,27,My Way,16.0,6,1,4,1,1,up,1975-03-22
1051,Major Harris,1975-05-10,Major Harris - My Way,27,31,22,12.0,26,My Way,16.0,7,4,1,4,1,up,1975-03-22
1052,Major Harris,1975-05-17,Major Harris - My Way,26,27,17,12.0,22,My Way,16.0,8,5,4,1,1,up,1975-03-22
1053,Major Harris,1975-05-24,Major Harris - My Way,22,26,16,12.0,17,My Way,16.0,9,1,5,4,1,up,1975-03-22
1054,Major Harris,1975-05-31,Major Harris - My Way,17,22,12,12.0,16,My Way,16.0,10,4,1,5,1,up,1975-03-22
1055,Major Harris,1975-06-07,Major Harris - My Way,16,17,12,12.0,12,My Way,16.0,11,0,4,1,0,stay,1975-03-22
1056,Major Harris,1975-06-14,Major Harris - My Way,12,16,13,12.0,12,My Way,16.0,12,-1,0,4,1,down,1975-03-22
1057,Major Harris,1975-06-21,Major Harris - My Way,12,12,13,12.0,13,My Way,16.0,13,0,-1,0,0,stay,1975-03-22
1058,Major Harris,1975-06-28,Major Harris - My Way,13,12,29,12.0,13,My Way,16.0,14,-16,0,-1,1,down,1975-03-22
1059,Major Harris,1975-07-05,Major Harris - My Way,13,13,46,12.0,29,My Way,16.0,15,-17,-16,0,1,down,1975-03-22
1060,Major Harris,1975-07-12,Major Harris - My Way,29,13,51,12.0,46,My Way,16.0,16,-5,-17,-16,1,down,1975-03-22
1061,Al Green,1975-03-29,Al Green - Al Green/Greatest Hits,51,51,20,3.0,35,Al Green/Greatest Hits,12.0,0,15,16,0,1,up,1975-03-29
1062,Al Green,1975-04-05,Al Green - Al Green/Greatest Hits,35,51,11,3.0,20,Al Green/Greatest Hits,12.0,1,9,15,16,1,up,1975-03-29
1063,Al Green,1975-04-12,Al Green - Al Green/Greatest Hits,20,35,5,3.0,11,Al Green/Greatest Hits,12.0,2,6,9,15,1,up,1975-03-29
1064,Al Green,1975-04-19,Al Green - Al Green/Greatest Hits,11,20,4,3.0,5,Al Green/Greatest Hits,12.0,3,1,6,9,1,up,1975-03-29
1065,Al Green,1975-04-26,Al Green - Al Green/Greatest Hits,5,11,3,3.0,4,Al Green/Greatest Hits,12.0,4,1,1,6,1,up,1975-03-29
1066,Al Green,1975-05-03,Al Green - Al Green/Greatest Hits,4,5,3,3.0,3,Al Green/Greatest Hits,12.0,5,0,1,1,0,stay,1975-03-29
1067,Al Green,1975-05-10,Al Green - Al Green/Greatest Hits,3,4,3,3.0,3,Al Green/Greatest Hits,12.0,6,0,0,1,0,stay,1975-03-29
1068,Al Green,1975-05-17,Al Green - Al Green/Greatest Hits,3,3,5,3.0,3,Al Green/Greatest Hits,12.0,7,-2,0,0,1,down,1975-03-29
1069,Al Green,1975-05-24,Al Green - Al Green/Greatest Hits,3,3,6,3.0,5,Al Green/Greatest Hits,12.0,8,-1,-2,0,1,down,1975-03-29
1070,Al Green,1975-05-31,Al Green - Al Green/Greatest Hits,5,3,5,3.0,6,Al Green/Greatest Hits,12.0,9,1,-1,-2,1,up,1975-03-29
1071,Al Green,1975-06-07,Al Green - Al Green/Greatest Hits,6,5,14,3.0,5,Al Green/Greatest Hits,12.0,10,-9,1,-1,1,down,1975-03-29
1072,Al Green,1975-06-14,Al Green - Al Green/Greatest Hits,5,6,32,3.0,14,Al Green/Greatest Hits,12.0,11,-18,-9,1,1,down,1975-03-29
1073,Al Green,1975-06-21,Al Green - Al Green/Greatest Hits,14,5,51,3.0,32,Al Green/Greatest Hits,12.0,12,-19,-18,-9,1,down,1975-03-29
1074,Donald Byrd,1975-03-29,Donald Byrd - Stepping Into Tomorrow,51,51,32,7.0,40,Stepping Into Tomorrow,16.0,0,8,11,0,1,up,1975-03-29
1075,Donald Byrd,1975-04-05,Donald Byrd - Stepping Into Tomorrow,40,51,28,7.0,32,Stepping Into Tomorrow,16.0,1,4,8,11,1,up,1975-03-29
1076,Donald Byrd,1975-04-12,Donald Byrd - Stepping Into Tomorrow,32,40,25,7.0,28,Stepping Into Tomorrow,16.0,2,3,4,8,1,up,1975-03-29
1077,Donald Byrd,1975-04-19,Donald Byrd - Stepping Into Tomorrow,28,32,20,7.0,25,Stepping Into Tomorrow,16.0,3,5,3,4,1,up,1975-03-29
1078,Donald Byrd,1975-04-26,Donald Byrd - Stepping Into Tomorrow,25,28,18,7.0,20,Stepping Into Tomorrow,16.0,4,2,5,3,1,up,1975-03-29
1079,Donald Byrd,1975-05-03,Donald Byrd - Stepping Into Tomorrow,20,25,16,7.0,18,Stepping Into Tomorrow,16.0,5,2,2,5,1,up,1975-03-29
1080,Donald Byrd,1975-05-10,Donald Byrd - Stepping Into Tomorrow,18,20,9,7.0,16,Stepping Into Tomorrow,16.0,6,7,2,2,1,up,1975-03-29
1081,Donald Byrd,1975-05-17,Donald Byrd - Stepping Into Tomorrow,16,18,7,7.0,9,Stepping Into Tomorrow,16.0,7,2,7,2,1,up,1975-03-29
1082,Donald Byrd,1975-05-24,Donald Byrd - Stepping Into Tomorrow,9,16,21,7.0,7,Stepping Into Tomorrow,16.0,8,-14,2,7,1,down,1975-03-29
1083,Donald Byrd,1975-05-31,Donald Byrd - Stepping Into Tomorrow,7,9,38,7.0,21,Stepping Into Tomorrow,16.0,9,-17,-14,2,1,down,1975-03-29
1084,Donald Byrd,1975-06-07,Donald Byrd - Stepping Into Tomorrow,21,7,37,7.0,38,Stepping Into Tomorrow,16.0,10,1,-17,-14,1,up,1975-03-29
1085,Donald Byrd,1975-06-14,Donald Byrd - Stepping Into Tomorrow,38,21,37,7.0,37,Stepping Into Tomorrow,16.0,11,0,1,-17,0,stay,1975-03-29
1086,Donald Byrd,1975-06-21,Donald Byrd - Stepping Into Tomorrow,37,38,33,7.0,37,Stepping Into Tomorrow,16.0,12,4,0,1,1,up,1975-03-29
1087,Donald Byrd,1975-06-28,Donald Byrd - Stepping Into Tomorrow,37,37,30,7.0,33,Stepping Into Tomorrow,16.0,13,3,4,0,1,up,1975-03-29
1088,Donald Byrd,1975-07-05,Donald Byrd - Stepping Into Tomorrow,33,37,43,7.0,30,Stepping Into Tomorrow,16.0,14,-13,3,4,1,down,1975-03-29
1089,Donald Byrd,1975-07-12,Donald Byrd - Stepping Into Tomorrow,30,33,49,7.0,43,Stepping Into Tomorrow,16.0,15,-6,-13,3,1,down,1975-03-29
1090,Donald Byrd,1975-07-19,Donald Byrd - Stepping Into Tomorrow,43,30,51,7.0,49,Stepping Into Tomorrow,16.0,16,-2,-6,-13,1,down,1975-03-29
1091,Ron Banks And The Dramatics,1975-03-29,Ron Banks And The Dramatics - The Dramatic Jackpot,51,51,35,9.0,45,The Dramatic Jackpot,20.0,0,10,6,0,1,up,1975-03-29
1092,Ron Banks And The Dramatics,1975-04-05,Ron Banks And The Dramatics - The Dramatic Jackpot,45,51,27,9.0,35,The Dramatic Jackpot,20.0,1,8,10,6,1,up,1975-03-29
1093,Ron Banks And The Dramatics,1975-04-12,Ron Banks And The Dramatics - The Dramatic Jackpot,35,45,17,9.0,27,The Dramatic Jackpot,20.0,2,10,8,10,1,up,1975-03-29
1094,Ron Banks And The Dramatics,1975-04-19,Ron Banks And The Dramatics - The Dramatic Jackpot,27,35,13,9.0,17,The Dramatic Jackpot,20.0,3,4,10,8,1,up,1975-03-29
1095,Ron Banks And The Dramatics,1975-04-26,Ron Banks And The Dramatics - The Dramatic Jackpot,17,27,10,9.0,13,The Dramatic Jackpot,20.0,4,3,4,10,1,up,1975-03-29
1096,Ron Banks And The Dramatics,1975-05-03,Ron Banks And The Dramatics - The Dramatic Jackpot,13,17,9,9.0,10,The Dramatic Jackpot,20.0,5,1,3,4,1,up,1975-03-29
1097,Ron Banks And The Dramatics,1975-05-10,Ron Banks And The Dramatics - The Dramatic Jackpot,10,13,11,9.0,9,The Dramatic Jackpot,20.0,6,-2,1,3,1,down,1975-03-29
1098,Ron Banks And The Dramatics,1975-05-17,Ron Banks And The Dramatics - The Dramatic Jackpot,9,10,11,9.0,11,The Dramatic Jackpot,20.0,7,0,-2,1,0,stay,1975-03-29
1099,Ron Banks And The Dramatics,1975-05-24,Ron Banks And The Dramatics - The Dramatic Jackpot,11,9,26,9.0,11,The Dramatic Jackpot,20.0,8,-15,0,-2,1,down,1975-03-29
1100,Ron Banks And The Dramatics,1975-05-31,Ron Banks And The Dramatics - The Dramatic Jackpot,11,11,22,9.0,26,The Dramatic Jackpot,20.0,9,4,-15,0,1,up,1975-03-29
1101,Ron Banks And The Dramatics,1975-06-07,Ron Banks And The Dramatics - The Dramatic Jackpot,26,11,21,9.0,22,The Dramatic Jackpot,20.0,10,1,4,-15,1,up,1975-03-29
1102,Ron Banks And The Dramatics,1975-06-14,Ron Banks And The Dramatics - The Dramatic Jackpot,22,26,20,9.0,21,The Dramatic Jackpot,20.0,11,1,1,4,1,up,1975-03-29
1103,Ron Banks And The Dramatics,1975-06-21,Ron Banks And The Dramatics - The Dramatic Jackpot,21,22,23,9.0,20,The Dramatic Jackpot,20.0,12,-3,1,1,1,down,1975-03-29
1104,Ron Banks And The Dramatics,1975-06-28,Ron Banks And The Dramatics - The Dramatic Jackpot,20,21,43,9.0,23,The Dramatic Jackpot,20.0,13,-20,-3,1,1,down,1975-03-29
1105,Ron Banks And The Dramatics,1975-07-05,Ron Banks And The Dramatics - The Dramatic Jackpot,23,20,33,9.0,43,The Dramatic Jackpot,20.0,14,10,-20,-3,1,up,1975-03-29
1106,Ron Banks And The Dramatics,1975-07-12,Ron Banks And The Dramatics - The Dramatic Jackpot,43,23,27,9.0,33,The Dramatic Jackpot,20.0,15,6,10,-20,1,up,1975-03-29
1107,Ron Banks And The Dramatics,1975-07-19,Ron Banks And The Dramatics - The Dramatic Jackpot,33,43,26,9.0,27,The Dramatic Jackpot,20.0,16,1,6,10,1,up,1975-03-29
1108,Ron Banks And The Dramatics,1975-07-26,Ron Banks And The Dramatics - The Dramatic Jackpot,27,33,24,9.0,26,The Dramatic Jackpot,20.0,17,2,1,6,1,up,1975-03-29
1109,Ron Banks And The Dramatics,1975-08-02,Ron Banks And The Dramatics - The Dramatic Jackpot,26,27,24,9.0,24,The Dramatic Jackpot,20.0,18,0,2,1,0,stay,1975-03-29
1110,Ron Banks And The Dramatics,1975-08-09,Ron Banks And The Dramatics - The Dramatic Jackpot,24,26,38,9.0,24,The Dramatic Jackpot,20.0,19,-14,0,2,1,down,1975-03-29
1111,Ron Banks And The Dramatics,1975-08-16,Ron Banks And The Dramatics - The Dramatic Jackpot,24,24,51,9.0,38,The Dramatic Jackpot,20.0,20,-13,-14,0,1,down,1975-03-29
1112,Funkadelic,1975-03-29,Funkadelic - Funkadelic's Greatest Hits,51,51,51,50.0,50,Funkadelic's Greatest Hits,0.0,0,-1,1,0,1,down,1975-03-29
1113,Roberta Flack,1975-04-05,Roberta Flack - Feel Like Makin' Love,51,51,23,5.0,39,Feel Like Makin' Love,16.0,0,16,12,0,1,up,1975-04-05
1114,Roberta Flack,1975-04-12,Roberta Flack - Feel Like Makin' Love,39,51,15,5.0,23,Feel Like Makin' Love,16.0,1,8,16,12,1,up,1975-04-05
1115,Roberta Flack,1975-04-19,Roberta Flack - Feel Like Makin' Love,23,39,8,5.0,15,Feel Like Makin' Love,16.0,2,7,8,16,1,up,1975-04-05
1116,Roberta Flack,1975-04-26,Roberta Flack - Feel Like Makin' Love,15,23,6,5.0,8,Feel Like Makin' Love,16.0,3,2,7,8,1,up,1975-04-05
1117,Roberta Flack,1975-05-03,Roberta Flack - Feel Like Makin' Love,8,15,5,5.0,6,Feel Like Makin' Love,16.0,4,1,2,7,1,up,1975-04-05
1118,Roberta Flack,1975-05-10,Roberta Flack - Feel Like Makin' Love,6,8,5,5.0,5,Feel Like Makin' Love,16.0,5,0,1,2,0,stay,1975-04-05
1119,Roberta Flack,1975-05-17,Roberta Flack - Feel Like Makin' Love,5,6,13,5.0,5,Feel Like Makin' Love,16.0,6,-8,0,1,1,down,1975-04-05
1120,Roberta Flack,1975-05-24,Roberta Flack - Feel Like Makin' Love,5,5,28,5.0,13,Feel Like Makin' Love,16.0,7,-15,-8,0,1,down,1975-04-05
1121,Roberta Flack,1975-05-31,Roberta Flack - Feel Like Makin' Love,13,5,39,5.0,28,Feel Like Makin' Love,16.0,8,-11,-15,-8,1,down,1975-04-05
1122,Roberta Flack,1975-06-07,Roberta Flack - Feel Like Makin' Love,28,13,33,5.0,39,Feel Like Makin' Love,16.0,9,6,-11,-15,1,up,1975-04-05
1123,Roberta Flack,1975-06-21,Roberta Flack - Feel Like Makin' Love,39,28,26,5.0,33,Feel Like Makin' Love,16.0,10,7,6,-11,1,up,1975-04-05
1124,Roberta Flack,1975-06-28,Roberta Flack - Feel Like Makin' Love,33,39,21,5.0,26,Feel Like Makin' Love,16.0,11,5,7,6,1,up,1975-04-05
1125,Roberta Flack,1975-07-05,Roberta Flack - Feel Like Makin' Love,26,33,20,5.0,21,Feel Like Makin' Love,16.0,12,1,5,7,1,up,1975-04-05
1126,Roberta Flack,1975-07-12,Roberta Flack - Feel Like Makin' Love,21,26,19,5.0,20,Feel Like Makin' Love,16.0,13,1,1,5,1,up,1975-04-05
1127,Roberta Flack,1975-07-19,Roberta Flack - Feel Like Makin' Love,20,21,24,5.0,19,Feel Like Makin' Love,16.0,14,-5,1,1,1,down,1975-04-05
1128,Roberta Flack,1975-07-26,Roberta Flack - Feel Like Makin' Love,19,20,38,5.0,24,Feel Like Makin' Love,16.0,15,-14,-5,1,1,down,1975-04-05
1129,Roberta Flack,1975-08-02,Roberta Flack - Feel Like Makin' Love,24,19,51,5.0,38,Feel Like Makin' Love,16.0,16,-13,-14,-5,1,down,1975-04-05
1130,Tom Scott & The L.A. Express,1975-04-05,Tom Scott & The L.A. Express - Tom Cat,51,51,40,18.0,43,Tom Cat,14.0,0,3,8,0,1,up,1975-04-05
1131,Tom Scott & The L.A. Express,1975-04-12,Tom Scott & The L.A. Express - Tom Cat,43,51,31,18.0,40,Tom Cat,14.0,1,9,3,8,1,up,1975-04-05
1132,Tom Scott & The L.A. Express,1975-04-19,Tom Scott & The L.A. Express - Tom Cat,40,43,25,18.0,31,Tom Cat,14.0,2,6,9,3,1,up,1975-04-05
1133,Tom Scott & The L.A. Express,1975-04-26,Tom Scott & The L.A. Express - Tom Cat,31,40,21,18.0,25,Tom Cat,14.0,3,4,6,9,1,up,1975-04-05
1134,Tom Scott & The L.A. Express,1975-05-03,Tom Scott & The L.A. Express - Tom Cat,25,31,18,18.0,21,Tom Cat,14.0,4,3,4,6,1,up,1975-04-05
1135,Tom Scott & The L.A. Express,1975-05-10,Tom Scott & The L.A. Express - Tom Cat,21,25,20,18.0,18,Tom Cat,14.0,5,-2,3,4,1,down,1975-04-05
1136,Tom Scott & The L.A. Express,1975-05-17,Tom Scott & The L.A. Express - Tom Cat,18,21,34,18.0,20,Tom Cat,14.0,6,-14,-2,3,1,down,1975-04-05
1137,Tom Scott & The L.A. Express,1975-05-24,Tom Scott & The L.A. Express - Tom Cat,20,18,35,18.0,34,Tom Cat,14.0,7,-1,-14,-2,1,down,1975-04-05
1138,Tom Scott & The L.A. Express,1975-05-31,Tom Scott & The L.A. Express - Tom Cat,34,20,45,18.0,35,Tom Cat,14.0,8,-10,-1,-14,1,down,1975-04-05
1139,Tom Scott & The L.A. Express,1975-06-14,Tom Scott & The L.A. Express - Tom Cat,35,34,43,18.0,45,Tom Cat,14.0,9,2,-10,-1,1,up,1975-04-05
1140,Tom Scott & The L.A. Express,1975-06-21,Tom Scott & The L.A. Express - Tom Cat,45,35,41,18.0,43,Tom Cat,14.0,10,2,2,-10,1,up,1975-04-05
1141,Tom Scott & The L.A. Express,1975-06-28,Tom Scott & The L.A. Express - Tom Cat,43,45,38,18.0,41,Tom Cat,14.0,11,3,2,2,1,up,1975-04-05
1142,Tom Scott & The L.A. Express,1975-07-05,Tom Scott & The L.A. Express - Tom Cat,41,43,32,18.0,38,Tom Cat,14.0,12,6,3,2,1,up,1975-04-05
1143,Tom Scott & The L.A. Express,1975-07-12,Tom Scott & The L.A. Express - Tom Cat,38,41,37,18.0,32,Tom Cat,14.0,13,-5,6,3,1,down,1975-04-05
1144,Tom Scott & The L.A. Express,1975-07-19,Tom Scott & The L.A. Express - Tom Cat,32,38,51,18.0,37,Tom Cat,14.0,14,-14,-5,6,1,down,1975-04-05
1145,Jimmy Caston Bunch,1975-04-05,Jimmy Caston Bunch - Butt Of Course,51,51,44,29.0,47,Butt Of Course,7.0,0,3,4,0,1,up,1975-04-05
1146,Jimmy Caston Bunch,1975-04-12,Jimmy Caston Bunch - Butt Of Course,47,51,38,29.0,44,Butt Of Course,7.0,1,6,3,4,1,up,1975-04-05
1147,Jimmy Caston Bunch,1975-04-19,Jimmy Caston Bunch - Butt Of Course,44,47,34,29.0,38,Butt Of Course,7.0,2,4,6,3,1,up,1975-04-05
1148,Jimmy Caston Bunch,1975-04-26,Jimmy Caston Bunch - Butt Of Course,38,44,29,29.0,34,Butt Of Course,7.0,3,5,4,6,1,up,1975-04-05
1149,Jimmy Caston Bunch,1975-05-03,Jimmy Caston Bunch - Butt Of Course,34,38,35,29.0,29,Butt Of Course,7.0,4,-6,5,4,1,down,1975-04-05
1150,Jimmy Caston Bunch,1975-05-10,Jimmy Caston Bunch - Butt Of Course,29,34,45,29.0,35,Butt Of Course,7.0,5,-10,-6,5,1,down,1975-04-05
1151,Jimmy Caston Bunch,1975-05-17,Jimmy Caston Bunch - Butt Of Course,35,29,46,29.0,45,Butt Of Course,7.0,6,-1,-10,-6,1,down,1975-04-05
1152,Jimmy Caston Bunch,1975-05-24,Jimmy Caston Bunch - Butt Of Course,45,35,51,29.0,46,Butt Of Course,7.0,7,-5,-1,-10,1,down,1975-04-05
1153,The Whispers,1975-04-05,The Whispers - Greatest Hits,51,51,51,48.0,48,Greatest Hits,0.0,0,-3,3,0,1,down,1975-04-05
1154,Commodores,1975-04-12,Commodores - Caught In The Act,51,51,42,7.0,46,Caught In The Act,18.0,0,4,5,0,1,up,1975-04-12
1155,Commodores,1975-04-19,Commodores - Caught In The Act,46,51,33,7.0,42,Caught In The Act,18.0,1,9,4,5,1,up,1975-04-12
1156,Commodores,1975-04-26,Commodores - Caught In The Act,42,46,30,7.0,33,Caught In The Act,18.0,2,3,9,4,1,up,1975-04-12
1157,Commodores,1975-05-03,Commodores - Caught In The Act,33,42,23,7.0,30,Caught In The Act,18.0,3,7,3,9,1,up,1975-04-12
1158,Commodores,1975-05-10,Commodores - Caught In The Act,30,33,21,7.0,23,Caught In The Act,18.0,4,2,7,3,1,up,1975-04-12
1159,Commodores,1975-05-17,Commodores - Caught In The Act,23,30,19,7.0,21,Caught In The Act,18.0,5,2,2,7,1,up,1975-04-12
1160,Commodores,1975-05-24,Commodores - Caught In The Act,21,23,17,7.0,19,Caught In The Act,18.0,6,2,2,2,1,up,1975-04-12
1161,Commodores,1975-05-31,Commodores - Caught In The Act,19,21,15,7.0,17,Caught In The Act,18.0,7,2,2,2,1,up,1975-04-12
1162,Commodores,1975-06-07,Commodores - Caught In The Act,17,19,9,7.0,15,Caught In The Act,18.0,8,6,2,2,1,up,1975-04-12
1163,Commodores,1975-06-14,Commodores - Caught In The Act,15,17,7,7.0,9,Caught In The Act,18.0,9,2,6,2,1,up,1975-04-12
1164,Commodores,1975-06-21,Commodores - Caught In The Act,9,15,8,7.0,7,Caught In The Act,18.0,10,-1,2,6,1,down,1975-04-12
1165,Commodores,1975-06-28,Commodores - Caught In The Act,7,9,8,7.0,8,Caught In The Act,18.0,11,0,-1,2,0,stay,1975-04-12
1166,Commodores,1975-07-05,Commodores - Caught In The Act,8,7,12,7.0,8,Caught In The Act,18.0,12,-4,0,-1,1,down,1975-04-12
1167,Commodores,1975-07-12,Commodores - Caught In The Act,8,8,17,7.0,12,Caught In The Act,18.0,13,-5,-4,0,1,down,1975-04-12
1168,Commodores,1975-07-19,Commodores - Caught In The Act,12,8,19,7.0,17,Caught In The Act,18.0,14,-2,-5,-4,1,down,1975-04-12
1169,Commodores,1975-07-26,Commodores - Caught In The Act,17,12,37,7.0,19,Caught In The Act,18.0,15,-18,-2,-5,1,down,1975-04-12
1170,Commodores,1975-08-02,Commodores - Caught In The Act,19,17,48,7.0,37,Caught In The Act,18.0,16,-11,-18,-2,1,down,1975-04-12
1171,Commodores,1975-08-09,Commodores - Caught In The Act,37,19,49,7.0,48,Caught In The Act,18.0,17,-1,-11,-18,1,down,1975-04-12
1172,Commodores,1975-08-16,Commodores - Caught In The Act,48,37,51,7.0,49,Caught In The Act,18.0,18,-2,-1,-11,1,down,1975-04-12
1173,Marlena Shaw,1975-04-12,"Marlena Shaw - Who Is This Bitch, Anyway?",51,51,51,47.0,47,"Who Is This Bitch, Anyway?",0.0,0,-4,4,0,1,down,1975-04-12
1174,Average White Band,1975-04-12,Average White Band - Put It Where You Want It,51,51,41,39.0,49,Put It Where You Want It,3.0,0,8,2,0,1,up,1975-04-12
1175,Average White Band,1975-04-19,Average White Band - Put It Where You Want It,49,51,39,39.0,41,Put It Where You Want It,3.0,1,2,8,2,1,up,1975-04-12
1176,Average White Band,1975-04-26,Average White Band - Put It Where You Want It,41,49,40,39.0,39,Put It Where You Want It,3.0,2,-1,2,8,1,down,1975-04-12
1177,Average White Band,1975-05-03,Average White Band - Put It Where You Want It,39,41,51,39.0,40,Put It Where You Want It,3.0,3,-11,-1,2,1,down,1975-04-12
1178,Ron Carter,1975-04-12,Ron Carter - Spanish Blue,51,51,40,37.0,50,Spanish Blue,4.0,0,10,1,0,1,up,1975-04-12
1179,Ron Carter,1975-04-19,Ron Carter - Spanish Blue,50,51,38,37.0,40,Spanish Blue,4.0,1,2,10,1,1,up,1975-04-12
1180,Ron Carter,1975-04-26,Ron Carter - Spanish Blue,40,50,37,37.0,38,Spanish Blue,4.0,2,1,2,10,1,up,1975-04-12
1181,Ron Carter,1975-05-03,Ron Carter - Spanish Blue,38,40,41,37.0,37,Spanish Blue,4.0,3,-4,1,2,1,down,1975-04-12
1182,Ron Carter,1975-05-10,Ron Carter - Spanish Blue,37,38,51,37.0,41,Spanish Blue,4.0,4,-10,-4,1,1,down,1975-04-12
1183,Barry White,1975-04-19,Barry White - Just Another Way To Say I Love You,51,51,23,1.0,37,Just Another Way To Say I Love You,13.0,0,14,14,0,1,up,1975-04-19
1184,Barry White,1975-04-26,Barry White - Just Another Way To Say I Love You,37,51,14,1.0,23,Just Another Way To Say I Love You,13.0,1,9,14,14,1,up,1975-04-19
1185,Barry White,1975-05-03,Barry White - Just Another Way To Say I Love You,23,37,8,1.0,14,Just Another Way To Say I Love You,13.0,2,6,9,14,1,up,1975-04-19
1186,Barry White,1975-05-10,Barry White - Just Another Way To Say I Love You,14,23,6,1.0,8,Just Another Way To Say I Love You,13.0,3,2,6,9,1,up,1975-04-19
1187,Barry White,1975-05-17,Barry White - Just Another Way To Say I Love You,8,14,3,1.0,6,Just Another Way To Say I Love You,13.0,4,3,2,6,1,up,1975-04-19
1188,Barry White,1975-05-24,Barry White - Just Another Way To Say I Love You,6,8,1,1.0,3,Just Another Way To Say I Love You,13.0,5,2,3,2,1,up,1975-04-19
1189,Barry White,1975-05-31,Barry White - Just Another Way To Say I Love You,3,6,2,1.0,1,Just Another Way To Say I Love You,13.0,6,-1,2,3,1,down,1975-04-19
1190,Barry White,1975-06-07,Barry White - Just Another Way To Say I Love You,1,3,10,1.0,2,Just Another Way To Say I Love You,13.0,7,-8,-1,2,1,down,1975-04-19
1191,Barry White,1975-06-14,Barry White - Just Another Way To Say I Love You,2,1,17,1.0,10,Just Another Way To Say I Love You,13.0,8,-7,-8,-1,1,down,1975-04-19
1192,Barry White,1975-06-21,Barry White - Just Another Way To Say I Love You,10,2,15,1.0,17,Just Another Way To Say I Love You,13.0,9,2,-7,-8,1,up,1975-04-19
1193,Barry White,1975-06-28,Barry White - Just Another Way To Say I Love You,17,10,12,1.0,15,Just Another Way To Say I Love You,13.0,10,3,2,-7,1,up,1975-04-19
1194,Barry White,1975-07-05,Barry White - Just Another Way To Say I Love You,15,17,25,1.0,12,Just Another Way To Say I Love You,13.0,11,-13,3,2,1,down,1975-04-19
1195,Barry White,1975-07-12,Barry White - Just Another Way To Say I Love You,12,15,44,1.0,25,Just Another Way To Say I Love You,13.0,12,-19,-13,3,1,down,1975-04-19
1196,Barry White,1975-07-19,Barry White - Just Another Way To Say I Love You,25,12,51,1.0,44,Just Another Way To Say I Love You,13.0,13,-7,-19,-13,1,down,1975-04-19
1197,Johnny Bristol,1975-04-19,Johnny Bristol - Feeling The Magic,51,51,36,29.0,44,Feeling The Magic,4.0,0,8,7,0,1,up,1975-04-19
1198,Johnny Bristol,1975-04-26,Johnny Bristol - Feeling The Magic,44,51,31,29.0,36,Feeling The Magic,4.0,1,5,8,7,1,up,1975-04-19
1199,Johnny Bristol,1975-05-03,Johnny Bristol - Feeling The Magic,36,44,29,29.0,31,Feeling The Magic,4.0,2,2,5,8,1,up,1975-04-19
1200,Johnny Bristol,1975-05-10,Johnny Bristol - Feeling The Magic,31,36,38,29.0,29,Feeling The Magic,4.0,3,-9,2,5,1,down,1975-04-19
1201,Johnny Bristol,1975-05-17,Johnny Bristol - Feeling The Magic,29,31,51,29.0,38,Feeling The Magic,4.0,4,-13,-9,2,1,down,1975-04-19
1202,Headhunters,1975-04-19,Headhunters - Survival Of The Fittest,51,51,41,34.0,46,Survival Of The Fittest,4.0,0,5,5,0,1,up,1975-04-19
1203,Headhunters,1975-04-26,Headhunters - Survival Of The Fittest,46,51,39,34.0,41,Survival Of The Fittest,4.0,1,2,5,5,1,up,1975-04-19
1204,Headhunters,1975-05-03,Headhunters - Survival Of The Fittest,41,46,34,34.0,39,Survival Of The Fittest,4.0,2,5,2,5,1,up,1975-04-19
1205,Headhunters,1975-05-10,Headhunters - Survival Of The Fittest,39,41,44,34.0,34,Survival Of The Fittest,4.0,3,-10,5,2,1,down,1975-04-19
1206,Headhunters,1975-05-17,Headhunters - Survival Of The Fittest,34,39,51,34.0,44,Survival Of The Fittest,4.0,4,-7,-10,5,1,down,1975-04-19
1207,Bob Marley And The Wailers,1975-04-19,Bob Marley And The Wailers - Natty Dread,51,51,46,44.0,48,Natty Dread,3.0,0,2,3,0,1,up,1975-04-19
1208,Bob Marley And The Wailers,1975-04-26,Bob Marley And The Wailers - Natty Dread,48,51,45,44.0,46,Natty Dread,3.0,1,1,2,3,1,up,1975-04-19
1209,Bob Marley And The Wailers,1975-05-03,Bob Marley And The Wailers - Natty Dread,46,48,44,44.0,45,Natty Dread,3.0,2,1,1,2,1,up,1975-04-19
1210,Bob Marley And The Wailers,1975-05-10,Bob Marley And The Wailers - Natty Dread,45,46,51,44.0,44,Natty Dread,3.0,3,-7,1,1,1,down,1975-04-19
1211,Undisputed Truth,1975-04-19,Undisputed Truth - Cosmic Truth,51,51,47,42.0,49,Cosmic Truth,3.0,0,2,2,0,1,up,1975-04-19
1212,Undisputed Truth,1975-04-26,Undisputed Truth - Cosmic Truth,49,51,42,42.0,47,Cosmic Truth,3.0,1,5,2,2,1,up,1975-04-19
1213,Undisputed Truth,1975-05-03,Undisputed Truth - Cosmic Truth,47,49,42,42.0,42,Cosmic Truth,3.0,2,0,5,2,0,stay,1975-04-19
1214,Undisputed Truth,1975-05-10,Undisputed Truth - Cosmic Truth,42,47,51,42.0,42,Cosmic Truth,3.0,3,-9,0,5,1,down,1975-04-19
1215,Funkadelic,1975-04-19,Funkadelic - Standing On The Verge Of Getting It On,51,51,45,43.0,50,Standing On The Verge Of Getting It On,3.0,0,5,1,0,1,up,1975-04-19
1216,Funkadelic,1975-04-26,Funkadelic - Standing On The Verge Of Getting It On,50,51,43,43.0,45,Standing On The Verge Of Getting It On,3.0,1,2,5,1,1,up,1975-04-19
1217,Funkadelic,1975-05-03,Funkadelic - Standing On The Verge Of Getting It On,45,50,47,43.0,43,Standing On The Verge Of Getting It On,3.0,2,-4,2,5,1,down,1975-04-19
1218,Funkadelic,1975-05-10,Funkadelic - Standing On The Verge Of Getting It On,43,45,51,43.0,47,Standing On The Verge Of Getting It On,3.0,3,-4,-4,2,1,down,1975-04-19
1219,Bob James,1975-04-26,Bob James - Two,51,51,33,28.0,44,Two,11.0,0,11,7,0,1,up,1975-04-26
1220,Bob James,1975-05-03,Bob James - Two,44,51,30,28.0,33,Two,11.0,1,3,11,7,1,up,1975-04-26
1221,Bob James,1975-05-10,Bob James - Two,33,44,28,28.0,30,Two,11.0,2,2,3,11,1,up,1975-04-26
1222,Bob James,1975-05-17,Bob James - Two,30,33,37,28.0,28,Two,11.0,3,-9,2,3,1,down,1975-04-26
1223,Bob James,1975-05-24,Bob James - Two,28,30,48,28.0,37,Two,11.0,4,-11,-9,2,1,down,1975-04-26
1224,Bob James,1975-06-07,Bob James - Two,37,28,43,28.0,48,Two,11.0,5,5,-11,-9,1,up,1975-04-26
1225,Bob James,1975-06-14,Bob James - Two,48,37,40,28.0,43,Two,11.0,6,3,5,-11,1,up,1975-04-26
1226,Bob James,1975-06-21,Bob James - Two,43,48,36,28.0,40,Two,11.0,7,4,3,5,1,up,1975-04-26
1227,Bob James,1975-06-28,Bob James - Two,40,43,33,28.0,36,Two,11.0,8,3,4,3,1,up,1975-04-26
1228,Bob James,1975-07-05,Bob James - Two,36,40,30,28.0,33,Two,11.0,9,3,3,4,1,up,1975-04-26
1229,Bob James,1975-07-12,Bob James - Two,33,36,48,28.0,30,Two,11.0,10,-18,3,3,1,down,1975-04-26
1230,Bob James,1975-07-19,Bob James - Two,30,33,51,28.0,48,Two,11.0,11,-3,-18,3,1,down,1975-04-26
1231,Eddie Harris,1975-04-26,Eddie Harris - I Need Some Money,51,51,44,36.0,48,I Need Some Money,4.0,0,4,3,0,1,up,1975-04-26
1232,Eddie Harris,1975-05-03,Eddie Harris - I Need Some Money,48,51,38,36.0,44,I Need Some Money,4.0,1,6,4,3,1,up,1975-04-26
1233,Eddie Harris,1975-05-10,Eddie Harris - I Need Some Money,44,48,36,36.0,38,I Need Some Money,4.0,2,2,6,4,1,up,1975-04-26
1234,Eddie Harris,1975-05-17,Eddie Harris - I Need Some Money,38,44,42,36.0,36,I Need Some Money,4.0,3,-6,2,6,1,down,1975-04-26
1235,Eddie Harris,1975-05-24,Eddie Harris - I Need Some Money,36,38,51,36.0,42,I Need Some Money,4.0,4,-9,-6,2,1,down,1975-04-26
1236,Herbie Mann,1975-04-26,Herbie Mann - Discotheque,51,51,49,19.0,50,Discotheque,8.0,0,1,1,0,1,up,1975-04-26
1237,Herbie Mann,1975-05-03,Herbie Mann - Discotheque,50,51,39,19.0,49,Discotheque,8.0,1,10,1,1,1,up,1975-04-26
1238,Herbie Mann,1975-05-10,Herbie Mann - Discotheque,49,50,26,19.0,39,Discotheque,8.0,2,13,10,1,1,up,1975-04-26
1239,Herbie Mann,1975-05-17,Herbie Mann - Discotheque,39,49,20,19.0,26,Discotheque,8.0,3,6,13,10,1,up,1975-04-26
1240,Herbie Mann,1975-05-24,Herbie Mann - Discotheque,26,39,19,19.0,20,Discotheque,8.0,4,1,6,13,1,up,1975-04-26
1241,Herbie Mann,1975-05-31,Herbie Mann - Discotheque,20,26,23,19.0,19,Discotheque,8.0,5,-4,1,6,1,down,1975-04-26
1242,Herbie Mann,1975-06-07,Herbie Mann - Discotheque,19,20,31,19.0,23,Discotheque,8.0,6,-8,-4,1,1,down,1975-04-26
1243,Herbie Mann,1975-06-14,Herbie Mann - Discotheque,23,19,42,19.0,31,Discotheque,8.0,7,-11,-8,-4,1,down,1975-04-26
1244,Herbie Mann,1975-06-21,Herbie Mann - Discotheque,31,23,51,19.0,42,Discotheque,8.0,8,-9,-11,-8,1,down,1975-04-26
1245,The O'Jays,1975-05-03,The O'Jays - Survival,51,51,27,1.0,41,Survival,21.0,0,14,10,0,1,up,1975-05-03
1246,The O'Jays,1975-05-10,The O'Jays - Survival,41,51,17,1.0,27,Survival,21.0,1,10,14,10,1,up,1975-05-03
1247,The O'Jays,1975-05-17,The O'Jays - Survival,27,41,12,1.0,17,Survival,21.0,2,5,10,14,1,up,1975-05-03
1248,The O'Jays,1975-05-24,The O'Jays - Survival,17,27,2,1.0,12,Survival,21.0,3,10,5,10,1,up,1975-05-03
1249,The O'Jays,1975-05-31,The O'Jays - Survival,12,17,1,1.0,2,Survival,21.0,4,1,10,5,1,up,1975-05-03
1250,The O'Jays,1975-06-07,The O'Jays - Survival,2,12,1,1.0,1,Survival,21.0,5,0,1,10,0,stay,1975-05-03
1251,The O'Jays,1975-06-14,The O'Jays - Survival,1,2,2,1.0,1,Survival,21.0,6,-1,0,1,1,down,1975-05-03
1252,The O'Jays,1975-06-21,The O'Jays - Survival,1,1,6,1.0,2,Survival,21.0,7,-4,-1,0,1,down,1975-05-03
1253,The O'Jays,1975-06-28,The O'Jays - Survival,2,1,7,1.0,6,Survival,21.0,8,-1,-4,-1,1,down,1975-05-03
1254,The O'Jays,1975-07-05,The O'Jays - Survival,6,2,5,1.0,7,Survival,21.0,9,2,-1,-4,1,up,1975-05-03
1255,The O'Jays,1975-07-12,The O'Jays - Survival,7,6,4,1.0,5,Survival,21.0,10,1,2,-1,1,up,1975-05-03
1256,The O'Jays,1975-07-19,The O'Jays - Survival,5,7,8,1.0,4,Survival,21.0,11,-4,1,2,1,down,1975-05-03
1257,The O'Jays,1975-07-26,The O'Jays - Survival,4,5,13,1.0,8,Survival,21.0,12,-5,-4,1,1,down,1975-05-03
1258,The O'Jays,1975-08-02,The O'Jays - Survival,8,4,13,1.0,13,Survival,21.0,13,0,-5,-4,0,stay,1975-05-03
1259,The O'Jays,1975-08-09,The O'Jays - Survival,13,8,15,1.0,13,Survival,21.0,14,-2,0,-5,1,down,1975-05-03
1260,The O'Jays,1975-08-16,The O'Jays - Survival,13,13,33,1.0,15,Survival,21.0,15,-18,-2,0,1,down,1975-05-03
1261,The O'Jays,1975-08-23,The O'Jays - Survival,15,13,48,1.0,33,Survival,21.0,16,-15,-18,-2,1,down,1975-05-03
1262,The O'Jays,1975-09-06,The O'Jays - Survival,33,15,43,1.0,48,Survival,21.0,17,5,-15,-18,1,up,1975-05-03
1263,The O'Jays,1975-09-13,The O'Jays - Survival,48,33,38,1.0,43,Survival,21.0,18,5,5,-15,1,up,1975-05-03
1264,The O'Jays,1975-09-20,The O'Jays - Survival,43,48,34,1.0,38,Survival,21.0,19,4,5,5,1,up,1975-05-03
1265,The O'Jays,1975-09-27,The O'Jays - Survival,38,43,33,1.0,34,Survival,21.0,20,1,4,5,1,up,1975-05-03
1266,The O'Jays,1975-10-04,The O'Jays - Survival,34,38,51,1.0,33,Survival,21.0,21,-18,1,4,1,down,1975-05-03
1267,Mandrill,1975-05-03,Mandrill - Solid,51,51,37,18.0,46,Solid,9.0,0,9,5,0,1,up,1975-05-03
1268,Mandrill,1975-05-10,Mandrill - Solid,46,51,27,18.0,37,Solid,9.0,1,10,9,5,1,up,1975-05-03
1269,Mandrill,1975-05-17,Mandrill - Solid,37,46,24,18.0,27,Solid,9.0,2,3,10,9,1,up,1975-05-03
1270,Mandrill,1975-05-24,Mandrill - Solid,27,37,23,18.0,24,Solid,9.0,3,1,3,10,1,up,1975-05-03
1271,Mandrill,1975-05-31,Mandrill - Solid,24,27,19,18.0,23,Solid,9.0,4,4,1,3,1,up,1975-05-03
1272,Mandrill,1975-06-07,Mandrill - Solid,23,24,18,18.0,19,Solid,9.0,5,1,4,1,1,up,1975-05-03
1273,Mandrill,1975-06-14,Mandrill - Solid,19,23,19,18.0,18,Solid,9.0,6,-1,1,4,1,down,1975-05-03
1274,Mandrill,1975-06-21,Mandrill - Solid,18,19,25,18.0,19,Solid,9.0,7,-6,-1,1,1,down,1975-05-03
1275,Mandrill,1975-06-28,Mandrill - Solid,19,18,47,18.0,25,Solid,9.0,8,-22,-6,-1,1,down,1975-05-03
1276,Mandrill,1975-07-05,Mandrill - Solid,25,19,51,18.0,47,Solid,9.0,9,-4,-22,-6,1,down,1975-05-03
1277,Ben E. King,1975-05-03,Ben E. King - Supernatural,51,51,43,13.0,47,Supernatural,8.0,0,4,4,0,1,up,1975-05-03
1278,Ben E. King,1975-05-10,Ben E. King - Supernatural,47,51,32,13.0,43,Supernatural,8.0,1,11,4,4,1,up,1975-05-03
1279,Ben E. King,1975-05-17,Ben E. King - Supernatural,43,47,23,13.0,32,Supernatural,8.0,2,9,11,4,1,up,1975-05-03
1280,Ben E. King,1975-05-24,Ben E. King - Supernatural,32,43,15,13.0,23,Supernatural,8.0,3,8,9,11,1,up,1975-05-03
1281,Ben E. King,1975-05-31,Ben E. King - Supernatural,23,32,13,13.0,15,Supernatural,8.0,4,2,8,9,1,up,1975-05-03
1282,Ben E. King,1975-06-07,Ben E. King - Supernatural,15,23,19,13.0,13,Supernatural,8.0,5,-6,2,8,1,down,1975-05-03
1283,Ben E. King,1975-06-14,Ben E. King - Supernatural,13,15,23,13.0,19,Supernatural,8.0,6,-4,-6,2,1,down,1975-05-03
1284,Ben E. King,1975-06-21,Ben E. King - Supernatural,19,13,34,13.0,23,Supernatural,8.0,7,-11,-4,-6,1,down,1975-05-03
1285,Ben E. King,1975-06-28,Ben E. King - Supernatural,23,19,51,13.0,34,Supernatural,8.0,8,-17,-11,-4,1,down,1975-05-03
1286,Smokey Robinson,1975-05-03,Smokey Robinson - A Quiet Storm,51,51,31,7.0,50,A Quiet Storm,11.0,0,19,1,0,1,up,1975-05-03
1287,Smokey Robinson,1975-05-10,Smokey Robinson - A Quiet Storm,50,51,24,7.0,31,A Quiet Storm,11.0,1,7,19,1,1,up,1975-05-03
1288,Smokey Robinson,1975-05-17,Smokey Robinson - A Quiet Storm,31,50,18,7.0,24,A Quiet Storm,11.0,2,6,7,19,1,up,1975-05-03
1289,Smokey Robinson,1975-05-24,Smokey Robinson - A Quiet Storm,24,31,11,7.0,18,A Quiet Storm,11.0,3,7,6,7,1,up,1975-05-03
1290,Smokey Robinson,1975-05-31,Smokey Robinson - A Quiet Storm,18,24,7,7.0,11,A Quiet Storm,11.0,4,4,7,6,1,up,1975-05-03
1291,Smokey Robinson,1975-06-07,Smokey Robinson - A Quiet Storm,11,18,7,7.0,7,A Quiet Storm,11.0,5,0,4,7,0,stay,1975-05-03
1292,Smokey Robinson,1975-06-14,Smokey Robinson - A Quiet Storm,7,11,12,7.0,7,A Quiet Storm,11.0,6,-5,0,4,1,down,1975-05-03
1293,Smokey Robinson,1975-06-21,Smokey Robinson - A Quiet Storm,7,7,11,7.0,12,A Quiet Storm,11.0,7,1,-5,0,1,up,1975-05-03
1294,Smokey Robinson,1975-06-28,Smokey Robinson - A Quiet Storm,12,7,23,7.0,11,A Quiet Storm,11.0,8,-12,1,-5,1,down,1975-05-03
1295,Smokey Robinson,1975-07-05,Smokey Robinson - A Quiet Storm,11,12,34,7.0,23,A Quiet Storm,11.0,9,-11,-12,1,1,down,1975-05-03
1296,Smokey Robinson,1975-07-12,Smokey Robinson - A Quiet Storm,23,11,50,7.0,34,A Quiet Storm,11.0,10,-16,-11,-12,1,down,1975-05-03
1297,Smokey Robinson,1975-08-02,Smokey Robinson - A Quiet Storm,34,23,51,7.0,50,A Quiet Storm,11.0,11,-1,-16,-11,1,down,1975-05-03
1298,Bobby Womack,1975-05-10,Bobby Womack - I Don't Know What The World Is Coming To,51,51,30,20.0,36,I Don't Know What The World Is Coming To,5.0,0,6,15,0,1,up,1975-05-10
1299,Bobby Womack,1975-05-17,Bobby Womack - I Don't Know What The World Is Coming To,36,51,22,20.0,30,I Don't Know What The World Is Coming To,5.0,1,8,6,15,1,up,1975-05-10
1300,Bobby Womack,1975-05-24,Bobby Womack - I Don't Know What The World Is Coming To,30,36,20,20.0,22,I Don't Know What The World Is Coming To,5.0,2,2,8,6,1,up,1975-05-10
1301,Bobby Womack,1975-05-31,Bobby Womack - I Don't Know What The World Is Coming To,22,30,25,20.0,20,I Don't Know What The World Is Coming To,5.0,3,-5,2,8,1,down,1975-05-10
1302,Bobby Womack,1975-06-07,Bobby Womack - I Don't Know What The World Is Coming To,20,22,49,20.0,25,I Don't Know What The World Is Coming To,5.0,4,-24,-5,2,1,down,1975-05-10
1303,Bobby Womack,1975-06-14,Bobby Womack - I Don't Know What The World Is Coming To,25,20,51,20.0,49,I Don't Know What The World Is Coming To,5.0,5,-2,-24,-5,1,down,1975-05-10
1304,The Main Ingredient,1975-05-10,The Main Ingredient - Rolling Down A Mountainside,51,51,31,3.0,40,Rolling Down A Mountainside,13.0,0,9,11,0,1,up,1975-05-10
1305,The Main Ingredient,1975-05-17,The Main Ingredient - Rolling Down A Mountainside,40,51,25,3.0,31,Rolling Down A Mountainside,13.0,1,6,9,11,1,up,1975-05-10
1306,The Main Ingredient,1975-05-24,The Main Ingredient - Rolling Down A Mountainside,31,40,13,3.0,25,Rolling Down A Mountainside,13.0,2,12,6,9,1,up,1975-05-10
1307,The Main Ingredient,1975-05-31,The Main Ingredient - Rolling Down A Mountainside,25,31,10,3.0,13,Rolling Down A Mountainside,13.0,3,3,12,6,1,up,1975-05-10
1308,The Main Ingredient,1975-06-07,The Main Ingredient - Rolling Down A Mountainside,13,25,3,3.0,10,Rolling Down A Mountainside,13.0,4,7,3,12,1,up,1975-05-10
1309,The Main Ingredient,1975-06-14,The Main Ingredient - Rolling Down A Mountainside,10,13,3,3.0,3,Rolling Down A Mountainside,13.0,5,0,7,3,0,stay,1975-05-10
1310,The Main Ingredient,1975-06-21,The Main Ingredient - Rolling Down A Mountainside,3,10,3,3.0,3,Rolling Down A Mountainside,13.0,6,0,0,7,0,stay,1975-05-10
1311,The Main Ingredient,1975-06-28,The Main Ingredient - Rolling Down A Mountainside,3,3,4,3.0,3,Rolling Down A Mountainside,13.0,7,-1,0,0,1,down,1975-05-10
1312,The Main Ingredient,1975-07-05,The Main Ingredient - Rolling Down A Mountainside,3,3,4,3.0,4,Rolling Down A Mountainside,13.0,8,0,-1,0,0,stay,1975-05-10
1313,The Main Ingredient,1975-07-12,The Main Ingredient - Rolling Down A Mountainside,4,3,16,3.0,4,Rolling Down A Mountainside,13.0,9,-12,0,-1,1,down,1975-05-10
1314,The Main Ingredient,1975-07-19,The Main Ingredient - Rolling Down A Mountainside,4,4,17,3.0,16,Rolling Down A Mountainside,13.0,10,-1,-12,0,1,down,1975-05-10
1315,The Main Ingredient,1975-07-26,The Main Ingredient - Rolling Down A Mountainside,16,4,19,3.0,17,Rolling Down A Mountainside,13.0,11,-2,-1,-12,1,down,1975-05-10
1316,The Main Ingredient,1975-08-02,The Main Ingredient - Rolling Down A Mountainside,17,16,32,3.0,19,Rolling Down A Mountainside,13.0,12,-13,-2,-1,1,down,1975-05-10
1317,The Main Ingredient,1975-08-09,The Main Ingredient - Rolling Down A Mountainside,19,17,51,3.0,32,Rolling Down A Mountainside,13.0,13,-19,-13,-2,1,down,1975-05-10
1318,Gladys Knight And The Pips,1975-05-10,Gladys Knight And The Pips - A Little Knight Music,51,51,34,32.0,46,A Little Knight Music,3.0,0,12,5,0,1,up,1975-05-10
1319,Gladys Knight And The Pips,1975-05-17,Gladys Knight And The Pips - A Little Knight Music,46,51,32,32.0,34,A Little Knight Music,3.0,1,2,12,5,1,up,1975-05-10
1320,Gladys Knight And The Pips,1975-05-24,Gladys Knight And The Pips - A Little Knight Music,34,46,37,32.0,32,A Little Knight Music,3.0,2,-5,2,12,1,down,1975-05-10
1321,Gladys Knight And The Pips,1975-05-31,Gladys Knight And The Pips - A Little Knight Music,32,34,51,32.0,37,A Little Knight Music,3.0,3,-14,-5,2,1,down,1975-05-10
1322,Stanley Turrentine,1975-05-10,Stanley Turrentine - In The Pocket,51,51,35,9.0,48,In The Pocket,11.0,0,13,3,0,1,up,1975-05-10
1323,Stanley Turrentine,1975-05-17,Stanley Turrentine - In The Pocket,48,51,28,9.0,35,In The Pocket,11.0,1,7,13,3,1,up,1975-05-10
1324,Stanley Turrentine,1975-05-24,Stanley Turrentine - In The Pocket,35,48,22,9.0,28,In The Pocket,11.0,2,6,7,13,1,up,1975-05-10
1325,Stanley Turrentine,1975-05-31,Stanley Turrentine - In The Pocket,28,35,17,9.0,22,In The Pocket,11.0,3,5,6,7,1,up,1975-05-10
1326,Stanley Turrentine,1975-06-07,Stanley Turrentine - In The Pocket,22,28,13,9.0,17,In The Pocket,11.0,4,4,5,6,1,up,1975-05-10
1327,Stanley Turrentine,1975-06-14,Stanley Turrentine - In The Pocket,17,22,10,9.0,13,In The Pocket,11.0,5,3,4,5,1,up,1975-05-10
1328,Stanley Turrentine,1975-06-21,Stanley Turrentine - In The Pocket,13,17,9,9.0,10,In The Pocket,11.0,6,1,3,4,1,up,1975-05-10
1329,Stanley Turrentine,1975-06-28,Stanley Turrentine - In The Pocket,10,13,19,9.0,9,In The Pocket,11.0,7,-10,1,3,1,down,1975-05-10
1330,Stanley Turrentine,1975-07-05,Stanley Turrentine - In The Pocket,9,10,24,9.0,19,In The Pocket,11.0,8,-5,-10,1,1,down,1975-05-10
1331,Stanley Turrentine,1975-07-12,Stanley Turrentine - In The Pocket,19,9,22,9.0,24,In The Pocket,11.0,9,2,-5,-10,1,up,1975-05-10
1332,Stanley Turrentine,1975-07-19,Stanley Turrentine - In The Pocket,24,19,38,9.0,22,In The Pocket,11.0,10,-16,2,-5,1,down,1975-05-10
1333,Stanley Turrentine,1975-07-26,Stanley Turrentine - In The Pocket,22,24,51,9.0,38,In The Pocket,11.0,11,-13,-16,2,1,down,1975-05-10
1334,Freddie Hubbard,1975-05-10,Freddie Hubbard - Polar AC,51,51,48,32.0,49,Polar AC,6.0,0,1,2,0,1,up,1975-05-10
1335,Freddie Hubbard,1975-05-17,Freddie Hubbard - Polar AC,49,51,45,32.0,48,Polar AC,6.0,1,3,1,2,1,up,1975-05-10
1336,Freddie Hubbard,1975-05-24,Freddie Hubbard - Polar AC,48,49,36,32.0,45,Polar AC,6.0,2,9,3,1,1,up,1975-05-10
1337,Freddie Hubbard,1975-05-31,Freddie Hubbard - Polar AC,45,48,33,32.0,36,Polar AC,6.0,3,3,9,3,1,up,1975-05-10
1338,Freddie Hubbard,1975-06-07,Freddie Hubbard - Polar AC,36,45,32,32.0,33,Polar AC,6.0,4,1,3,9,1,up,1975-05-10
1339,Freddie Hubbard,1975-06-14,Freddie Hubbard - Polar AC,33,36,44,32.0,32,Polar AC,6.0,5,-12,1,3,1,down,1975-05-10
1340,Freddie Hubbard,1975-06-21,Freddie Hubbard - Polar AC,32,33,51,32.0,44,Polar AC,6.0,6,-7,-12,1,1,down,1975-05-10
1341,Van Mccoy,1975-05-10,Van Mccoy - Disco Baby,51,51,39,1.0,50,Disco Baby,17.0,0,11,1,0,1,up,1975-05-10
1342,Van Mccoy,1975-05-17,Van Mccoy - Disco Baby,50,51,31,1.0,39,Disco Baby,17.0,1,8,11,1,1,up,1975-05-10
1343,Van Mccoy,1975-05-24,Van Mccoy - Disco Baby,39,50,25,1.0,31,Disco Baby,17.0,2,6,8,11,1,up,1975-05-10
1344,Van Mccoy,1975-05-31,Van Mccoy - Disco Baby,31,39,18,1.0,25,Disco Baby,17.0,3,7,6,8,1,up,1975-05-10
1345,Van Mccoy,1975-06-07,Van Mccoy - Disco Baby,25,31,15,1.0,18,Disco Baby,17.0,4,3,7,6,1,up,1975-05-10
1346,Van Mccoy,1975-06-14,Van Mccoy - Disco Baby,18,25,8,1.0,15,Disco Baby,17.0,5,7,3,7,1,up,1975-05-10
1347,Van Mccoy,1975-06-21,Van Mccoy - Disco Baby,15,18,2,1.0,8,Disco Baby,17.0,6,6,7,3,1,up,1975-05-10
1348,Van Mccoy,1975-06-28,Van Mccoy - Disco Baby,8,15,2,1.0,2,Disco Baby,17.0,7,0,6,7,0,stay,1975-05-10
1349,Van Mccoy,1975-07-05,Van Mccoy - Disco Baby,2,8,1,1.0,2,Disco Baby,17.0,8,1,0,6,1,up,1975-05-10
1350,Van Mccoy,1975-07-12,Van Mccoy - Disco Baby,2,2,3,1.0,1,Disco Baby,17.0,9,-2,1,0,1,down,1975-05-10
1351,Van Mccoy,1975-07-19,Van Mccoy - Disco Baby,1,2,9,1.0,3,Disco Baby,17.0,10,-6,-2,1,1,down,1975-05-10
1352,Van Mccoy,1975-07-26,Van Mccoy - Disco Baby,3,1,14,1.0,9,Disco Baby,17.0,11,-5,-6,-2,1,down,1975-05-10
1353,Van Mccoy,1975-08-02,Van Mccoy - Disco Baby,9,3,19,1.0,14,Disco Baby,17.0,12,-5,-5,-6,1,down,1975-05-10
1354,Van Mccoy,1975-08-09,Van Mccoy - Disco Baby,14,9,31,1.0,19,Disco Baby,17.0,13,-12,-5,-5,1,down,1975-05-10
1355,Van Mccoy,1975-08-16,Van Mccoy - Disco Baby,19,14,39,1.0,31,Disco Baby,17.0,14,-8,-12,-5,1,down,1975-05-10
1356,Van Mccoy,1975-08-23,Van Mccoy - Disco Baby,31,19,39,1.0,39,Disco Baby,17.0,15,0,-8,-12,0,stay,1975-05-10
1357,Van Mccoy,1975-08-30,Van Mccoy - Disco Baby,39,31,49,1.0,39,Disco Baby,17.0,16,-10,0,-8,1,down,1975-05-10
1358,Van Mccoy,1975-09-06,Van Mccoy - Disco Baby,39,39,51,1.0,49,Disco Baby,17.0,17,-2,-10,0,1,down,1975-05-10
1359,Disco Tex & The Sex-O-Lettes Starring Sir Monti Rock III,1975-05-17,Disco Tex & The Sex-O-Lettes Starring Sir Monti Rock III - Disco Tex And The Sex-O-Lettes,51,51,29,20.0,41,Disco Tex And The Sex-O-Lettes,6.0,0,12,10,0,1,up,1975-05-17
1360,Disco Tex & The Sex-O-Lettes Starring Sir Monti Rock III,1975-05-24,Disco Tex & The Sex-O-Lettes Starring Sir Monti Rock III - Disco Tex And The Sex-O-Lettes,41,51,27,20.0,29,Disco Tex And The Sex-O-Lettes,6.0,1,2,12,10,1,up,1975-05-17
1361,Disco Tex & The Sex-O-Lettes Starring Sir Monti Rock III,1975-05-31,Disco Tex & The Sex-O-Lettes Starring Sir Monti Rock III - Disco Tex And The Sex-O-Lettes,29,41,21,20.0,27,Disco Tex And The Sex-O-Lettes,6.0,2,6,2,12,1,up,1975-05-17
1362,Disco Tex & The Sex-O-Lettes Starring Sir Monti Rock III,1975-06-07,Disco Tex & The Sex-O-Lettes Starring Sir Monti Rock III - Disco Tex And The Sex-O-Lettes,27,29,20,20.0,21,Disco Tex And The Sex-O-Lettes,6.0,3,1,6,2,1,up,1975-05-17
1363,Disco Tex & The Sex-O-Lettes Starring Sir Monti Rock III,1975-06-14,Disco Tex & The Sex-O-Lettes Starring Sir Monti Rock III - Disco Tex And The Sex-O-Lettes,21,27,36,20.0,20,Disco Tex And The Sex-O-Lettes,6.0,4,-16,1,6,1,down,1975-05-17
1364,Disco Tex & The Sex-O-Lettes Starring Sir Monti Rock III,1975-06-21,Disco Tex & The Sex-O-Lettes Starring Sir Monti Rock III - Disco Tex And The Sex-O-Lettes,20,21,44,20.0,36,Disco Tex And The Sex-O-Lettes,6.0,5,-8,-16,1,1,down,1975-05-17
1365,Disco Tex & The Sex-O-Lettes Starring Sir Monti Rock III,1975-06-28,Disco Tex & The Sex-O-Lettes Starring Sir Monti Rock III - Disco Tex And The Sex-O-Lettes,36,20,51,20.0,44,Disco Tex And The Sex-O-Lettes,6.0,6,-7,-8,-16,1,down,1975-05-17
1366,Original Cast,1975-05-17,Original Cast - The Wiz,51,51,36,30.0,46,The Wiz,12.0,0,10,5,0,1,up,1975-05-17
1367,Original Cast,1975-05-24,Original Cast - The Wiz,46,51,32,30.0,36,The Wiz,12.0,1,4,10,5,1,up,1975-05-17
1368,Original Cast,1975-05-31,Original Cast - The Wiz,36,46,30,30.0,32,The Wiz,12.0,2,2,4,10,1,up,1975-05-17
1369,Original Cast,1975-06-07,Original Cast - The Wiz,32,36,30,30.0,30,The Wiz,12.0,3,0,2,4,0,stay,1975-05-17
1370,Original Cast,1975-06-14,Original Cast - The Wiz,30,32,45,30.0,30,The Wiz,12.0,4,-15,0,2,1,down,1975-05-17
1371,Original Cast,1975-06-21,Original Cast - The Wiz,30,30,45,30.0,45,The Wiz,12.0,5,0,-15,0,0,stay,1975-05-17
1372,Original Cast,1975-06-28,Original Cast - The Wiz,45,30,42,30.0,45,The Wiz,12.0,6,3,0,-15,1,up,1975-05-17
1373,Original Cast,1975-07-05,Original Cast - The Wiz,45,45,38,30.0,42,The Wiz,12.0,7,4,3,0,1,up,1975-05-17
1374,Original Cast,1975-07-12,Original Cast - The Wiz,42,45,36,30.0,38,The Wiz,12.0,8,2,4,3,1,up,1975-05-17
1375,Original Cast,1975-07-19,Original Cast - The Wiz,38,42,34,30.0,36,The Wiz,12.0,9,2,2,4,1,up,1975-05-17
1376,Original Cast,1975-07-26,Original Cast - The Wiz,36,38,32,30.0,34,The Wiz,12.0,10,2,2,2,1,up,1975-05-17
1377,Original Cast,1975-08-02,Original Cast - The Wiz,34,36,36,30.0,32,The Wiz,12.0,11,-4,2,2,1,down,1975-05-17
1378,Original Cast,1975-08-09,Original Cast - The Wiz,32,34,51,30.0,36,The Wiz,12.0,12,-15,-4,2,1,down,1975-05-17
1379,Hamilton Bohannon,1975-05-17,Hamilton Bohannon - Insides Out,51,51,41,28.0,47,Insides Out,16.0,0,6,4,0,1,up,1975-05-17
1380,Hamilton Bohannon,1975-05-24,Hamilton Bohannon - Insides Out,47,51,38,28.0,41,Insides Out,16.0,1,3,6,4,1,up,1975-05-17
1381,Hamilton Bohannon,1975-05-31,Hamilton Bohannon - Insides Out,41,47,37,28.0,38,Insides Out,16.0,2,1,3,6,1,up,1975-05-17
1382,Hamilton Bohannon,1975-06-07,Hamilton Bohannon - Insides Out,38,41,40,28.0,37,Insides Out,16.0,3,-3,1,3,1,down,1975-05-17
1383,Hamilton Bohannon,1975-06-14,Hamilton Bohannon - Insides Out,37,38,39,28.0,40,Insides Out,16.0,4,1,-3,1,1,up,1975-05-17
1384,Hamilton Bohannon,1975-06-21,Hamilton Bohannon - Insides Out,40,37,38,28.0,39,Insides Out,16.0,5,1,1,-3,1,up,1975-05-17
1385,Hamilton Bohannon,1975-06-28,Hamilton Bohannon - Insides Out,39,40,44,28.0,38,Insides Out,16.0,6,-6,1,1,1,down,1975-05-17
1386,Hamilton Bohannon,1975-07-05,Hamilton Bohannon - Insides Out,38,39,47,28.0,44,Insides Out,16.0,7,-3,-6,1,1,down,1975-05-17
1387,Hamilton Bohannon,1975-08-16,Hamilton Bohannon - Insides Out,44,38,40,28.0,47,Insides Out,16.0,8,7,-3,-6,1,up,1975-05-17
1388,Hamilton Bohannon,1975-08-23,Hamilton Bohannon - Insides Out,47,44,38,28.0,40,Insides Out,16.0,9,2,7,-3,1,up,1975-05-17
1389,Hamilton Bohannon,1975-08-30,Hamilton Bohannon - Insides Out,40,47,32,28.0,38,Insides Out,16.0,10,6,2,7,1,up,1975-05-17
1390,Hamilton Bohannon,1975-09-06,Hamilton Bohannon - Insides Out,38,40,30,28.0,32,Insides Out,16.0,11,2,6,2,1,up,1975-05-17
1391,Hamilton Bohannon,1975-09-13,Hamilton Bohannon - Insides Out,32,38,28,28.0,30,Insides Out,16.0,12,2,2,6,1,up,1975-05-17
1392,Hamilton Bohannon,1975-09-20,Hamilton Bohannon - Insides Out,30,32,31,28.0,28,Insides Out,16.0,13,-3,2,2,1,down,1975-05-17
1393,Hamilton Bohannon,1975-09-27,Hamilton Bohannon - Insides Out,28,30,38,28.0,31,Insides Out,16.0,14,-7,-3,2,1,down,1975-05-17
1394,Hamilton Bohannon,1975-10-04,Hamilton Bohannon - Insides Out,31,28,44,28.0,38,Insides Out,16.0,15,-6,-7,-3,1,down,1975-05-17
1395,Hamilton Bohannon,1975-10-11,Hamilton Bohannon - Insides Out,38,31,51,28.0,44,Insides Out,16.0,16,-7,-6,-7,1,down,1975-05-17
1396,Parliament,1975-05-17,Parliament - Chocolate City,51,51,43,18.0,49,Chocolate City,10.0,0,6,2,0,1,up,1975-05-17
1397,Parliament,1975-05-24,Parliament - Chocolate City,49,51,42,18.0,43,Chocolate City,10.0,1,1,6,2,1,up,1975-05-17
1398,Parliament,1975-05-31,Parliament - Chocolate City,43,49,31,18.0,42,Chocolate City,10.0,2,11,1,6,1,up,1975-05-17
1399,Parliament,1975-06-07,Parliament - Chocolate City,42,43,27,18.0,31,Chocolate City,10.0,3,4,11,1,1,up,1975-05-17
1400,Parliament,1975-06-14,Parliament - Chocolate City,31,42,22,18.0,27,Chocolate City,10.0,4,5,4,11,1,up,1975-05-17
1401,Parliament,1975-06-21,Parliament - Chocolate City,27,31,18,18.0,22,Chocolate City,10.0,5,4,5,4,1,up,1975-05-17
1402,Parliament,1975-06-28,Parliament - Chocolate City,22,27,18,18.0,18,Chocolate City,10.0,6,0,4,5,0,stay,1975-05-17
1403,Parliament,1975-07-05,Parliament - Chocolate City,18,22,22,18.0,18,Chocolate City,10.0,7,-4,0,4,1,down,1975-05-17
1404,Parliament,1975-07-12,Parliament - Chocolate City,18,18,23,18.0,22,Chocolate City,10.0,8,-1,-4,0,1,down,1975-05-17
1405,Parliament,1975-07-19,Parliament - Chocolate City,22,18,32,18.0,23,Chocolate City,10.0,9,-9,-1,-4,1,down,1975-05-17
1406,Parliament,1975-07-26,Parliament - Chocolate City,23,22,51,18.0,32,Chocolate City,10.0,10,-19,-9,-1,1,down,1975-05-17
1407,Bill Withers,1975-05-24,Bill Withers - The Best Of Bill Withers,51,51,40,33.0,48,The Best Of Bill Withers,4.0,0,8,3,0,1,up,1975-05-24
1408,Bill Withers,1975-05-31,Bill Withers - The Best Of Bill Withers,48,51,35,33.0,40,The Best Of Bill Withers,4.0,1,5,8,3,1,up,1975-05-24
1409,Bill Withers,1975-06-07,Bill Withers - The Best Of Bill Withers,40,48,33,33.0,35,The Best Of Bill Withers,4.0,2,2,5,8,1,up,1975-05-24
1410,Bill Withers,1975-06-14,Bill Withers - The Best Of Bill Withers,35,40,38,33.0,33,The Best Of Bill Withers,4.0,3,-5,2,5,1,down,1975-05-24
1411,Bill Withers,1975-06-21,Bill Withers - The Best Of Bill Withers,33,35,51,33.0,38,The Best Of Bill Withers,4.0,4,-13,-5,2,1,down,1975-05-24
1412,Melba Moore,1975-05-24,Melba Moore - Peach Melba,51,51,51,49.0,49,Peach Melba,0.0,0,-2,2,0,1,down,1975-05-24
1413,The Trammps,1975-05-24,The Trammps - Trammps,51,51,46,30.0,50,Trammps,5.0,0,4,1,0,1,up,1975-05-24
1414,The Trammps,1975-05-31,The Trammps - Trammps,50,51,43,30.0,46,Trammps,5.0,1,3,4,1,1,up,1975-05-24
1415,The Trammps,1975-06-07,The Trammps - Trammps,46,50,35,30.0,43,Trammps,5.0,2,8,3,4,1,up,1975-05-24
1416,The Trammps,1975-06-14,The Trammps - Trammps,43,46,30,30.0,35,Trammps,5.0,3,5,8,3,1,up,1975-05-24
1417,The Trammps,1975-06-21,The Trammps - Trammps,35,43,42,30.0,30,Trammps,5.0,4,-12,5,8,1,down,1975-05-24
1418,The Trammps,1975-06-28,The Trammps - Trammps,30,35,51,30.0,42,Trammps,5.0,5,-9,-12,5,1,down,1975-05-24
1419,The New Birth,1975-05-31,The New Birth - Blind Baby,51,51,27,17.0,39,Blind Baby,12.0,0,12,12,0,1,up,1975-05-31
1420,The New Birth,1975-06-07,The New Birth - Blind Baby,39,51,25,17.0,27,Blind Baby,12.0,1,2,12,12,1,up,1975-05-31
1421,The New Birth,1975-06-14,The New Birth - Blind Baby,27,39,24,17.0,25,Blind Baby,12.0,2,1,2,12,1,up,1975-05-31
1422,The New Birth,1975-06-21,The New Birth - Blind Baby,25,27,37,17.0,24,Blind Baby,12.0,3,-13,1,2,1,down,1975-05-31
1423,The New Birth,1975-06-28,The New Birth - Blind Baby,24,25,34,17.0,37,Blind Baby,12.0,4,3,-13,1,1,up,1975-05-31
1424,The New Birth,1975-07-05,The New Birth - Blind Baby,37,24,29,17.0,34,Blind Baby,12.0,5,5,3,-13,1,up,1975-05-31
1425,The New Birth,1975-07-12,The New Birth - Blind Baby,34,37,28,17.0,29,Blind Baby,12.0,6,1,5,3,1,up,1975-05-31
1426,The New Birth,1975-07-19,The New Birth - Blind Baby,29,34,23,17.0,28,Blind Baby,12.0,7,5,1,5,1,up,1975-05-31
1427,The New Birth,1975-07-26,The New Birth - Blind Baby,28,29,20,17.0,23,Blind Baby,12.0,8,3,5,1,1,up,1975-05-31
1428,The New Birth,1975-08-02,The New Birth - Blind Baby,23,28,17,17.0,20,Blind Baby,12.0,9,3,3,5,1,up,1975-05-31
1429,The New Birth,1975-08-09,The New Birth - Blind Baby,20,23,17,17.0,17,Blind Baby,12.0,10,0,3,3,0,stay,1975-05-31
1430,The New Birth,1975-08-16,The New Birth - Blind Baby,17,20,30,17.0,17,Blind Baby,12.0,11,-13,0,3,1,down,1975-05-31
1431,The New Birth,1975-08-23,The New Birth - Blind Baby,17,17,51,17.0,30,Blind Baby,12.0,12,-21,-13,0,1,down,1975-05-31
1432,Lonnie Liston Smith,1975-05-31,Lonnie Liston Smith - Expansions,51,51,32,27.0,41,Expansions,10.0,0,9,10,0,1,up,1975-05-31
1433,Lonnie Liston Smith,1975-06-07,Lonnie Liston Smith - Expansions,41,51,29,27.0,32,Expansions,10.0,1,3,9,10,1,up,1975-05-31
1434,Lonnie Liston Smith,1975-06-14,Lonnie Liston Smith - Expansions,32,41,34,27.0,29,Expansions,10.0,2,-5,3,9,1,down,1975-05-31
1435,Lonnie Liston Smith,1975-06-21,Lonnie Liston Smith - Expansions,29,32,42,27.0,34,Expansions,10.0,3,-8,-5,3,1,down,1975-05-31
1436,Lonnie Liston Smith,1975-07-12,Lonnie Liston Smith - Expansions,34,29,32,27.0,42,Expansions,10.0,4,10,-8,-5,1,up,1975-05-31
1437,Lonnie Liston Smith,1975-07-19,Lonnie Liston Smith - Expansions,42,34,28,27.0,32,Expansions,10.0,5,4,10,-8,1,up,1975-05-31
1438,Lonnie Liston Smith,1975-07-26,Lonnie Liston Smith - Expansions,32,42,27,27.0,28,Expansions,10.0,6,1,4,10,1,up,1975-05-31
1439,Lonnie Liston Smith,1975-08-02,Lonnie Liston Smith - Expansions,28,32,27,27.0,27,Expansions,10.0,7,0,1,4,0,stay,1975-05-31
1440,Lonnie Liston Smith,1975-08-09,Lonnie Liston Smith - Expansions,27,28,35,27.0,27,Expansions,10.0,8,-8,0,1,1,down,1975-05-31
1441,Lonnie Liston Smith,1975-08-16,Lonnie Liston Smith - Expansions,27,27,47,27.0,35,Expansions,10.0,9,-12,-8,0,1,down,1975-05-31
1442,Lonnie Liston Smith,1975-08-23,Lonnie Liston Smith - Expansions,35,27,51,27.0,47,Expansions,10.0,10,-4,-12,-8,1,down,1975-05-31
1443,Phoebe Snow,1975-05-31,Phoebe Snow - Phoebe Snow,51,51,34,22.0,43,Phoebe Snow,6.0,0,9,8,0,1,up,1975-05-31
1444,Phoebe Snow,1975-06-07,Phoebe Snow - Phoebe Snow,43,51,28,22.0,34,Phoebe Snow,6.0,1,6,9,8,1,up,1975-05-31
1445,Phoebe Snow,1975-06-14,Phoebe Snow - Phoebe Snow,34,43,25,22.0,28,Phoebe Snow,6.0,2,3,6,9,1,up,1975-05-31
1446,Phoebe Snow,1975-06-21,Phoebe Snow - Phoebe Snow,28,34,22,22.0,25,Phoebe Snow,6.0,3,3,3,6,1,up,1975-05-31
1447,Phoebe Snow,1975-06-28,Phoebe Snow - Phoebe Snow,25,28,28,22.0,22,Phoebe Snow,6.0,4,-6,3,3,1,down,1975-05-31
1448,Phoebe Snow,1975-07-05,Phoebe Snow - Phoebe Snow,22,25,48,22.0,28,Phoebe Snow,6.0,5,-20,-6,3,1,down,1975-05-31
1449,Phoebe Snow,1975-07-12,Phoebe Snow - Phoebe Snow,28,22,51,22.0,48,Phoebe Snow,6.0,6,-3,-20,-6,1,down,1975-05-31
1450,Tamiko Jones,1975-05-31,Tamiko Jones - Love Trip,51,51,40,40.0,44,Love Trip,2.0,0,4,7,0,1,up,1975-05-31
1451,Tamiko Jones,1975-06-07,Tamiko Jones - Love Trip,44,51,42,40.0,40,Love Trip,2.0,1,-2,4,7,1,down,1975-05-31
1452,Tamiko Jones,1975-06-14,Tamiko Jones - Love Trip,40,44,51,40.0,42,Love Trip,2.0,2,-9,-2,4,1,down,1975-05-31
1453,The Intruders,1975-05-31,The Intruders - Energy Of Love,51,51,44,41.0,48,Energy Of Love,2.0,0,4,3,0,1,up,1975-05-31
1454,The Intruders,1975-06-07,The Intruders - Energy Of Love,48,51,41,41.0,44,Energy Of Love,2.0,1,3,4,3,1,up,1975-05-31
1455,The Intruders,1975-06-14,The Intruders - Energy Of Love,44,48,51,41.0,41,Energy Of Love,2.0,2,-10,3,4,1,down,1975-05-31
1456,Patti LaBelle,1975-05-31,Patti LaBelle - Moon Shadow,51,51,42,42.0,49,Moon Shadow,1.0,0,7,2,0,1,up,1975-05-31
1457,Patti LaBelle,1975-06-07,Patti LaBelle - Moon Shadow,49,51,51,42.0,42,Moon Shadow,1.0,1,-9,7,2,1,down,1975-05-31
1458,Leroy Hutson,1975-05-31,Leroy Hutson - Hutson,51,51,47,46.0,50,Hutson,2.0,0,3,1,0,1,up,1975-05-31
1459,Leroy Hutson,1975-06-07,Leroy Hutson - Hutson,50,51,46,46.0,47,Hutson,2.0,1,1,3,1,1,up,1975-05-31
1460,Leroy Hutson,1975-06-14,Leroy Hutson - Hutson,47,50,51,46.0,46,Hutson,2.0,2,-5,1,3,1,down,1975-05-31
1461,James Brown,1975-06-07,James Brown - Sex Machine Today,51,51,24,10.0,36,Sex Machine Today,7.0,0,12,15,0,1,up,1975-06-07
1462,James Brown,1975-06-14,James Brown - Sex Machine Today,36,51,18,10.0,24,Sex Machine Today,7.0,1,6,12,15,1,up,1975-06-07
1463,James Brown,1975-06-21,James Brown - Sex Machine Today,24,36,14,10.0,18,Sex Machine Today,7.0,2,4,6,12,1,up,1975-06-07
1464,James Brown,1975-06-28,James Brown - Sex Machine Today,18,24,11,10.0,14,Sex Machine Today,7.0,3,3,4,6,1,up,1975-06-07
1465,James Brown,1975-07-05,James Brown - Sex Machine Today,14,18,10,10.0,11,Sex Machine Today,7.0,4,1,3,4,1,up,1975-06-07
1466,James Brown,1975-07-12,James Brown - Sex Machine Today,11,14,20,10.0,10,Sex Machine Today,7.0,5,-10,1,3,1,down,1975-06-07
1467,James Brown,1975-07-19,James Brown - Sex Machine Today,10,11,42,10.0,20,Sex Machine Today,7.0,6,-22,-10,1,1,down,1975-06-07
1468,James Brown,1975-07-26,James Brown - Sex Machine Today,20,10,51,10.0,42,Sex Machine Today,7.0,7,-9,-22,-10,1,down,1975-06-07
1469,Jimmie Walker/Esther Rolle,1975-06-07,Jimmie Walker/Esther Rolle - Dyn-O-Mite,51,51,34,29.0,45,Dyn-O-Mite,4.0,0,11,6,0,1,up,1975-06-07
1470,Jimmie Walker/Esther Rolle,1975-06-14,Jimmie Walker/Esther Rolle - Dyn-O-Mite,45,51,29,29.0,34,Dyn-O-Mite,4.0,1,5,11,6,1,up,1975-06-07
1471,Jimmie Walker/Esther Rolle,1975-06-21,Jimmie Walker/Esther Rolle - Dyn-O-Mite,34,45,29,29.0,29,Dyn-O-Mite,4.0,2,0,5,11,0,stay,1975-06-07
1472,Jimmie Walker/Esther Rolle,1975-06-28,Jimmie Walker/Esther Rolle - Dyn-O-Mite,29,34,35,29.0,29,Dyn-O-Mite,4.0,3,-6,0,5,1,down,1975-06-07
1473,Jimmie Walker/Esther Rolle,1975-07-05,Jimmie Walker/Esther Rolle - Dyn-O-Mite,29,29,51,29.0,35,Dyn-O-Mite,4.0,4,-16,-6,0,1,down,1975-06-07
1474,The Brecker Brothers,1975-06-07,The Brecker Brothers - The Brecker Brothers,51,51,36,25.0,46,The Brecker Brothers,7.0,0,10,5,0,1,up,1975-06-07
1475,The Brecker Brothers,1975-06-14,The Brecker Brothers - The Brecker Brothers,46,51,31,25.0,36,The Brecker Brothers,7.0,1,5,10,5,1,up,1975-06-07
1476,The Brecker Brothers,1975-06-21,The Brecker Brothers - The Brecker Brothers,36,46,27,25.0,31,The Brecker Brothers,7.0,2,4,5,10,1,up,1975-06-07
1477,The Brecker Brothers,1975-06-28,The Brecker Brothers - The Brecker Brothers,31,36,25,25.0,27,The Brecker Brothers,7.0,3,2,4,5,1,up,1975-06-07
1478,The Brecker Brothers,1975-07-05,The Brecker Brothers - The Brecker Brothers,27,31,27,25.0,25,The Brecker Brothers,7.0,4,-2,2,4,1,down,1975-06-07
1479,The Brecker Brothers,1975-07-12,The Brecker Brothers - The Brecker Brothers,25,27,38,25.0,27,The Brecker Brothers,7.0,5,-11,-2,2,1,down,1975-06-07
1480,The Brecker Brothers,1975-07-19,The Brecker Brothers - The Brecker Brothers,27,25,48,25.0,38,The Brecker Brothers,7.0,6,-10,-11,-2,1,down,1975-06-07
1481,The Brecker Brothers,1975-07-26,The Brecker Brothers - The Brecker Brothers,38,27,51,25.0,48,The Brecker Brothers,7.0,7,-3,-10,-11,1,down,1975-06-07
1482,Minnie Riperton,1975-06-07,Minnie Riperton - Adventures In Paradise,51,51,38,5.0,49,Adventures In Paradise,13.0,0,11,2,0,1,up,1975-06-07
1483,Minnie Riperton,1975-06-14,Minnie Riperton - Adventures In Paradise,49,51,28,5.0,38,Adventures In Paradise,13.0,1,10,11,2,1,up,1975-06-07
1484,Minnie Riperton,1975-06-21,Minnie Riperton - Adventures In Paradise,38,49,20,5.0,28,Adventures In Paradise,13.0,2,8,10,11,1,up,1975-06-07
1485,Minnie Riperton,1975-06-28,Minnie Riperton - Adventures In Paradise,28,38,17,5.0,20,Adventures In Paradise,13.0,3,3,8,10,1,up,1975-06-07
1486,Minnie Riperton,1975-07-05,Minnie Riperton - Adventures In Paradise,20,28,16,5.0,17,Adventures In Paradise,13.0,4,1,3,8,1,up,1975-06-07
1487,Minnie Riperton,1975-07-12,Minnie Riperton - Adventures In Paradise,17,20,11,5.0,16,Adventures In Paradise,13.0,5,5,1,3,1,up,1975-06-07
1488,Minnie Riperton,1975-07-19,Minnie Riperton - Adventures In Paradise,16,17,7,5.0,11,Adventures In Paradise,13.0,6,4,5,1,1,up,1975-06-07
1489,Minnie Riperton,1975-07-26,Minnie Riperton - Adventures In Paradise,11,16,5,5.0,7,Adventures In Paradise,13.0,7,2,4,5,1,up,1975-06-07
1490,Minnie Riperton,1975-08-02,Minnie Riperton - Adventures In Paradise,7,11,5,5.0,5,Adventures In Paradise,13.0,8,0,2,4,0,stay,1975-06-07
1491,Minnie Riperton,1975-08-09,Minnie Riperton - Adventures In Paradise,5,7,14,5.0,5,Adventures In Paradise,13.0,9,-9,0,2,1,down,1975-06-07
1492,Minnie Riperton,1975-08-16,Minnie Riperton - Adventures In Paradise,5,5,29,5.0,14,Adventures In Paradise,13.0,10,-15,-9,0,1,down,1975-06-07
1493,Minnie Riperton,1975-08-23,Minnie Riperton - Adventures In Paradise,14,5,34,5.0,29,Adventures In Paradise,13.0,11,-5,-15,-9,1,down,1975-06-07
1494,Minnie Riperton,1975-08-30,Minnie Riperton - Adventures In Paradise,29,14,45,5.0,34,Adventures In Paradise,13.0,12,-11,-5,-15,1,down,1975-06-07
1495,Minnie Riperton,1975-09-06,Minnie Riperton - Adventures In Paradise,34,29,51,5.0,45,Adventures In Paradise,13.0,13,-6,-11,-5,1,down,1975-06-07
1496,Barrett Strong,1975-06-07,Barrett Strong - Stronghold,51,51,47,47.0,50,Stronghold,1.0,0,3,1,0,1,up,1975-06-07
1497,Barrett Strong,1975-06-14,Barrett Strong - Stronghold,50,51,51,47.0,47,Stronghold,1.0,1,-4,3,1,1,down,1975-06-07
1498,Four Tops,1975-06-14,Four Tops - Night Lights Harmony,51,51,27,24.0,39,Night Lights Harmony,5.0,0,12,12,0,1,up,1975-06-14
1499,Four Tops,1975-06-21,Four Tops - Night Lights Harmony,39,51,24,24.0,27,Night Lights Harmony,5.0,1,3,12,12,1,up,1975-06-14
1500,Four Tops,1975-06-28,Four Tops - Night Lights Harmony,27,39,24,24.0,24,Night Lights Harmony,5.0,2,0,3,12,0,stay,1975-06-14
1501,Four Tops,1975-07-05,Four Tops - Night Lights Harmony,24,27,37,24.0,24,Night Lights Harmony,5.0,3,-13,0,3,1,down,1975-06-14
1502,Four Tops,1975-07-12,Four Tops - Night Lights Harmony,24,24,46,24.0,37,Night Lights Harmony,5.0,4,-9,-13,0,1,down,1975-06-14
1503,Four Tops,1975-07-19,Four Tops - Night Lights Harmony,37,24,51,24.0,46,Night Lights Harmony,5.0,5,-5,-9,-13,1,down,1975-06-14
1504,Jackson 5,1975-06-14,Jackson 5 - Moving Violation,51,51,26,6.0,44,Moving Violation,14.0,0,18,7,0,1,up,1975-06-14
1505,Jackson 5,1975-06-21,Jackson 5 - Moving Violation,44,51,16,6.0,26,Moving Violation,14.0,1,10,18,7,1,up,1975-06-14
1506,Jackson 5,1975-06-28,Jackson 5 - Moving Violation,26,44,14,6.0,16,Moving Violation,14.0,2,2,10,18,1,up,1975-06-14
1507,Jackson 5,1975-07-05,Jackson 5 - Moving Violation,16,26,13,6.0,14,Moving Violation,14.0,3,1,2,10,1,up,1975-06-14
1508,Jackson 5,1975-07-12,Jackson 5 - Moving Violation,14,16,12,6.0,13,Moving Violation,14.0,4,1,1,2,1,up,1975-06-14
1509,Jackson 5,1975-07-19,Jackson 5 - Moving Violation,13,14,10,6.0,12,Moving Violation,14.0,5,2,1,1,1,up,1975-06-14
1510,Jackson 5,1975-07-26,Jackson 5 - Moving Violation,12,13,8,6.0,10,Moving Violation,14.0,6,2,2,1,1,up,1975-06-14
1511,Jackson 5,1975-08-02,Jackson 5 - Moving Violation,10,12,6,6.0,8,Moving Violation,14.0,7,2,2,2,1,up,1975-06-14
1512,Jackson 5,1975-08-09,Jackson 5 - Moving Violation,8,10,6,6.0,6,Moving Violation,14.0,8,0,2,2,0,stay,1975-06-14
1513,Jackson 5,1975-08-16,Jackson 5 - Moving Violation,6,8,10,6.0,6,Moving Violation,14.0,9,-4,0,2,1,down,1975-06-14
1514,Jackson 5,1975-08-23,Jackson 5 - Moving Violation,6,6,23,6.0,10,Moving Violation,14.0,10,-13,-4,0,1,down,1975-06-14
1515,Jackson 5,1975-08-30,Jackson 5 - Moving Violation,10,6,41,6.0,23,Moving Violation,14.0,11,-18,-13,-4,1,down,1975-06-14
1516,Jackson 5,1975-09-06,Jackson 5 - Moving Violation,23,10,49,6.0,41,Moving Violation,14.0,12,-8,-18,-13,1,down,1975-06-14
1517,Jackson 5,1975-09-20,Jackson 5 - Moving Violation,41,23,47,6.0,49,Moving Violation,14.0,13,2,-8,-18,1,up,1975-06-14
1518,Jackson 5,1975-09-27,Jackson 5 - Moving Violation,49,41,51,6.0,47,Moving Violation,14.0,14,-4,2,-8,1,down,1975-06-14
1519,Kokomo,1975-06-14,Kokomo - Kokomo,51,51,48,34.0,48,Kokomo,8.0,0,0,3,0,0,stay,1975-06-14
1520,Kokomo,1975-06-21,Kokomo - Kokomo,48,51,43,34.0,48,Kokomo,8.0,1,5,0,3,1,up,1975-06-14
1521,Kokomo,1975-06-28,Kokomo - Kokomo,48,48,41,34.0,43,Kokomo,8.0,2,2,5,0,1,up,1975-06-14
1522,Kokomo,1975-07-05,Kokomo - Kokomo,43,48,44,34.0,41,Kokomo,8.0,3,-3,2,5,1,down,1975-06-14
1523,Kokomo,1975-07-12,Kokomo - Kokomo,41,43,42,34.0,44,Kokomo,8.0,4,2,-3,2,1,up,1975-06-14
1524,Kokomo,1975-07-19,Kokomo - Kokomo,44,41,37,34.0,42,Kokomo,8.0,5,5,2,-3,1,up,1975-06-14
1525,Kokomo,1975-07-26,Kokomo - Kokomo,42,44,34,34.0,37,Kokomo,8.0,6,3,5,2,1,up,1975-06-14
1526,Kokomo,1975-08-02,Kokomo - Kokomo,37,42,37,34.0,34,Kokomo,8.0,7,-3,3,5,1,down,1975-06-14
1527,Kokomo,1975-08-09,Kokomo - Kokomo,34,37,51,34.0,37,Kokomo,8.0,8,-14,-3,3,1,down,1975-06-14
1528,Loleatta Holloway,1975-06-14,Loleatta Holloway - Cry To Me,51,51,47,47.0,50,Cry To Me,2.0,0,3,1,0,1,up,1975-06-14
1529,Loleatta Holloway,1975-06-21,Loleatta Holloway - Cry To Me,50,51,48,47.0,47,Cry To Me,2.0,1,-1,3,1,1,down,1975-06-14
1530,Loleatta Holloway,1975-06-28,Loleatta Holloway - Cry To Me,47,50,51,47.0,48,Cry To Me,2.0,2,-3,-1,3,1,down,1975-06-14
1531,The Stylistics,1975-06-21,The Stylistics - Thank You Baby,51,51,28,9.0,35,Thank You Baby,11.0,0,7,16,0,1,up,1975-06-21
1532,The Stylistics,1975-06-28,The Stylistics - Thank You Baby,35,51,22,9.0,28,Thank You Baby,11.0,1,6,7,16,1,up,1975-06-21
1533,The Stylistics,1975-07-05,The Stylistics - Thank You Baby,28,35,17,9.0,22,Thank You Baby,11.0,2,5,6,7,1,up,1975-06-21
1534,The Stylistics,1975-07-12,The Stylistics - Thank You Baby,22,28,15,9.0,17,Thank You Baby,11.0,3,2,5,6,1,up,1975-06-21
1535,The Stylistics,1975-07-19,The Stylistics - Thank You Baby,17,22,11,9.0,15,Thank You Baby,11.0,4,4,2,5,1,up,1975-06-21
1536,The Stylistics,1975-07-26,The Stylistics - Thank You Baby,15,17,9,9.0,11,Thank You Baby,11.0,5,2,4,2,1,up,1975-06-21
1537,The Stylistics,1975-08-02,The Stylistics - Thank You Baby,11,15,9,9.0,9,Thank You Baby,11.0,6,0,2,4,0,stay,1975-06-21
1538,The Stylistics,1975-08-09,The Stylistics - Thank You Baby,9,11,10,9.0,9,Thank You Baby,11.0,7,-1,0,2,1,down,1975-06-21
1539,The Stylistics,1975-08-16,The Stylistics - Thank You Baby,9,9,27,9.0,10,Thank You Baby,11.0,8,-17,-1,0,1,down,1975-06-21
1540,The Stylistics,1975-08-23,The Stylistics - Thank You Baby,10,9,30,9.0,27,Thank You Baby,11.0,9,-3,-17,-1,1,down,1975-06-21
1541,The Stylistics,1975-08-30,The Stylistics - Thank You Baby,27,10,43,9.0,30,Thank You Baby,11.0,10,-13,-3,-17,1,down,1975-06-21
1542,The Stylistics,1975-09-06,The Stylistics - Thank You Baby,30,27,51,9.0,43,Thank You Baby,11.0,11,-8,-13,-3,1,down,1975-06-21
1543,Average White Band,1975-06-21,Average White Band - Cut The Cake,51,51,31,1.0,46,Cut The Cake,15.0,0,15,5,0,1,up,1975-06-21
1544,Average White Band,1975-06-28,Average White Band - Cut The Cake,46,51,20,1.0,31,Cut The Cake,15.0,1,11,15,5,1,up,1975-06-21
1545,Average White Band,1975-07-05,Average White Band - Cut The Cake,31,46,15,1.0,20,Cut The Cake,15.0,2,5,11,15,1,up,1975-06-21
1546,Average White Band,1975-07-12,Average White Band - Cut The Cake,20,31,8,1.0,15,Cut The Cake,15.0,3,7,5,11,1,up,1975-06-21
1547,Average White Band,1975-07-19,Average White Band - Cut The Cake,15,20,5,1.0,8,Cut The Cake,15.0,4,3,7,5,1,up,1975-06-21
1548,Average White Band,1975-07-26,Average White Band - Cut The Cake,8,15,4,1.0,5,Cut The Cake,15.0,5,1,3,7,1,up,1975-06-21
1549,Average White Band,1975-08-02,Average White Band - Cut The Cake,5,8,2,1.0,4,Cut The Cake,15.0,6,2,1,3,1,up,1975-06-21
1550,Average White Band,1975-08-09,Average White Band - Cut The Cake,4,5,2,1.0,2,Cut The Cake,15.0,7,0,2,1,0,stay,1975-06-21
1551,Average White Band,1975-08-16,Average White Band - Cut The Cake,2,4,1,1.0,2,Cut The Cake,15.0,8,1,0,2,1,up,1975-06-21
1552,Average White Band,1975-08-23,Average White Band - Cut The Cake,2,2,2,1.0,1,Cut The Cake,15.0,9,-1,1,0,1,down,1975-06-21
1553,Average White Band,1975-08-30,Average White Band - Cut The Cake,1,2,10,1.0,2,Cut The Cake,15.0,10,-8,-1,1,1,down,1975-06-21
1554,Average White Band,1975-09-06,Average White Band - Cut The Cake,2,1,13,1.0,10,Cut The Cake,15.0,11,-3,-8,-1,1,down,1975-06-21
1555,Average White Band,1975-09-13,Average White Band - Cut The Cake,10,2,23,1.0,13,Cut The Cake,15.0,12,-10,-3,-8,1,down,1975-06-21
1556,Average White Band,1975-09-20,Average White Band - Cut The Cake,13,10,33,1.0,23,Cut The Cake,15.0,13,-10,-10,-3,1,down,1975-06-21
1557,Average White Band,1975-09-27,Average White Band - Cut The Cake,23,13,42,1.0,33,Cut The Cake,15.0,14,-9,-10,-10,1,down,1975-06-21
1558,Average White Band,1975-10-04,Average White Band - Cut The Cake,33,23,51,1.0,42,Cut The Cake,15.0,15,-9,-9,-10,1,down,1975-06-21
1559,The Supremes,1975-06-21,The Supremes - The Supremes,51,51,40,25.0,49,The Supremes,7.0,0,9,2,0,1,up,1975-06-21
1560,The Supremes,1975-06-28,The Supremes - The Supremes,49,51,32,25.0,40,The Supremes,7.0,1,8,9,2,1,up,1975-06-21
1561,The Supremes,1975-07-05,The Supremes - The Supremes,40,49,28,25.0,32,The Supremes,7.0,2,4,8,9,1,up,1975-06-21
1562,The Supremes,1975-07-12,The Supremes - The Supremes,32,40,26,25.0,28,The Supremes,7.0,3,2,4,8,1,up,1975-06-21
1563,The Supremes,1975-07-19,The Supremes - The Supremes,28,32,25,25.0,26,The Supremes,7.0,4,1,2,4,1,up,1975-06-21
1564,The Supremes,1975-07-26,The Supremes - The Supremes,26,28,25,25.0,25,The Supremes,7.0,5,0,1,2,0,stay,1975-06-21
1565,The Supremes,1975-08-02,The Supremes - The Supremes,25,26,42,25.0,25,The Supremes,7.0,6,-17,0,1,1,down,1975-06-21
1566,The Supremes,1975-08-09,The Supremes - The Supremes,25,25,51,25.0,42,The Supremes,7.0,7,-9,-17,0,1,down,1975-06-21
1567,Curtis Mayfield,1975-06-21,Curtis Mayfield - There's No Place Like America Today,51,51,39,13.0,50,There's No Place Like America Today,14.0,0,11,1,0,1,up,1975-06-21
1568,Curtis Mayfield,1975-06-28,Curtis Mayfield - There's No Place Like America Today,50,51,26,13.0,39,There's No Place Like America Today,14.0,1,13,11,1,1,up,1975-06-21
1569,Curtis Mayfield,1975-07-05,Curtis Mayfield - There's No Place Like America Today,39,50,14,13.0,26,There's No Place Like America Today,14.0,2,12,13,11,1,up,1975-06-21
1570,Curtis Mayfield,1975-07-12,Curtis Mayfield - There's No Place Like America Today,26,39,13,13.0,14,There's No Place Like America Today,14.0,3,1,12,13,1,up,1975-06-21
1571,Curtis Mayfield,1975-07-19,Curtis Mayfield - There's No Place Like America Today,14,26,16,13.0,13,There's No Place Like America Today,14.0,4,-3,1,12,1,down,1975-06-21
1572,Curtis Mayfield,1975-07-26,Curtis Mayfield - There's No Place Like America Today,13,14,21,13.0,16,There's No Place Like America Today,14.0,5,-5,-3,1,1,down,1975-06-21
1573,Curtis Mayfield,1975-08-02,Curtis Mayfield - There's No Place Like America Today,16,13,31,13.0,21,There's No Place Like America Today,14.0,6,-10,-5,-3,1,down,1975-06-21
1574,Curtis Mayfield,1975-08-09,Curtis Mayfield - There's No Place Like America Today,21,16,26,13.0,31,There's No Place Like America Today,14.0,7,5,-10,-5,1,up,1975-06-21
1575,Curtis Mayfield,1975-08-16,Curtis Mayfield - There's No Place Like America Today,31,21,24,13.0,26,There's No Place Like America Today,14.0,8,2,5,-10,1,up,1975-06-21
1576,Curtis Mayfield,1975-08-23,Curtis Mayfield - There's No Place Like America Today,26,31,22,13.0,24,There's No Place Like America Today,14.0,9,2,2,5,1,up,1975-06-21
1577,Curtis Mayfield,1975-08-30,Curtis Mayfield - There's No Place Like America Today,24,26,31,13.0,22,There's No Place Like America Today,14.0,10,-9,2,2,1,down,1975-06-21
1578,Curtis Mayfield,1975-09-06,Curtis Mayfield - There's No Place Like America Today,22,24,42,13.0,31,There's No Place Like America Today,14.0,11,-11,-9,2,1,down,1975-06-21
1579,Curtis Mayfield,1975-09-13,Curtis Mayfield - There's No Place Like America Today,31,22,40,13.0,42,There's No Place Like America Today,14.0,12,2,-11,-9,1,up,1975-06-21
1580,Curtis Mayfield,1975-09-20,Curtis Mayfield - There's No Place Like America Today,42,31,44,13.0,40,There's No Place Like America Today,14.0,13,-4,2,-11,1,down,1975-06-21
1581,Curtis Mayfield,1975-09-27,Curtis Mayfield - There's No Place Like America Today,40,42,51,13.0,44,There's No Place Like America Today,14.0,14,-7,-4,2,1,down,1975-06-21
1582,The Isley Brothers,1975-06-28,The Isley Brothers - The Heat Is On,51,51,16,1.0,32,The Heat Is On,24.0,0,16,19,0,1,up,1975-06-28
1583,The Isley Brothers,1975-07-05,The Isley Brothers - The Heat Is On,32,51,6,1.0,16,The Heat Is On,24.0,1,10,16,19,1,up,1975-06-28
1584,The Isley Brothers,1975-07-12,The Isley Brothers - The Heat Is On,16,32,1,1.0,6,The Heat Is On,24.0,2,5,10,16,1,up,1975-06-28
1585,The Isley Brothers,1975-07-19,The Isley Brothers - The Heat Is On,6,16,1,1.0,1,The Heat Is On,24.0,3,0,5,10,0,stay,1975-06-28
1586,The Isley Brothers,1975-07-26,The Isley Brothers - The Heat Is On,1,6,1,1.0,1,The Heat Is On,24.0,4,0,0,5,0,stay,1975-06-28
1587,The Isley Brothers,1975-08-02,The Isley Brothers - The Heat Is On,1,1,4,1.0,1,The Heat Is On,24.0,5,-3,0,0,1,down,1975-06-28
1588,The Isley Brothers,1975-08-09,The Isley Brothers - The Heat Is On,1,1,7,1.0,4,The Heat Is On,24.0,6,-3,-3,0,1,down,1975-06-28
1589,The Isley Brothers,1975-08-16,The Isley Brothers - The Heat Is On,4,1,7,1.0,7,The Heat Is On,24.0,7,0,-3,-3,0,stay,1975-06-28
1590,The Isley Brothers,1975-08-23,The Isley Brothers - The Heat Is On,7,4,7,1.0,7,The Heat Is On,24.0,8,0,0,-3,0,stay,1975-06-28
1591,The Isley Brothers,1975-08-30,The Isley Brothers - The Heat Is On,7,7,6,1.0,7,The Heat Is On,24.0,9,1,0,0,1,up,1975-06-28
1592,The Isley Brothers,1975-09-06,The Isley Brothers - The Heat Is On,7,7,4,1.0,6,The Heat Is On,24.0,10,2,1,0,1,up,1975-06-28
1593,The Isley Brothers,1975-09-13,The Isley Brothers - The Heat Is On,6,7,1,1.0,4,The Heat Is On,24.0,11,3,2,1,1,up,1975-06-28
1594,The Isley Brothers,1975-09-20,The Isley Brothers - The Heat Is On,4,6,4,1.0,1,The Heat Is On,24.0,12,-3,3,2,1,down,1975-06-28
1595,The Isley Brothers,1975-09-27,The Isley Brothers - The Heat Is On,1,4,6,1.0,4,The Heat Is On,24.0,13,-2,-3,3,1,down,1975-06-28
1596,The Isley Brothers,1975-10-04,The Isley Brothers - The Heat Is On,4,1,8,1.0,6,The Heat Is On,24.0,14,-2,-2,-3,1,down,1975-06-28
1597,The Isley Brothers,1975-10-11,The Isley Brothers - The Heat Is On,6,4,19,1.0,8,The Heat Is On,24.0,15,-11,-2,-2,1,down,1975-06-28
1598,The Isley Brothers,1975-10-18,The Isley Brothers - The Heat Is On,8,6,18,1.0,19,The Heat Is On,24.0,16,1,-11,-2,1,up,1975-06-28
1599,The Isley Brothers,1975-10-25,The Isley Brothers - The Heat Is On,19,8,16,1.0,18,The Heat Is On,24.0,17,2,1,-11,1,up,1975-06-28
1600,The Isley Brothers,1975-11-01,The Isley Brothers - The Heat Is On,18,19,15,1.0,16,The Heat Is On,24.0,18,1,2,1,1,up,1975-06-28
1601,The Isley Brothers,1975-11-08,The Isley Brothers - The Heat Is On,16,18,17,1.0,15,The Heat Is On,24.0,19,-2,1,2,1,down,1975-06-28
1602,The Isley Brothers,1975-11-15,The Isley Brothers - The Heat Is On,15,16,17,1.0,17,The Heat Is On,24.0,20,0,-2,1,0,stay,1975-06-28
1603,The Isley Brothers,1975-11-22,The Isley Brothers - The Heat Is On,17,15,37,1.0,17,The Heat Is On,24.0,21,-20,0,-2,1,down,1975-06-28
1604,The Isley Brothers,1975-11-29,The Isley Brothers - The Heat Is On,17,17,36,1.0,37,The Heat Is On,24.0,22,1,-20,0,1,up,1975-06-28
1605,The Isley Brothers,1975-12-06,The Isley Brothers - The Heat Is On,37,17,35,1.0,36,The Heat Is On,24.0,23,1,1,-20,1,up,1975-06-28
1606,The Isley Brothers,1975-12-13,The Isley Brothers - The Heat Is On,36,37,51,1.0,35,The Heat Is On,24.0,24,-16,1,1,1,down,1975-06-28
1607,MFSB,1975-06-28,MFSB - Universal Love,51,51,15,2.0,35,Universal Love,13.0,0,20,16,0,1,up,1975-06-28
1608,MFSB,1975-07-05,MFSB - Universal Love,35,51,7,2.0,15,Universal Love,13.0,1,8,20,16,1,up,1975-06-28
1609,MFSB,1975-07-12,MFSB - Universal Love,15,35,6,2.0,7,Universal Love,13.0,2,1,8,20,1,up,1975-06-28
1610,MFSB,1975-07-19,MFSB - Universal Love,7,15,3,2.0,6,Universal Love,13.0,3,3,1,8,1,up,1975-06-28
1611,MFSB,1975-07-26,MFSB - Universal Love,6,7,2,2.0,3,Universal Love,13.0,4,1,3,1,1,up,1975-06-28
1612,MFSB,1975-08-02,MFSB - Universal Love,3,6,3,2.0,2,Universal Love,13.0,5,-1,1,3,1,down,1975-06-28
1613,MFSB,1975-08-09,MFSB - Universal Love,2,3,3,2.0,3,Universal Love,13.0,6,0,-1,1,0,stay,1975-06-28
1614,MFSB,1975-08-16,MFSB - Universal Love,3,2,8,2.0,3,Universal Love,13.0,7,-5,0,-1,1,down,1975-06-28
1615,MFSB,1975-08-23,MFSB - Universal Love,3,3,19,2.0,8,Universal Love,13.0,8,-11,-5,0,1,down,1975-06-28
1616,MFSB,1975-08-30,MFSB - Universal Love,8,3,20,2.0,19,Universal Love,13.0,9,-1,-11,-5,1,down,1975-06-28
1617,MFSB,1975-09-06,MFSB - Universal Love,19,8,27,2.0,20,Universal Love,13.0,10,-7,-1,-11,1,down,1975-06-28
1618,MFSB,1975-09-13,MFSB - Universal Love,20,19,31,2.0,27,Universal Love,13.0,11,-4,-7,-1,1,down,1975-06-28
1619,MFSB,1975-09-20,MFSB - Universal Love,27,20,42,2.0,31,Universal Love,13.0,12,-11,-4,-7,1,down,1975-06-28
1620,MFSB,1975-09-27,MFSB - Universal Love,31,27,51,2.0,42,Universal Love,13.0,13,-9,-11,-4,1,down,1975-06-28
1621,Isaac Hayes,1975-06-28,Isaac Hayes - Chocolate Chip,51,51,27,1.0,46,Chocolate Chip,16.0,0,19,5,0,1,up,1975-06-28
1622,Isaac Hayes,1975-07-05,Isaac Hayes - Chocolate Chip,46,51,11,1.0,27,Chocolate Chip,16.0,1,16,19,5,1,up,1975-06-28
1623,Isaac Hayes,1975-07-12,Isaac Hayes - Chocolate Chip,27,46,10,1.0,11,Chocolate Chip,16.0,2,1,16,19,1,up,1975-06-28
1624,Isaac Hayes,1975-07-19,Isaac Hayes - Chocolate Chip,11,27,4,1.0,10,Chocolate Chip,16.0,3,6,1,16,1,up,1975-06-28
1625,Isaac Hayes,1975-07-26,Isaac Hayes - Chocolate Chip,10,11,3,1.0,4,Chocolate Chip,16.0,4,1,6,1,1,up,1975-06-28
1626,Isaac Hayes,1975-08-02,Isaac Hayes - Chocolate Chip,4,10,1,1.0,3,Chocolate Chip,16.0,5,2,1,6,1,up,1975-06-28
1627,Isaac Hayes,1975-08-09,Isaac Hayes - Chocolate Chip,3,4,1,1.0,1,Chocolate Chip,16.0,6,0,2,1,0,stay,1975-06-28
1628,Isaac Hayes,1975-08-16,Isaac Hayes - Chocolate Chip,1,3,4,1.0,1,Chocolate Chip,16.0,7,-3,0,2,1,down,1975-06-28
1629,Isaac Hayes,1975-08-23,Isaac Hayes - Chocolate Chip,1,1,10,1.0,4,Chocolate Chip,16.0,8,-6,-3,0,1,down,1975-06-28
1630,Isaac Hayes,1975-08-30,Isaac Hayes - Chocolate Chip,4,1,12,1.0,10,Chocolate Chip,16.0,9,-2,-6,-3,1,down,1975-06-28
1631,Isaac Hayes,1975-09-06,Isaac Hayes - Chocolate Chip,10,4,16,1.0,12,Chocolate Chip,16.0,10,-4,-2,-6,1,down,1975-06-28
1632,Isaac Hayes,1975-09-13,Isaac Hayes - Chocolate Chip,12,10,17,1.0,16,Chocolate Chip,16.0,11,-1,-4,-2,1,down,1975-06-28
1633,Isaac Hayes,1975-09-20,Isaac Hayes - Chocolate Chip,16,12,22,1.0,17,Chocolate Chip,16.0,12,-5,-1,-4,1,down,1975-06-28
1634,Isaac Hayes,1975-09-27,Isaac Hayes - Chocolate Chip,17,16,28,1.0,22,Chocolate Chip,16.0,13,-6,-5,-1,1,down,1975-06-28
1635,Isaac Hayes,1975-10-04,Isaac Hayes - Chocolate Chip,22,17,27,1.0,28,Chocolate Chip,16.0,14,1,-6,-5,1,up,1975-06-28
1636,Isaac Hayes,1975-10-11,Isaac Hayes - Chocolate Chip,28,22,34,1.0,27,Chocolate Chip,16.0,15,-7,1,-6,1,down,1975-06-28
1637,Isaac Hayes,1975-10-18,Isaac Hayes - Chocolate Chip,27,28,51,1.0,34,Chocolate Chip,16.0,16,-17,-7,1,1,down,1975-06-28
1638,The Three Degrees,1975-06-28,The Three Degrees - International,51,51,37,31.0,47,International,3.0,0,10,4,0,1,up,1975-06-28
1639,The Three Degrees,1975-07-05,The Three Degrees - International,47,51,31,31.0,37,International,3.0,1,6,10,4,1,up,1975-06-28
1640,The Three Degrees,1975-07-12,The Three Degrees - International,37,47,41,31.0,31,International,3.0,2,-10,6,10,1,down,1975-06-28
1641,The Three Degrees,1975-07-19,The Three Degrees - International,31,37,51,31.0,41,International,3.0,3,-10,-10,6,1,down,1975-06-28
1642,Gwen McCrae,1975-06-28,Gwen McCrae - Rockin'chair,51,51,31,18.0,49,Rockin'chair,8.0,0,18,2,0,1,up,1975-06-28
1643,Gwen McCrae,1975-07-05,Gwen McCrae - Rockin'chair,49,51,26,18.0,31,Rockin'chair,8.0,1,5,18,2,1,up,1975-06-28
1644,Gwen McCrae,1975-07-12,Gwen McCrae - Rockin'chair,31,49,24,18.0,26,Rockin'chair,8.0,2,2,5,18,1,up,1975-06-28
1645,Gwen McCrae,1975-07-19,Gwen McCrae - Rockin'chair,26,31,21,18.0,24,Rockin'chair,8.0,3,3,2,5,1,up,1975-06-28
1646,Gwen McCrae,1975-07-26,Gwen McCrae - Rockin'chair,24,26,18,18.0,21,Rockin'chair,8.0,4,3,3,2,1,up,1975-06-28
1647,Gwen McCrae,1975-08-02,Gwen McCrae - Rockin'chair,21,24,18,18.0,18,Rockin'chair,8.0,5,0,3,3,0,stay,1975-06-28
1648,Gwen McCrae,1975-08-09,Gwen McCrae - Rockin'chair,18,21,25,18.0,18,Rockin'chair,8.0,6,-7,0,3,1,down,1975-06-28
1649,Gwen McCrae,1975-08-16,Gwen McCrae - Rockin'chair,18,18,44,18.0,25,Rockin'chair,8.0,7,-19,-7,0,1,down,1975-06-28
1650,Gwen McCrae,1975-08-23,Gwen McCrae - Rockin'chair,25,18,51,18.0,44,Rockin'chair,8.0,8,-7,-19,-7,1,down,1975-06-28
1651,Fantastic Four,1975-06-28,Fantastic Four - Alvin Stone :birth & Death Of A Gangster,51,51,45,33.0,50,Alvin Stone :birth & Death Of A Gangster,7.0,0,5,1,0,1,up,1975-06-28
1652,Fantastic Four,1975-07-05,Fantastic Four - Alvin Stone :birth & Death Of A Gangster,50,51,36,33.0,45,Alvin Stone :birth & Death Of A Gangster,7.0,1,9,5,1,1,up,1975-06-28
1653,Fantastic Four,1975-07-12,Fantastic Four - Alvin Stone :birth & Death Of A Gangster,45,50,34,33.0,36,Alvin Stone :birth & Death Of A Gangster,7.0,2,2,9,5,1,up,1975-06-28
1654,Fantastic Four,1975-07-19,Fantastic Four - Alvin Stone :birth & Death Of A Gangster,36,45,33,33.0,34,Alvin Stone :birth & Death Of A Gangster,7.0,3,1,2,9,1,up,1975-06-28
1655,Fantastic Four,1975-07-26,Fantastic Four - Alvin Stone :birth & Death Of A Gangster,34,36,44,33.0,33,Alvin Stone :birth & Death Of A Gangster,7.0,4,-11,1,2,1,down,1975-06-28
1656,Fantastic Four,1975-08-02,Fantastic Four - Alvin Stone :birth & Death Of A Gangster,33,34,45,33.0,44,Alvin Stone :birth & Death Of A Gangster,7.0,5,-1,-11,1,1,down,1975-06-28
1657,Fantastic Four,1975-08-09,Fantastic Four - Alvin Stone :birth & Death Of A Gangster,44,33,46,33.0,45,Alvin Stone :birth & Death Of A Gangster,7.0,6,-1,-1,-11,1,down,1975-06-28
1658,Fantastic Four,1975-08-16,Fantastic Four - Alvin Stone :birth & Death Of A Gangster,45,44,51,33.0,46,Alvin Stone :birth & Death Of A Gangster,7.0,7,-5,-1,-1,1,down,1975-06-28
1659,Weather Report,1975-07-05,Weather Report - Tale Spinnin',51,51,23,12.0,39,Tale Spinnin',6.0,0,16,12,0,1,up,1975-07-05
1660,Weather Report,1975-07-12,Weather Report - Tale Spinnin',39,51,14,12.0,23,Tale Spinnin',6.0,1,9,16,12,1,up,1975-07-05
1661,Weather Report,1975-07-19,Weather Report - Tale Spinnin',23,39,12,12.0,14,Tale Spinnin',6.0,2,2,9,16,1,up,1975-07-05
1662,Weather Report,1975-07-26,Weather Report - Tale Spinnin',14,23,12,12.0,12,Tale Spinnin',6.0,3,0,2,9,0,stay,1975-07-05
1663,Weather Report,1975-08-02,Weather Report - Tale Spinnin',12,14,16,12.0,12,Tale Spinnin',6.0,4,-4,0,2,1,down,1975-07-05
1664,Weather Report,1975-08-09,Weather Report - Tale Spinnin',12,12,29,12.0,16,Tale Spinnin',6.0,5,-13,-4,0,1,down,1975-07-05
1665,Weather Report,1975-08-16,Weather Report - Tale Spinnin',16,12,51,12.0,29,Tale Spinnin',6.0,6,-22,-13,-4,1,down,1975-07-05
1666,The Blackbyrds,1975-07-05,"The Blackbyrds - Cornbread, Earl And Me",51,51,41,19.0,46,"Cornbread, Earl And Me",9.0,0,5,5,0,1,up,1975-07-05
1667,The Blackbyrds,1975-07-12,"The Blackbyrds - Cornbread, Earl And Me",46,51,33,19.0,41,"Cornbread, Earl And Me",9.0,1,8,5,5,1,up,1975-07-05
1668,The Blackbyrds,1975-07-19,"The Blackbyrds - Cornbread, Earl And Me",41,46,31,19.0,33,"Cornbread, Earl And Me",9.0,2,2,8,5,1,up,1975-07-05
1669,The Blackbyrds,1975-07-26,"The Blackbyrds - Cornbread, Earl And Me",33,41,29,19.0,31,"Cornbread, Earl And Me",9.0,3,2,2,8,1,up,1975-07-05
1670,The Blackbyrds,1975-08-02,"The Blackbyrds - Cornbread, Earl And Me",31,33,21,19.0,29,"Cornbread, Earl And Me",9.0,4,8,2,2,1,up,1975-07-05
1671,The Blackbyrds,1975-08-09,"The Blackbyrds - Cornbread, Earl And Me",29,31,19,19.0,21,"Cornbread, Earl And Me",9.0,5,2,8,2,1,up,1975-07-05
1672,The Blackbyrds,1975-08-16,"The Blackbyrds - Cornbread, Earl And Me",21,29,19,19.0,19,"Cornbread, Earl And Me",9.0,6,0,2,8,0,stay,1975-07-05
1673,The Blackbyrds,1975-08-23,"The Blackbyrds - Cornbread, Earl And Me",19,21,24,19.0,19,"Cornbread, Earl And Me",9.0,7,-5,0,2,1,down,1975-07-05
1674,The Blackbyrds,1975-08-30,"The Blackbyrds - Cornbread, Earl And Me",19,19,42,19.0,24,"Cornbread, Earl And Me",9.0,8,-18,-5,0,1,down,1975-07-05
1675,The Blackbyrds,1975-09-06,"The Blackbyrds - Cornbread, Earl And Me",24,19,51,19.0,42,"Cornbread, Earl And Me",9.0,9,-9,-18,-5,1,down,1975-07-05
1676,Latimore,1975-07-05,Latimore - Latimore II,51,51,51,49.0,49,Latimore II,0.0,0,-2,2,0,1,down,1975-07-05
1677,Ray Charles,1975-07-05,Ray Charles - Renaissance,51,51,50,34.0,50,Renaissance,11.0,0,0,1,0,0,stay,1975-07-05
1678,Ray Charles,1975-07-12,Ray Charles - Renaissance,50,51,47,34.0,50,Renaissance,11.0,1,3,0,1,1,up,1975-07-05
1679,Ray Charles,1975-07-19,Ray Charles - Renaissance,50,50,44,34.0,47,Renaissance,11.0,2,3,3,0,1,up,1975-07-05
1680,Ray Charles,1975-07-26,Ray Charles - Renaissance,47,50,41,34.0,44,Renaissance,11.0,3,3,3,3,1,up,1975-07-05
1681,Ray Charles,1975-08-02,Ray Charles - Renaissance,44,47,38,34.0,41,Renaissance,11.0,4,3,3,3,1,up,1975-07-05
1682,Ray Charles,1975-08-09,Ray Charles - Renaissance,41,44,34,34.0,38,Renaissance,11.0,5,4,3,3,1,up,1975-07-05
1683,Ray Charles,1975-08-16,Ray Charles - Renaissance,38,41,34,34.0,34,Renaissance,11.0,6,0,4,3,0,stay,1975-07-05
1684,Ray Charles,1975-08-23,Ray Charles - Renaissance,34,38,46,34.0,34,Renaissance,11.0,7,-12,0,4,1,down,1975-07-05
1685,Ray Charles,1975-08-30,Ray Charles - Renaissance,34,34,41,34.0,46,Renaissance,11.0,8,5,-12,0,1,up,1975-07-05
1686,Ray Charles,1975-09-13,Ray Charles - Renaissance,46,34,41,34.0,41,Renaissance,11.0,9,0,5,-12,0,stay,1975-07-05
1687,Ray Charles,1975-09-20,Ray Charles - Renaissance,41,46,40,34.0,41,Renaissance,11.0,10,1,0,5,1,up,1975-07-05
1688,Ray Charles,1975-09-27,Ray Charles - Renaissance,41,41,51,34.0,40,Renaissance,11.0,11,-11,1,0,1,down,1975-07-05
1689,The Moments,1975-07-12,The Moments - Look At Me,51,51,30,13.0,39,Look At Me,8.0,0,9,12,0,1,up,1975-07-12
1690,The Moments,1975-07-19,The Moments - Look At Me,39,51,20,13.0,30,Look At Me,8.0,1,10,9,12,1,up,1975-07-12
1691,The Moments,1975-07-26,The Moments - Look At Me,30,39,16,13.0,20,Look At Me,8.0,2,4,10,9,1,up,1975-07-12
1692,The Moments,1975-08-02,The Moments - Look At Me,20,30,14,13.0,16,Look At Me,8.0,3,2,4,10,1,up,1975-07-12
1693,The Moments,1975-08-09,The Moments - Look At Me,16,20,13,13.0,14,Look At Me,8.0,4,1,2,4,1,up,1975-07-12
1694,The Moments,1975-08-16,The Moments - Look At Me,14,16,28,13.0,13,Look At Me,8.0,5,-15,1,2,1,down,1975-07-12
1695,The Moments,1975-08-23,The Moments - Look At Me,13,14,31,13.0,28,Look At Me,8.0,6,-3,-15,1,1,down,1975-07-12
1696,The Moments,1975-08-30,The Moments - Look At Me,28,13,44,13.0,31,Look At Me,8.0,7,-13,-3,-15,1,down,1975-07-12
1697,The Moments,1975-09-06,The Moments - Look At Me,31,28,51,13.0,44,Look At Me,8.0,8,-7,-13,-3,1,down,1975-07-12
1698,War,1975-07-12,War - Why Can't We Be Friends?,51,51,25,1.0,40,Why Can't We Be Friends?,20.0,0,15,11,0,1,up,1975-07-12
1699,War,1975-07-19,War - Why Can't We Be Friends?,40,51,15,1.0,25,Why Can't We Be Friends?,20.0,1,10,15,11,1,up,1975-07-12
1700,War,1975-07-26,War - Why Can't We Be Friends?,25,40,11,1.0,15,Why Can't We Be Friends?,20.0,2,4,10,15,1,up,1975-07-12
1701,War,1975-08-02,War - Why Can't We Be Friends?,15,25,8,1.0,11,Why Can't We Be Friends?,20.0,3,3,4,10,1,up,1975-07-12
1702,War,1975-08-09,War - Why Can't We Be Friends?,11,15,4,1.0,8,Why Can't We Be Friends?,20.0,4,4,3,4,1,up,1975-07-12
1703,War,1975-08-16,War - Why Can't We Be Friends?,8,11,2,1.0,4,Why Can't We Be Friends?,20.0,5,2,4,3,1,up,1975-07-12
1704,War,1975-08-23,War - Why Can't We Be Friends?,4,8,1,1.0,2,Why Can't We Be Friends?,20.0,6,1,2,4,1,up,1975-07-12
1705,War,1975-08-30,War - Why Can't We Be Friends?,2,4,9,1.0,1,Why Can't We Be Friends?,20.0,7,-8,1,2,1,down,1975-07-12
1706,War,1975-09-06,War - Why Can't We Be Friends?,1,2,12,1.0,9,Why Can't We Be Friends?,20.0,8,-3,-8,1,1,down,1975-07-12
1707,War,1975-09-13,War - Why Can't We Be Friends?,9,1,11,1.0,12,Why Can't We Be Friends?,20.0,9,1,-3,-8,1,up,1975-07-12
1708,War,1975-09-20,War - Why Can't We Be Friends?,12,9,12,1.0,11,Why Can't We Be Friends?,20.0,10,-1,1,-3,1,down,1975-07-12
1709,War,1975-09-27,War - Why Can't We Be Friends?,11,12,15,1.0,12,Why Can't We Be Friends?,20.0,11,-3,-1,1,1,down,1975-07-12
1710,War,1975-10-04,War - Why Can't We Be Friends?,12,11,20,1.0,15,Why Can't We Be Friends?,20.0,12,-5,-3,-1,1,down,1975-07-12
1711,War,1975-10-11,War - Why Can't We Be Friends?,15,12,16,1.0,20,Why Can't We Be Friends?,20.0,13,4,-5,-3,1,up,1975-07-12
1712,War,1975-10-18,War - Why Can't We Be Friends?,20,15,8,1.0,16,Why Can't We Be Friends?,20.0,14,8,4,-5,1,up,1975-07-12
1713,War,1975-10-25,War - Why Can't We Be Friends?,16,20,6,1.0,8,Why Can't We Be Friends?,20.0,15,2,8,4,1,up,1975-07-12
1714,War,1975-11-01,War - Why Can't We Be Friends?,8,16,4,1.0,6,Why Can't We Be Friends?,20.0,16,2,2,8,1,up,1975-07-12
1715,War,1975-11-08,War - Why Can't We Be Friends?,6,8,4,1.0,4,Why Can't We Be Friends?,20.0,17,0,2,2,0,stay,1975-07-12
1716,War,1975-11-15,War - Why Can't We Be Friends?,4,6,11,1.0,4,Why Can't We Be Friends?,20.0,18,-7,0,2,1,down,1975-07-12
1717,War,1975-11-22,War - Why Can't We Be Friends?,4,4,21,1.0,11,Why Can't We Be Friends?,20.0,19,-10,-7,0,1,down,1975-07-12
1718,War,1975-11-29,War - Why Can't We Be Friends?,11,4,51,1.0,21,Why Can't We Be Friends?,20.0,20,-30,-10,-7,1,down,1975-07-12
1719,The Impressions,1975-07-12,The Impressions - First Impressions,51,51,31,13.0,45,First Impressions,13.0,0,14,6,0,1,up,1975-07-12
1720,The Impressions,1975-07-19,The Impressions - First Impressions,45,51,29,13.0,31,First Impressions,13.0,1,2,14,6,1,up,1975-07-12
1721,The Impressions,1975-07-26,The Impressions - First Impressions,31,45,26,13.0,29,First Impressions,13.0,2,3,2,14,1,up,1975-07-12
1722,The Impressions,1975-08-02,The Impressions - First Impressions,29,31,20,13.0,26,First Impressions,13.0,3,6,3,2,1,up,1975-07-12
1723,The Impressions,1975-08-09,The Impressions - First Impressions,26,29,16,13.0,20,First Impressions,13.0,4,4,6,3,1,up,1975-07-12
1724,The Impressions,1975-08-16,The Impressions - First Impressions,20,26,14,13.0,16,First Impressions,13.0,5,2,4,6,1,up,1975-07-12
1725,The Impressions,1975-08-23,The Impressions - First Impressions,16,20,13,13.0,14,First Impressions,13.0,6,1,2,4,1,up,1975-07-12
1726,The Impressions,1975-08-30,The Impressions - First Impressions,14,16,17,13.0,13,First Impressions,13.0,7,-4,1,2,1,down,1975-07-12
1727,The Impressions,1975-09-06,The Impressions - First Impressions,13,14,48,13.0,17,First Impressions,13.0,8,-31,-4,1,1,down,1975-07-12
1728,The Impressions,1975-09-13,The Impressions - First Impressions,17,13,46,13.0,48,First Impressions,13.0,9,2,-31,-4,1,up,1975-07-12
1729,The Impressions,1975-09-20,The Impressions - First Impressions,48,17,45,13.0,46,First Impressions,13.0,10,1,2,-31,1,up,1975-07-12
1730,The Impressions,1975-09-27,The Impressions - First Impressions,46,48,43,13.0,45,First Impressions,13.0,11,2,1,2,1,up,1975-07-12
1731,The Impressions,1975-10-04,The Impressions - First Impressions,45,46,48,13.0,43,First Impressions,13.0,12,-5,2,1,1,down,1975-07-12
1732,The Impressions,1975-10-25,The Impressions - First Impressions,43,45,51,13.0,48,First Impressions,13.0,13,-3,-5,2,1,down,1975-07-12
1733,The Pointer Sisters,1975-07-12,The Pointer Sisters - Steppin',51,51,39,3.0,49,Steppin',19.0,0,10,2,0,1,up,1975-07-12
1734,The Pointer Sisters,1975-07-19,The Pointer Sisters - Steppin',49,51,30,3.0,39,Steppin',19.0,1,9,10,2,1,up,1975-07-12
1735,The Pointer Sisters,1975-07-26,The Pointer Sisters - Steppin',39,49,22,3.0,30,Steppin',19.0,2,8,9,10,1,up,1975-07-12
1736,The Pointer Sisters,1975-08-02,The Pointer Sisters - Steppin',30,39,15,3.0,22,Steppin',19.0,3,7,8,9,1,up,1975-07-12
1737,The Pointer Sisters,1975-08-09,The Pointer Sisters - Steppin',22,30,11,3.0,15,Steppin',19.0,4,4,7,8,1,up,1975-07-12
1738,The Pointer Sisters,1975-08-16,The Pointer Sisters - Steppin',15,22,3,3.0,11,Steppin',19.0,5,8,4,7,1,up,1975-07-12
1739,The Pointer Sisters,1975-08-23,The Pointer Sisters - Steppin',11,15,3,3.0,3,Steppin',19.0,6,0,8,4,0,stay,1975-07-12
1740,The Pointer Sisters,1975-08-30,The Pointer Sisters - Steppin',3,11,4,3.0,3,Steppin',19.0,7,-1,0,8,1,down,1975-07-12
1741,The Pointer Sisters,1975-09-06,The Pointer Sisters - Steppin',3,3,9,3.0,4,Steppin',19.0,8,-5,-1,0,1,down,1975-07-12
1742,The Pointer Sisters,1975-09-13,The Pointer Sisters - Steppin',4,3,13,3.0,9,Steppin',19.0,9,-4,-5,-1,1,down,1975-07-12
1743,The Pointer Sisters,1975-09-20,The Pointer Sisters - Steppin',9,4,20,3.0,13,Steppin',19.0,10,-7,-4,-5,1,down,1975-07-12
1744,The Pointer Sisters,1975-09-27,The Pointer Sisters - Steppin',13,9,24,3.0,20,Steppin',19.0,11,-4,-7,-4,1,down,1975-07-12
1745,The Pointer Sisters,1975-10-04,The Pointer Sisters - Steppin',20,13,24,3.0,24,Steppin',19.0,12,0,-4,-7,0,stay,1975-07-12
1746,The Pointer Sisters,1975-10-11,The Pointer Sisters - Steppin',24,20,27,3.0,24,Steppin',19.0,13,-3,0,-4,1,down,1975-07-12
1747,The Pointer Sisters,1975-10-18,The Pointer Sisters - Steppin',24,24,30,3.0,27,Steppin',19.0,14,-3,-3,0,1,down,1975-07-12
1748,The Pointer Sisters,1975-10-25,The Pointer Sisters - Steppin',27,24,28,3.0,30,Steppin',19.0,15,2,-3,-3,1,up,1975-07-12
1749,The Pointer Sisters,1975-11-01,The Pointer Sisters - Steppin',30,27,27,3.0,28,Steppin',19.0,16,1,2,-3,1,up,1975-07-12
1750,The Pointer Sisters,1975-11-08,The Pointer Sisters - Steppin',28,30,28,3.0,27,Steppin',19.0,17,-1,1,2,1,down,1975-07-12
1751,The Pointer Sisters,1975-11-15,The Pointer Sisters - Steppin',27,28,46,3.0,28,Steppin',19.0,18,-18,-1,1,1,down,1975-07-12
1752,The Pointer Sisters,1975-11-22,The Pointer Sisters - Steppin',28,27,51,3.0,46,Steppin',19.0,19,-5,-18,-1,1,down,1975-07-12
1753,Eddie Kendricks,1975-07-19,Eddie Kendricks - The Hit Man,51,51,22,9.0,35,The Hit Man,10.0,0,13,16,0,1,up,1975-07-19
1754,Eddie Kendricks,1975-07-26,Eddie Kendricks - The Hit Man,35,51,15,9.0,22,The Hit Man,10.0,1,7,13,16,1,up,1975-07-19
1755,Eddie Kendricks,1975-08-02,Eddie Kendricks - The Hit Man,22,35,11,9.0,15,The Hit Man,10.0,2,4,7,13,1,up,1975-07-19
1756,Eddie Kendricks,1975-08-09,Eddie Kendricks - The Hit Man,15,22,9,9.0,11,The Hit Man,10.0,3,2,4,7,1,up,1975-07-19
1757,Eddie Kendricks,1975-08-16,Eddie Kendricks - The Hit Man,11,15,9,9.0,9,The Hit Man,10.0,4,0,2,4,0,stay,1975-07-19
1758,Eddie Kendricks,1975-08-23,Eddie Kendricks - The Hit Man,9,11,18,9.0,9,The Hit Man,10.0,5,-9,0,2,1,down,1975-07-19
1759,Eddie Kendricks,1975-08-30,Eddie Kendricks - The Hit Man,9,9,19,9.0,18,The Hit Man,10.0,6,-1,-9,0,1,down,1975-07-19
1760,Eddie Kendricks,1975-09-06,Eddie Kendricks - The Hit Man,18,9,22,9.0,19,The Hit Man,10.0,7,-3,-1,-9,1,down,1975-07-19
1761,Eddie Kendricks,1975-09-13,Eddie Kendricks - The Hit Man,19,18,33,9.0,22,The Hit Man,10.0,8,-11,-3,-1,1,down,1975-07-19
1762,Eddie Kendricks,1975-09-20,Eddie Kendricks - The Hit Man,22,19,43,9.0,33,The Hit Man,10.0,9,-10,-11,-3,1,down,1975-07-19
1763,Eddie Kendricks,1975-09-27,Eddie Kendricks - The Hit Man,33,22,51,9.0,43,The Hit Man,10.0,10,-8,-10,-11,1,down,1975-07-19
1764,George McCrae,1975-07-19,George McCrae - George Mc Crae,51,51,35,24.0,40,George Mc Crae,5.0,0,5,11,0,1,up,1975-07-19
1765,George McCrae,1975-07-26,George McCrae - George Mc Crae,40,51,28,24.0,35,George Mc Crae,5.0,1,7,5,11,1,up,1975-07-19
1766,George McCrae,1975-08-02,George McCrae - George Mc Crae,35,40,26,24.0,28,George Mc Crae,5.0,2,2,7,5,1,up,1975-07-19
1767,George McCrae,1975-08-09,George McCrae - George Mc Crae,28,35,24,24.0,26,George Mc Crae,5.0,3,2,2,7,1,up,1975-07-19
1768,George McCrae,1975-08-16,George McCrae - George Mc Crae,26,28,32,24.0,24,George Mc Crae,5.0,4,-8,2,2,1,down,1975-07-19
1769,George McCrae,1975-08-23,George McCrae - George Mc Crae,24,26,51,24.0,32,George Mc Crae,5.0,5,-19,-8,2,1,down,1975-07-19
1770,Nancy Wilson,1975-07-19,Nancy Wilson - Come Get To This,51,51,36,14.0,45,Come Get To This,11.0,0,9,6,0,1,up,1975-07-19
1771,Nancy Wilson,1975-07-26,Nancy Wilson - Come Get To This,45,51,30,14.0,36,Come Get To This,11.0,1,6,9,6,1,up,1975-07-19
1772,Nancy Wilson,1975-08-02,Nancy Wilson - Come Get To This,36,45,25,14.0,30,Come Get To This,11.0,2,5,6,9,1,up,1975-07-19
1773,Nancy Wilson,1975-08-09,Nancy Wilson - Come Get To This,30,36,20,14.0,25,Come Get To This,11.0,3,5,5,6,1,up,1975-07-19
1774,Nancy Wilson,1975-08-16,Nancy Wilson - Come Get To This,25,30,17,14.0,20,Come Get To This,11.0,4,3,5,5,1,up,1975-07-19
1775,Nancy Wilson,1975-08-23,Nancy Wilson - Come Get To This,20,25,16,14.0,17,Come Get To This,11.0,5,1,3,5,1,up,1975-07-19
1776,Nancy Wilson,1975-08-30,Nancy Wilson - Come Get To This,17,20,14,14.0,16,Come Get To This,11.0,6,2,1,3,1,up,1975-07-19
1777,Nancy Wilson,1975-09-06,Nancy Wilson - Come Get To This,16,17,15,14.0,14,Come Get To This,11.0,7,-1,2,1,1,down,1975-07-19
1778,Nancy Wilson,1975-09-13,Nancy Wilson - Come Get To This,14,16,26,14.0,15,Come Get To This,11.0,8,-11,-1,2,1,down,1975-07-19
1779,Nancy Wilson,1975-09-20,Nancy Wilson - Come Get To This,15,14,39,14.0,26,Come Get To This,11.0,9,-13,-11,-1,1,down,1975-07-19
1780,Nancy Wilson,1975-09-27,Nancy Wilson - Come Get To This,26,15,44,14.0,39,Come Get To This,11.0,10,-5,-13,-11,1,down,1975-07-19
1781,Nancy Wilson,1975-10-04,Nancy Wilson - Come Get To This,39,26,51,14.0,44,Come Get To This,11.0,11,-7,-5,-13,1,down,1975-07-19
1782,Willie Hutch,1975-07-19,Willie Hutch - Ode To My Lady,51,51,45,24.0,50,Ode To My Lady,17.0,0,5,1,0,1,up,1975-07-19
1783,Willie Hutch,1975-07-26,Willie Hutch - Ode To My Lady,50,51,39,24.0,45,Ode To My Lady,17.0,1,6,5,1,1,up,1975-07-19
1784,Willie Hutch,1975-08-02,Willie Hutch - Ode To My Lady,45,50,34,24.0,39,Ode To My Lady,17.0,2,5,6,5,1,up,1975-07-19
1785,Willie Hutch,1975-08-09,Willie Hutch - Ode To My Lady,39,45,33,24.0,34,Ode To My Lady,17.0,3,1,5,6,1,up,1975-07-19
1786,Willie Hutch,1975-08-16,Willie Hutch - Ode To My Lady,34,39,31,24.0,33,Ode To My Lady,17.0,4,2,1,5,1,up,1975-07-19
1787,Willie Hutch,1975-08-23,Willie Hutch - Ode To My Lady,33,34,28,24.0,31,Ode To My Lady,17.0,5,3,2,1,1,up,1975-07-19
1788,Willie Hutch,1975-08-30,Willie Hutch - Ode To My Lady,31,33,24,24.0,28,Ode To My Lady,17.0,6,4,3,2,1,up,1975-07-19
1789,Willie Hutch,1975-09-06,Willie Hutch - Ode To My Lady,28,31,31,24.0,24,Ode To My Lady,17.0,7,-7,4,3,1,down,1975-07-19
1790,Willie Hutch,1975-09-13,Willie Hutch - Ode To My Lady,24,28,36,24.0,31,Ode To My Lady,17.0,8,-5,-7,4,1,down,1975-07-19
1791,Willie Hutch,1975-09-20,Willie Hutch - Ode To My Lady,31,24,48,24.0,36,Ode To My Lady,17.0,9,-12,-5,-7,1,down,1975-07-19
1792,Willie Hutch,1975-10-04,Willie Hutch - Ode To My Lady,36,31,49,24.0,48,Ode To My Lady,17.0,10,-1,-12,-5,1,down,1975-07-19
1793,Willie Hutch,1975-10-11,Willie Hutch - Ode To My Lady,48,36,50,24.0,49,Ode To My Lady,17.0,11,-1,-1,-12,1,down,1975-07-19
1794,Willie Hutch,1975-10-25,Willie Hutch - Ode To My Lady,49,48,45,24.0,50,Ode To My Lady,17.0,12,5,-1,-1,1,up,1975-07-19
1795,Willie Hutch,1975-11-01,Willie Hutch - Ode To My Lady,50,49,42,24.0,45,Ode To My Lady,17.0,13,3,5,-1,1,up,1975-07-19
1796,Willie Hutch,1975-11-08,Willie Hutch - Ode To My Lady,45,50,44,24.0,42,Ode To My Lady,17.0,14,-2,3,5,1,down,1975-07-19
1797,Willie Hutch,1975-11-15,Willie Hutch - Ode To My Lady,42,45,43,24.0,44,Ode To My Lady,17.0,15,1,-2,3,1,up,1975-07-19
1798,Willie Hutch,1975-11-22,Willie Hutch - Ode To My Lady,44,42,42,24.0,43,Ode To My Lady,17.0,16,1,1,-2,1,up,1975-07-19
1799,Willie Hutch,1975-11-29,Willie Hutch - Ode To My Lady,43,44,51,24.0,42,Ode To My Lady,17.0,17,-9,1,1,1,down,1975-07-19
1800,Funkadelic,1975-07-26,Funkadelic - Let's Take It To The Stage,51,51,36,14.0,39,Let's Take It To The Stage,8.0,0,3,12,0,1,up,1975-07-26
1801,Funkadelic,1975-08-02,Funkadelic - Let's Take It To The Stage,39,51,30,14.0,36,Let's Take It To The Stage,8.0,1,6,3,12,1,up,1975-07-26
1802,Funkadelic,1975-08-09,Funkadelic - Let's Take It To The Stage,36,39,21,14.0,30,Let's Take It To The Stage,8.0,2,9,6,3,1,up,1975-07-26
1803,Funkadelic,1975-08-16,Funkadelic - Let's Take It To The Stage,30,36,16,14.0,21,Let's Take It To The Stage,8.0,3,5,9,6,1,up,1975-07-26
1804,Funkadelic,1975-08-23,Funkadelic - Let's Take It To The Stage,21,30,14,14.0,16,Let's Take It To The Stage,8.0,4,2,5,9,1,up,1975-07-26
1805,Funkadelic,1975-08-30,Funkadelic - Let's Take It To The Stage,16,21,18,14.0,14,Let's Take It To The Stage,8.0,5,-4,2,5,1,down,1975-07-26
1806,Funkadelic,1975-09-06,Funkadelic - Let's Take It To The Stage,14,16,32,14.0,18,Let's Take It To The Stage,8.0,6,-14,-4,2,1,down,1975-07-26
1807,Funkadelic,1975-09-13,Funkadelic - Let's Take It To The Stage,18,14,37,14.0,32,Let's Take It To The Stage,8.0,7,-5,-14,-4,1,down,1975-07-26
1808,Funkadelic,1975-09-20,Funkadelic - Let's Take It To The Stage,32,18,51,14.0,37,Let's Take It To The Stage,8.0,8,-14,-5,-14,1,down,1975-07-26
1809,Billy Preston,1975-07-26,Billy Preston - It's My Pleasure,51,51,31,18.0,40,It's My Pleasure,8.0,0,9,11,0,1,up,1975-07-26
1810,Billy Preston,1975-08-02,Billy Preston - It's My Pleasure,40,51,22,18.0,31,It's My Pleasure,8.0,1,9,9,11,1,up,1975-07-26
1811,Billy Preston,1975-08-09,Billy Preston - It's My Pleasure,31,40,18,18.0,22,It's My Pleasure,8.0,2,4,9,9,1,up,1975-07-26
1812,Billy Preston,1975-08-16,Billy Preston - It's My Pleasure,22,31,18,18.0,18,It's My Pleasure,8.0,3,0,4,9,0,stay,1975-07-26
1813,Billy Preston,1975-08-23,Billy Preston - It's My Pleasure,18,22,20,18.0,18,It's My Pleasure,8.0,4,-2,0,4,1,down,1975-07-26
1814,Billy Preston,1975-08-30,Billy Preston - It's My Pleasure,18,18,35,18.0,20,It's My Pleasure,8.0,5,-15,-2,0,1,down,1975-07-26
1815,Billy Preston,1975-09-06,Billy Preston - It's My Pleasure,20,18,37,18.0,35,It's My Pleasure,8.0,6,-2,-15,-2,1,down,1975-07-26
1816,Billy Preston,1975-09-13,Billy Preston - It's My Pleasure,35,20,42,18.0,37,It's My Pleasure,8.0,7,-5,-2,-15,1,down,1975-07-26
1817,Billy Preston,1975-09-20,Billy Preston - It's My Pleasure,37,35,51,18.0,42,It's My Pleasure,8.0,8,-9,-5,-2,1,down,1975-07-26
1818,Joe Simon,1975-07-26,Joe Simon - Get Down,51,51,35,10.0,43,Get Down,13.0,0,8,8,0,1,up,1975-07-26
1819,Joe Simon,1975-08-02,Joe Simon - Get Down,43,51,29,10.0,35,Get Down,13.0,1,6,8,8,1,up,1975-07-26
1820,Joe Simon,1975-08-09,Joe Simon - Get Down,35,43,22,10.0,29,Get Down,13.0,2,7,6,8,1,up,1975-07-26
1821,Joe Simon,1975-08-16,Joe Simon - Get Down,29,35,15,10.0,22,Get Down,13.0,3,7,7,6,1,up,1975-07-26
1822,Joe Simon,1975-08-23,Joe Simon - Get Down,22,29,11,10.0,15,Get Down,13.0,4,4,7,7,1,up,1975-07-26
1823,Joe Simon,1975-08-30,Joe Simon - Get Down,15,22,11,10.0,11,Get Down,13.0,5,0,4,7,0,stay,1975-07-26
1824,Joe Simon,1975-09-06,Joe Simon - Get Down,11,15,11,10.0,11,Get Down,13.0,6,0,0,4,0,stay,1975-07-26
1825,Joe Simon,1975-09-13,Joe Simon - Get Down,11,11,10,10.0,11,Get Down,13.0,7,1,0,0,1,up,1975-07-26
1826,Joe Simon,1975-09-20,Joe Simon - Get Down,11,11,14,10.0,10,Get Down,13.0,8,-4,1,0,1,down,1975-07-26
1827,Joe Simon,1975-09-27,Joe Simon - Get Down,10,11,23,10.0,14,Get Down,13.0,9,-9,-4,1,1,down,1975-07-26
1828,Joe Simon,1975-10-04,Joe Simon - Get Down,14,10,23,10.0,23,Get Down,13.0,10,0,-9,-4,0,stay,1975-07-26
1829,Joe Simon,1975-10-11,Joe Simon - Get Down,23,14,29,10.0,23,Get Down,13.0,11,-6,0,-9,1,down,1975-07-26
1830,Joe Simon,1975-10-18,Joe Simon - Get Down,23,23,39,10.0,29,Get Down,13.0,12,-10,-6,0,1,down,1975-07-26
1831,Joe Simon,1975-10-25,Joe Simon - Get Down,29,23,51,10.0,39,Get Down,13.0,13,-12,-10,-6,1,down,1975-07-26
1832,The Hues Corporation,1975-07-26,The Hues Corporation - Love Corporation,51,51,40,40.0,47,Love Corporation,3.0,0,7,4,0,1,up,1975-07-26
1833,The Hues Corporation,1975-08-02,The Hues Corporation - Love Corporation,47,51,40,40.0,40,Love Corporation,3.0,1,0,7,4,0,stay,1975-07-26
1834,The Hues Corporation,1975-08-09,The Hues Corporation - Love Corporation,40,47,48,40.0,40,Love Corporation,3.0,2,-8,0,7,1,down,1975-07-26
1835,The Hues Corporation,1975-08-16,The Hues Corporation - Love Corporation,40,40,51,40.0,48,Love Corporation,3.0,3,-3,-8,0,1,down,1975-07-26
1836,Bob Marley And The Wailers,1975-07-26,Bob Marley And The Wailers - Burnin',51,51,45,41.0,49,Burnin',4.0,0,4,2,0,1,up,1975-07-26
1837,Bob Marley And The Wailers,1975-08-02,Bob Marley And The Wailers - Burnin',49,51,41,41.0,45,Burnin',4.0,1,4,4,2,1,up,1975-07-26
1838,Bob Marley And The Wailers,1975-08-09,Bob Marley And The Wailers - Burnin',45,49,41,41.0,41,Burnin',4.0,2,0,4,4,0,stay,1975-07-26
1839,Bob Marley And The Wailers,1975-08-16,Bob Marley And The Wailers - Burnin',41,45,48,41.0,41,Burnin',4.0,3,-7,0,4,1,down,1975-07-26
1840,Bob Marley And The Wailers,1975-08-23,Bob Marley And The Wailers - Burnin',41,41,51,41.0,48,Burnin',4.0,4,-3,-7,0,1,down,1975-07-26
1841,Natural Four,1975-07-26,Natural Four - Heaven Right Here On Earth,51,51,49,49.0,50,Heaven Right Here On Earth,1.0,0,1,1,0,1,up,1975-07-26
1842,Natural Four,1975-08-02,Natural Four - Heaven Right Here On Earth,50,51,51,49.0,49,Heaven Right Here On Earth,1.0,1,-2,1,1,1,down,1975-07-26
1843,Freddie Hubbard,1975-08-02,Freddie Hubbard - Liquid Love,51,51,28,21.0,42,Liquid Love,6.0,0,14,9,0,1,up,1975-08-02
1844,Freddie Hubbard,1975-08-09,Freddie Hubbard - Liquid Love,42,51,23,21.0,28,Liquid Love,6.0,1,5,14,9,1,up,1975-08-02
1845,Freddie Hubbard,1975-08-16,Freddie Hubbard - Liquid Love,28,42,23,21.0,23,Liquid Love,6.0,2,0,5,14,0,stay,1975-08-02
1846,Freddie Hubbard,1975-08-23,Freddie Hubbard - Liquid Love,23,28,21,21.0,23,Liquid Love,6.0,3,2,0,5,1,up,1975-08-02
1847,Freddie Hubbard,1975-08-30,Freddie Hubbard - Liquid Love,23,23,27,21.0,21,Liquid Love,6.0,4,-6,2,0,1,down,1975-08-02
1848,Freddie Hubbard,1975-09-06,Freddie Hubbard - Liquid Love,21,23,33,21.0,27,Liquid Love,6.0,5,-6,-6,2,1,down,1975-08-02
1849,Freddie Hubbard,1975-09-13,Freddie Hubbard - Liquid Love,27,21,51,21.0,33,Liquid Love,6.0,6,-18,-6,-6,1,down,1975-08-02
1850,The Chi-lites,1975-08-02,The Chi-lites - Half A Love,51,51,43,41.0,46,Half A Love,4.0,0,3,5,0,1,up,1975-08-02
1851,The Chi-lites,1975-08-09,The Chi-lites - Half A Love,46,51,42,41.0,43,Half A Love,4.0,1,1,3,5,1,up,1975-08-02
1852,The Chi-lites,1975-08-16,The Chi-lites - Half A Love,43,46,42,41.0,42,Half A Love,4.0,2,0,1,3,0,stay,1975-08-02
1853,The Chi-lites,1975-08-23,The Chi-lites - Half A Love,42,43,41,41.0,42,Half A Love,4.0,3,1,0,1,1,up,1975-08-02
1854,The Chi-lites,1975-08-30,The Chi-lites - Half A Love,42,42,51,41.0,41,Half A Love,4.0,4,-10,1,0,1,down,1975-08-02
1855,Shirley (& Company),1975-08-02,Shirley (& Company) - Shame Shame Shame,51,51,51,47.0,47,Shame Shame Shame,0.0,0,-4,4,0,1,down,1975-08-02
1856,The Rance Allen Group,1975-08-02,The Rance Allen Group - A Soulful Experience,51,51,39,35.0,48,A Soulful Experience,4.0,0,9,3,0,1,up,1975-08-02
1857,The Rance Allen Group,1975-08-09,The Rance Allen Group - A Soulful Experience,48,51,39,35.0,39,A Soulful Experience,4.0,1,0,9,3,0,stay,1975-08-02
1858,The Rance Allen Group,1975-08-16,The Rance Allen Group - A Soulful Experience,39,48,36,35.0,39,A Soulful Experience,4.0,2,3,0,9,1,up,1975-08-02
1859,The Rance Allen Group,1975-08-23,The Rance Allen Group - A Soulful Experience,39,39,35,35.0,36,A Soulful Experience,4.0,3,1,3,0,1,up,1975-08-02
1860,The Rance Allen Group,1975-08-30,The Rance Allen Group - A Soulful Experience,36,39,51,35.0,35,A Soulful Experience,4.0,4,-16,1,3,1,down,1975-08-02
1861,Graham Central Station,1975-08-09,Graham Central Station - Ain't No 'bout-a-doubt It,51,51,27,4.0,44,Ain't No 'bout-a-doubt It,19.0,0,17,7,0,1,up,1975-08-09
1862,Graham Central Station,1975-08-16,Graham Central Station - Ain't No 'bout-a-doubt It,44,51,11,4.0,27,Ain't No 'bout-a-doubt It,19.0,1,16,17,7,1,up,1975-08-09
1863,Graham Central Station,1975-08-23,Graham Central Station - Ain't No 'bout-a-doubt It,27,44,9,4.0,11,Ain't No 'bout-a-doubt It,19.0,2,2,16,17,1,up,1975-08-09
1864,Graham Central Station,1975-08-30,Graham Central Station - Ain't No 'bout-a-doubt It,11,27,7,4.0,9,Ain't No 'bout-a-doubt It,19.0,3,2,2,16,1,up,1975-08-09
1865,Graham Central Station,1975-09-06,Graham Central Station - Ain't No 'bout-a-doubt It,9,11,6,4.0,7,Ain't No 'bout-a-doubt It,19.0,4,1,2,2,1,up,1975-08-09
1866,Graham Central Station,1975-09-13,Graham Central Station - Ain't No 'bout-a-doubt It,7,9,6,4.0,6,Ain't No 'bout-a-doubt It,19.0,5,0,1,2,0,stay,1975-08-09
1867,Graham Central Station,1975-09-20,Graham Central Station - Ain't No 'bout-a-doubt It,6,7,5,4.0,6,Ain't No 'bout-a-doubt It,19.0,6,1,0,1,1,up,1975-08-09
1868,Graham Central Station,1975-09-27,Graham Central Station - Ain't No 'bout-a-doubt It,6,6,4,4.0,5,Ain't No 'bout-a-doubt It,19.0,7,1,1,0,1,up,1975-08-09
1869,Graham Central Station,1975-10-04,Graham Central Station - Ain't No 'bout-a-doubt It,5,6,4,4.0,4,Ain't No 'bout-a-doubt It,19.0,8,0,1,1,0,stay,1975-08-09
1870,Graham Central Station,1975-10-11,Graham Central Station - Ain't No 'bout-a-doubt It,4,5,7,4.0,4,Ain't No 'bout-a-doubt It,19.0,9,-3,0,1,1,down,1975-08-09
1871,Graham Central Station,1975-10-18,Graham Central Station - Ain't No 'bout-a-doubt It,4,4,9,4.0,7,Ain't No 'bout-a-doubt It,19.0,10,-2,-3,0,1,down,1975-08-09
1872,Graham Central Station,1975-10-25,Graham Central Station - Ain't No 'bout-a-doubt It,7,4,13,4.0,9,Ain't No 'bout-a-doubt It,19.0,11,-4,-2,-3,1,down,1975-08-09
1873,Graham Central Station,1975-11-01,Graham Central Station - Ain't No 'bout-a-doubt It,9,7,14,4.0,13,Ain't No 'bout-a-doubt It,19.0,12,-1,-4,-2,1,down,1975-08-09
1874,Graham Central Station,1975-11-08,Graham Central Station - Ain't No 'bout-a-doubt It,13,9,16,4.0,14,Ain't No 'bout-a-doubt It,19.0,13,-2,-1,-4,1,down,1975-08-09
1875,Graham Central Station,1975-11-15,Graham Central Station - Ain't No 'bout-a-doubt It,14,13,16,4.0,16,Ain't No 'bout-a-doubt It,19.0,14,0,-2,-1,0,stay,1975-08-09
1876,Graham Central Station,1975-11-22,Graham Central Station - Ain't No 'bout-a-doubt It,16,14,14,4.0,16,Ain't No 'bout-a-doubt It,19.0,15,2,0,-2,1,up,1975-08-09
1877,Graham Central Station,1975-11-29,Graham Central Station - Ain't No 'bout-a-doubt It,16,16,24,4.0,14,Ain't No 'bout-a-doubt It,19.0,16,-10,2,0,1,down,1975-08-09
1878,Graham Central Station,1975-12-06,Graham Central Station - Ain't No 'bout-a-doubt It,14,16,43,4.0,24,Ain't No 'bout-a-doubt It,19.0,17,-19,-10,2,1,down,1975-08-09
1879,Graham Central Station,1975-12-13,Graham Central Station - Ain't No 'bout-a-doubt It,24,14,41,4.0,43,Ain't No 'bout-a-doubt It,19.0,18,2,-19,-10,1,up,1975-08-09
1880,Graham Central Station,1975-12-20,Graham Central Station - Ain't No 'bout-a-doubt It,43,24,51,4.0,41,Ain't No 'bout-a-doubt It,19.0,19,-10,2,-19,1,down,1975-08-09
1881,The New Birth,1975-08-09,The New Birth - The Best Of The New Birth,51,51,45,45.0,46,The Best Of The New Birth,2.0,0,1,5,0,1,up,1975-08-09
1882,The New Birth,1975-08-16,The New Birth - The Best Of The New Birth,46,51,49,45.0,45,The Best Of The New Birth,2.0,1,-4,1,5,1,down,1975-08-09
1883,The New Birth,1975-08-23,The New Birth - The Best Of The New Birth,45,46,51,45.0,49,The Best Of The New Birth,2.0,2,-2,-4,1,1,down,1975-08-09
1884,The Spinners,1975-08-09,The Spinners - Pick Of The Litter,51,51,32,2.0,47,Pick Of The Litter,24.0,0,15,4,0,1,up,1975-08-09
1885,The Spinners,1975-08-16,The Spinners - Pick Of The Litter,47,51,12,2.0,32,Pick Of The Litter,24.0,1,20,15,4,1,up,1975-08-09
1886,The Spinners,1975-08-23,The Spinners - Pick Of The Litter,32,47,8,2.0,12,Pick Of The Litter,24.0,2,4,20,15,1,up,1975-08-09
1887,The Spinners,1975-08-30,The Spinners - Pick Of The Litter,12,32,5,2.0,8,Pick Of The Litter,24.0,3,3,4,20,1,up,1975-08-09
1888,The Spinners,1975-09-06,The Spinners - Pick Of The Litter,8,12,3,2.0,5,Pick Of The Litter,24.0,4,2,3,4,1,up,1975-08-09
1889,The Spinners,1975-09-13,The Spinners - Pick Of The Litter,5,8,3,2.0,3,Pick Of The Litter,24.0,5,0,2,3,0,stay,1975-08-09
1890,The Spinners,1975-09-20,The Spinners - Pick Of The Litter,3,5,2,2.0,3,Pick Of The Litter,24.0,6,1,0,2,1,up,1975-08-09
1891,The Spinners,1975-09-27,The Spinners - Pick Of The Litter,3,3,2,2.0,2,Pick Of The Litter,24.0,7,0,1,0,0,stay,1975-08-09
1892,The Spinners,1975-10-04,The Spinners - Pick Of The Litter,2,3,6,2.0,2,Pick Of The Litter,24.0,8,-4,0,1,1,down,1975-08-09
1893,The Spinners,1975-10-11,The Spinners - Pick Of The Litter,2,2,11,2.0,6,Pick Of The Litter,24.0,9,-5,-4,0,1,down,1975-08-09
1894,The Spinners,1975-10-18,The Spinners - Pick Of The Litter,6,2,19,2.0,11,Pick Of The Litter,24.0,10,-8,-5,-4,1,down,1975-08-09
1895,The Spinners,1975-10-25,The Spinners - Pick Of The Litter,11,6,17,2.0,19,Pick Of The Litter,24.0,11,2,-8,-5,1,up,1975-08-09
1896,The Spinners,1975-11-01,The Spinners - Pick Of The Litter,19,11,13,2.0,17,Pick Of The Litter,24.0,12,4,2,-8,1,up,1975-08-09
1897,The Spinners,1975-11-08,The Spinners - Pick Of The Litter,17,19,10,2.0,13,Pick Of The Litter,24.0,13,3,4,2,1,up,1975-08-09
1898,The Spinners,1975-11-15,The Spinners - Pick Of The Litter,13,17,10,2.0,10,Pick Of The Litter,24.0,14,0,3,4,0,stay,1975-08-09
1899,The Spinners,1975-11-22,The Spinners - Pick Of The Litter,10,13,9,2.0,10,Pick Of The Litter,24.0,15,1,0,3,1,up,1975-08-09
1900,The Spinners,1975-11-29,The Spinners - Pick Of The Litter,10,10,7,2.0,9,Pick Of The Litter,24.0,16,2,1,0,1,up,1975-08-09
1901,The Spinners,1975-12-06,The Spinners - Pick Of The Litter,9,10,6,2.0,7,Pick Of The Litter,24.0,17,1,2,1,1,up,1975-08-09
1902,The Spinners,1975-12-13,The Spinners - Pick Of The Litter,7,9,19,2.0,6,Pick Of The Litter,24.0,18,-13,1,2,1,down,1975-08-09
1903,The Spinners,1975-12-20,The Spinners - Pick Of The Litter,6,7,33,2.0,19,Pick Of The Litter,24.0,19,-14,-13,1,1,down,1975-08-09
1904,The Spinners,1975-12-27,The Spinners - Pick Of The Litter,19,6,49,2.0,33,Pick Of The Litter,24.0,20,-16,-14,-13,1,down,1975-08-09
1905,The Spinners,1976-01-03,The Spinners - Pick Of The Litter,33,19,47,2.0,49,Pick Of The Litter,24.0,21,2,-16,-14,1,up,1975-08-09
1906,The Spinners,1976-01-10,The Spinners - Pick Of The Litter,49,33,45,2.0,47,Pick Of The Litter,24.0,22,2,2,-16,1,up,1975-08-09
1907,The Spinners,1976-01-17,The Spinners - Pick Of The Litter,47,49,48,2.0,45,Pick Of The Litter,24.0,23,-3,2,2,1,down,1975-08-09
1908,The Spinners,1976-01-24,The Spinners - Pick Of The Litter,45,47,51,2.0,48,Pick Of The Litter,24.0,24,-3,-3,2,1,down,1975-08-09
1909,Hugh Masekela,1975-08-09,Hugh Masekela - The Boys Doin' It,51,51,40,18.0,49,The Boys Doin' It,9.0,0,9,2,0,1,up,1975-08-09
1910,Hugh Masekela,1975-08-16,Hugh Masekela - The Boys Doin' It,49,51,35,18.0,40,The Boys Doin' It,9.0,1,5,9,2,1,up,1975-08-09
1911,Hugh Masekela,1975-08-23,Hugh Masekela - The Boys Doin' It,40,49,27,18.0,35,The Boys Doin' It,9.0,2,8,5,9,1,up,1975-08-09
1912,Hugh Masekela,1975-08-30,Hugh Masekela - The Boys Doin' It,35,40,25,18.0,27,The Boys Doin' It,9.0,3,2,8,5,1,up,1975-08-09
1913,Hugh Masekela,1975-09-06,Hugh Masekela - The Boys Doin' It,27,35,21,18.0,25,The Boys Doin' It,9.0,4,4,2,8,1,up,1975-08-09
1914,Hugh Masekela,1975-09-13,Hugh Masekela - The Boys Doin' It,25,27,19,18.0,21,The Boys Doin' It,9.0,5,2,4,2,1,up,1975-08-09
1915,Hugh Masekela,1975-09-20,Hugh Masekela - The Boys Doin' It,21,25,18,18.0,19,The Boys Doin' It,9.0,6,1,2,4,1,up,1975-08-09
1916,Hugh Masekela,1975-09-27,Hugh Masekela - The Boys Doin' It,19,21,25,18.0,18,The Boys Doin' It,9.0,7,-7,1,2,1,down,1975-08-09
1917,Hugh Masekela,1975-10-04,Hugh Masekela - The Boys Doin' It,18,19,37,18.0,25,The Boys Doin' It,9.0,8,-12,-7,1,1,down,1975-08-09
1918,Hugh Masekela,1975-10-11,Hugh Masekela - The Boys Doin' It,25,18,51,18.0,37,The Boys Doin' It,9.0,9,-14,-12,-7,1,down,1975-08-09
1919,Tavares,1975-08-09,Tavares - In The City,51,51,36,8.0,50,In The City,11.0,0,14,1,0,1,up,1975-08-09
1920,Tavares,1975-08-16,Tavares - In The City,50,51,25,8.0,36,In The City,11.0,1,11,14,1,1,up,1975-08-09
1921,Tavares,1975-08-23,Tavares - In The City,36,50,17,8.0,25,In The City,11.0,2,8,11,14,1,up,1975-08-09
1922,Tavares,1975-08-30,Tavares - In The City,25,36,13,8.0,17,In The City,11.0,3,4,8,11,1,up,1975-08-09
1923,Tavares,1975-09-06,Tavares - In The City,17,25,10,8.0,13,In The City,11.0,4,3,4,8,1,up,1975-08-09
1924,Tavares,1975-09-13,Tavares - In The City,13,17,9,8.0,10,In The City,11.0,5,1,3,4,1,up,1975-08-09
1925,Tavares,1975-09-20,Tavares - In The City,10,13,8,8.0,9,In The City,11.0,6,1,1,3,1,up,1975-08-09
1926,Tavares,1975-09-27,Tavares - In The City,9,10,8,8.0,8,In The City,11.0,7,0,1,1,0,stay,1975-08-09
1927,Tavares,1975-10-04,Tavares - In The City,8,9,13,8.0,8,In The City,11.0,8,-5,0,1,1,down,1975-08-09
1928,Tavares,1975-10-11,Tavares - In The City,8,8,26,8.0,13,In The City,11.0,9,-13,-5,0,1,down,1975-08-09
1929,Tavares,1975-10-18,Tavares - In The City,13,8,34,8.0,26,In The City,11.0,10,-8,-13,-5,1,down,1975-08-09
1930,Tavares,1975-10-25,Tavares - In The City,26,13,51,8.0,34,In The City,11.0,11,-17,-8,-13,1,down,1975-08-09
1931,B.T. Express,1975-08-16,B.T. Express - Non-stop,51,51,13,1.0,30,Non-stop,14.0,0,17,21,0,1,up,1975-08-16
1932,B.T. Express,1975-08-23,B.T. Express - Non-stop,30,51,5,1.0,13,Non-stop,14.0,1,8,17,21,1,up,1975-08-16
1933,B.T. Express,1975-08-30,B.T. Express - Non-stop,13,30,1,1.0,5,Non-stop,14.0,2,4,8,17,1,up,1975-08-16
1934,B.T. Express,1975-09-06,B.T. Express - Non-stop,5,13,1,1.0,1,Non-stop,14.0,3,0,4,8,0,stay,1975-08-16
1935,B.T. Express,1975-09-13,B.T. Express - Non-stop,1,5,4,1.0,1,Non-stop,14.0,4,-3,0,4,1,down,1975-08-16
1936,B.T. Express,1975-09-20,B.T. Express - Non-stop,1,1,7,1.0,4,Non-stop,14.0,5,-3,-3,0,1,down,1975-08-16
1937,B.T. Express,1975-09-27,B.T. Express - Non-stop,4,1,10,1.0,7,Non-stop,14.0,6,-3,-3,-3,1,down,1975-08-16
1938,B.T. Express,1975-10-04,B.T. Express - Non-stop,7,4,17,1.0,10,Non-stop,14.0,7,-7,-3,-3,1,down,1975-08-16
1939,B.T. Express,1975-10-11,B.T. Express - Non-stop,10,7,21,1.0,17,Non-stop,14.0,8,-4,-7,-3,1,down,1975-08-16
1940,B.T. Express,1975-10-18,B.T. Express - Non-stop,17,10,24,1.0,21,Non-stop,14.0,9,-3,-4,-7,1,down,1975-08-16
1941,B.T. Express,1975-10-25,B.T. Express - Non-stop,21,17,20,1.0,24,Non-stop,14.0,10,4,-3,-4,1,up,1975-08-16
1942,B.T. Express,1975-11-01,B.T. Express - Non-stop,24,21,20,1.0,20,Non-stop,14.0,11,0,4,-3,0,stay,1975-08-16
1943,B.T. Express,1975-11-08,B.T. Express - Non-stop,20,24,21,1.0,20,Non-stop,14.0,12,-1,0,4,1,down,1975-08-16
1944,B.T. Express,1975-11-15,B.T. Express - Non-stop,20,20,47,1.0,21,Non-stop,14.0,13,-26,-1,0,1,down,1975-08-16
1945,B.T. Express,1975-11-22,B.T. Express - Non-stop,21,20,51,1.0,47,Non-stop,14.0,14,-4,-26,-1,1,down,1975-08-16
1946,Millie Jackson,1975-08-16,Millie Jackson - Still Caught Up,51,51,37,27.0,43,Still Caught Up,12.0,0,6,8,0,1,up,1975-08-16
1947,Millie Jackson,1975-08-23,Millie Jackson - Still Caught Up,43,51,42,27.0,37,Still Caught Up,12.0,1,-5,6,8,1,down,1975-08-16
1948,Millie Jackson,1975-08-30,Millie Jackson - Still Caught Up,37,43,40,27.0,42,Still Caught Up,12.0,2,2,-5,6,1,up,1975-08-16
1949,Millie Jackson,1975-09-06,Millie Jackson - Still Caught Up,42,37,40,27.0,40,Still Caught Up,12.0,3,0,2,-5,0,stay,1975-08-16
1950,Millie Jackson,1975-09-13,Millie Jackson - Still Caught Up,40,42,39,27.0,40,Still Caught Up,12.0,4,1,0,2,1,up,1975-08-16
1951,Millie Jackson,1975-09-20,Millie Jackson - Still Caught Up,40,40,32,27.0,39,Still Caught Up,12.0,5,7,1,0,1,up,1975-08-16
1952,Millie Jackson,1975-09-27,Millie Jackson - Still Caught Up,39,40,29,27.0,32,Still Caught Up,12.0,6,3,7,1,1,up,1975-08-16
1953,Millie Jackson,1975-10-04,Millie Jackson - Still Caught Up,32,39,34,27.0,29,Still Caught Up,12.0,7,-5,3,7,1,down,1975-08-16
1954,Millie Jackson,1975-10-11,Millie Jackson - Still Caught Up,29,32,30,27.0,34,Still Caught Up,12.0,8,4,-5,3,1,up,1975-08-16
1955,Millie Jackson,1975-10-18,Millie Jackson - Still Caught Up,34,29,27,27.0,30,Still Caught Up,12.0,9,3,4,-5,1,up,1975-08-16
1956,Millie Jackson,1975-10-25,Millie Jackson - Still Caught Up,30,34,27,27.0,27,Still Caught Up,12.0,10,0,3,4,0,stay,1975-08-16
1957,Millie Jackson,1975-11-01,Millie Jackson - Still Caught Up,27,30,43,27.0,27,Still Caught Up,12.0,11,-16,0,3,1,down,1975-08-16
1958,Millie Jackson,1975-11-08,Millie Jackson - Still Caught Up,27,27,51,27.0,43,Still Caught Up,12.0,12,-8,-16,0,1,down,1975-08-16
1959,KC And The Sunshine Band,1975-08-16,KC And The Sunshine Band - K C And The Sunshine Band,51,51,22,1.0,44,K C And The Sunshine Band,30.0,0,22,7,0,1,up,1975-08-16
1960,KC And The Sunshine Band,1975-08-23,KC And The Sunshine Band - K C And The Sunshine Band,44,51,15,1.0,22,K C And The Sunshine Band,30.0,1,7,22,7,1,up,1975-08-16
1961,KC And The Sunshine Band,1975-08-30,KC And The Sunshine Band - K C And The Sunshine Band,22,44,8,1.0,15,K C And The Sunshine Band,30.0,2,7,7,22,1,up,1975-08-16
1962,KC And The Sunshine Band,1975-09-06,KC And The Sunshine Band - K C And The Sunshine Band,15,22,7,1.0,8,K C And The Sunshine Band,30.0,3,1,7,7,1,up,1975-08-16
1963,KC And The Sunshine Band,1975-09-13,KC And The Sunshine Band - K C And The Sunshine Band,8,15,7,1.0,7,K C And The Sunshine Band,30.0,4,0,1,7,0,stay,1975-08-16
1964,KC And The Sunshine Band,1975-09-20,KC And The Sunshine Band - K C And The Sunshine Band,7,8,6,1.0,7,K C And The Sunshine Band,30.0,5,1,0,1,1,up,1975-08-16
1965,KC And The Sunshine Band,1975-09-27,KC And The Sunshine Band - K C And The Sunshine Band,7,7,5,1.0,6,K C And The Sunshine Band,30.0,6,1,1,0,1,up,1975-08-16
1966,KC And The Sunshine Band,1975-10-04,KC And The Sunshine Band - K C And The Sunshine Band,6,7,3,1.0,5,K C And The Sunshine Band,30.0,7,2,1,1,1,up,1975-08-16
1967,KC And The Sunshine Band,1975-10-11,KC And The Sunshine Band - K C And The Sunshine Band,5,6,3,1.0,3,K C And The Sunshine Band,30.0,8,0,2,1,0,stay,1975-08-16
1968,KC And The Sunshine Band,1975-10-18,KC And The Sunshine Band - K C And The Sunshine Band,3,5,5,1.0,3,K C And The Sunshine Band,30.0,9,-2,0,2,1,down,1975-08-16
1969,KC And The Sunshine Band,1975-10-25,KC And The Sunshine Band - K C And The Sunshine Band,3,3,3,1.0,5,K C And The Sunshine Band,30.0,10,2,-2,0,1,up,1975-08-16
1970,KC And The Sunshine Band,1975-11-01,KC And The Sunshine Band - K C And The Sunshine Band,5,3,2,1.0,3,K C And The Sunshine Band,30.0,11,1,2,-2,1,up,1975-08-16
1971,KC And The Sunshine Band,1975-11-08,KC And The Sunshine Band - K C And The Sunshine Band,3,5,1,1.0,2,K C And The Sunshine Band,30.0,12,1,1,2,1,up,1975-08-16
1972,KC And The Sunshine Band,1975-11-15,KC And The Sunshine Band - K C And The Sunshine Band,2,3,7,1.0,1,K C And The Sunshine Band,30.0,13,-6,1,1,1,down,1975-08-16
1973,KC And The Sunshine Band,1975-11-22,KC And The Sunshine Band - K C And The Sunshine Band,1,2,8,1.0,7,K C And The Sunshine Band,30.0,14,-1,-6,1,1,down,1975-08-16
1974,KC And The Sunshine Band,1975-11-29,KC And The Sunshine Band - K C And The Sunshine Band,7,1,8,1.0,8,K C And The Sunshine Band,30.0,15,0,-1,-6,0,stay,1975-08-16
1975,KC And The Sunshine Band,1975-12-06,KC And The Sunshine Band - K C And The Sunshine Band,8,7,18,1.0,8,K C And The Sunshine Band,30.0,16,-10,0,-1,1,down,1975-08-16
1976,KC And The Sunshine Band,1975-12-13,KC And The Sunshine Band - K C And The Sunshine Band,8,8,23,1.0,18,K C And The Sunshine Band,30.0,17,-5,-10,0,1,down,1975-08-16
1977,KC And The Sunshine Band,1975-12-20,KC And The Sunshine Band - K C And The Sunshine Band,18,8,23,1.0,23,K C And The Sunshine Band,30.0,18,0,-5,-10,0,stay,1975-08-16
1978,KC And The Sunshine Band,1975-12-27,KC And The Sunshine Band - K C And The Sunshine Band,23,18,18,1.0,23,K C And The Sunshine Band,30.0,19,5,0,-5,1,up,1975-08-16
1979,KC And The Sunshine Band,1976-01-03,KC And The Sunshine Band - K C And The Sunshine Band,23,23,13,1.0,18,K C And The Sunshine Band,30.0,20,5,5,0,1,up,1975-08-16
1980,KC And The Sunshine Band,1976-01-10,KC And The Sunshine Band - K C And The Sunshine Band,18,23,11,1.0,13,K C And The Sunshine Band,30.0,21,2,5,5,1,up,1975-08-16
1981,KC And The Sunshine Band,1976-01-17,KC And The Sunshine Band - K C And The Sunshine Band,13,18,10,1.0,11,K C And The Sunshine Band,30.0,22,1,2,5,1,up,1975-08-16
1982,KC And The Sunshine Band,1976-01-24,KC And The Sunshine Band - K C And The Sunshine Band,11,13,13,1.0,10,K C And The Sunshine Band,30.0,23,-3,1,2,1,down,1975-08-16
1983,KC And The Sunshine Band,1976-01-31,KC And The Sunshine Band - K C And The Sunshine Band,10,11,13,1.0,13,K C And The Sunshine Band,30.0,24,0,-3,1,0,stay,1975-08-16
1984,KC And The Sunshine Band,1976-02-07,KC And The Sunshine Band - K C And The Sunshine Band,13,10,12,1.0,13,K C And The Sunshine Band,30.0,25,1,0,-3,1,up,1975-08-16
1985,KC And The Sunshine Band,1976-02-14,KC And The Sunshine Band - K C And The Sunshine Band,13,13,23,1.0,12,K C And The Sunshine Band,30.0,26,-11,1,0,1,down,1975-08-16
1986,KC And The Sunshine Band,1976-02-21,KC And The Sunshine Band - K C And The Sunshine Band,12,13,40,1.0,23,K C And The Sunshine Band,30.0,27,-17,-11,1,1,down,1975-08-16
1987,KC And The Sunshine Band,1976-02-28,KC And The Sunshine Band - K C And The Sunshine Band,23,12,38,1.0,40,K C And The Sunshine Band,30.0,28,2,-17,-11,1,up,1975-08-16
1988,KC And The Sunshine Band,1976-03-06,KC And The Sunshine Band - K C And The Sunshine Band,40,23,38,1.0,38,K C And The Sunshine Band,30.0,29,0,2,-17,0,stay,1975-08-16
1989,KC And The Sunshine Band,1976-03-13,KC And The Sunshine Band - K C And The Sunshine Band,38,40,51,1.0,38,K C And The Sunshine Band,30.0,30,-13,0,2,1,down,1975-08-16
1990,Natalie Cole,1975-08-16,Natalie Cole - Inseparable,51,51,38,1.0,50,Inseparable,44.0,0,12,1,0,1,up,1975-08-16
1991,Natalie Cole,1975-08-23,Natalie Cole - Inseparable,50,51,33,1.0,38,Inseparable,44.0,1,5,12,1,1,up,1975-08-16
1992,Natalie Cole,1975-08-30,Natalie Cole - Inseparable,38,50,29,1.0,33,Inseparable,44.0,2,4,5,12,1,up,1975-08-16
1993,Natalie Cole,1975-09-06,Natalie Cole - Inseparable,33,38,23,1.0,29,Inseparable,44.0,3,6,4,5,1,up,1975-08-16
1994,Natalie Cole,1975-09-13,Natalie Cole - Inseparable,29,33,20,1.0,23,Inseparable,44.0,4,3,6,4,1,up,1975-08-16
1995,Natalie Cole,1975-09-20,Natalie Cole - Inseparable,23,29,16,1.0,20,Inseparable,44.0,5,4,3,6,1,up,1975-08-16
1996,Natalie Cole,1975-09-27,Natalie Cole - Inseparable,20,23,14,1.0,16,Inseparable,44.0,6,2,4,3,1,up,1975-08-16
1997,Natalie Cole,1975-10-04,Natalie Cole - Inseparable,16,20,12,1.0,14,Inseparable,44.0,7,2,2,4,1,up,1975-08-16
1998,Natalie Cole,1975-10-11,Natalie Cole - Inseparable,14,16,12,1.0,12,Inseparable,44.0,8,0,2,2,0,stay,1975-08-16
1999,Natalie Cole,1975-10-18,Natalie Cole - Inseparable,12,14,11,1.0,12,Inseparable,44.0,9,1,0,2,1,up,1975-08-16
2000,Natalie Cole,1975-10-25,Natalie Cole - Inseparable,12,12,8,1.0,11,Inseparable,44.0,10,3,1,0,1,up,1975-08-16
2001,Natalie Cole,1975-11-01,Natalie Cole - Inseparable,11,12,6,1.0,8,Inseparable,44.0,11,2,3,1,1,up,1975-08-16
2002,Natalie Cole,1975-11-08,Natalie Cole - Inseparable,8,11,2,1.0,6,Inseparable,44.0,12,4,2,3,1,up,1975-08-16
2003,Natalie Cole,1975-11-15,Natalie Cole - Inseparable,6,8,1,1.0,2,Inseparable,44.0,13,1,4,2,1,up,1975-08-16
2004,Natalie Cole,1975-11-22,Natalie Cole - Inseparable,2,6,4,1.0,1,Inseparable,44.0,14,-3,1,4,1,down,1975-08-16
2005,Natalie Cole,1975-11-29,Natalie Cole - Inseparable,1,2,5,1.0,4,Inseparable,44.0,15,-1,-3,1,1,down,1975-08-16
2006,Natalie Cole,1975-12-06,Natalie Cole - Inseparable,4,1,15,1.0,5,Inseparable,44.0,16,-10,-1,-3,1,down,1975-08-16
2007,Natalie Cole,1975-12-13,Natalie Cole - Inseparable,5,4,25,1.0,15,Inseparable,44.0,17,-10,-10,-1,1,down,1975-08-16
2008,Natalie Cole,1975-12-20,Natalie Cole - Inseparable,15,5,24,1.0,25,Inseparable,44.0,18,1,-10,-10,1,up,1975-08-16
2009,Natalie Cole,1975-12-27,Natalie Cole - Inseparable,25,15,20,1.0,24,Inseparable,44.0,19,4,1,-10,1,up,1975-08-16
2010,Natalie Cole,1976-01-03,Natalie Cole - Inseparable,24,25,21,1.0,20,Inseparable,44.0,20,-1,4,1,1,down,1975-08-16
2011,Natalie Cole,1976-01-10,Natalie Cole - Inseparable,20,24,26,1.0,21,Inseparable,44.0,21,-5,-1,4,1,down,1975-08-16
2012,Natalie Cole,1976-01-17,Natalie Cole - Inseparable,21,20,23,1.0,26,Inseparable,44.0,22,3,-5,-1,1,up,1975-08-16
2013,Natalie Cole,1976-01-24,Natalie Cole - Inseparable,26,21,19,1.0,23,Inseparable,44.0,23,4,3,-5,1,up,1975-08-16
2014,Natalie Cole,1976-01-31,Natalie Cole - Inseparable,23,26,12,1.0,19,Inseparable,44.0,24,7,4,3,1,up,1975-08-16
2015,Natalie Cole,1976-02-07,Natalie Cole - Inseparable,19,23,10,1.0,12,Inseparable,44.0,25,2,7,4,1,up,1975-08-16
2016,Natalie Cole,1976-02-14,Natalie Cole - Inseparable,12,19,9,1.0,10,Inseparable,44.0,26,1,2,7,1,up,1975-08-16
2017,Natalie Cole,1976-02-21,Natalie Cole - Inseparable,10,12,7,1.0,9,Inseparable,44.0,27,2,1,2,1,up,1975-08-16
2018,Natalie Cole,1976-02-28,Natalie Cole - Inseparable,9,10,7,1.0,7,Inseparable,44.0,28,0,2,1,0,stay,1975-08-16
2019,Natalie Cole,1976-03-06,Natalie Cole - Inseparable,7,9,7,1.0,7,Inseparable,44.0,29,0,0,2,0,stay,1975-08-16
2020,Natalie Cole,1976-03-13,Natalie Cole - Inseparable,7,7,6,1.0,7,Inseparable,44.0,30,1,0,0,1,up,1975-08-16
2021,Natalie Cole,1976-03-20,Natalie Cole - Inseparable,7,7,4,1.0,6,Inseparable,44.0,31,2,1,0,1,up,1975-08-16
2022,Natalie Cole,1976-03-27,Natalie Cole - Inseparable,6,7,6,1.0,4,Inseparable,44.0,32,-2,2,1,1,down,1975-08-16
2023,Natalie Cole,1976-04-03,Natalie Cole - Inseparable,4,6,11,1.0,6,Inseparable,44.0,33,-5,-2,2,1,down,1975-08-16
2024,Natalie Cole,1976-04-10,Natalie Cole - Inseparable,6,4,16,1.0,11,Inseparable,44.0,34,-5,-5,-2,1,down,1975-08-16
2025,Natalie Cole,1976-04-17,Natalie Cole - Inseparable,11,6,17,1.0,16,Inseparable,44.0,35,-1,-5,-5,1,down,1975-08-16
2026,Natalie Cole,1976-04-24,Natalie Cole - Inseparable,16,11,24,1.0,17,Inseparable,44.0,36,-7,-1,-5,1,down,1975-08-16
2027,Natalie Cole,1976-05-01,Natalie Cole - Inseparable,17,16,25,1.0,24,Inseparable,44.0,37,-1,-7,-1,1,down,1975-08-16
2028,Natalie Cole,1976-05-08,Natalie Cole - Inseparable,24,17,28,1.0,25,Inseparable,44.0,38,-3,-1,-7,1,down,1975-08-16
2029,Natalie Cole,1976-05-15,Natalie Cole - Inseparable,25,24,49,1.0,28,Inseparable,44.0,39,-21,-3,-1,1,down,1975-08-16
2030,Natalie Cole,1976-06-05,Natalie Cole - Inseparable,28,25,49,1.0,49,Inseparable,44.0,40,0,-21,-3,0,stay,1975-08-16
2031,Natalie Cole,1976-06-12,Natalie Cole - Inseparable,49,28,39,1.0,49,Inseparable,44.0,41,10,0,-21,1,up,1975-08-16
2032,Natalie Cole,1976-06-19,Natalie Cole - Inseparable,49,49,39,1.0,39,Inseparable,44.0,42,0,10,0,0,stay,1975-08-16
2033,Natalie Cole,1976-06-26,Natalie Cole - Inseparable,39,49,37,1.0,39,Inseparable,44.0,43,2,0,10,1,up,1975-08-16
2034,Natalie Cole,1976-07-04,Natalie Cole - Inseparable,39,39,51,1.0,37,Inseparable,44.0,44,-14,2,0,1,down,1975-08-16
2035,Ohio Players,1975-08-23,Ohio Players - Honey,51,51,12,1.0,20,Honey,31.0,0,8,31,0,1,up,1975-08-23
2036,Ohio Players,1975-08-30,Ohio Players - Honey,20,51,2,1.0,12,Honey,31.0,1,10,8,31,1,up,1975-08-23
2037,Ohio Players,1975-09-06,Ohio Players - Honey,12,20,2,1.0,2,Honey,31.0,2,0,10,8,0,stay,1975-08-23
2038,Ohio Players,1975-09-13,Ohio Players - Honey,2,12,2,1.0,2,Honey,31.0,3,0,0,10,0,stay,1975-08-23
2039,Ohio Players,1975-09-20,Ohio Players - Honey,2,2,1,1.0,2,Honey,31.0,4,1,0,0,1,up,1975-08-23
2040,Ohio Players,1975-09-27,Ohio Players - Honey,2,2,1,1.0,1,Honey,31.0,5,0,1,0,0,stay,1975-08-23
2041,Ohio Players,1975-10-04,Ohio Players - Honey,1,2,2,1.0,1,Honey,31.0,6,-1,0,1,1,down,1975-08-23
2042,Ohio Players,1975-10-11,Ohio Players - Honey,1,1,2,1.0,2,Honey,31.0,7,0,-1,0,0,stay,1975-08-23
2043,Ohio Players,1975-10-18,Ohio Players - Honey,2,1,1,1.0,2,Honey,31.0,8,1,0,-1,1,up,1975-08-23
2044,Ohio Players,1975-10-25,Ohio Players - Honey,2,2,2,1.0,1,Honey,31.0,9,-1,1,0,1,down,1975-08-23
2045,Ohio Players,1975-11-01,Ohio Players - Honey,1,2,3,1.0,2,Honey,31.0,10,-1,-1,1,1,down,1975-08-23
2046,Ohio Players,1975-11-08,Ohio Players - Honey,2,1,5,1.0,3,Honey,31.0,11,-2,-1,-1,1,down,1975-08-23
2047,Ohio Players,1975-11-15,Ohio Players - Honey,3,2,4,1.0,5,Honey,31.0,12,1,-2,-1,1,up,1975-08-23
2048,Ohio Players,1975-11-22,Ohio Players - Honey,5,3,3,1.0,4,Honey,31.0,13,1,1,-2,1,up,1975-08-23
2049,Ohio Players,1975-11-29,Ohio Players - Honey,4,5,3,1.0,3,Honey,31.0,14,0,1,1,0,stay,1975-08-23
2050,Ohio Players,1975-12-06,Ohio Players - Honey,3,4,5,1.0,3,Honey,31.0,15,-2,0,1,1,down,1975-08-23
2051,Ohio Players,1975-12-13,Ohio Players - Honey,3,3,6,1.0,5,Honey,31.0,16,-1,-2,0,1,down,1975-08-23
2052,Ohio Players,1975-12-20,Ohio Players - Honey,5,3,17,1.0,6,Honey,31.0,17,-11,-1,-2,1,down,1975-08-23
2053,Ohio Players,1975-12-27,Ohio Players - Honey,6,5,17,1.0,17,Honey,31.0,18,0,-11,-1,0,stay,1975-08-23
2054,Ohio Players,1976-01-03,Ohio Players - Honey,17,6,15,1.0,17,Honey,31.0,19,2,0,-11,1,up,1975-08-23
2055,Ohio Players,1976-01-10,Ohio Players - Honey,17,17,14,1.0,15,Honey,31.0,20,1,2,0,1,up,1975-08-23
2056,Ohio Players,1976-01-17,Ohio Players - Honey,15,17,12,1.0,14,Honey,31.0,21,2,1,2,1,up,1975-08-23
2057,Ohio Players,1976-01-24,Ohio Players - Honey,14,15,12,1.0,12,Honey,31.0,22,0,2,1,0,stay,1975-08-23
2058,Ohio Players,1976-01-31,Ohio Players - Honey,12,14,10,1.0,12,Honey,31.0,23,2,0,2,1,up,1975-08-23
2059,Ohio Players,1976-02-07,Ohio Players - Honey,12,12,9,1.0,10,Honey,31.0,24,1,2,0,1,up,1975-08-23
2060,Ohio Players,1976-02-14,Ohio Players - Honey,10,12,8,1.0,9,Honey,31.0,25,1,1,2,1,up,1975-08-23
2061,Ohio Players,1976-02-21,Ohio Players - Honey,9,10,13,1.0,8,Honey,31.0,26,-5,1,1,1,down,1975-08-23
2062,Ohio Players,1976-02-28,Ohio Players - Honey,8,9,13,1.0,13,Honey,31.0,27,0,-5,1,0,stay,1975-08-23
2063,Ohio Players,1976-03-06,Ohio Players - Honey,13,8,16,1.0,13,Honey,31.0,28,-3,0,-5,1,down,1975-08-23
2064,Ohio Players,1976-03-13,Ohio Players - Honey,13,13,23,1.0,16,Honey,31.0,29,-7,-3,0,1,down,1975-08-23
2065,Ohio Players,1976-03-20,Ohio Players - Honey,16,13,40,1.0,23,Honey,31.0,30,-17,-7,-3,1,down,1975-08-23
2066,Ohio Players,1976-03-27,Ohio Players - Honey,23,16,51,1.0,40,Honey,31.0,31,-11,-17,-7,1,down,1975-08-23
2067,Buddy Miles,1975-08-23,Buddy Miles - More Miles Per Gallon,51,51,37,27.0,41,More Miles Per Gallon,7.0,0,4,10,0,1,up,1975-08-23
2068,Buddy Miles,1975-08-30,Buddy Miles - More Miles Per Gallon,41,51,34,27.0,37,More Miles Per Gallon,7.0,1,3,4,10,1,up,1975-08-23
2069,Buddy Miles,1975-09-06,Buddy Miles - More Miles Per Gallon,37,41,29,27.0,34,More Miles Per Gallon,7.0,2,5,3,4,1,up,1975-08-23
2070,Buddy Miles,1975-09-13,Buddy Miles - More Miles Per Gallon,34,37,27,27.0,29,More Miles Per Gallon,7.0,3,2,5,3,1,up,1975-08-23
2071,Buddy Miles,1975-09-20,Buddy Miles - More Miles Per Gallon,29,34,27,27.0,27,More Miles Per Gallon,7.0,4,0,2,5,0,stay,1975-08-23
2072,Buddy Miles,1975-09-27,Buddy Miles - More Miles Per Gallon,27,29,32,27.0,27,More Miles Per Gallon,7.0,5,-5,0,2,1,down,1975-08-23
2073,Buddy Miles,1975-10-04,Buddy Miles - More Miles Per Gallon,27,27,39,27.0,32,More Miles Per Gallon,7.0,6,-7,-5,0,1,down,1975-08-23
2074,Buddy Miles,1975-10-11,Buddy Miles - More Miles Per Gallon,32,27,51,27.0,39,More Miles Per Gallon,7.0,7,-12,-7,-5,1,down,1975-08-23
2075,Cannonball Adderley,1975-08-23,Cannonball Adderley - Phenix,51,51,32,24.0,43,Phenix,9.0,0,11,8,0,1,up,1975-08-23
2076,Cannonball Adderley,1975-08-30,Cannonball Adderley - Phenix,43,51,28,24.0,32,Phenix,9.0,1,4,11,8,1,up,1975-08-23
2077,Cannonball Adderley,1975-09-06,Cannonball Adderley - Phenix,32,43,26,24.0,28,Phenix,9.0,2,2,4,11,1,up,1975-08-23
2078,Cannonball Adderley,1975-09-13,Cannonball Adderley - Phenix,28,32,24,24.0,26,Phenix,9.0,3,2,2,4,1,up,1975-08-23
2079,Cannonball Adderley,1975-09-20,Cannonball Adderley - Phenix,26,28,24,24.0,24,Phenix,9.0,4,0,2,2,0,stay,1975-08-23
2080,Cannonball Adderley,1975-09-27,Cannonball Adderley - Phenix,24,26,27,24.0,24,Phenix,9.0,5,-3,0,2,1,down,1975-08-23
2081,Cannonball Adderley,1975-10-04,Cannonball Adderley - Phenix,24,24,32,24.0,27,Phenix,9.0,6,-5,-3,0,1,down,1975-08-23
2082,Cannonball Adderley,1975-10-11,Cannonball Adderley - Phenix,27,24,32,24.0,32,Phenix,9.0,7,0,-5,-3,0,stay,1975-08-23
2083,Cannonball Adderley,1975-10-18,Cannonball Adderley - Phenix,32,27,41,24.0,32,Phenix,9.0,8,-9,0,-5,1,down,1975-08-23
2084,Cannonball Adderley,1975-10-25,Cannonball Adderley - Phenix,32,32,51,24.0,41,Phenix,9.0,9,-10,-9,0,1,down,1975-08-23
2085,Ace Spectrum,1975-08-23,Ace Spectrum - Low Rent Rendezvous,51,51,43,35.0,45,Low Rent Rendezvous,4.0,0,2,6,0,1,up,1975-08-23
2086,Ace Spectrum,1975-08-30,Ace Spectrum - Low Rent Rendezvous,45,51,37,35.0,43,Low Rent Rendezvous,4.0,1,6,2,6,1,up,1975-08-23
2087,Ace Spectrum,1975-09-06,Ace Spectrum - Low Rent Rendezvous,43,45,35,35.0,37,Low Rent Rendezvous,4.0,2,2,6,2,1,up,1975-08-23
2088,Ace Spectrum,1975-09-13,Ace Spectrum - Low Rent Rendezvous,37,43,47,35.0,35,Low Rent Rendezvous,4.0,3,-12,2,6,1,down,1975-08-23
2089,Ace Spectrum,1975-09-20,Ace Spectrum - Low Rent Rendezvous,35,37,51,35.0,47,Low Rent Rendezvous,4.0,4,-4,-12,2,1,down,1975-08-23
2090,Leon Haywood,1975-08-23,Leon Haywood - Come And Get Yourself Some,51,51,36,21.0,46,Come And Get Yourself Some,8.0,0,10,5,0,1,up,1975-08-23
2091,Leon Haywood,1975-08-30,Leon Haywood - Come And Get Yourself Some,46,51,30,21.0,36,Come And Get Yourself Some,8.0,1,6,10,5,1,up,1975-08-23
2092,Leon Haywood,1975-09-06,Leon Haywood - Come And Get Yourself Some,36,46,25,21.0,30,Come And Get Yourself Some,8.0,2,5,6,10,1,up,1975-08-23
2093,Leon Haywood,1975-09-13,Leon Haywood - Come And Get Yourself Some,30,36,25,21.0,25,Come And Get Yourself Some,8.0,3,0,5,6,0,stay,1975-08-23
2094,Leon Haywood,1975-09-20,Leon Haywood - Come And Get Yourself Some,25,30,23,21.0,25,Come And Get Yourself Some,8.0,4,2,0,5,1,up,1975-08-23
2095,Leon Haywood,1975-09-27,Leon Haywood - Come And Get Yourself Some,25,25,21,21.0,23,Come And Get Yourself Some,8.0,5,2,2,0,1,up,1975-08-23
2096,Leon Haywood,1975-10-04,Leon Haywood - Come And Get Yourself Some,23,25,21,21.0,21,Come And Get Yourself Some,8.0,6,0,2,2,0,stay,1975-08-23
2097,Leon Haywood,1975-10-11,Leon Haywood - Come And Get Yourself Some,21,23,38,21.0,21,Come And Get Yourself Some,8.0,7,-17,0,2,1,down,1975-08-23
2098,Leon Haywood,1975-10-18,Leon Haywood - Come And Get Yourself Some,21,21,51,21.0,38,Come And Get Yourself Some,8.0,8,-13,-17,0,1,down,1975-08-23
2099,The Dynamic Superiors,1975-08-23,The Dynamic Superiors - Pure Pleasure,51,51,40,36.0,50,Pure Pleasure,4.0,0,10,1,0,1,up,1975-08-23
2100,The Dynamic Superiors,1975-08-30,The Dynamic Superiors - Pure Pleasure,50,51,36,36.0,40,Pure Pleasure,4.0,1,4,10,1,1,up,1975-08-23
2101,The Dynamic Superiors,1975-09-06,The Dynamic Superiors - Pure Pleasure,40,50,36,36.0,36,Pure Pleasure,4.0,2,0,4,10,0,stay,1975-08-23
2102,The Dynamic Superiors,1975-09-13,The Dynamic Superiors - Pure Pleasure,36,40,48,36.0,36,Pure Pleasure,4.0,3,-12,0,4,1,down,1975-08-23
2103,The Dynamic Superiors,1975-09-20,The Dynamic Superiors - Pure Pleasure,36,36,51,36.0,48,Pure Pleasure,4.0,4,-3,-12,0,1,down,1975-08-23
2104,Richard Pryor,1975-08-30,Richard Pryor - Is It Something I Said?,51,51,15,1.0,29,Is It Something I Said?,15.0,0,14,22,0,1,up,1975-08-30
2105,Richard Pryor,1975-09-06,Richard Pryor - Is It Something I Said?,29,51,8,1.0,15,Is It Something I Said?,15.0,1,7,14,22,1,up,1975-08-30
2106,Richard Pryor,1975-09-13,Richard Pryor - Is It Something I Said?,15,29,5,1.0,8,Is It Something I Said?,15.0,2,3,7,14,1,up,1975-08-30
2107,Richard Pryor,1975-09-20,Richard Pryor - Is It Something I Said?,8,15,3,1.0,5,Is It Something I Said?,15.0,3,2,3,7,1,up,1975-08-30
2108,Richard Pryor,1975-09-27,Richard Pryor - Is It Something I Said?,5,8,3,1.0,3,Is It Something I Said?,15.0,4,0,2,3,0,stay,1975-08-30
2109,Richard Pryor,1975-10-04,Richard Pryor - Is It Something I Said?,3,5,1,1.0,3,Is It Something I Said?,15.0,5,2,0,2,1,up,1975-08-30
2110,Richard Pryor,1975-10-11,Richard Pryor - Is It Something I Said?,3,3,1,1.0,1,Is It Something I Said?,15.0,6,0,2,0,0,stay,1975-08-30
2111,Richard Pryor,1975-10-18,Richard Pryor - Is It Something I Said?,1,3,4,1.0,1,Is It Something I Said?,15.0,7,-3,0,2,1,down,1975-08-30
2112,Richard Pryor,1975-10-25,Richard Pryor - Is It Something I Said?,1,1,4,1.0,4,Is It Something I Said?,15.0,8,0,-3,0,0,stay,1975-08-30
2113,Richard Pryor,1975-11-01,Richard Pryor - Is It Something I Said?,4,1,5,1.0,4,Is It Something I Said?,15.0,9,-1,0,-3,1,down,1975-08-30
2114,Richard Pryor,1975-11-08,Richard Pryor - Is It Something I Said?,4,4,8,1.0,5,Is It Something I Said?,15.0,10,-3,-1,0,1,down,1975-08-30
2115,Richard Pryor,1975-11-15,Richard Pryor - Is It Something I Said?,5,4,12,1.0,8,Is It Something I Said?,15.0,11,-4,-3,-1,1,down,1975-08-30
2116,Richard Pryor,1975-11-22,Richard Pryor - Is It Something I Said?,8,5,12,1.0,12,Is It Something I Said?,15.0,12,0,-4,-3,0,stay,1975-08-30
2117,Richard Pryor,1975-11-29,Richard Pryor - Is It Something I Said?,12,8,37,1.0,12,Is It Something I Said?,15.0,13,-25,0,-4,1,down,1975-08-30
2118,Richard Pryor,1975-12-06,Richard Pryor - Is It Something I Said?,12,12,38,1.0,37,Is It Something I Said?,15.0,14,-1,-25,0,1,down,1975-08-30
2119,Richard Pryor,1975-12-13,Richard Pryor - Is It Something I Said?,37,12,51,1.0,38,Is It Something I Said?,15.0,15,-13,-1,-25,1,down,1975-08-30
2120,"Faith, Hope And Charity",1975-08-30,"Faith, Hope And Charity - Faith,hope And Charity",51,51,39,24.0,44,"Faith,hope And Charity",9.0,0,5,7,0,1,up,1975-08-30
2121,"Faith, Hope And Charity",1975-09-06,"Faith, Hope And Charity - Faith,hope And Charity",44,51,34,24.0,39,"Faith,hope And Charity",9.0,1,5,5,7,1,up,1975-08-30
2122,"Faith, Hope And Charity",1975-09-13,"Faith, Hope And Charity - Faith,hope And Charity",39,44,30,24.0,34,"Faith,hope And Charity",9.0,2,4,5,5,1,up,1975-08-30
2123,"Faith, Hope And Charity",1975-09-20,"Faith, Hope And Charity - Faith,hope And Charity",34,39,28,24.0,30,"Faith,hope And Charity",9.0,3,2,4,5,1,up,1975-08-30
2124,"Faith, Hope And Charity",1975-09-27,"Faith, Hope And Charity - Faith,hope And Charity",30,34,26,24.0,28,"Faith,hope And Charity",9.0,4,2,2,4,1,up,1975-08-30
2125,"Faith, Hope And Charity",1975-10-04,"Faith, Hope And Charity - Faith,hope And Charity",28,30,26,24.0,26,"Faith,hope And Charity",9.0,5,0,2,2,0,stay,1975-08-30
2126,"Faith, Hope And Charity",1975-10-11,"Faith, Hope And Charity - Faith,hope And Charity",26,28,24,24.0,26,"Faith,hope And Charity",9.0,6,2,0,2,1,up,1975-08-30
2127,"Faith, Hope And Charity",1975-10-18,"Faith, Hope And Charity - Faith,hope And Charity",26,26,25,24.0,24,"Faith,hope And Charity",9.0,7,-1,2,0,1,down,1975-08-30
2128,"Faith, Hope And Charity",1975-10-25,"Faith, Hope And Charity - Faith,hope And Charity",24,26,42,24.0,25,"Faith,hope And Charity",9.0,8,-17,-1,2,1,down,1975-08-30
2129,"Faith, Hope And Charity",1975-11-01,"Faith, Hope And Charity - Faith,hope And Charity",25,24,51,24.0,42,"Faith,hope And Charity",9.0,9,-9,-17,-1,1,down,1975-08-30
2130,Esther Phillips,1975-08-30,Esther Phillips - What A Diff'rence A Day Makes,51,51,33,13.0,45,What A Diff'rence A Day Makes,10.0,0,12,6,0,1,up,1975-08-30
2131,Esther Phillips,1975-09-06,Esther Phillips - What A Diff'rence A Day Makes,45,51,28,13.0,33,What A Diff'rence A Day Makes,10.0,1,5,12,6,1,up,1975-08-30
2132,Esther Phillips,1975-09-13,Esther Phillips - What A Diff'rence A Day Makes,33,45,22,13.0,28,What A Diff'rence A Day Makes,10.0,2,6,5,12,1,up,1975-08-30
2133,Esther Phillips,1975-09-20,Esther Phillips - What A Diff'rence A Day Makes,28,33,17,13.0,22,What A Diff'rence A Day Makes,10.0,3,5,6,5,1,up,1975-08-30
2134,Esther Phillips,1975-09-27,Esther Phillips - What A Diff'rence A Day Makes,22,28,17,13.0,17,What A Diff'rence A Day Makes,10.0,4,0,5,6,0,stay,1975-08-30
2135,Esther Phillips,1975-10-04,Esther Phillips - What A Diff'rence A Day Makes,17,22,16,13.0,17,What A Diff'rence A Day Makes,10.0,5,1,0,5,1,up,1975-08-30
2136,Esther Phillips,1975-10-11,Esther Phillips - What A Diff'rence A Day Makes,17,17,13,13.0,16,What A Diff'rence A Day Makes,10.0,6,3,1,0,1,up,1975-08-30
2137,Esther Phillips,1975-10-18,Esther Phillips - What A Diff'rence A Day Makes,16,17,16,13.0,13,What A Diff'rence A Day Makes,10.0,7,-3,3,1,1,down,1975-08-30
2138,Esther Phillips,1975-10-25,Esther Phillips - What A Diff'rence A Day Makes,13,16,19,13.0,16,What A Diff'rence A Day Makes,10.0,8,-3,-3,3,1,down,1975-08-30
2139,Esther Phillips,1975-11-01,Esther Phillips - What A Diff'rence A Day Makes,16,13,39,13.0,19,What A Diff'rence A Day Makes,10.0,9,-20,-3,-3,1,down,1975-08-30
2140,Esther Phillips,1975-11-08,Esther Phillips - What A Diff'rence A Day Makes,19,16,51,13.0,39,What A Diff'rence A Day Makes,10.0,10,-12,-20,-3,1,down,1975-08-30
2141,Quincy Jones,1975-08-30,Quincy Jones - Mellow Madness,51,51,26,3.0,47,Mellow Madness,13.0,0,21,4,0,1,up,1975-08-30
2142,Quincy Jones,1975-09-06,Quincy Jones - Mellow Madness,47,51,18,3.0,26,Mellow Madness,13.0,1,8,21,4,1,up,1975-08-30
2143,Quincy Jones,1975-09-13,Quincy Jones - Mellow Madness,26,47,14,3.0,18,Mellow Madness,13.0,2,4,8,21,1,up,1975-08-30
2144,Quincy Jones,1975-09-20,Quincy Jones - Mellow Madness,18,26,10,3.0,14,Mellow Madness,13.0,3,4,4,8,1,up,1975-08-30
2145,Quincy Jones,1975-09-27,Quincy Jones - Mellow Madness,14,18,9,3.0,10,Mellow Madness,13.0,4,1,4,4,1,up,1975-08-30
2146,Quincy Jones,1975-10-04,Quincy Jones - Mellow Madness,10,14,5,3.0,9,Mellow Madness,13.0,5,4,1,4,1,up,1975-08-30
2147,Quincy Jones,1975-10-11,Quincy Jones - Mellow Madness,9,10,4,3.0,5,Mellow Madness,13.0,6,1,4,1,1,up,1975-08-30
2148,Quincy Jones,1975-10-18,Quincy Jones - Mellow Madness,5,9,3,3.0,4,Mellow Madness,13.0,7,1,1,4,1,up,1975-08-30
2149,Quincy Jones,1975-10-25,Quincy Jones - Mellow Madness,4,5,11,3.0,3,Mellow Madness,13.0,8,-8,1,1,1,down,1975-08-30
2150,Quincy Jones,1975-11-01,Quincy Jones - Mellow Madness,3,4,11,3.0,11,Mellow Madness,13.0,9,0,-8,1,0,stay,1975-08-30
2151,Quincy Jones,1975-11-08,Quincy Jones - Mellow Madness,11,3,14,3.0,11,Mellow Madness,13.0,10,-3,0,-8,1,down,1975-08-30
2152,Quincy Jones,1975-11-15,Quincy Jones - Mellow Madness,11,11,14,3.0,14,Mellow Madness,13.0,11,0,-3,0,0,stay,1975-08-30
2153,Quincy Jones,1975-11-22,Quincy Jones - Mellow Madness,14,11,38,3.0,14,Mellow Madness,13.0,12,-24,0,-3,1,down,1975-08-30
2154,Quincy Jones,1975-11-29,Quincy Jones - Mellow Madness,14,14,51,3.0,38,Mellow Madness,13.0,13,-13,-24,0,1,down,1975-08-30
2155,Norman Connors,1975-08-30,Norman Connors - Saturday Night Special,51,51,47,35.0,48,Saturday Night Special,10.0,0,1,3,0,1,up,1975-08-30
2156,Norman Connors,1975-09-06,Norman Connors - Saturday Night Special,48,51,45,35.0,47,Saturday Night Special,10.0,1,2,1,3,1,up,1975-08-30
2157,Norman Connors,1975-09-13,Norman Connors - Saturday Night Special,47,48,50,35.0,45,Saturday Night Special,10.0,2,-5,2,1,1,down,1975-08-30
2158,Norman Connors,1975-09-20,Norman Connors - Saturday Night Special,45,47,46,35.0,50,Saturday Night Special,10.0,3,4,-5,2,1,up,1975-08-30
2159,Norman Connors,1975-10-04,Norman Connors - Saturday Night Special,50,45,42,35.0,46,Saturday Night Special,10.0,4,4,4,-5,1,up,1975-08-30
2160,Norman Connors,1975-10-11,Norman Connors - Saturday Night Special,46,50,36,35.0,42,Saturday Night Special,10.0,5,6,4,4,1,up,1975-08-30
2161,Norman Connors,1975-10-18,Norman Connors - Saturday Night Special,42,46,36,35.0,36,Saturday Night Special,10.0,6,0,6,4,0,stay,1975-08-30
2162,Norman Connors,1975-10-25,Norman Connors - Saturday Night Special,36,42,35,35.0,36,Saturday Night Special,10.0,7,1,0,6,1,up,1975-08-30
2163,Norman Connors,1975-11-01,Norman Connors - Saturday Night Special,36,36,35,35.0,35,Saturday Night Special,10.0,8,0,1,0,0,stay,1975-08-30
2164,Norman Connors,1975-11-08,Norman Connors - Saturday Night Special,35,36,46,35.0,35,Saturday Night Special,10.0,9,-11,0,1,1,down,1975-08-30
2165,Norman Connors,1975-11-15,Norman Connors - Saturday Night Special,35,35,51,35.0,46,Saturday Night Special,10.0,10,-5,-11,0,1,down,1975-08-30
2166,Olympic Runners,1975-08-30,Olympic Runners - Out In Front,51,51,51,49.0,49,Out In Front,0.0,0,-2,2,0,1,down,1975-08-30
2167,The Crusaders,1975-08-30,The Crusaders - Chain Reaction,51,51,38,9.0,50,Chain Reaction,11.0,0,12,1,0,1,up,1975-08-30
2168,The Crusaders,1975-09-06,The Crusaders - Chain Reaction,50,51,24,9.0,38,Chain Reaction,11.0,1,14,12,1,1,up,1975-08-30
2169,The Crusaders,1975-09-13,The Crusaders - Chain Reaction,38,50,18,9.0,24,Chain Reaction,11.0,2,6,14,12,1,up,1975-08-30
2170,The Crusaders,1975-09-20,The Crusaders - Chain Reaction,24,38,13,9.0,18,Chain Reaction,11.0,3,5,6,14,1,up,1975-08-30
2171,The Crusaders,1975-09-27,The Crusaders - Chain Reaction,18,24,11,9.0,13,Chain Reaction,11.0,4,2,5,6,1,up,1975-08-30
2172,The Crusaders,1975-10-04,The Crusaders - Chain Reaction,13,18,9,9.0,11,Chain Reaction,11.0,5,2,2,5,1,up,1975-08-30
2173,The Crusaders,1975-10-11,The Crusaders - Chain Reaction,11,13,9,9.0,9,Chain Reaction,11.0,6,0,2,2,0,stay,1975-08-30
2174,The Crusaders,1975-10-18,The Crusaders - Chain Reaction,9,11,17,9.0,9,Chain Reaction,11.0,7,-8,0,2,1,down,1975-08-30
2175,The Crusaders,1975-10-25,The Crusaders - Chain Reaction,9,9,33,9.0,17,Chain Reaction,11.0,8,-16,-8,0,1,down,1975-08-30
2176,The Crusaders,1975-11-01,The Crusaders - Chain Reaction,17,9,31,9.0,33,Chain Reaction,11.0,9,2,-16,-8,1,up,1975-08-30
2177,The Crusaders,1975-11-08,The Crusaders - Chain Reaction,33,17,32,9.0,31,Chain Reaction,11.0,10,-1,2,-16,1,down,1975-08-30
2178,The Crusaders,1975-11-15,The Crusaders - Chain Reaction,31,33,51,9.0,32,Chain Reaction,11.0,11,-19,-1,2,1,down,1975-08-30
2179,Kool & The Gang,1975-09-06,Kool & The Gang - Spirit Of The Boogie,51,51,14,5.0,23,Spirit Of The Boogie,11.0,0,9,28,0,1,up,1975-09-06
2180,Kool & The Gang,1975-09-13,Kool & The Gang - Spirit Of The Boogie,23,51,12,5.0,14,Spirit Of The Boogie,11.0,1,2,9,28,1,up,1975-09-06
2181,Kool & The Gang,1975-09-20,Kool & The Gang - Spirit Of The Boogie,14,23,9,5.0,12,Spirit Of The Boogie,11.0,2,3,2,9,1,up,1975-09-06
2182,Kool & The Gang,1975-09-27,Kool & The Gang - Spirit Of The Boogie,12,14,7,5.0,9,Spirit Of The Boogie,11.0,3,2,3,2,1,up,1975-09-06
2183,Kool & The Gang,1975-10-04,Kool & The Gang - Spirit Of The Boogie,9,12,7,5.0,7,Spirit Of The Boogie,11.0,4,0,2,3,0,stay,1975-09-06
2184,Kool & The Gang,1975-10-11,Kool & The Gang - Spirit Of The Boogie,7,9,6,5.0,7,Spirit Of The Boogie,11.0,5,1,0,2,1,up,1975-09-06
2185,Kool & The Gang,1975-10-18,Kool & The Gang - Spirit Of The Boogie,7,7,6,5.0,6,Spirit Of The Boogie,11.0,6,0,1,0,0,stay,1975-09-06
2186,Kool & The Gang,1975-10-25,Kool & The Gang - Spirit Of The Boogie,6,7,5,5.0,6,Spirit Of The Boogie,11.0,7,1,0,1,1,up,1975-09-06
2187,Kool & The Gang,1975-11-01,Kool & The Gang - Spirit Of The Boogie,6,6,10,5.0,5,Spirit Of The Boogie,11.0,8,-5,1,0,1,down,1975-09-06
2188,Kool & The Gang,1975-11-08,Kool & The Gang - Spirit Of The Boogie,5,6,18,5.0,10,Spirit Of The Boogie,11.0,9,-8,-5,1,1,down,1975-09-06
2189,Kool & The Gang,1975-11-15,Kool & The Gang - Spirit Of The Boogie,10,5,23,5.0,18,Spirit Of The Boogie,11.0,10,-5,-8,-5,1,down,1975-09-06
2190,Kool & The Gang,1975-11-22,Kool & The Gang - Spirit Of The Boogie,18,10,51,5.0,23,Spirit Of The Boogie,11.0,11,-28,-5,-8,1,down,1975-09-06
2191,Gary Toms Empire,1975-09-06,Gary Toms Empire - 7-6-5-4-3-2-1 Blow Your Whistle,51,51,46,33.0,46,7-6-5-4-3-2-1 Blow Your Whistle,5.0,0,0,5,0,0,stay,1975-09-06
2192,Gary Toms Empire,1975-09-13,Gary Toms Empire - 7-6-5-4-3-2-1 Blow Your Whistle,46,51,44,33.0,46,7-6-5-4-3-2-1 Blow Your Whistle,5.0,1,2,0,5,1,up,1975-09-06
2193,Gary Toms Empire,1975-09-20,Gary Toms Empire - 7-6-5-4-3-2-1 Blow Your Whistle,46,46,38,33.0,44,7-6-5-4-3-2-1 Blow Your Whistle,5.0,2,6,2,0,1,up,1975-09-06
2194,Gary Toms Empire,1975-09-27,Gary Toms Empire - 7-6-5-4-3-2-1 Blow Your Whistle,44,46,34,33.0,38,7-6-5-4-3-2-1 Blow Your Whistle,5.0,3,4,6,2,1,up,1975-09-06
2195,Gary Toms Empire,1975-10-04,Gary Toms Empire - 7-6-5-4-3-2-1 Blow Your Whistle,38,44,33,33.0,34,7-6-5-4-3-2-1 Blow Your Whistle,5.0,4,1,4,6,1,up,1975-09-06
2196,Gary Toms Empire,1975-10-11,Gary Toms Empire - 7-6-5-4-3-2-1 Blow Your Whistle,34,38,51,33.0,33,7-6-5-4-3-2-1 Blow Your Whistle,5.0,5,-18,1,4,1,down,1975-09-06
2197,Willis Jackson,1975-09-06,Willis Jackson - Theway We Were,51,51,50,50.0,50,Theway We Were,1.0,0,0,1,0,0,stay,1975-09-06
2198,Willis Jackson,1975-09-13,Willis Jackson - Theway We Were,50,51,51,50.0,50,Theway We Were,1.0,1,-1,0,1,1,down,1975-09-06
2199,Hubert Laws,1975-09-13,Hubert Laws - The Chicago Theme,51,51,32,18.0,38,The Chicago Theme,7.0,0,6,13,0,1,up,1975-09-13
2200,Hubert Laws,1975-09-20,Hubert Laws - The Chicago Theme,38,51,26,18.0,32,The Chicago Theme,7.0,1,6,6,13,1,up,1975-09-13
2201,Hubert Laws,1975-09-27,Hubert Laws - The Chicago Theme,32,38,22,18.0,26,The Chicago Theme,7.0,2,4,6,6,1,up,1975-09-13
2202,Hubert Laws,1975-10-04,Hubert Laws - The Chicago Theme,26,32,18,18.0,22,The Chicago Theme,7.0,3,4,4,6,1,up,1975-09-13
2203,Hubert Laws,1975-10-11,Hubert Laws - The Chicago Theme,22,26,18,18.0,18,The Chicago Theme,7.0,4,0,4,4,0,stay,1975-09-13
2204,Hubert Laws,1975-10-18,Hubert Laws - The Chicago Theme,18,22,21,18.0,18,The Chicago Theme,7.0,5,-3,0,4,1,down,1975-09-13
2205,Hubert Laws,1975-10-25,Hubert Laws - The Chicago Theme,18,18,47,18.0,21,The Chicago Theme,7.0,6,-26,-3,0,1,down,1975-09-13
2206,Hubert Laws,1975-11-01,Hubert Laws - The Chicago Theme,21,18,51,18.0,47,The Chicago Theme,7.0,7,-4,-26,-3,1,down,1975-09-13
2207,Gino Vannelli,1975-09-13,Gino Vannelli - Storm At Sunup,51,51,35,35.0,39,Storm At Sunup,4.0,0,4,12,0,1,up,1975-09-13
2208,Gino Vannelli,1975-09-20,Gino Vannelli - Storm At Sunup,39,51,35,35.0,35,Storm At Sunup,4.0,1,0,4,12,0,stay,1975-09-13
2209,Gino Vannelli,1975-09-27,Gino Vannelli - Storm At Sunup,35,39,36,35.0,35,Storm At Sunup,4.0,2,-1,0,4,1,down,1975-09-13
2210,Gino Vannelli,1975-10-04,Gino Vannelli - Storm At Sunup,35,35,38,35.0,36,Storm At Sunup,4.0,3,-2,-1,0,1,down,1975-09-13
2211,Gino Vannelli,1975-10-11,Gino Vannelli - Storm At Sunup,36,35,51,35.0,38,Storm At Sunup,4.0,4,-13,-2,-1,1,down,1975-09-13
2212,Bobby Bland,1975-09-13,Bobby Bland - Get On Down With Bobby Bland,51,51,34,14.0,44,Get On Down With Bobby Bland,9.0,0,10,7,0,1,up,1975-09-13
2213,Bobby Bland,1975-09-20,Bobby Bland - Get On Down With Bobby Bland,44,51,25,14.0,34,Get On Down With Bobby Bland,9.0,1,9,10,7,1,up,1975-09-13
2214,Bobby Bland,1975-09-27,Bobby Bland - Get On Down With Bobby Bland,34,44,19,14.0,25,Get On Down With Bobby Bland,9.0,2,6,9,10,1,up,1975-09-13
2215,Bobby Bland,1975-10-04,Bobby Bland - Get On Down With Bobby Bland,25,34,15,14.0,19,Get On Down With Bobby Bland,9.0,3,4,6,9,1,up,1975-09-13
2216,Bobby Bland,1975-10-11,Bobby Bland - Get On Down With Bobby Bland,19,25,14,14.0,15,Get On Down With Bobby Bland,9.0,4,1,4,6,1,up,1975-09-13
2217,Bobby Bland,1975-10-18,Bobby Bland - Get On Down With Bobby Bland,15,19,14,14.0,14,Get On Down With Bobby Bland,9.0,5,0,1,4,0,stay,1975-09-13
2218,Bobby Bland,1975-10-25,Bobby Bland - Get On Down With Bobby Bland,14,15,15,14.0,14,Get On Down With Bobby Bland,9.0,6,-1,0,1,1,down,1975-09-13
2219,Bobby Bland,1975-11-01,Bobby Bland - Get On Down With Bobby Bland,14,14,25,14.0,15,Get On Down With Bobby Bland,9.0,7,-10,-1,0,1,down,1975-09-13
2220,Bobby Bland,1975-11-08,Bobby Bland - Get On Down With Bobby Bland,15,14,38,14.0,25,Get On Down With Bobby Bland,9.0,8,-13,-10,-1,1,down,1975-09-13
2221,Bobby Bland,1975-11-15,Bobby Bland - Get On Down With Bobby Bland,25,15,51,14.0,38,Get On Down With Bobby Bland,9.0,9,-13,-13,-10,1,down,1975-09-13
2222,Meters,1975-09-13,Meters - Fire On The Bayou,51,51,43,41.0,47,Fire On The Bayou,3.0,0,4,4,0,1,up,1975-09-13
2223,Meters,1975-09-20,Meters - Fire On The Bayou,47,51,41,41.0,43,Fire On The Bayou,3.0,1,2,4,4,1,up,1975-09-13
2224,Meters,1975-09-27,Meters - Fire On The Bayou,43,47,45,41.0,41,Fire On The Bayou,3.0,2,-4,2,4,1,down,1975-09-13
2225,Meters,1975-10-04,Meters - Fire On The Bayou,41,43,51,41.0,45,Fire On The Bayou,3.0,3,-6,-4,2,1,down,1975-09-13
2226,The 5th Dimension,1975-09-13,The 5th Dimension - Earthbound,51,51,45,30.0,49,Earthbound,5.0,0,4,2,0,1,up,1975-09-13
2227,The 5th Dimension,1975-09-20,The 5th Dimension - Earthbound,49,51,37,30.0,45,Earthbound,5.0,1,8,4,2,1,up,1975-09-13
2228,The 5th Dimension,1975-09-27,The 5th Dimension - Earthbound,45,49,30,30.0,37,Earthbound,5.0,2,7,8,4,1,up,1975-09-13
2229,The 5th Dimension,1975-10-04,The 5th Dimension - Earthbound,37,45,30,30.0,30,Earthbound,5.0,3,0,7,8,0,stay,1975-09-13
2230,The 5th Dimension,1975-10-11,The 5th Dimension - Earthbound,30,37,41,30.0,30,Earthbound,5.0,4,-11,0,7,1,down,1975-09-13
2231,The 5th Dimension,1975-10-18,The 5th Dimension - Earthbound,30,30,51,30.0,41,Earthbound,5.0,5,-10,-11,0,1,down,1975-09-13
2232,People's Choice,1975-09-20,People's Choice - Boogie Down U.S.A.,51,51,19,7.0,29,Boogie Down U.S.A.,10.0,0,10,22,0,1,up,1975-09-20
2233,People's Choice,1975-09-27,People's Choice - Boogie Down U.S.A.,29,51,13,7.0,19,Boogie Down U.S.A.,10.0,1,6,10,22,1,up,1975-09-20
2234,People's Choice,1975-10-04,People's Choice - Boogie Down U.S.A.,19,29,10,7.0,13,Boogie Down U.S.A.,10.0,2,3,6,10,1,up,1975-09-20
2235,People's Choice,1975-10-11,People's Choice - Boogie Down U.S.A.,13,19,8,7.0,10,Boogie Down U.S.A.,10.0,3,2,3,6,1,up,1975-09-20
2236,People's Choice,1975-10-18,People's Choice - Boogie Down U.S.A.,10,13,7,7.0,8,Boogie Down U.S.A.,10.0,4,1,2,3,1,up,1975-09-20
2237,People's Choice,1975-10-25,People's Choice - Boogie Down U.S.A.,8,10,7,7.0,7,Boogie Down U.S.A.,10.0,5,0,1,2,0,stay,1975-09-20
2238,People's Choice,1975-11-01,People's Choice - Boogie Down U.S.A.,7,8,12,7.0,7,Boogie Down U.S.A.,10.0,6,-5,0,1,1,down,1975-09-20
2239,People's Choice,1975-11-08,People's Choice - Boogie Down U.S.A.,7,7,15,7.0,12,Boogie Down U.S.A.,10.0,7,-3,-5,0,1,down,1975-09-20
2240,People's Choice,1975-11-15,People's Choice - Boogie Down U.S.A.,12,7,22,7.0,15,Boogie Down U.S.A.,10.0,8,-7,-3,-5,1,down,1975-09-20
2241,People's Choice,1975-11-22,People's Choice - Boogie Down U.S.A.,15,12,40,7.0,22,Boogie Down U.S.A.,10.0,9,-18,-7,-3,1,down,1975-09-20
2242,People's Choice,1975-11-29,People's Choice - Boogie Down U.S.A.,22,15,51,7.0,40,Boogie Down U.S.A.,10.0,10,-11,-18,-7,1,down,1975-09-20
2243,Al Green,1975-09-27,Al Green - Al Green Is Love,51,51,16,1.0,30,Al Green Is Love,11.0,0,14,21,0,1,up,1975-09-27
2244,Al Green,1975-10-04,Al Green - Al Green Is Love,30,51,11,1.0,16,Al Green Is Love,11.0,1,5,14,21,1,up,1975-09-27
2245,Al Green,1975-10-11,Al Green - Al Green Is Love,16,30,5,1.0,11,Al Green Is Love,11.0,2,6,5,14,1,up,1975-09-27
2246,Al Green,1975-10-18,Al Green - Al Green Is Love,11,16,2,1.0,5,Al Green Is Love,11.0,3,3,6,5,1,up,1975-09-27
2247,Al Green,1975-10-25,Al Green - Al Green Is Love,5,11,1,1.0,2,Al Green Is Love,11.0,4,1,3,6,1,up,1975-09-27
2248,Al Green,1975-11-01,Al Green - Al Green Is Love,2,5,1,1.0,1,Al Green Is Love,11.0,5,0,1,3,0,stay,1975-09-27
2249,Al Green,1975-11-08,Al Green - Al Green Is Love,1,2,6,1.0,1,Al Green Is Love,11.0,6,-5,0,1,1,down,1975-09-27
2250,Al Green,1975-11-15,Al Green - Al Green Is Love,1,1,8,1.0,6,Al Green Is Love,11.0,7,-2,-5,0,1,down,1975-09-27
2251,Al Green,1975-11-22,Al Green - Al Green Is Love,6,1,10,1.0,8,Al Green Is Love,11.0,8,-2,-2,-5,1,down,1975-09-27
2252,Al Green,1975-11-29,Al Green - Al Green Is Love,8,6,21,1.0,10,Al Green Is Love,11.0,9,-11,-2,-2,1,down,1975-09-27
2253,Al Green,1975-12-06,Al Green - Al Green Is Love,10,8,42,1.0,21,Al Green Is Love,11.0,10,-21,-11,-2,1,down,1975-09-27
2254,Al Green,1975-12-13,Al Green - Al Green Is Love,21,10,51,1.0,42,Al Green Is Love,11.0,11,-9,-21,-11,1,down,1975-09-27
2255,Labelle,1975-09-27,Labelle - Phoenix,51,51,20,10.0,36,Phoenix,8.0,0,16,15,0,1,up,1975-09-27
2256,Labelle,1975-10-04,Labelle - Phoenix,36,51,14,10.0,20,Phoenix,8.0,1,6,16,15,1,up,1975-09-27
2257,Labelle,1975-10-11,Labelle - Phoenix,20,36,10,10.0,14,Phoenix,8.0,2,4,6,16,1,up,1975-09-27
2258,Labelle,1975-10-18,Labelle - Phoenix,14,20,10,10.0,10,Phoenix,8.0,3,0,4,6,0,stay,1975-09-27
2259,Labelle,1975-10-25,Labelle - Phoenix,10,14,14,10.0,10,Phoenix,8.0,4,-4,0,4,1,down,1975-09-27
2260,Labelle,1975-11-01,Labelle - Phoenix,10,10,16,10.0,14,Phoenix,8.0,5,-2,-4,0,1,down,1975-09-27
2261,Labelle,1975-11-08,Labelle - Phoenix,14,10,20,10.0,16,Phoenix,8.0,6,-4,-2,-4,1,down,1975-09-27
2262,Labelle,1975-11-15,Labelle - Phoenix,16,14,45,10.0,20,Phoenix,8.0,7,-25,-4,-2,1,down,1975-09-27
2263,Labelle,1975-11-22,Labelle - Phoenix,20,16,51,10.0,45,Phoenix,8.0,8,-6,-25,-4,1,down,1975-09-27
2264,Johnny Guitar Watson,1975-09-27,"Johnny Guitar Watson - I Don't Want To Be Alone, Stranger",51,51,40,40.0,46,"I Don't Want To Be Alone, Stranger",1.0,0,6,5,0,1,up,1975-09-27
2265,Johnny Guitar Watson,1975-10-04,"Johnny Guitar Watson - I Don't Want To Be Alone, Stranger",46,51,51,40.0,40,"I Don't Want To Be Alone, Stranger",1.0,1,-11,6,5,1,down,1975-09-27
2266,Silver Convention,1975-09-27,Silver Convention - Save Me,51,51,39,1.0,48,Save Me,19.0,0,9,3,0,1,up,1975-09-27
2267,Silver Convention,1975-10-04,Silver Convention - Save Me,48,51,31,1.0,39,Save Me,19.0,1,8,9,3,1,up,1975-09-27
2268,Silver Convention,1975-10-11,Silver Convention - Save Me,39,48,25,1.0,31,Save Me,19.0,2,6,8,9,1,up,1975-09-27
2269,Silver Convention,1975-10-18,Silver Convention - Save Me,31,39,20,1.0,25,Save Me,19.0,3,5,6,8,1,up,1975-09-27
2270,Silver Convention,1975-10-25,Silver Convention - Save Me,25,31,12,1.0,20,Save Me,19.0,4,8,5,6,1,up,1975-09-27
2271,Silver Convention,1975-11-01,Silver Convention - Save Me,20,25,7,1.0,12,Save Me,19.0,5,5,8,5,1,up,1975-09-27
2272,Silver Convention,1975-11-08,Silver Convention - Save Me,12,20,3,1.0,7,Save Me,19.0,6,4,5,8,1,up,1975-09-27
2273,Silver Convention,1975-11-15,Silver Convention - Save Me,7,12,2,1.0,3,Save Me,19.0,7,1,4,5,1,up,1975-09-27
2274,Silver Convention,1975-11-22,Silver Convention - Save Me,3,7,1,1.0,2,Save Me,19.0,8,1,1,4,1,up,1975-09-27
2275,Silver Convention,1975-11-29,Silver Convention - Save Me,2,3,2,1.0,1,Save Me,19.0,9,-1,1,1,1,down,1975-09-27
2276,Silver Convention,1975-12-06,Silver Convention - Save Me,1,2,2,1.0,2,Save Me,19.0,10,0,-1,1,0,stay,1975-09-27
2277,Silver Convention,1975-12-13,Silver Convention - Save Me,2,1,4,1.0,2,Save Me,19.0,11,-2,0,-1,1,down,1975-09-27
2278,Silver Convention,1975-12-20,Silver Convention - Save Me,2,2,5,1.0,4,Save Me,19.0,12,-1,-2,0,1,down,1975-09-27
2279,Silver Convention,1975-12-27,Silver Convention - Save Me,4,2,7,1.0,5,Save Me,19.0,13,-2,-1,-2,1,down,1975-09-27
2280,Silver Convention,1976-01-03,Silver Convention - Save Me,5,4,14,1.0,7,Save Me,19.0,14,-7,-2,-1,1,down,1975-09-27
2281,Silver Convention,1976-01-10,Silver Convention - Save Me,7,5,25,1.0,14,Save Me,19.0,15,-11,-7,-2,1,down,1975-09-27
2282,Silver Convention,1976-01-17,Silver Convention - Save Me,14,7,30,1.0,25,Save Me,19.0,16,-5,-11,-7,1,down,1975-09-27
2283,Silver Convention,1976-01-24,Silver Convention - Save Me,25,14,32,1.0,30,Save Me,19.0,17,-2,-5,-11,1,down,1975-09-27
2284,Silver Convention,1976-01-31,Silver Convention - Save Me,30,25,34,1.0,32,Save Me,19.0,18,-2,-2,-5,1,down,1975-09-27
2285,Silver Convention,1976-02-07,Silver Convention - Save Me,32,30,51,1.0,34,Save Me,19.0,19,-17,-2,-2,1,down,1975-09-27
2286,Herbie Mann,1975-09-27,Herbie Mann - Waterbed,51,51,35,21.0,49,Waterbed,7.0,0,14,2,0,1,up,1975-09-27
2287,Herbie Mann,1975-10-04,Herbie Mann - Waterbed,49,51,29,21.0,35,Waterbed,7.0,1,6,14,2,1,up,1975-09-27
2288,Herbie Mann,1975-10-11,Herbie Mann - Waterbed,35,49,22,21.0,29,Waterbed,7.0,2,7,6,14,1,up,1975-09-27
2289,Herbie Mann,1975-10-18,Herbie Mann - Waterbed,29,35,22,21.0,22,Waterbed,7.0,3,0,7,6,0,stay,1975-09-27
2290,Herbie Mann,1975-10-25,Herbie Mann - Waterbed,22,29,21,21.0,22,Waterbed,7.0,4,1,0,7,1,up,1975-09-27
2291,Herbie Mann,1975-11-01,Herbie Mann - Waterbed,22,22,21,21.0,21,Waterbed,7.0,5,0,1,0,0,stay,1975-09-27
2292,Herbie Mann,1975-11-08,Herbie Mann - Waterbed,21,22,23,21.0,21,Waterbed,7.0,6,-2,0,1,1,down,1975-09-27
2293,Herbie Mann,1975-11-15,Herbie Mann - Waterbed,21,21,51,21.0,23,Waterbed,7.0,7,-28,-2,0,1,down,1975-09-27
2294,Merry Clayton,1975-09-27,Merry Clayton - Keep Your Eye On Sparrow,51,51,51,50.0,50,Keep Your Eye On Sparrow,0.0,0,-1,1,0,1,down,1975-09-27
2295,Eumir Deodato,1975-10-04,Eumir Deodato - First Cuckoo,51,51,28,15.0,41,First Cuckoo,5.0,0,13,10,0,1,up,1975-10-04
2296,Eumir Deodato,1975-10-11,Eumir Deodato - First Cuckoo,41,51,15,15.0,28,First Cuckoo,5.0,1,13,13,10,1,up,1975-10-04
2297,Eumir Deodato,1975-10-18,Eumir Deodato - First Cuckoo,28,41,15,15.0,15,First Cuckoo,5.0,2,0,13,13,0,stay,1975-10-04
2298,Eumir Deodato,1975-10-25,Eumir Deodato - First Cuckoo,15,28,18,15.0,15,First Cuckoo,5.0,3,-3,0,13,1,down,1975-10-04
2299,Eumir Deodato,1975-11-01,Eumir Deodato - First Cuckoo,15,15,37,15.0,18,First Cuckoo,5.0,4,-19,-3,0,1,down,1975-10-04
2300,Eumir Deodato,1975-11-08,Eumir Deodato - First Cuckoo,18,15,51,15.0,37,First Cuckoo,5.0,5,-14,-19,-3,1,down,1975-10-04
2301,Blue Magic,1975-10-04,Blue Magic - Thirteen Blue Magic Lane,51,51,25,9.0,47,Thirteen Blue Magic Lane,10.0,0,22,4,0,1,up,1975-10-04
2302,Blue Magic,1975-10-11,Blue Magic - Thirteen Blue Magic Lane,47,51,17,9.0,25,Thirteen Blue Magic Lane,10.0,1,8,22,4,1,up,1975-10-04
2303,Blue Magic,1975-10-18,Blue Magic - Thirteen Blue Magic Lane,25,47,13,9.0,17,Thirteen Blue Magic Lane,10.0,2,4,8,22,1,up,1975-10-04
2304,Blue Magic,1975-10-25,Blue Magic - Thirteen Blue Magic Lane,17,25,10,9.0,13,Thirteen Blue Magic Lane,10.0,3,3,4,8,1,up,1975-10-04
2305,Blue Magic,1975-11-01,Blue Magic - Thirteen Blue Magic Lane,13,17,9,9.0,10,Thirteen Blue Magic Lane,10.0,4,1,3,4,1,up,1975-10-04
2306,Blue Magic,1975-11-08,Blue Magic - Thirteen Blue Magic Lane,10,13,9,9.0,9,Thirteen Blue Magic Lane,10.0,5,0,1,3,0,stay,1975-10-04
2307,Blue Magic,1975-11-15,Blue Magic - Thirteen Blue Magic Lane,9,10,13,9.0,9,Thirteen Blue Magic Lane,10.0,6,-4,0,1,1,down,1975-10-04
2308,Blue Magic,1975-11-22,Blue Magic - Thirteen Blue Magic Lane,9,9,13,9.0,13,Thirteen Blue Magic Lane,10.0,7,0,-4,0,0,stay,1975-10-04
2309,Blue Magic,1975-11-29,Blue Magic - Thirteen Blue Magic Lane,13,9,22,9.0,13,Thirteen Blue Magic Lane,10.0,8,-9,0,-4,1,down,1975-10-04
2310,Blue Magic,1975-12-06,Blue Magic - Thirteen Blue Magic Lane,13,13,46,9.0,22,Thirteen Blue Magic Lane,10.0,9,-24,-9,0,1,down,1975-10-04
2311,Blue Magic,1975-12-13,Blue Magic - Thirteen Blue Magic Lane,22,13,51,9.0,46,Thirteen Blue Magic Lane,10.0,10,-5,-24,-9,1,down,1975-10-04
2312,Tina Turner,1975-10-04,Tina Turner - Acid Queen,51,51,43,39.0,49,Acid Queen,3.0,0,6,2,0,1,up,1975-10-04
2313,Tina Turner,1975-10-11,Tina Turner - Acid Queen,49,51,39,39.0,43,Acid Queen,3.0,1,4,6,2,1,up,1975-10-04
2314,Tina Turner,1975-10-18,Tina Turner - Acid Queen,43,49,42,39.0,39,Acid Queen,3.0,2,-3,4,6,1,down,1975-10-04
2315,Tina Turner,1975-10-25,Tina Turner - Acid Queen,39,43,51,39.0,42,Acid Queen,3.0,3,-9,-3,4,1,down,1975-10-04
2316,Ronnie Laws,1975-10-04,Ronnie Laws - Pressure Sensitive,51,51,40,25.0,50,Pressure Sensitive,7.0,0,10,1,0,1,up,1975-10-04
2317,Ronnie Laws,1975-10-11,Ronnie Laws - Pressure Sensitive,50,51,31,25.0,40,Pressure Sensitive,7.0,1,9,10,1,1,up,1975-10-04
2318,Ronnie Laws,1975-10-18,Ronnie Laws - Pressure Sensitive,40,50,28,25.0,31,Pressure Sensitive,7.0,2,3,9,10,1,up,1975-10-04
2319,Ronnie Laws,1975-10-25,Ronnie Laws - Pressure Sensitive,31,40,25,25.0,28,Pressure Sensitive,7.0,3,3,3,9,1,up,1975-10-04
2320,Ronnie Laws,1975-11-01,Ronnie Laws - Pressure Sensitive,28,31,38,25.0,25,Pressure Sensitive,7.0,4,-13,3,3,1,down,1975-10-04
2321,Ronnie Laws,1975-11-08,Ronnie Laws - Pressure Sensitive,25,28,36,25.0,38,Pressure Sensitive,7.0,5,2,-13,3,1,up,1975-10-04
2322,Ronnie Laws,1975-11-15,Ronnie Laws - Pressure Sensitive,38,25,42,25.0,36,Pressure Sensitive,7.0,6,-6,2,-13,1,down,1975-10-04
2323,Ronnie Laws,1975-11-22,Ronnie Laws - Pressure Sensitive,36,38,51,25.0,42,Pressure Sensitive,7.0,7,-9,-6,2,1,down,1975-10-04
2324,Ramsey Lewis,1975-10-11,Ramsey Lewis - Don't It Feel Good,51,51,20,5.0,36,Don't It Feel Good,10.0,0,16,15,0,1,up,1975-10-11
2325,Ramsey Lewis,1975-10-18,Ramsey Lewis - Don't It Feel Good,36,51,12,5.0,20,Don't It Feel Good,10.0,1,8,16,15,1,up,1975-10-11
2326,Ramsey Lewis,1975-10-25,Ramsey Lewis - Don't It Feel Good,20,36,9,5.0,12,Don't It Feel Good,10.0,2,3,8,16,1,up,1975-10-11
2327,Ramsey Lewis,1975-11-01,Ramsey Lewis - Don't It Feel Good,12,20,8,5.0,9,Don't It Feel Good,10.0,3,1,3,8,1,up,1975-10-11
2328,Ramsey Lewis,1975-11-08,Ramsey Lewis - Don't It Feel Good,9,12,7,5.0,8,Don't It Feel Good,10.0,4,1,1,3,1,up,1975-10-11
2329,Ramsey Lewis,1975-11-15,Ramsey Lewis - Don't It Feel Good,8,9,5,5.0,7,Don't It Feel Good,10.0,5,2,1,1,1,up,1975-10-11
2330,Ramsey Lewis,1975-11-22,Ramsey Lewis - Don't It Feel Good,7,8,5,5.0,5,Don't It Feel Good,10.0,6,0,2,1,0,stay,1975-10-11
2331,Ramsey Lewis,1975-11-29,Ramsey Lewis - Don't It Feel Good,5,7,19,5.0,5,Don't It Feel Good,10.0,7,-14,0,2,1,down,1975-10-11
2332,Ramsey Lewis,1975-12-06,Ramsey Lewis - Don't It Feel Good,5,5,25,5.0,19,Don't It Feel Good,10.0,8,-6,-14,0,1,down,1975-10-11
2333,Ramsey Lewis,1975-12-13,Ramsey Lewis - Don't It Feel Good,19,5,33,5.0,25,Don't It Feel Good,10.0,9,-8,-6,-14,1,down,1975-10-11
2334,Ramsey Lewis,1975-12-20,Ramsey Lewis - Don't It Feel Good,25,19,51,5.0,33,Don't It Feel Good,10.0,10,-18,-8,-6,1,down,1975-10-11
2335,James Brown,1975-10-11,James Brown - Everybody's Doin' The Hustle & Dead Double Bump,51,51,33,22.0,41,Everybody's Doin' The Hustle & Dead Double Bump,5.0,0,8,10,0,1,up,1975-10-11
2336,James Brown,1975-10-18,James Brown - Everybody's Doin' The Hustle & Dead Double Bump,41,51,26,22.0,33,Everybody's Doin' The Hustle & Dead Double Bump,5.0,1,7,8,10,1,up,1975-10-11
2337,James Brown,1975-10-25,James Brown - Everybody's Doin' The Hustle & Dead Double Bump,33,41,22,22.0,26,Everybody's Doin' The Hustle & Dead Double Bump,5.0,2,4,7,8,1,up,1975-10-11
2338,James Brown,1975-11-01,James Brown - Everybody's Doin' The Hustle & Dead Double Bump,26,33,23,22.0,22,Everybody's Doin' The Hustle & Dead Double Bump,5.0,3,-1,4,7,1,down,1975-10-11
2339,James Brown,1975-11-08,James Brown - Everybody's Doin' The Hustle & Dead Double Bump,22,26,31,22.0,23,Everybody's Doin' The Hustle & Dead Double Bump,5.0,4,-8,-1,4,1,down,1975-10-11
2340,James Brown,1975-11-15,James Brown - Everybody's Doin' The Hustle & Dead Double Bump,23,22,51,22.0,31,Everybody's Doin' The Hustle & Dead Double Bump,5.0,5,-20,-8,-1,1,down,1975-10-11
2341,Gloria Gaynor,1975-10-11,Gloria Gaynor - Experience Gloria Gaynor,51,51,37,32.0,45,Experience Gloria Gaynor,5.0,0,8,6,0,1,up,1975-10-11
2342,Gloria Gaynor,1975-10-18,Gloria Gaynor - Experience Gloria Gaynor,45,51,33,32.0,37,Experience Gloria Gaynor,5.0,1,4,8,6,1,up,1975-10-11
2343,Gloria Gaynor,1975-10-25,Gloria Gaynor - Experience Gloria Gaynor,37,45,32,32.0,33,Experience Gloria Gaynor,5.0,2,1,4,8,1,up,1975-10-11
2344,Gloria Gaynor,1975-11-01,Gloria Gaynor - Experience Gloria Gaynor,33,37,33,32.0,32,Experience Gloria Gaynor,5.0,3,-1,1,4,1,down,1975-10-11
2345,Gloria Gaynor,1975-11-08,Gloria Gaynor - Experience Gloria Gaynor,32,33,35,32.0,33,Experience Gloria Gaynor,5.0,4,-2,-1,1,1,down,1975-10-11
2346,Gloria Gaynor,1975-11-15,Gloria Gaynor - Experience Gloria Gaynor,33,32,51,32.0,35,Experience Gloria Gaynor,5.0,5,-16,-2,-1,1,down,1975-10-11
2347,Eddie Harris,1975-10-11,Eddie Harris - Bad Luck Is All I Have,51,51,35,26.0,46,Bad Luck Is All I Have,5.0,0,11,5,0,1,up,1975-10-11
2348,Eddie Harris,1975-10-18,Eddie Harris - Bad Luck Is All I Have,46,51,29,26.0,35,Bad Luck Is All I Have,5.0,1,6,11,5,1,up,1975-10-11
2349,Eddie Harris,1975-10-25,Eddie Harris - Bad Luck Is All I Have,35,46,26,26.0,29,Bad Luck Is All I Have,5.0,2,3,6,11,1,up,1975-10-11
2350,Eddie Harris,1975-11-01,Eddie Harris - Bad Luck Is All I Have,29,35,26,26.0,26,Bad Luck Is All I Have,5.0,3,0,3,6,0,stay,1975-10-11
2351,Eddie Harris,1975-11-08,Eddie Harris - Bad Luck Is All I Have,26,29,27,26.0,26,Bad Luck Is All I Have,5.0,4,-1,0,3,1,down,1975-10-11
2352,Eddie Harris,1975-11-15,Eddie Harris - Bad Luck Is All I Have,26,26,51,26.0,27,Bad Luck Is All I Have,5.0,5,-24,-1,0,1,down,1975-10-11
2353,Van Mccoy,1975-10-11,Van Mccoy - From Disco To Love,51,51,44,41.0,47,From Disco To Love,4.0,0,3,4,0,1,up,1975-10-11
2354,Van Mccoy,1975-10-18,Van Mccoy - From Disco To Love,47,51,44,41.0,44,From Disco To Love,4.0,1,0,3,4,0,stay,1975-10-11
2355,Van Mccoy,1975-10-25,Van Mccoy - From Disco To Love,44,47,41,41.0,44,From Disco To Love,4.0,2,3,0,3,1,up,1975-10-11
2356,Van Mccoy,1975-11-01,Van Mccoy - From Disco To Love,44,44,49,41.0,41,From Disco To Love,4.0,3,-8,3,0,1,down,1975-10-11
2357,Van Mccoy,1975-11-08,Van Mccoy - From Disco To Love,41,44,51,41.0,49,From Disco To Love,4.0,4,-2,-8,3,1,down,1975-10-11
2358,The Staple Singers,1975-10-11,The Staple Singers - Let's Do It Again,51,51,42,1.0,48,Let's Do It Again,21.0,0,6,3,0,1,up,1975-10-11
2359,The Staple Singers,1975-10-18,The Staple Singers - Let's Do It Again,48,51,38,1.0,42,Let's Do It Again,21.0,1,4,6,3,1,up,1975-10-11
2360,The Staple Singers,1975-10-25,The Staple Singers - Let's Do It Again,42,48,29,1.0,38,Let's Do It Again,21.0,2,9,4,6,1,up,1975-10-11
2361,The Staple Singers,1975-11-01,The Staple Singers - Let's Do It Again,38,42,19,1.0,29,Let's Do It Again,21.0,3,10,9,4,1,up,1975-10-11
2362,The Staple Singers,1975-11-08,The Staple Singers - Let's Do It Again,29,38,11,1.0,19,Let's Do It Again,21.0,4,8,10,9,1,up,1975-10-11
2363,The Staple Singers,1975-11-15,The Staple Singers - Let's Do It Again,19,29,3,1.0,11,Let's Do It Again,21.0,5,8,8,10,1,up,1975-10-11
2364,The Staple Singers,1975-11-22,The Staple Singers - Let's Do It Again,11,19,2,1.0,3,Let's Do It Again,21.0,6,1,8,8,1,up,1975-10-11
2365,The Staple Singers,1975-11-29,The Staple Singers - Let's Do It Again,3,11,1,1.0,2,Let's Do It Again,21.0,7,1,1,8,1,up,1975-10-11
2366,The Staple Singers,1975-12-06,The Staple Singers - Let's Do It Again,2,3,1,1.0,1,Let's Do It Again,21.0,8,0,1,1,0,stay,1975-10-11
2367,The Staple Singers,1975-12-13,The Staple Singers - Let's Do It Again,1,2,2,1.0,1,Let's Do It Again,21.0,9,-1,0,1,1,down,1975-10-11
2368,The Staple Singers,1975-12-20,The Staple Singers - Let's Do It Again,1,1,3,1.0,2,Let's Do It Again,21.0,10,-1,-1,0,1,down,1975-10-11
2369,The Staple Singers,1975-12-27,The Staple Singers - Let's Do It Again,2,1,4,1.0,3,Let's Do It Again,21.0,11,-1,-1,-1,1,down,1975-10-11
2370,The Staple Singers,1976-01-03,The Staple Singers - Let's Do It Again,3,2,4,1.0,4,Let's Do It Again,21.0,12,0,-1,-1,0,stay,1975-10-11
2371,The Staple Singers,1976-01-10,The Staple Singers - Let's Do It Again,4,3,8,1.0,4,Let's Do It Again,21.0,13,-4,0,-1,1,down,1975-10-11
2372,The Staple Singers,1976-01-17,The Staple Singers - Let's Do It Again,4,4,13,1.0,8,Let's Do It Again,21.0,14,-5,-4,0,1,down,1975-10-11
2373,The Staple Singers,1976-01-24,The Staple Singers - Let's Do It Again,8,4,14,1.0,13,Let's Do It Again,21.0,15,-1,-5,-4,1,down,1975-10-11
2374,The Staple Singers,1976-01-31,The Staple Singers - Let's Do It Again,13,8,21,1.0,14,Let's Do It Again,21.0,16,-7,-1,-5,1,down,1975-10-11
2375,The Staple Singers,1976-02-07,The Staple Singers - Let's Do It Again,14,13,27,1.0,21,Let's Do It Again,21.0,17,-6,-7,-1,1,down,1975-10-11
2376,The Staple Singers,1976-02-14,The Staple Singers - Let's Do It Again,21,14,43,1.0,27,Let's Do It Again,21.0,18,-16,-6,-7,1,down,1975-10-11
2377,The Staple Singers,1976-02-21,The Staple Singers - Let's Do It Again,27,21,44,1.0,43,Let's Do It Again,21.0,19,-1,-16,-6,1,down,1975-10-11
2378,The Staple Singers,1976-02-28,The Staple Singers - Let's Do It Again,43,27,44,1.0,44,Let's Do It Again,21.0,20,0,-1,-16,0,stay,1975-10-11
2379,The Staple Singers,1976-03-06,The Staple Singers - Let's Do It Again,44,43,51,1.0,44,Let's Do It Again,21.0,21,-7,0,-1,1,down,1975-10-11
2380,Lonnie Liston Smith,1975-10-11,Lonnie Liston Smith - Visions Of A New World,51,51,40,14.0,50,Visions Of A New World,16.0,0,10,1,0,1,up,1975-10-11
2381,Lonnie Liston Smith,1975-10-18,Lonnie Liston Smith - Visions Of A New World,50,51,31,14.0,40,Visions Of A New World,16.0,1,9,10,1,1,up,1975-10-11
2382,Lonnie Liston Smith,1975-10-25,Lonnie Liston Smith - Visions Of A New World,40,50,23,14.0,31,Visions Of A New World,16.0,2,8,9,10,1,up,1975-10-11
2383,Lonnie Liston Smith,1975-11-01,Lonnie Liston Smith - Visions Of A New World,31,40,22,14.0,23,Visions Of A New World,16.0,3,1,8,9,1,up,1975-10-11
2384,Lonnie Liston Smith,1975-11-08,Lonnie Liston Smith - Visions Of A New World,23,31,19,14.0,22,Visions Of A New World,16.0,4,3,1,8,1,up,1975-10-11
2385,Lonnie Liston Smith,1975-11-15,Lonnie Liston Smith - Visions Of A New World,22,23,19,14.0,19,Visions Of A New World,16.0,5,0,3,1,0,stay,1975-10-11
2386,Lonnie Liston Smith,1975-11-22,Lonnie Liston Smith - Visions Of A New World,19,22,16,14.0,19,Visions Of A New World,16.0,6,3,0,3,1,up,1975-10-11
2387,Lonnie Liston Smith,1975-11-29,Lonnie Liston Smith - Visions Of A New World,19,19,14,14.0,16,Visions Of A New World,16.0,7,2,3,0,1,up,1975-10-11
2388,Lonnie Liston Smith,1975-12-06,Lonnie Liston Smith - Visions Of A New World,16,19,14,14.0,14,Visions Of A New World,16.0,8,0,2,3,0,stay,1975-10-11
2389,Lonnie Liston Smith,1975-12-13,Lonnie Liston Smith - Visions Of A New World,14,16,26,14.0,14,Visions Of A New World,16.0,9,-12,0,2,1,down,1975-10-11
2390,Lonnie Liston Smith,1975-12-20,Lonnie Liston Smith - Visions Of A New World,14,14,36,14.0,26,Visions Of A New World,16.0,10,-10,-12,0,1,down,1975-10-11
2391,Lonnie Liston Smith,1975-12-27,Lonnie Liston Smith - Visions Of A New World,26,14,46,14.0,36,Visions Of A New World,16.0,11,-10,-10,-12,1,down,1975-10-11
2392,Lonnie Liston Smith,1976-01-03,Lonnie Liston Smith - Visions Of A New World,36,26,41,14.0,46,Visions Of A New World,16.0,12,5,-10,-10,1,up,1975-10-11
2393,Lonnie Liston Smith,1976-01-10,Lonnie Liston Smith - Visions Of A New World,46,36,36,14.0,41,Visions Of A New World,16.0,13,5,5,-10,1,up,1975-10-11
2394,Lonnie Liston Smith,1976-01-17,Lonnie Liston Smith - Visions Of A New World,41,46,33,14.0,36,Visions Of A New World,16.0,14,3,5,5,1,up,1975-10-11
2395,Lonnie Liston Smith,1976-01-24,Lonnie Liston Smith - Visions Of A New World,36,41,42,14.0,33,Visions Of A New World,16.0,15,-9,3,5,1,down,1975-10-11
2396,Lonnie Liston Smith,1976-01-31,Lonnie Liston Smith - Visions Of A New World,33,36,51,14.0,42,Visions Of A New World,16.0,16,-9,-9,3,1,down,1975-10-11
2397,The Sunshine Band,1975-10-18,The Sunshine Band - The Sound Of Sunshine,51,51,35,24.0,43,The Sound Of Sunshine,5.0,0,8,8,0,1,up,1975-10-18
2398,The Sunshine Band,1975-10-25,The Sunshine Band - The Sound Of Sunshine,43,51,24,24.0,35,The Sound Of Sunshine,5.0,1,11,8,8,1,up,1975-10-18
2399,The Sunshine Band,1975-11-01,The Sunshine Band - The Sound Of Sunshine,35,43,24,24.0,24,The Sound Of Sunshine,5.0,2,0,11,8,0,stay,1975-10-18
2400,The Sunshine Band,1975-11-08,The Sunshine Band - The Sound Of Sunshine,24,35,25,24.0,24,The Sound Of Sunshine,5.0,3,-1,0,11,1,down,1975-10-18
2401,The Sunshine Band,1975-11-15,The Sunshine Band - The Sound Of Sunshine,24,24,25,24.0,25,The Sound Of Sunshine,5.0,4,0,-1,0,0,stay,1975-10-18
2402,The Sunshine Band,1975-11-22,The Sunshine Band - The Sound Of Sunshine,25,24,51,24.0,25,The Sound Of Sunshine,5.0,5,-26,0,-1,1,down,1975-10-18
2403,Tower Of Power,1975-10-18,Tower Of Power - In The Slot,51,51,37,29.0,45,In The Slot,6.0,0,8,6,0,1,up,1975-10-18
2404,Tower Of Power,1975-10-25,Tower Of Power - In The Slot,45,51,31,29.0,37,In The Slot,6.0,1,6,8,6,1,up,1975-10-18
2405,Tower Of Power,1975-11-01,Tower Of Power - In The Slot,37,45,29,29.0,31,In The Slot,6.0,2,2,6,8,1,up,1975-10-18
2406,Tower Of Power,1975-11-08,Tower Of Power - In The Slot,31,37,29,29.0,29,In The Slot,6.0,3,0,2,6,0,stay,1975-10-18
2407,Tower Of Power,1975-11-15,Tower Of Power - In The Slot,29,31,33,29.0,29,In The Slot,6.0,4,-4,0,2,1,down,1975-10-18
2408,Tower Of Power,1975-11-22,Tower Of Power - In The Slot,29,29,43,29.0,33,In The Slot,6.0,5,-10,-4,0,1,down,1975-10-18
2409,Tower Of Power,1975-11-29,Tower Of Power - In The Slot,33,29,51,29.0,43,In The Slot,6.0,6,-8,-10,-4,1,down,1975-10-18
2410,Michael Jackson,1975-10-18,Michael Jackson - The Best Of Michael Jackson: 20th Century Masters The Millenium Collection,51,51,45,44.0,46,The Best Of Michael Jackson: 20th Century Masters The Millenium Collection,3.0,0,1,5,0,1,up,1975-10-18
2411,Michael Jackson,1975-10-25,Michael Jackson - The Best Of Michael Jackson: 20th Century Masters The Millenium Collection,46,51,44,44.0,45,The Best Of Michael Jackson: 20th Century Masters The Millenium Collection,3.0,1,1,1,5,1,up,1975-10-18
2412,Michael Jackson,1975-11-01,Michael Jackson - The Best Of Michael Jackson: 20th Century Masters The Millenium Collection,45,46,46,44.0,44,The Best Of Michael Jackson: 20th Century Masters The Millenium Collection,3.0,2,-2,1,1,1,down,1975-10-18
2413,Michael Jackson,1975-11-08,Michael Jackson - The Best Of Michael Jackson: 20th Century Masters The Millenium Collection,44,45,51,44.0,46,The Best Of Michael Jackson: 20th Century Masters The Millenium Collection,3.0,3,-5,-2,1,1,down,1975-10-18
2414,Taj Mahal,1975-10-18,Taj Mahal - Music Keeps Me Together,51,51,43,40.0,47,Music Keeps Me Together,4.0,0,4,4,0,1,up,1975-10-18
2415,Taj Mahal,1975-10-25,Taj Mahal - Music Keeps Me Together,47,51,40,40.0,43,Music Keeps Me Together,4.0,1,3,4,4,1,up,1975-10-18
2416,Taj Mahal,1975-11-01,Taj Mahal - Music Keeps Me Together,43,47,40,40.0,40,Music Keeps Me Together,4.0,2,0,3,4,0,stay,1975-10-18
2417,Taj Mahal,1975-11-08,Taj Mahal - Music Keeps Me Together,40,43,47,40.0,40,Music Keeps Me Together,4.0,3,-7,0,3,1,down,1975-10-18
2418,Taj Mahal,1975-11-15,Taj Mahal - Music Keeps Me Together,40,40,51,40.0,47,Music Keeps Me Together,4.0,4,-4,-7,0,1,down,1975-10-18
2419,Chocolate Milk,1975-10-18,Chocolate Milk - Action Speaks Louder Than Words,51,51,40,34.0,48,Action Speaks Louder Than Words,5.0,0,8,3,0,1,up,1975-10-18
2420,Chocolate Milk,1975-10-25,Chocolate Milk - Action Speaks Louder Than Words,48,51,34,34.0,40,Action Speaks Louder Than Words,5.0,1,6,8,3,1,up,1975-10-18
2421,Chocolate Milk,1975-11-01,Chocolate Milk - Action Speaks Louder Than Words,40,48,34,34.0,34,Action Speaks Louder Than Words,5.0,2,0,6,8,0,stay,1975-10-18
2422,Chocolate Milk,1975-11-08,Chocolate Milk - Action Speaks Louder Than Words,34,40,41,34.0,34,Action Speaks Louder Than Words,5.0,3,-7,0,6,1,down,1975-10-18
2423,Chocolate Milk,1975-11-15,Chocolate Milk - Action Speaks Louder Than Words,34,34,37,34.0,41,Action Speaks Louder Than Words,5.0,4,4,-7,0,1,up,1975-10-18
2424,Chocolate Milk,1975-11-22,Chocolate Milk - Action Speaks Louder Than Words,41,34,51,34.0,37,Action Speaks Louder Than Words,5.0,5,-14,4,-7,1,down,1975-10-18
2425,Soundtrack,1975-10-18,Soundtrack - Cooley High,51,51,46,45.0,49,Cooley High,4.0,0,3,2,0,1,up,1975-10-18
2426,Soundtrack,1975-10-25,Soundtrack - Cooley High,49,51,46,45.0,46,Cooley High,4.0,1,0,3,2,0,stay,1975-10-18
2427,Soundtrack,1975-11-01,Soundtrack - Cooley High,46,49,45,45.0,46,Cooley High,4.0,2,1,0,3,1,up,1975-10-18
2428,Soundtrack,1975-11-08,Soundtrack - Cooley High,46,46,45,45.0,45,Cooley High,4.0,3,0,1,0,0,stay,1975-10-18
2429,Soundtrack,1975-11-15,Soundtrack - Cooley High,45,46,51,45.0,45,Cooley High,4.0,4,-6,0,1,1,down,1975-10-18
2430,Crown Heights Affair,1975-10-25,Crown Heights Affair - Dreaming A Dream,51,51,37,28.0,47,Dreaming A Dream,6.0,0,10,4,0,1,up,1975-10-25
2431,Crown Heights Affair,1975-11-01,Crown Heights Affair - Dreaming A Dream,47,51,30,28.0,37,Dreaming A Dream,6.0,1,7,10,4,1,up,1975-10-25
2432,Crown Heights Affair,1975-11-08,Crown Heights Affair - Dreaming A Dream,37,47,30,28.0,30,Dreaming A Dream,6.0,2,0,7,10,0,stay,1975-10-25
2433,Crown Heights Affair,1975-11-15,Crown Heights Affair - Dreaming A Dream,30,37,28,28.0,30,Dreaming A Dream,6.0,3,2,0,7,1,up,1975-10-25
2434,Crown Heights Affair,1975-11-22,Crown Heights Affair - Dreaming A Dream,30,30,28,28.0,28,Dreaming A Dream,6.0,4,0,2,0,0,stay,1975-10-25
2435,Crown Heights Affair,1975-11-29,Crown Heights Affair - Dreaming A Dream,28,30,49,28.0,28,Dreaming A Dream,6.0,5,-21,0,2,1,down,1975-10-25
2436,Crown Heights Affair,1975-12-06,Crown Heights Affair - Dreaming A Dream,28,28,51,28.0,49,Dreaming A Dream,6.0,6,-2,-21,0,1,down,1975-10-25
2437,Herbie Hancock,1975-10-25,Herbie Hancock - Man-child,51,51,36,6.0,49,Man-child,8.0,0,13,2,0,1,up,1975-10-25
2438,Herbie Hancock,1975-11-01,Herbie Hancock - Man-child,49,51,17,6.0,36,Man-child,8.0,1,19,13,2,1,up,1975-10-25
2439,Herbie Hancock,1975-11-08,Herbie Hancock - Man-child,36,49,12,6.0,17,Man-child,8.0,2,5,19,13,1,up,1975-10-25
2440,Herbie Hancock,1975-11-15,Herbie Hancock - Man-child,17,36,6,6.0,12,Man-child,8.0,3,6,5,19,1,up,1975-10-25
2441,Herbie Hancock,1975-11-22,Herbie Hancock - Man-child,12,17,6,6.0,6,Man-child,8.0,4,0,6,5,0,stay,1975-10-25
2442,Herbie Hancock,1975-11-29,Herbie Hancock - Man-child,6,12,20,6.0,6,Man-child,8.0,5,-14,0,6,1,down,1975-10-25
2443,Herbie Hancock,1975-12-06,Herbie Hancock - Man-child,6,6,29,6.0,20,Man-child,8.0,6,-9,-14,0,1,down,1975-10-25
2444,Herbie Hancock,1975-12-13,Herbie Hancock - Man-child,20,6,34,6.0,29,Man-child,8.0,7,-5,-9,-14,1,down,1975-10-25
2445,Herbie Hancock,1975-12-20,Herbie Hancock - Man-child,29,20,51,6.0,34,Man-child,8.0,8,-17,-5,-9,1,down,1975-10-25
2446,Gladys Knight And The Pips,1975-11-01,Gladys Knight And The Pips - Second Anniversary,51,51,18,4.0,30,Second Anniversary,14.0,0,12,21,0,1,up,1975-11-01
2447,Gladys Knight And The Pips,1975-11-08,Gladys Knight And The Pips - Second Anniversary,30,51,13,4.0,18,Second Anniversary,14.0,1,5,12,21,1,up,1975-11-01
2448,Gladys Knight And The Pips,1975-11-15,Gladys Knight And The Pips - Second Anniversary,18,30,9,4.0,13,Second Anniversary,14.0,2,4,5,12,1,up,1975-11-01
2449,Gladys Knight And The Pips,1975-11-22,Gladys Knight And The Pips - Second Anniversary,13,18,7,4.0,9,Second Anniversary,14.0,3,2,4,5,1,up,1975-11-01
2450,Gladys Knight And The Pips,1975-11-29,Gladys Knight And The Pips - Second Anniversary,9,13,4,4.0,7,Second Anniversary,14.0,4,3,2,4,1,up,1975-11-01
2451,Gladys Knight And The Pips,1975-12-06,Gladys Knight And The Pips - Second Anniversary,7,9,4,4.0,4,Second Anniversary,14.0,5,0,3,2,0,stay,1975-11-01
2452,Gladys Knight And The Pips,1975-12-13,Gladys Knight And The Pips - Second Anniversary,4,7,11,4.0,4,Second Anniversary,14.0,6,-7,0,3,1,down,1975-11-01
2453,Gladys Knight And The Pips,1975-12-20,Gladys Knight And The Pips - Second Anniversary,4,4,20,4.0,11,Second Anniversary,14.0,7,-9,-7,0,1,down,1975-11-01
2454,Gladys Knight And The Pips,1975-12-27,Gladys Knight And The Pips - Second Anniversary,11,4,21,4.0,20,Second Anniversary,14.0,8,-1,-9,-7,1,down,1975-11-01
2455,Gladys Knight And The Pips,1976-01-03,Gladys Knight And The Pips - Second Anniversary,20,11,31,4.0,21,Second Anniversary,14.0,9,-10,-1,-9,1,down,1975-11-01
2456,Gladys Knight And The Pips,1976-01-10,Gladys Knight And The Pips - Second Anniversary,21,20,28,4.0,31,Second Anniversary,14.0,10,3,-10,-1,1,up,1975-11-01
2457,Gladys Knight And The Pips,1976-01-17,Gladys Knight And The Pips - Second Anniversary,31,21,28,4.0,28,Second Anniversary,14.0,11,0,3,-10,0,stay,1975-11-01
2458,Gladys Knight And The Pips,1976-01-24,Gladys Knight And The Pips - Second Anniversary,28,31,29,4.0,28,Second Anniversary,14.0,12,-1,0,3,1,down,1975-11-01
2459,Gladys Knight And The Pips,1976-01-31,Gladys Knight And The Pips - Second Anniversary,28,28,35,4.0,29,Second Anniversary,14.0,13,-6,-1,0,1,down,1975-11-01
2460,Gladys Knight And The Pips,1976-02-07,Gladys Knight And The Pips - Second Anniversary,29,28,51,4.0,35,Second Anniversary,14.0,14,-16,-6,-1,1,down,1975-11-01
2461,Van Mccoy,1975-11-01,Van Mccoy - The Disco Kid,51,51,28,18.0,38,The Disco Kid,5.0,0,10,13,0,1,up,1975-11-01
2462,Van Mccoy,1975-11-08,Van Mccoy - The Disco Kid,38,51,22,18.0,28,The Disco Kid,5.0,1,6,10,13,1,up,1975-11-01
2463,Van Mccoy,1975-11-15,Van Mccoy - The Disco Kid,28,38,18,18.0,22,The Disco Kid,5.0,2,4,6,10,1,up,1975-11-01
2464,Van Mccoy,1975-11-22,Van Mccoy - The Disco Kid,22,28,18,18.0,18,The Disco Kid,5.0,3,0,4,6,0,stay,1975-11-01
2465,Van Mccoy,1975-11-29,Van Mccoy - The Disco Kid,18,22,44,18.0,18,The Disco Kid,5.0,4,-26,0,4,1,down,1975-11-01
2466,Van Mccoy,1975-12-06,Van Mccoy - The Disco Kid,18,18,51,18.0,44,The Disco Kid,5.0,5,-7,-26,0,1,down,1975-11-01
2467,The Ritchie Family,1975-11-01,The Ritchie Family - Brazil,51,51,32,26.0,43,Brazil,4.0,0,11,8,0,1,up,1975-11-01
2468,The Ritchie Family,1975-11-08,The Ritchie Family - Brazil,43,51,26,26.0,32,Brazil,4.0,1,6,11,8,1,up,1975-11-01
2469,The Ritchie Family,1975-11-15,The Ritchie Family - Brazil,32,43,26,26.0,26,Brazil,4.0,2,0,6,11,0,stay,1975-11-01
2470,The Ritchie Family,1975-11-22,The Ritchie Family - Brazil,26,32,32,26.0,26,Brazil,4.0,3,-6,0,6,1,down,1975-11-01
2471,The Ritchie Family,1975-11-29,The Ritchie Family - Brazil,26,26,51,26.0,32,Brazil,4.0,4,-19,-6,0,1,down,1975-11-01
2472,The Miracles,1975-11-01,The Miracles - City Of Angels,51,51,36,29.0,49,City Of Angels,5.0,0,13,2,0,1,up,1975-11-01
2473,The Miracles,1975-11-08,The Miracles - City Of Angels,49,51,33,29.0,36,City Of Angels,5.0,1,3,13,2,1,up,1975-11-01
2474,The Miracles,1975-11-15,The Miracles - City Of Angels,36,49,29,29.0,33,City Of Angels,5.0,2,4,3,13,1,up,1975-11-01
2475,The Miracles,1975-11-22,The Miracles - City Of Angels,33,36,29,29.0,29,City Of Angels,5.0,3,0,4,3,0,stay,1975-11-01
2476,The Miracles,1975-11-29,The Miracles - City Of Angels,29,33,40,29.0,29,City Of Angels,5.0,4,-11,0,4,1,down,1975-11-01
2477,The Miracles,1975-12-06,The Miracles - City Of Angels,29,29,51,29.0,40,City Of Angels,5.0,5,-11,-11,0,1,down,1975-11-01
2478,Daryl Hall John Oates,1975-11-01,Daryl Hall John Oates - Daryl Hall & John Oates,51,51,51,50.0,50,Daryl Hall & John Oates,0.0,0,-1,1,0,1,down,1975-11-01
2479,Sly & The Family Stone,1975-11-08,Sly & The Family Stone - High On You,51,51,24,11.0,41,High On You,6.0,0,17,10,0,1,up,1975-11-08
2480,Sly & The Family Stone,1975-11-15,Sly & The Family Stone - High On You,41,51,15,11.0,24,High On You,6.0,1,9,17,10,1,up,1975-11-08
2481,Sly & The Family Stone,1975-11-22,Sly & The Family Stone - High On You,24,41,11,11.0,15,High On You,6.0,2,4,9,17,1,up,1975-11-08
2482,Sly & The Family Stone,1975-11-29,Sly & The Family Stone - High On You,15,24,11,11.0,11,High On You,6.0,3,0,4,9,0,stay,1975-11-08
2483,Sly & The Family Stone,1975-12-06,Sly & The Family Stone - High On You,11,15,22,11.0,11,High On You,6.0,4,-11,0,4,1,down,1975-11-08
2484,Sly & The Family Stone,1975-12-13,Sly & The Family Stone - High On You,11,11,36,11.0,22,High On You,6.0,5,-14,-11,0,1,down,1975-11-08
2485,Sly & The Family Stone,1975-12-20,Sly & The Family Stone - High On You,22,11,51,11.0,36,High On You,6.0,6,-15,-14,-11,1,down,1975-11-08
2486,Stanley Clarke,1975-11-08,Stanley Clarke - Journey To Love,51,51,34,8.0,44,Journey To Love,12.0,0,10,7,0,1,up,1975-11-08
2487,Stanley Clarke,1975-11-15,Stanley Clarke - Journey To Love,44,51,24,8.0,34,Journey To Love,12.0,1,10,10,7,1,up,1975-11-08
2488,Stanley Clarke,1975-11-22,Stanley Clarke - Journey To Love,34,44,20,8.0,24,Journey To Love,12.0,2,4,10,10,1,up,1975-11-08
2489,Stanley Clarke,1975-11-29,Stanley Clarke - Journey To Love,24,34,15,8.0,20,Journey To Love,12.0,3,5,4,10,1,up,1975-11-08
2490,Stanley Clarke,1975-12-06,Stanley Clarke - Journey To Love,20,24,8,8.0,15,Journey To Love,12.0,4,7,5,4,1,up,1975-11-08
2491,Stanley Clarke,1975-12-13,Stanley Clarke - Journey To Love,15,20,8,8.0,8,Journey To Love,12.0,5,0,7,5,0,stay,1975-11-08
2492,Stanley Clarke,1975-12-20,Stanley Clarke - Journey To Love,8,15,21,8.0,8,Journey To Love,12.0,6,-13,0,7,1,down,1975-11-08
2493,Stanley Clarke,1975-12-27,Stanley Clarke - Journey To Love,8,8,28,8.0,21,Journey To Love,12.0,7,-7,-13,0,1,down,1975-11-08
2494,Stanley Clarke,1976-01-03,Stanley Clarke - Journey To Love,21,8,27,8.0,28,Journey To Love,12.0,8,1,-7,-13,1,up,1975-11-08
2495,Stanley Clarke,1976-01-10,Stanley Clarke - Journey To Love,28,21,30,8.0,27,Journey To Love,12.0,9,-3,1,-7,1,down,1975-11-08
2496,Stanley Clarke,1976-01-17,Stanley Clarke - Journey To Love,27,28,34,8.0,30,Journey To Love,12.0,10,-4,-3,1,1,down,1975-11-08
2497,Stanley Clarke,1976-01-24,Stanley Clarke - Journey To Love,30,27,37,8.0,34,Journey To Love,12.0,11,-3,-4,-3,1,down,1975-11-08
2498,Stanley Clarke,1976-01-31,Stanley Clarke - Journey To Love,34,30,51,8.0,37,Journey To Love,12.0,12,-14,-3,-4,1,down,1975-11-08
2499,Donna Summer,1975-11-08,Donna Summer - Love To Love You Baby,51,51,42,6.0,47,Love To Love You Baby,21.0,0,5,4,0,1,up,1975-11-08
2500,Donna Summer,1975-11-15,Donna Summer - Love To Love You Baby,47,51,34,6.0,42,Love To Love You Baby,21.0,1,8,5,4,1,up,1975-11-08
2501,Donna Summer,1975-11-22,Donna Summer - Love To Love You Baby,42,47,26,6.0,34,Love To Love You Baby,21.0,2,8,8,5,1,up,1975-11-08
2502,Donna Summer,1975-11-29,Donna Summer - Love To Love You Baby,34,42,18,6.0,26,Love To Love You Baby,21.0,3,8,8,8,1,up,1975-11-08
2503,Donna Summer,1975-12-06,Donna Summer - Love To Love You Baby,26,34,11,6.0,18,Love To Love You Baby,21.0,4,7,8,8,1,up,1975-11-08
2504,Donna Summer,1975-12-13,Donna Summer - Love To Love You Baby,18,26,9,6.0,11,Love To Love You Baby,21.0,5,2,7,8,1,up,1975-11-08
2505,Donna Summer,1975-12-20,Donna Summer - Love To Love You Baby,11,18,6,6.0,9,Love To Love You Baby,21.0,6,3,2,7,1,up,1975-11-08
2506,Donna Summer,1975-12-27,Donna Summer - Love To Love You Baby,9,11,6,6.0,6,Love To Love You Baby,21.0,7,0,3,2,0,stay,1975-11-08
2507,Donna Summer,1976-01-03,Donna Summer - Love To Love You Baby,6,9,12,6.0,6,Love To Love You Baby,21.0,8,-6,0,3,1,down,1975-11-08
2508,Donna Summer,1976-01-10,Donna Summer - Love To Love You Baby,6,6,12,6.0,12,Love To Love You Baby,21.0,9,0,-6,0,0,stay,1975-11-08
2509,Donna Summer,1976-01-17,Donna Summer - Love To Love You Baby,12,6,9,6.0,12,Love To Love You Baby,21.0,10,3,0,-6,1,up,1975-11-08
2510,Donna Summer,1976-01-24,Donna Summer - Love To Love You Baby,12,12,8,6.0,9,Love To Love You Baby,21.0,11,1,3,0,1,up,1975-11-08
2511,Donna Summer,1976-01-31,Donna Summer - Love To Love You Baby,9,12,7,6.0,8,Love To Love You Baby,21.0,12,1,1,3,1,up,1975-11-08
2512,Donna Summer,1976-02-07,Donna Summer - Love To Love You Baby,8,9,6,6.0,7,Love To Love You Baby,21.0,13,1,1,1,1,up,1975-11-08
2513,Donna Summer,1976-02-14,Donna Summer - Love To Love You Baby,7,8,6,6.0,6,Love To Love You Baby,21.0,14,0,1,1,0,stay,1975-11-08
2514,Donna Summer,1976-02-21,Donna Summer - Love To Love You Baby,6,7,6,6.0,6,Love To Love You Baby,21.0,15,0,0,1,0,stay,1975-11-08
2515,Donna Summer,1976-02-28,Donna Summer - Love To Love You Baby,6,6,12,6.0,6,Love To Love You Baby,21.0,16,-6,0,0,1,down,1975-11-08
2516,Donna Summer,1976-03-06,Donna Summer - Love To Love You Baby,6,6,13,6.0,12,Love To Love You Baby,21.0,17,-1,-6,0,1,down,1975-11-08
2517,Donna Summer,1976-03-13,Donna Summer - Love To Love You Baby,12,6,19,6.0,13,Love To Love You Baby,21.0,18,-6,-1,-6,1,down,1975-11-08
2518,Donna Summer,1976-03-20,Donna Summer - Love To Love You Baby,13,12,21,6.0,19,Love To Love You Baby,21.0,19,-2,-6,-1,1,down,1975-11-08
2519,Donna Summer,1976-03-27,Donna Summer - Love To Love You Baby,19,13,50,6.0,21,Love To Love You Baby,21.0,20,-29,-2,-6,1,down,1975-11-08
2520,Donna Summer,1976-04-03,Donna Summer - Love To Love You Baby,21,19,51,6.0,50,Love To Love You Baby,21.0,21,-1,-29,-2,1,down,1975-11-08
2521,Stanley Turrentine,1975-11-08,Stanley Turrentine - Have You Every Seen The Rain,51,51,39,27.0,48,Have You Every Seen The Rain,7.0,0,9,3,0,1,up,1975-11-08
2522,Stanley Turrentine,1975-11-15,Stanley Turrentine - Have You Every Seen The Rain,48,51,30,27.0,39,Have You Every Seen The Rain,7.0,1,9,9,3,1,up,1975-11-08
2523,Stanley Turrentine,1975-11-22,Stanley Turrentine - Have You Every Seen The Rain,39,48,27,27.0,30,Have You Every Seen The Rain,7.0,2,3,9,9,1,up,1975-11-08
2524,Stanley Turrentine,1975-11-29,Stanley Turrentine - Have You Every Seen The Rain,30,39,27,27.0,27,Have You Every Seen The Rain,7.0,3,0,3,9,0,stay,1975-11-08
2525,Stanley Turrentine,1975-12-06,Stanley Turrentine - Have You Every Seen The Rain,27,30,47,27.0,27,Have You Every Seen The Rain,7.0,4,-20,0,3,1,down,1975-11-08
2526,Stanley Turrentine,1975-12-13,Stanley Turrentine - Have You Every Seen The Rain,27,27,45,27.0,47,Have You Every Seen The Rain,7.0,5,2,-20,0,1,up,1975-11-08
2527,Stanley Turrentine,1975-12-20,Stanley Turrentine - Have You Every Seen The Rain,47,27,42,27.0,45,Have You Every Seen The Rain,7.0,6,3,2,-20,1,up,1975-11-08
2528,Stanley Turrentine,1975-12-27,Stanley Turrentine - Have You Every Seen The Rain,45,47,51,27.0,42,Have You Every Seen The Rain,7.0,7,-9,3,2,1,down,1975-11-08
2529,The Stylistics,1975-11-08,The Stylistics - You Are Beautiful,51,51,40,12.0,50,You Are Beautiful,10.0,0,10,1,0,1,up,1975-11-08
2530,The Stylistics,1975-11-15,The Stylistics - You Are Beautiful,50,51,32,12.0,40,You Are Beautiful,10.0,1,8,10,1,1,up,1975-11-08
2531,The Stylistics,1975-11-22,The Stylistics - You Are Beautiful,40,50,23,12.0,32,You Are Beautiful,10.0,2,9,8,10,1,up,1975-11-08
2532,The Stylistics,1975-11-29,The Stylistics - You Are Beautiful,32,40,12,12.0,23,You Are Beautiful,10.0,3,11,9,8,1,up,1975-11-08
2533,The Stylistics,1975-12-06,The Stylistics - You Are Beautiful,23,32,12,12.0,12,You Are Beautiful,10.0,4,0,11,9,0,stay,1975-11-08
2534,The Stylistics,1975-12-13,The Stylistics - You Are Beautiful,12,23,24,12.0,12,You Are Beautiful,10.0,5,-12,0,11,1,down,1975-11-08
2535,The Stylistics,1975-12-20,The Stylistics - You Are Beautiful,12,12,32,12.0,24,You Are Beautiful,10.0,6,-8,-12,0,1,down,1975-11-08
2536,The Stylistics,1975-12-27,The Stylistics - You Are Beautiful,24,12,38,12.0,32,You Are Beautiful,10.0,7,-6,-8,-12,1,down,1975-11-08
2537,The Stylistics,1976-01-03,The Stylistics - You Are Beautiful,32,24,44,12.0,38,You Are Beautiful,10.0,8,-6,-6,-8,1,down,1975-11-08
2538,The Stylistics,1976-01-10,The Stylistics - You Are Beautiful,38,32,49,12.0,44,You Are Beautiful,10.0,9,-5,-6,-6,1,down,1975-11-08
2539,The Stylistics,1976-01-17,The Stylistics - You Are Beautiful,44,38,51,12.0,49,You Are Beautiful,10.0,10,-2,-5,-6,1,down,1975-11-08
2540,Bill Withers,1975-11-15,Bill Withers - Making Music,51,51,21,7.0,37,Making Music,16.0,0,16,14,0,1,up,1975-11-15
2541,Bill Withers,1975-11-22,Bill Withers - Making Music,37,51,19,7.0,21,Making Music,16.0,1,2,16,14,1,up,1975-11-15
2542,Bill Withers,1975-11-29,Bill Withers - Making Music,21,37,17,7.0,19,Making Music,16.0,2,2,2,16,1,up,1975-11-15
2543,Bill Withers,1975-12-06,Bill Withers - Making Music,19,21,13,7.0,17,Making Music,16.0,3,4,2,2,1,up,1975-11-15
2544,Bill Withers,1975-12-13,Bill Withers - Making Music,17,19,12,7.0,13,Making Music,16.0,4,1,4,2,1,up,1975-11-15
2545,Bill Withers,1975-12-20,Bill Withers - Making Music,13,17,11,7.0,12,Making Music,16.0,5,1,1,4,1,up,1975-11-15
2546,Bill Withers,1975-12-27,Bill Withers - Making Music,12,13,11,7.0,11,Making Music,16.0,6,0,1,1,0,stay,1975-11-15
2547,Bill Withers,1976-01-03,Bill Withers - Making Music,11,12,9,7.0,11,Making Music,16.0,7,2,0,1,1,up,1975-11-15
2548,Bill Withers,1976-01-10,Bill Withers - Making Music,11,11,9,7.0,9,Making Music,16.0,8,0,2,0,0,stay,1975-11-15
2549,Bill Withers,1976-01-17,Bill Withers - Making Music,9,11,8,7.0,9,Making Music,16.0,9,1,0,2,1,up,1975-11-15
2550,Bill Withers,1976-01-24,Bill Withers - Making Music,9,9,7,7.0,8,Making Music,16.0,10,1,1,0,1,up,1975-11-15
2551,Bill Withers,1976-01-31,Bill Withers - Making Music,8,9,11,7.0,7,Making Music,16.0,11,-4,1,1,1,down,1975-11-15
2552,Bill Withers,1976-02-07,Bill Withers - Making Music,7,8,17,7.0,11,Making Music,16.0,12,-6,-4,1,1,down,1975-11-15
2553,Bill Withers,1976-02-14,Bill Withers - Making Music,11,7,32,7.0,17,Making Music,16.0,13,-15,-6,-4,1,down,1975-11-15
2554,Bill Withers,1976-02-21,Bill Withers - Making Music,17,11,38,7.0,32,Making Music,16.0,14,-6,-15,-6,1,down,1975-11-15
2555,Bill Withers,1976-02-28,Bill Withers - Making Music,32,17,39,7.0,38,Making Music,16.0,15,-1,-6,-15,1,down,1975-11-15
2556,Bill Withers,1976-03-06,Bill Withers - Making Music,38,32,51,7.0,39,Making Music,16.0,16,-12,-1,-6,1,down,1975-11-15
2557,Commodores,1975-11-15,Commodores - Movin' On,51,51,20,7.0,43,Movin' On,27.0,0,23,8,0,1,up,1975-11-15
2558,Commodores,1975-11-22,Commodores - Movin' On,43,51,15,7.0,20,Movin' On,27.0,1,5,23,8,1,up,1975-11-15
2559,Commodores,1975-11-29,Commodores - Movin' On,20,43,9,7.0,15,Movin' On,27.0,2,6,5,23,1,up,1975-11-15
2560,Commodores,1975-12-06,Commodores - Movin' On,15,20,7,7.0,9,Movin' On,27.0,3,2,6,5,1,up,1975-11-15
2561,Commodores,1975-12-13,Commodores - Movin' On,9,15,7,7.0,7,Movin' On,27.0,4,0,2,6,0,stay,1975-11-15
2562,Commodores,1975-12-20,Commodores - Movin' On,7,9,8,7.0,7,Movin' On,27.0,5,-1,0,2,1,down,1975-11-15
2563,Commodores,1975-12-27,Commodores - Movin' On,7,7,22,7.0,8,Movin' On,27.0,6,-14,-1,0,1,down,1975-11-15
2564,Commodores,1976-01-03,Commodores - Movin' On,8,7,22,7.0,22,Movin' On,27.0,7,0,-14,-1,0,stay,1975-11-15
2565,Commodores,1976-01-10,Commodores - Movin' On,22,8,20,7.0,22,Movin' On,27.0,8,2,0,-14,1,up,1975-11-15
2566,Commodores,1976-01-17,Commodores - Movin' On,22,22,19,7.0,20,Movin' On,27.0,9,1,2,0,1,up,1975-11-15
2567,Commodores,1976-01-24,Commodores - Movin' On,20,22,17,7.0,19,Movin' On,27.0,10,2,1,2,1,up,1975-11-15
2568,Commodores,1976-01-31,Commodores - Movin' On,19,20,16,7.0,17,Movin' On,27.0,11,1,2,1,1,up,1975-11-15
2569,Commodores,1976-02-07,Commodores - Movin' On,17,19,18,7.0,16,Movin' On,27.0,12,-2,1,2,1,down,1975-11-15
2570,Commodores,1976-02-14,Commodores - Movin' On,16,17,21,7.0,18,Movin' On,27.0,13,-3,-2,1,1,down,1975-11-15
2571,Commodores,1976-02-21,Commodores - Movin' On,18,16,27,7.0,21,Movin' On,27.0,14,-6,-3,-2,1,down,1975-11-15
2572,Commodores,1976-02-28,Commodores - Movin' On,21,18,27,7.0,27,Movin' On,27.0,15,0,-6,-3,0,stay,1975-11-15
2573,Commodores,1976-03-06,Commodores - Movin' On,27,21,25,7.0,27,Movin' On,27.0,16,2,0,-6,1,up,1975-11-15
2574,Commodores,1976-03-13,Commodores - Movin' On,27,27,22,7.0,25,Movin' On,27.0,17,3,2,0,1,up,1975-11-15
2575,Commodores,1976-03-20,Commodores - Movin' On,25,27,34,7.0,22,Movin' On,27.0,18,-12,3,2,1,down,1975-11-15
2576,Commodores,1976-03-27,Commodores - Movin' On,22,25,34,7.0,34,Movin' On,27.0,19,0,-12,3,0,stay,1975-11-15
2577,Commodores,1976-04-03,Commodores - Movin' On,34,22,36,7.0,34,Movin' On,27.0,20,-2,0,-12,1,down,1975-11-15
2578,Commodores,1976-04-10,Commodores - Movin' On,34,34,39,7.0,36,Movin' On,27.0,21,-3,-2,0,1,down,1975-11-15
2579,Commodores,1976-04-17,Commodores - Movin' On,36,34,50,7.0,39,Movin' On,27.0,22,-11,-3,-2,1,down,1975-11-15
2580,Commodores,1976-05-08,Commodores - Movin' On,39,36,45,7.0,50,Movin' On,27.0,23,5,-11,-3,1,up,1975-11-15
2581,Commodores,1976-05-15,Commodores - Movin' On,50,39,45,7.0,45,Movin' On,27.0,24,0,5,-11,0,stay,1975-11-15
2582,Commodores,1976-05-22,Commodores - Movin' On,45,50,38,7.0,45,Movin' On,27.0,25,7,0,5,1,up,1975-11-15
2583,Commodores,1976-05-29,Commodores - Movin' On,45,45,45,7.0,38,Movin' On,27.0,26,-7,7,0,1,down,1975-11-15
2584,Commodores,1976-06-05,Commodores - Movin' On,38,45,51,7.0,45,Movin' On,27.0,27,-6,-7,7,1,down,1975-11-15
2585,Ron Banks And The Dramatics,1975-11-15,Ron Banks And The Dramatics - Drama V,51,51,27,10.0,48,Drama V,14.0,0,21,3,0,1,up,1975-11-15
2586,Ron Banks And The Dramatics,1975-11-22,Ron Banks And The Dramatics - Drama V,48,51,17,10.0,27,Drama V,14.0,1,10,21,3,1,up,1975-11-15
2587,Ron Banks And The Dramatics,1975-11-29,Ron Banks And The Dramatics - Drama V,27,48,13,10.0,17,Drama V,14.0,2,4,10,21,1,up,1975-11-15
2588,Ron Banks And The Dramatics,1975-12-06,Ron Banks And The Dramatics - Drama V,17,27,10,10.0,13,Drama V,14.0,3,3,4,10,1,up,1975-11-15
2589,Ron Banks And The Dramatics,1975-12-13,Ron Banks And The Dramatics - Drama V,13,17,10,10.0,10,Drama V,14.0,4,0,3,4,0,stay,1975-11-15
2590,Ron Banks And The Dramatics,1975-12-20,Ron Banks And The Dramatics - Drama V,10,13,19,10.0,10,Drama V,14.0,5,-9,0,3,1,down,1975-11-15
2591,Ron Banks And The Dramatics,1975-12-27,Ron Banks And The Dramatics - Drama V,10,10,30,10.0,19,Drama V,14.0,6,-11,-9,0,1,down,1975-11-15
2592,Ron Banks And The Dramatics,1976-01-03,Ron Banks And The Dramatics - Drama V,19,10,39,10.0,30,Drama V,14.0,7,-9,-11,-9,1,down,1975-11-15
2593,Ron Banks And The Dramatics,1976-01-10,Ron Banks And The Dramatics - Drama V,30,19,42,10.0,39,Drama V,14.0,8,-3,-9,-11,1,down,1975-11-15
2594,Ron Banks And The Dramatics,1976-01-17,Ron Banks And The Dramatics - Drama V,39,30,43,10.0,42,Drama V,14.0,9,-1,-3,-9,1,down,1975-11-15
2595,Ron Banks And The Dramatics,1976-01-24,Ron Banks And The Dramatics - Drama V,42,39,44,10.0,43,Drama V,14.0,10,-1,-1,-3,1,down,1975-11-15
2596,Ron Banks And The Dramatics,1976-01-31,Ron Banks And The Dramatics - Drama V,43,42,41,10.0,44,Drama V,14.0,11,3,-1,-1,1,up,1975-11-15
2597,Ron Banks And The Dramatics,1976-02-07,Ron Banks And The Dramatics - Drama V,44,43,39,10.0,41,Drama V,14.0,12,2,3,-1,1,up,1975-11-15
2598,Ron Banks And The Dramatics,1976-02-14,Ron Banks And The Dramatics - Drama V,41,44,44,10.0,39,Drama V,14.0,13,-5,2,3,1,down,1975-11-15
2599,Ron Banks And The Dramatics,1976-02-21,Ron Banks And The Dramatics - Drama V,39,41,51,10.0,44,Drama V,14.0,14,-7,-5,2,1,down,1975-11-15
2600,Gil Scott-Heron,1975-11-15,Gil Scott-Heron - From South Africa To South Carolina,51,51,36,28.0,49,From South Africa To South Carolina,7.0,0,13,2,0,1,up,1975-11-15
2601,Gil Scott-Heron,1975-11-22,Gil Scott-Heron - From South Africa To South Carolina,49,51,34,28.0,36,From South Africa To South Carolina,7.0,1,2,13,2,1,up,1975-11-15
2602,Gil Scott-Heron,1975-11-29,Gil Scott-Heron - From South Africa To South Carolina,36,49,34,28.0,34,From South Africa To South Carolina,7.0,2,0,2,13,0,stay,1975-11-15
2603,Gil Scott-Heron,1975-12-06,Gil Scott-Heron - From South Africa To South Carolina,34,36,31,28.0,34,From South Africa To South Carolina,7.0,3,3,0,2,1,up,1975-11-15
2604,Gil Scott-Heron,1975-12-13,Gil Scott-Heron - From South Africa To South Carolina,34,34,28,28.0,31,From South Africa To South Carolina,7.0,4,3,3,0,1,up,1975-11-15
2605,Gil Scott-Heron,1975-12-20,Gil Scott-Heron - From South Africa To South Carolina,31,34,31,28.0,28,From South Africa To South Carolina,7.0,5,-3,3,3,1,down,1975-11-15
2606,Gil Scott-Heron,1975-12-27,Gil Scott-Heron - From South Africa To South Carolina,28,31,43,28.0,31,From South Africa To South Carolina,7.0,6,-12,-3,3,1,down,1975-11-15
2607,Gil Scott-Heron,1976-01-03,Gil Scott-Heron - From South Africa To South Carolina,31,28,51,28.0,43,From South Africa To South Carolina,7.0,7,-8,-12,-3,1,down,1975-11-15
2608,B.B. King,1975-11-15,B.B. King - Lucille Talks Back,51,51,39,25.0,50,Lucille Talks Back,9.0,0,11,1,0,1,up,1975-11-15
2609,B.B. King,1975-11-22,B.B. King - Lucille Talks Back,50,51,31,25.0,39,Lucille Talks Back,9.0,1,8,11,1,1,up,1975-11-15
2610,B.B. King,1975-11-29,B.B. King - Lucille Talks Back,39,50,28,25.0,31,Lucille Talks Back,9.0,2,3,8,11,1,up,1975-11-15
2611,B.B. King,1975-12-06,B.B. King - Lucille Talks Back,31,39,27,25.0,28,Lucille Talks Back,9.0,3,1,3,8,1,up,1975-11-15
2612,B.B. King,1975-12-13,B.B. King - Lucille Talks Back,28,31,27,25.0,27,Lucille Talks Back,9.0,4,0,1,3,0,stay,1975-11-15
2613,B.B. King,1975-12-20,B.B. King - Lucille Talks Back,27,28,26,25.0,27,Lucille Talks Back,9.0,5,1,0,1,1,up,1975-11-15
2614,B.B. King,1975-12-27,B.B. King - Lucille Talks Back,27,27,25,25.0,26,Lucille Talks Back,9.0,6,1,1,0,1,up,1975-11-15
2615,B.B. King,1976-01-03,B.B. King - Lucille Talks Back,26,27,32,25.0,25,Lucille Talks Back,9.0,7,-7,1,1,1,down,1975-11-15
2616,B.B. King,1976-01-10,B.B. King - Lucille Talks Back,25,26,44,25.0,32,Lucille Talks Back,9.0,8,-12,-7,1,1,down,1975-11-15
2617,B.B. King,1976-01-17,B.B. King - Lucille Talks Back,32,25,51,25.0,44,Lucille Talks Back,9.0,9,-7,-12,-7,1,down,1975-11-15
2618,Barry White,1975-11-22,Barry White - Barry White's Greatest Hits Volume 1,51,51,22,15.0,31,Barry White's Greatest Hits Volume 1,8.0,0,9,20,0,1,up,1975-11-22
2619,Barry White,1975-11-29,Barry White - Barry White's Greatest Hits Volume 1,31,51,16,15.0,22,Barry White's Greatest Hits Volume 1,8.0,1,6,9,20,1,up,1975-11-22
2620,Barry White,1975-12-06,Barry White - Barry White's Greatest Hits Volume 1,22,31,16,15.0,16,Barry White's Greatest Hits Volume 1,8.0,2,0,6,9,0,stay,1975-11-22
2621,Barry White,1975-12-13,Barry White - Barry White's Greatest Hits Volume 1,16,22,15,15.0,16,Barry White's Greatest Hits Volume 1,8.0,3,1,0,6,1,up,1975-11-22
2622,Barry White,1975-12-20,Barry White - Barry White's Greatest Hits Volume 1,16,16,18,15.0,15,Barry White's Greatest Hits Volume 1,8.0,4,-3,1,0,1,down,1975-11-22
2623,Barry White,1975-12-27,Barry White - Barry White's Greatest Hits Volume 1,15,16,26,15.0,18,Barry White's Greatest Hits Volume 1,8.0,5,-8,-3,1,1,down,1975-11-22
2624,Barry White,1976-01-03,Barry White - Barry White's Greatest Hits Volume 1,18,15,26,15.0,26,Barry White's Greatest Hits Volume 1,8.0,6,0,-8,-3,0,stay,1975-11-22
2625,Barry White,1976-01-10,Barry White - Barry White's Greatest Hits Volume 1,26,18,43,15.0,26,Barry White's Greatest Hits Volume 1,8.0,7,-17,0,-8,1,down,1975-11-22
2626,Barry White,1976-01-17,Barry White - Barry White's Greatest Hits Volume 1,26,26,51,15.0,43,Barry White's Greatest Hits Volume 1,8.0,8,-8,-17,0,1,down,1975-11-22
2627,"Grover Washington, Jr.",1975-11-22,"Grover Washington, Jr. - Feels So Good",51,51,24,1.0,35,Feels So Good,27.0,0,11,16,0,1,up,1975-11-22
2628,"Grover Washington, Jr.",1975-11-29,"Grover Washington, Jr. - Feels So Good",35,51,6,1.0,24,Feels So Good,27.0,1,18,11,16,1,up,1975-11-22
2629,"Grover Washington, Jr.",1975-12-06,"Grover Washington, Jr. - Feels So Good",24,35,3,1.0,6,Feels So Good,27.0,2,3,18,11,1,up,1975-11-22
2630,"Grover Washington, Jr.",1975-12-13,"Grover Washington, Jr. - Feels So Good",6,24,1,1.0,3,Feels So Good,27.0,3,2,3,18,1,up,1975-11-22
2631,"Grover Washington, Jr.",1975-12-20,"Grover Washington, Jr. - Feels So Good",3,6,4,1.0,1,Feels So Good,27.0,4,-3,2,3,1,down,1975-11-22
2632,"Grover Washington, Jr.",1975-12-27,"Grover Washington, Jr. - Feels So Good",1,3,9,1.0,4,Feels So Good,27.0,5,-5,-3,2,1,down,1975-11-22
2633,"Grover Washington, Jr.",1976-01-03,"Grover Washington, Jr. - Feels So Good",4,1,8,1.0,9,Feels So Good,27.0,6,1,-5,-3,1,up,1975-11-22
2634,"Grover Washington, Jr.",1976-01-10,"Grover Washington, Jr. - Feels So Good",9,4,7,1.0,8,Feels So Good,27.0,7,1,1,-5,1,up,1975-11-22
2635,"Grover Washington, Jr.",1976-01-17,"Grover Washington, Jr. - Feels So Good",8,9,6,1.0,7,Feels So Good,27.0,8,1,1,1,1,up,1975-11-22
2636,"Grover Washington, Jr.",1976-01-24,"Grover Washington, Jr. - Feels So Good",7,8,6,1.0,6,Feels So Good,27.0,9,0,1,1,0,stay,1975-11-22
2637,"Grover Washington, Jr.",1976-01-31,"Grover Washington, Jr. - Feels So Good",6,7,6,1.0,6,Feels So Good,27.0,10,0,0,1,0,stay,1975-11-22
2638,"Grover Washington, Jr.",1976-02-07,"Grover Washington, Jr. - Feels So Good",6,6,5,1.0,6,Feels So Good,27.0,11,1,0,0,1,up,1975-11-22
2639,"Grover Washington, Jr.",1976-02-14,"Grover Washington, Jr. - Feels So Good",6,6,5,1.0,5,Feels So Good,27.0,12,0,1,0,0,stay,1975-11-22
2640,"Grover Washington, Jr.",1976-02-21,"Grover Washington, Jr. - Feels So Good",5,6,5,1.0,5,Feels So Good,27.0,13,0,0,1,0,stay,1975-11-22
2641,"Grover Washington, Jr.",1976-02-28,"Grover Washington, Jr. - Feels So Good",5,5,4,1.0,5,Feels So Good,27.0,14,1,0,0,1,up,1975-11-22
2642,"Grover Washington, Jr.",1976-03-06,"Grover Washington, Jr. - Feels So Good",5,5,6,1.0,4,Feels So Good,27.0,15,-2,1,0,1,down,1975-11-22
2643,"Grover Washington, Jr.",1976-03-13,"Grover Washington, Jr. - Feels So Good",4,5,16,1.0,6,Feels So Good,27.0,16,-10,-2,1,1,down,1975-11-22
2644,"Grover Washington, Jr.",1976-03-20,"Grover Washington, Jr. - Feels So Good",6,4,16,1.0,16,Feels So Good,27.0,17,0,-10,-2,0,stay,1975-11-22
2645,"Grover Washington, Jr.",1976-03-27,"Grover Washington, Jr. - Feels So Good",16,6,16,1.0,16,Feels So Good,27.0,18,0,0,-10,0,stay,1975-11-22
2646,"Grover Washington, Jr.",1976-04-03,"Grover Washington, Jr. - Feels So Good",16,16,17,1.0,16,Feels So Good,27.0,19,-1,0,0,1,down,1975-11-22
2647,"Grover Washington, Jr.",1976-04-10,"Grover Washington, Jr. - Feels So Good",16,16,14,1.0,17,Feels So Good,27.0,20,3,-1,0,1,up,1975-11-22
2648,"Grover Washington, Jr.",1976-04-17,"Grover Washington, Jr. - Feels So Good",17,16,15,1.0,14,Feels So Good,27.0,21,-1,3,-1,1,down,1975-11-22
2649,"Grover Washington, Jr.",1976-04-24,"Grover Washington, Jr. - Feels So Good",14,17,15,1.0,15,Feels So Good,27.0,22,0,-1,3,0,stay,1975-11-22
2650,"Grover Washington, Jr.",1976-05-01,"Grover Washington, Jr. - Feels So Good",15,14,24,1.0,15,Feels So Good,27.0,23,-9,0,-1,1,down,1975-11-22
2651,"Grover Washington, Jr.",1976-05-08,"Grover Washington, Jr. - Feels So Good",15,15,24,1.0,24,Feels So Good,27.0,24,0,-9,0,0,stay,1975-11-22
2652,"Grover Washington, Jr.",1976-05-15,"Grover Washington, Jr. - Feels So Good",24,15,34,1.0,24,Feels So Good,27.0,25,-10,0,-9,1,down,1975-11-22
2653,"Grover Washington, Jr.",1976-05-22,"Grover Washington, Jr. - Feels So Good",24,24,42,1.0,34,Feels So Good,27.0,26,-8,-10,0,1,down,1975-11-22
2654,"Grover Washington, Jr.",1976-05-29,"Grover Washington, Jr. - Feels So Good",34,24,51,1.0,42,Feels So Good,27.0,27,-9,-8,-10,1,down,1975-11-22
2655,Aretha Franklin,1975-11-22,Aretha Franklin - You,51,51,25,9.0,38,You,12.0,0,13,13,0,1,up,1975-11-22
2656,Aretha Franklin,1975-11-29,Aretha Franklin - You,38,51,10,9.0,25,You,12.0,1,15,13,13,1,up,1975-11-22
2657,Aretha Franklin,1975-12-06,Aretha Franklin - You,25,38,9,9.0,10,You,12.0,2,1,15,13,1,up,1975-11-22
2658,Aretha Franklin,1975-12-13,Aretha Franklin - You,10,25,13,9.0,9,You,12.0,3,-4,1,15,1,down,1975-11-22
2659,Aretha Franklin,1975-12-20,Aretha Franklin - You,9,10,12,9.0,13,You,12.0,4,1,-4,1,1,up,1975-11-22
2660,Aretha Franklin,1975-12-27,Aretha Franklin - You,13,9,10,9.0,12,You,12.0,5,2,1,-4,1,up,1975-11-22
2661,Aretha Franklin,1976-01-03,Aretha Franklin - You,12,13,16,9.0,10,You,12.0,6,-6,2,1,1,down,1975-11-22
2662,Aretha Franklin,1976-01-10,Aretha Franklin - You,10,12,15,9.0,16,You,12.0,7,1,-6,2,1,up,1975-11-22
2663,Aretha Franklin,1976-01-17,Aretha Franklin - You,16,10,14,9.0,15,You,12.0,8,1,1,-6,1,up,1975-11-22
2664,Aretha Franklin,1976-01-24,Aretha Franklin - You,15,16,16,9.0,14,You,12.0,9,-2,1,1,1,down,1975-11-22
2665,Aretha Franklin,1976-01-31,Aretha Franklin - You,14,15,22,9.0,16,You,12.0,10,-6,-2,1,1,down,1975-11-22
2666,Aretha Franklin,1976-02-07,Aretha Franklin - You,16,14,41,9.0,22,You,12.0,11,-19,-6,-2,1,down,1975-11-22
2667,Aretha Franklin,1976-02-14,Aretha Franklin - You,22,16,51,9.0,41,You,12.0,12,-10,-19,-6,1,down,1975-11-22
2668,Jimmy Caston Bunch,1975-11-22,Jimmy Caston Bunch - Supersound,51,51,36,30.0,40,Supersound,6.0,0,4,11,0,1,up,1975-11-22
2669,Jimmy Caston Bunch,1975-11-29,Jimmy Caston Bunch - Supersound,40,51,31,30.0,36,Supersound,6.0,1,5,4,11,1,up,1975-11-22
2670,Jimmy Caston Bunch,1975-12-06,Jimmy Caston Bunch - Supersound,36,40,30,30.0,31,Supersound,6.0,2,1,5,4,1,up,1975-11-22
2671,Jimmy Caston Bunch,1975-12-13,Jimmy Caston Bunch - Supersound,31,36,30,30.0,30,Supersound,6.0,3,0,1,5,0,stay,1975-11-22
2672,Jimmy Caston Bunch,1975-12-20,Jimmy Caston Bunch - Supersound,30,31,30,30.0,30,Supersound,6.0,4,0,0,1,0,stay,1975-11-22
2673,Jimmy Caston Bunch,1975-12-27,Jimmy Caston Bunch - Supersound,30,30,44,30.0,30,Supersound,6.0,5,-14,0,0,1,down,1975-11-22
2674,Jimmy Caston Bunch,1976-01-03,Jimmy Caston Bunch - Supersound,30,30,51,30.0,44,Supersound,6.0,6,-7,-14,0,1,down,1975-11-22
2675,Billy Cobham,1975-11-22,Billy Cobham - A Funky Thide Of Sings,51,51,35,32.0,41,A Funky Thide Of Sings,4.0,0,6,10,0,1,up,1975-11-22
2676,Billy Cobham,1975-11-29,Billy Cobham - A Funky Thide Of Sings,41,51,32,32.0,35,A Funky Thide Of Sings,4.0,1,3,6,10,1,up,1975-11-22
2677,Billy Cobham,1975-12-06,Billy Cobham - A Funky Thide Of Sings,35,41,32,32.0,32,A Funky Thide Of Sings,4.0,2,0,3,6,0,stay,1975-11-22
2678,Billy Cobham,1975-12-13,Billy Cobham - A Funky Thide Of Sings,32,35,40,32.0,32,A Funky Thide Of Sings,4.0,3,-8,0,3,1,down,1975-11-22
2679,Billy Cobham,1975-12-20,Billy Cobham - A Funky Thide Of Sings,32,32,51,32.0,40,A Funky Thide Of Sings,4.0,4,-11,-8,0,1,down,1975-11-22
2680,Soundtrack,1975-11-22,Soundtrack - Mahogany,51,51,30,15.0,44,Mahogany,11.0,0,14,7,0,1,up,1975-11-22
2681,Soundtrack,1975-11-29,Soundtrack - Mahogany,44,51,23,15.0,30,Mahogany,11.0,1,7,14,7,1,up,1975-11-22
2682,Soundtrack,1975-12-06,Soundtrack - Mahogany,30,44,21,15.0,23,Mahogany,11.0,2,2,7,14,1,up,1975-11-22
2683,Soundtrack,1975-12-13,Soundtrack - Mahogany,23,30,18,15.0,21,Mahogany,11.0,3,3,2,7,1,up,1975-11-22
2684,Soundtrack,1975-12-20,Soundtrack - Mahogany,21,23,15,15.0,18,Mahogany,11.0,4,3,3,2,1,up,1975-11-22
2685,Soundtrack,1975-12-27,Soundtrack - Mahogany,18,21,15,15.0,15,Mahogany,11.0,5,0,3,3,0,stay,1975-11-22
2686,Soundtrack,1976-01-03,Soundtrack - Mahogany,15,18,19,15.0,15,Mahogany,11.0,6,-4,0,3,1,down,1975-11-22
2687,Soundtrack,1976-01-10,Soundtrack - Mahogany,15,15,16,15.0,19,Mahogany,11.0,7,3,-4,0,1,up,1975-11-22
2688,Soundtrack,1976-01-17,Soundtrack - Mahogany,19,15,21,15.0,16,Mahogany,11.0,8,-5,3,-4,1,down,1975-11-22
2689,Soundtrack,1976-01-24,Soundtrack - Mahogany,16,19,25,15.0,21,Mahogany,11.0,9,-4,-5,3,1,down,1975-11-22
2690,Soundtrack,1976-01-31,Soundtrack - Mahogany,21,16,32,15.0,25,Mahogany,11.0,10,-7,-4,-5,1,down,1975-11-22
2691,Soundtrack,1976-02-07,Soundtrack - Mahogany,25,21,51,15.0,32,Mahogany,11.0,11,-19,-7,-4,1,down,1975-11-22
2692,Donald Byrd,1975-11-22,Donald Byrd - Places And Spaces,51,51,33,6.0,48,Places And Spaces,21.0,0,15,3,0,1,up,1975-11-22
2693,Donald Byrd,1975-11-29,Donald Byrd - Places And Spaces,48,51,25,6.0,33,Places And Spaces,21.0,1,8,15,3,1,up,1975-11-22
2694,Donald Byrd,1975-12-06,Donald Byrd - Places And Spaces,33,48,19,6.0,25,Places And Spaces,21.0,2,6,8,15,1,up,1975-11-22
2695,Donald Byrd,1975-12-13,Donald Byrd - Places And Spaces,25,33,14,6.0,19,Places And Spaces,21.0,3,5,6,8,1,up,1975-11-22
2696,Donald Byrd,1975-12-20,Donald Byrd - Places And Spaces,19,25,10,6.0,14,Places And Spaces,21.0,4,4,5,6,1,up,1975-11-22
2697,Donald Byrd,1975-12-27,Donald Byrd - Places And Spaces,14,19,8,6.0,10,Places And Spaces,21.0,5,2,4,5,1,up,1975-11-22
2698,Donald Byrd,1976-01-03,Donald Byrd - Places And Spaces,10,14,6,6.0,8,Places And Spaces,21.0,6,2,2,4,1,up,1975-11-22
2699,Donald Byrd,1976-01-10,Donald Byrd - Places And Spaces,8,10,6,6.0,6,Places And Spaces,21.0,7,0,2,2,0,stay,1975-11-22
2700,Donald Byrd,1976-01-17,Donald Byrd - Places And Spaces,6,8,7,6.0,6,Places And Spaces,21.0,8,-1,0,2,1,down,1975-11-22
2701,Donald Byrd,1976-01-24,Donald Byrd - Places And Spaces,6,6,11,6.0,7,Places And Spaces,21.0,9,-4,-1,0,1,down,1975-11-22
2702,Donald Byrd,1976-01-31,Donald Byrd - Places And Spaces,7,6,18,6.0,11,Places And Spaces,21.0,10,-7,-4,-1,1,down,1975-11-22
2703,Donald Byrd,1976-02-07,Donald Byrd - Places And Spaces,11,7,16,6.0,18,Places And Spaces,21.0,11,2,-7,-4,1,up,1975-11-22
2704,Donald Byrd,1976-02-14,Donald Byrd - Places And Spaces,18,11,13,6.0,16,Places And Spaces,21.0,12,3,2,-7,1,up,1975-11-22
2705,Donald Byrd,1976-02-21,Donald Byrd - Places And Spaces,16,18,20,6.0,13,Places And Spaces,21.0,13,-7,3,2,1,down,1975-11-22
2706,Donald Byrd,1976-02-28,Donald Byrd - Places And Spaces,13,16,20,6.0,20,Places And Spaces,21.0,14,0,-7,3,0,stay,1975-11-22
2707,Donald Byrd,1976-03-06,Donald Byrd - Places And Spaces,20,13,26,6.0,20,Places And Spaces,21.0,15,-6,0,-7,1,down,1975-11-22
2708,Donald Byrd,1976-03-13,Donald Byrd - Places And Spaces,20,20,42,6.0,26,Places And Spaces,21.0,16,-16,-6,0,1,down,1975-11-22
2709,Donald Byrd,1976-03-20,Donald Byrd - Places And Spaces,26,20,39,6.0,42,Places And Spaces,21.0,17,3,-16,-6,1,up,1975-11-22
2710,Donald Byrd,1976-03-27,Donald Byrd - Places And Spaces,42,26,33,6.0,39,Places And Spaces,21.0,18,6,3,-16,1,up,1975-11-22
2711,Donald Byrd,1976-04-03,Donald Byrd - Places And Spaces,39,42,43,6.0,33,Places And Spaces,21.0,19,-10,6,3,1,down,1975-11-22
2712,Donald Byrd,1976-04-10,Donald Byrd - Places And Spaces,33,39,47,6.0,43,Places And Spaces,21.0,20,-4,-10,6,1,down,1975-11-22
2713,Donald Byrd,1976-05-15,Donald Byrd - Places And Spaces,43,33,51,6.0,47,Places And Spaces,21.0,21,-4,-4,-10,1,down,1975-11-22
2714,Bobby Humphrey,1975-11-22,Bobby Humphrey - Fancy Dancer,51,51,44,24.0,49,Fancy Dancer,9.0,0,5,2,0,1,up,1975-11-22
2715,Bobby Humphrey,1975-11-29,Bobby Humphrey - Fancy Dancer,49,51,41,24.0,44,Fancy Dancer,9.0,1,3,5,2,1,up,1975-11-22
2716,Bobby Humphrey,1975-12-06,Bobby Humphrey - Fancy Dancer,44,49,33,24.0,41,Fancy Dancer,9.0,2,8,3,5,1,up,1975-11-22
2717,Bobby Humphrey,1975-12-13,Bobby Humphrey - Fancy Dancer,41,44,29,24.0,33,Fancy Dancer,9.0,3,4,8,3,1,up,1975-11-22
2718,Bobby Humphrey,1975-12-20,Bobby Humphrey - Fancy Dancer,33,41,27,24.0,29,Fancy Dancer,9.0,4,2,4,8,1,up,1975-11-22
2719,Bobby Humphrey,1975-12-27,Bobby Humphrey - Fancy Dancer,29,33,24,24.0,27,Fancy Dancer,9.0,5,3,2,4,1,up,1975-11-22
2720,Bobby Humphrey,1976-01-03,Bobby Humphrey - Fancy Dancer,27,29,25,24.0,24,Fancy Dancer,9.0,6,-1,3,2,1,down,1975-11-22
2721,Bobby Humphrey,1976-01-10,Bobby Humphrey - Fancy Dancer,24,27,39,24.0,25,Fancy Dancer,9.0,7,-14,-1,3,1,down,1975-11-22
2722,Bobby Humphrey,1976-01-17,Bobby Humphrey - Fancy Dancer,25,24,46,24.0,39,Fancy Dancer,9.0,8,-7,-14,-1,1,down,1975-11-22
2723,Bobby Humphrey,1976-01-24,Bobby Humphrey - Fancy Dancer,39,25,51,24.0,46,Fancy Dancer,9.0,9,-5,-7,-14,1,down,1975-11-22
2724,David Ruffin,1975-11-22,David Ruffin - Who I Am,51,51,45,5.0,50,Who I Am,19.0,0,5,1,0,1,up,1975-11-22
2725,David Ruffin,1975-11-29,David Ruffin - Who I Am,50,51,30,5.0,45,Who I Am,19.0,1,15,5,1,1,up,1975-11-22
2726,David Ruffin,1975-12-06,David Ruffin - Who I Am,45,50,23,5.0,30,Who I Am,19.0,2,7,15,5,1,up,1975-11-22
2727,David Ruffin,1975-12-13,David Ruffin - Who I Am,30,45,17,5.0,23,Who I Am,19.0,3,6,7,15,1,up,1975-11-22
2728,David Ruffin,1975-12-20,David Ruffin - Who I Am,23,30,7,5.0,17,Who I Am,19.0,4,10,6,7,1,up,1975-11-22
2729,David Ruffin,1975-12-27,David Ruffin - Who I Am,17,23,5,5.0,7,Who I Am,19.0,5,2,10,6,1,up,1975-11-22
2730,David Ruffin,1976-01-03,David Ruffin - Who I Am,7,17,5,5.0,5,Who I Am,19.0,6,0,2,10,0,stay,1975-11-22
2731,David Ruffin,1976-01-10,David Ruffin - Who I Am,5,7,10,5.0,5,Who I Am,19.0,7,-5,0,2,1,down,1975-11-22
2732,David Ruffin,1976-01-17,David Ruffin - Who I Am,5,5,11,5.0,10,Who I Am,19.0,8,-1,-5,0,1,down,1975-11-22
2733,David Ruffin,1976-01-24,David Ruffin - Who I Am,10,5,10,5.0,11,Who I Am,19.0,9,1,-1,-5,1,up,1975-11-22
2734,David Ruffin,1976-01-31,David Ruffin - Who I Am,11,10,9,5.0,10,Who I Am,19.0,10,1,1,-1,1,up,1975-11-22
2735,David Ruffin,1976-02-07,David Ruffin - Who I Am,10,11,11,5.0,9,Who I Am,19.0,11,-2,1,1,1,down,1975-11-22
2736,David Ruffin,1976-02-14,David Ruffin - Who I Am,9,10,12,5.0,11,Who I Am,19.0,12,-1,-2,1,1,down,1975-11-22
2737,David Ruffin,1976-02-21,David Ruffin - Who I Am,11,9,22,5.0,12,Who I Am,19.0,13,-10,-1,-2,1,down,1975-11-22
2738,David Ruffin,1976-02-28,David Ruffin - Who I Am,12,11,24,5.0,22,Who I Am,19.0,14,-2,-10,-1,1,down,1975-11-22
2739,David Ruffin,1976-03-06,David Ruffin - Who I Am,22,12,27,5.0,24,Who I Am,19.0,15,-3,-2,-10,1,down,1975-11-22
2740,David Ruffin,1976-03-13,David Ruffin - Who I Am,24,22,41,5.0,27,Who I Am,19.0,16,-14,-3,-2,1,down,1975-11-22
2741,David Ruffin,1976-03-20,David Ruffin - Who I Am,27,24,45,5.0,41,Who I Am,19.0,17,-4,-14,-3,1,down,1975-11-22
2742,David Ruffin,1976-03-27,David Ruffin - Who I Am,41,27,41,5.0,45,Who I Am,19.0,18,4,-4,-14,1,up,1975-11-22
2743,David Ruffin,1976-04-03,David Ruffin - Who I Am,45,41,51,5.0,41,Who I Am,19.0,19,-10,4,-4,1,down,1975-11-22
2744,The O'Jays,1975-11-29,The O'Jays - Family Reunion,51,51,26,1.0,39,Family Reunion,26.0,0,13,12,0,1,up,1975-11-29
2745,The O'Jays,1975-12-06,The O'Jays - Family Reunion,39,51,17,1.0,26,Family Reunion,26.0,1,9,13,12,1,up,1975-11-29
2746,The O'Jays,1975-12-13,The O'Jays - Family Reunion,26,39,3,1.0,17,Family Reunion,26.0,2,14,9,13,1,up,1975-11-29
2747,The O'Jays,1975-12-20,The O'Jays - Family Reunion,17,26,1,1.0,3,Family Reunion,26.0,3,2,14,9,1,up,1975-11-29
2748,The O'Jays,1975-12-27,The O'Jays - Family Reunion,3,17,2,1.0,1,Family Reunion,26.0,4,-1,2,14,1,down,1975-11-29
2749,The O'Jays,1976-01-03,The O'Jays - Family Reunion,1,3,3,1.0,2,Family Reunion,26.0,5,-1,-1,2,1,down,1975-11-29
2750,The O'Jays,1976-01-10,The O'Jays - Family Reunion,2,1,4,1.0,3,Family Reunion,26.0,6,-1,-1,-1,1,down,1975-11-29
2751,The O'Jays,1976-01-17,The O'Jays - Family Reunion,3,2,4,1.0,4,Family Reunion,26.0,7,0,-1,-1,0,stay,1975-11-29
2752,The O'Jays,1976-01-24,The O'Jays - Family Reunion,4,3,5,1.0,4,Family Reunion,26.0,8,-1,0,-1,1,down,1975-11-29
2753,The O'Jays,1976-01-31,The O'Jays - Family Reunion,4,4,5,1.0,5,Family Reunion,26.0,9,0,-1,0,0,stay,1975-11-29
2754,The O'Jays,1976-02-07,The O'Jays - Family Reunion,5,4,4,1.0,5,Family Reunion,26.0,10,1,0,-1,1,up,1975-11-29
2755,The O'Jays,1976-02-14,The O'Jays - Family Reunion,5,5,4,1.0,4,Family Reunion,26.0,11,0,1,0,0,stay,1975-11-29
2756,The O'Jays,1976-02-21,The O'Jays - Family Reunion,4,5,4,1.0,4,Family Reunion,26.0,12,0,0,1,0,stay,1975-11-29
2757,The O'Jays,1976-02-28,The O'Jays - Family Reunion,4,4,5,1.0,4,Family Reunion,26.0,13,-1,0,0,1,down,1975-11-29
2758,The O'Jays,1976-03-06,The O'Jays - Family Reunion,4,4,5,1.0,5,Family Reunion,26.0,14,0,-1,0,0,stay,1975-11-29
2759,The O'Jays,1976-03-13,The O'Jays - Family Reunion,5,4,5,1.0,5,Family Reunion,26.0,15,0,0,-1,0,stay,1975-11-29
2760,The O'Jays,1976-03-20,The O'Jays - Family Reunion,5,5,7,1.0,5,Family Reunion,26.0,16,-2,0,0,1,down,1975-11-29
2761,The O'Jays,1976-03-27,The O'Jays - Family Reunion,5,5,7,1.0,7,Family Reunion,26.0,17,0,-2,0,0,stay,1975-11-29
2762,The O'Jays,1976-04-03,The O'Jays - Family Reunion,7,5,7,1.0,7,Family Reunion,26.0,18,0,0,-2,0,stay,1975-11-29
2763,The O'Jays,1976-04-10,The O'Jays - Family Reunion,7,7,11,1.0,7,Family Reunion,26.0,19,-4,0,0,1,down,1975-11-29
2764,The O'Jays,1976-04-17,The O'Jays - Family Reunion,7,7,12,1.0,11,Family Reunion,26.0,20,-1,-4,0,1,down,1975-11-29
2765,The O'Jays,1976-04-24,The O'Jays - Family Reunion,11,7,17,1.0,12,Family Reunion,26.0,21,-5,-1,-4,1,down,1975-11-29
2766,The O'Jays,1976-05-01,The O'Jays - Family Reunion,12,11,14,1.0,17,Family Reunion,26.0,22,3,-5,-1,1,up,1975-11-29
2767,The O'Jays,1976-05-08,The O'Jays - Family Reunion,17,12,15,1.0,14,Family Reunion,26.0,23,-1,3,-5,1,down,1975-11-29
2768,The O'Jays,1976-05-15,The O'Jays - Family Reunion,14,17,15,1.0,15,Family Reunion,26.0,24,0,-1,3,0,stay,1975-11-29
2769,The O'Jays,1976-05-22,The O'Jays - Family Reunion,15,14,16,1.0,15,Family Reunion,26.0,25,-1,0,-1,1,down,1975-11-29
2770,The O'Jays,1976-05-29,The O'Jays - Family Reunion,15,15,51,1.0,16,Family Reunion,26.0,26,-35,-1,0,1,down,1975-11-29
2771,Rufus And Chaka Khan,1975-11-29,Rufus And Chaka Khan - Rufus Featuring Chaka Khan,51,51,33,1.0,41,Rufus Featuring Chaka Khan,30.0,0,8,10,0,1,up,1975-11-29
2772,Rufus And Chaka Khan,1975-12-06,Rufus And Chaka Khan - Rufus Featuring Chaka Khan,41,51,24,1.0,33,Rufus Featuring Chaka Khan,30.0,1,9,8,10,1,up,1975-11-29
2773,Rufus And Chaka Khan,1975-12-13,Rufus And Chaka Khan - Rufus Featuring Chaka Khan,33,41,16,1.0,24,Rufus Featuring Chaka Khan,30.0,2,8,9,8,1,up,1975-11-29
2774,Rufus And Chaka Khan,1975-12-20,Rufus And Chaka Khan - Rufus Featuring Chaka Khan,24,33,13,1.0,16,Rufus Featuring Chaka Khan,30.0,3,3,8,9,1,up,1975-11-29
2775,Rufus And Chaka Khan,1975-12-27,Rufus And Chaka Khan - Rufus Featuring Chaka Khan,16,24,12,1.0,13,Rufus Featuring Chaka Khan,30.0,4,1,3,8,1,up,1975-11-29
2776,Rufus And Chaka Khan,1976-01-03,Rufus And Chaka Khan - Rufus Featuring Chaka Khan,13,16,7,1.0,12,Rufus Featuring Chaka Khan,30.0,5,5,1,3,1,up,1975-11-29
2777,Rufus And Chaka Khan,1976-01-10,Rufus And Chaka Khan - Rufus Featuring Chaka Khan,12,13,3,1.0,7,Rufus Featuring Chaka Khan,30.0,6,4,5,1,1,up,1975-11-29
2778,Rufus And Chaka Khan,1976-01-17,Rufus And Chaka Khan - Rufus Featuring Chaka Khan,7,12,2,1.0,3,Rufus Featuring Chaka Khan,30.0,7,1,4,5,1,up,1975-11-29
2779,Rufus And Chaka Khan,1976-01-24,Rufus And Chaka Khan - Rufus Featuring Chaka Khan,3,7,2,1.0,2,Rufus Featuring Chaka Khan,30.0,8,0,1,4,0,stay,1975-11-29
2780,Rufus And Chaka Khan,1976-01-31,Rufus And Chaka Khan - Rufus Featuring Chaka Khan,2,3,3,1.0,2,Rufus Featuring Chaka Khan,30.0,9,-1,0,1,1,down,1975-11-29
2781,Rufus And Chaka Khan,1976-02-07,Rufus And Chaka Khan - Rufus Featuring Chaka Khan,2,2,3,1.0,3,Rufus Featuring Chaka Khan,30.0,10,0,-1,0,0,stay,1975-11-29
2782,Rufus And Chaka Khan,1976-02-14,Rufus And Chaka Khan - Rufus Featuring Chaka Khan,3,2,2,1.0,3,Rufus Featuring Chaka Khan,30.0,11,1,0,-1,1,up,1975-11-29
2783,Rufus And Chaka Khan,1976-02-21,Rufus And Chaka Khan - Rufus Featuring Chaka Khan,3,3,1,1.0,2,Rufus Featuring Chaka Khan,30.0,12,1,1,0,1,up,1975-11-29
2784,Rufus And Chaka Khan,1976-02-28,Rufus And Chaka Khan - Rufus Featuring Chaka Khan,2,3,1,1.0,1,Rufus Featuring Chaka Khan,30.0,13,0,1,1,0,stay,1975-11-29
2785,Rufus And Chaka Khan,1976-03-06,Rufus And Chaka Khan - Rufus Featuring Chaka Khan,1,2,1,1.0,1,Rufus Featuring Chaka Khan,30.0,14,0,0,1,0,stay,1975-11-29
2786,Rufus And Chaka Khan,1976-03-13,Rufus And Chaka Khan - Rufus Featuring Chaka Khan,1,1,1,1.0,1,Rufus Featuring Chaka Khan,30.0,15,0,0,0,0,stay,1975-11-29
2787,Rufus And Chaka Khan,1976-03-20,Rufus And Chaka Khan - Rufus Featuring Chaka Khan,1,1,1,1.0,1,Rufus Featuring Chaka Khan,30.0,16,0,0,0,0,stay,1975-11-29
2788,Rufus And Chaka Khan,1976-03-27,Rufus And Chaka Khan - Rufus Featuring Chaka Khan,1,1,1,1.0,1,Rufus Featuring Chaka Khan,30.0,17,0,0,0,0,stay,1975-11-29
2789,Rufus And Chaka Khan,1976-04-03,Rufus And Chaka Khan - Rufus Featuring Chaka Khan,1,1,2,1.0,1,Rufus Featuring Chaka Khan,30.0,18,-1,0,0,1,down,1975-11-29
2790,Rufus And Chaka Khan,1976-04-10,Rufus And Chaka Khan - Rufus Featuring Chaka Khan,1,1,7,1.0,2,Rufus Featuring Chaka Khan,30.0,19,-5,-1,0,1,down,1975-11-29
2791,Rufus And Chaka Khan,1976-04-17,Rufus And Chaka Khan - Rufus Featuring Chaka Khan,2,1,7,1.0,7,Rufus Featuring Chaka Khan,30.0,20,0,-5,-1,0,stay,1975-11-29
2792,Rufus And Chaka Khan,1976-04-24,Rufus And Chaka Khan - Rufus Featuring Chaka Khan,7,2,6,1.0,7,Rufus Featuring Chaka Khan,30.0,21,1,0,-5,1,up,1975-11-29
2793,Rufus And Chaka Khan,1976-05-01,Rufus And Chaka Khan - Rufus Featuring Chaka Khan,7,7,6,1.0,6,Rufus Featuring Chaka Khan,30.0,22,0,1,0,0,stay,1975-11-29
2794,Rufus And Chaka Khan,1976-05-08,Rufus And Chaka Khan - Rufus Featuring Chaka Khan,6,7,6,1.0,6,Rufus Featuring Chaka Khan,30.0,23,0,0,1,0,stay,1975-11-29
2795,Rufus And Chaka Khan,1976-05-15,Rufus And Chaka Khan - Rufus Featuring Chaka Khan,6,6,6,1.0,6,Rufus Featuring Chaka Khan,30.0,24,0,0,0,0,stay,1975-11-29
2796,Rufus And Chaka Khan,1976-05-22,Rufus And Chaka Khan - Rufus Featuring Chaka Khan,6,6,9,1.0,6,Rufus Featuring Chaka Khan,30.0,25,-3,0,0,1,down,1975-11-29
2797,Rufus And Chaka Khan,1976-05-29,Rufus And Chaka Khan - Rufus Featuring Chaka Khan,6,6,9,1.0,9,Rufus Featuring Chaka Khan,30.0,26,0,-3,0,0,stay,1975-11-29
2798,Rufus And Chaka Khan,1976-06-05,Rufus And Chaka Khan - Rufus Featuring Chaka Khan,9,6,20,1.0,9,Rufus Featuring Chaka Khan,30.0,27,-11,0,-3,1,down,1975-11-29
2799,Rufus And Chaka Khan,1976-06-12,Rufus And Chaka Khan - Rufus Featuring Chaka Khan,9,9,23,1.0,20,Rufus Featuring Chaka Khan,30.0,28,-3,-11,0,1,down,1975-11-29
2800,Rufus And Chaka Khan,1976-06-19,Rufus And Chaka Khan - Rufus Featuring Chaka Khan,20,9,31,1.0,23,Rufus Featuring Chaka Khan,30.0,29,-8,-3,-11,1,down,1975-11-29
2801,Rufus And Chaka Khan,1976-06-26,Rufus And Chaka Khan - Rufus Featuring Chaka Khan,23,20,51,1.0,31,Rufus Featuring Chaka Khan,30.0,30,-20,-8,-3,1,down,1975-11-29
2802,Hot Chocolate,1975-11-29,Hot Chocolate - Hot Chocolate,51,51,38,34.0,46,Hot Chocolate,14.0,0,8,5,0,1,up,1975-11-29
2803,Hot Chocolate,1975-12-06,Hot Chocolate - Hot Chocolate,46,51,36,34.0,38,Hot Chocolate,14.0,1,2,8,5,1,up,1975-11-29
2804,Hot Chocolate,1975-12-13,Hot Chocolate - Hot Chocolate,38,46,35,34.0,36,Hot Chocolate,14.0,2,1,2,8,1,up,1975-11-29
2805,Hot Chocolate,1975-12-20,Hot Chocolate - Hot Chocolate,36,38,35,34.0,35,Hot Chocolate,14.0,3,0,1,2,0,stay,1975-11-29
2806,Hot Chocolate,1975-12-27,Hot Chocolate - Hot Chocolate,35,36,45,34.0,35,Hot Chocolate,14.0,4,-10,0,1,1,down,1975-11-29
2807,Hot Chocolate,1976-01-03,Hot Chocolate - Hot Chocolate,35,35,49,34.0,45,Hot Chocolate,14.0,5,-4,-10,0,1,down,1975-11-29
2808,Hot Chocolate,1976-01-10,Hot Chocolate - Hot Chocolate,45,35,47,34.0,49,Hot Chocolate,14.0,6,2,-4,-10,1,up,1975-11-29
2809,Hot Chocolate,1976-01-17,Hot Chocolate - Hot Chocolate,49,45,45,34.0,47,Hot Chocolate,14.0,7,2,2,-4,1,up,1975-11-29
2810,Hot Chocolate,1976-01-24,Hot Chocolate - Hot Chocolate,47,49,43,34.0,45,Hot Chocolate,14.0,8,2,2,2,1,up,1975-11-29
2811,Hot Chocolate,1976-01-31,Hot Chocolate - Hot Chocolate,45,47,40,34.0,43,Hot Chocolate,14.0,9,3,2,2,1,up,1975-11-29
2812,Hot Chocolate,1976-02-07,Hot Chocolate - Hot Chocolate,43,45,34,34.0,40,Hot Chocolate,14.0,10,6,3,2,1,up,1975-11-29
2813,Hot Chocolate,1976-02-14,Hot Chocolate - Hot Chocolate,40,43,42,34.0,34,Hot Chocolate,14.0,11,-8,6,3,1,down,1975-11-29
2814,Hot Chocolate,1976-02-21,Hot Chocolate - Hot Chocolate,34,40,43,34.0,42,Hot Chocolate,14.0,12,-1,-8,6,1,down,1975-11-29
2815,Hot Chocolate,1976-02-28,Hot Chocolate - Hot Chocolate,42,34,43,34.0,43,Hot Chocolate,14.0,13,0,-1,-8,0,stay,1975-11-29
2816,Hot Chocolate,1976-03-06,Hot Chocolate - Hot Chocolate,43,42,51,34.0,43,Hot Chocolate,14.0,14,-8,0,-1,1,down,1975-11-29
2817,MFSB,1975-11-29,MFSB - Philadelphia Freedom,51,51,39,14.0,47,Philadelphia Freedom,9.0,0,8,4,0,1,up,1975-11-29
2818,MFSB,1975-12-06,MFSB - Philadelphia Freedom,47,51,26,14.0,39,Philadelphia Freedom,9.0,1,13,8,4,1,up,1975-11-29
2819,MFSB,1975-12-13,MFSB - Philadelphia Freedom,39,47,20,14.0,26,Philadelphia Freedom,9.0,2,6,13,8,1,up,1975-11-29
2820,MFSB,1975-12-20,MFSB - Philadelphia Freedom,26,39,16,14.0,20,Philadelphia Freedom,9.0,3,4,6,13,1,up,1975-11-29
2821,MFSB,1975-12-27,MFSB - Philadelphia Freedom,20,26,14,14.0,16,Philadelphia Freedom,9.0,4,2,4,6,1,up,1975-11-29
2822,MFSB,1976-01-03,MFSB - Philadelphia Freedom,16,20,17,14.0,14,Philadelphia Freedom,9.0,5,-3,2,4,1,down,1975-11-29
2823,MFSB,1976-01-10,MFSB - Philadelphia Freedom,14,16,27,14.0,17,Philadelphia Freedom,9.0,6,-10,-3,2,1,down,1975-11-29
2824,MFSB,1976-01-17,MFSB - Philadelphia Freedom,17,14,32,14.0,27,Philadelphia Freedom,9.0,7,-5,-10,-3,1,down,1975-11-29
2825,MFSB,1976-01-24,MFSB - Philadelphia Freedom,27,17,45,14.0,32,Philadelphia Freedom,9.0,8,-13,-5,-10,1,down,1975-11-29
2826,MFSB,1976-01-31,MFSB - Philadelphia Freedom,32,27,51,14.0,45,Philadelphia Freedom,9.0,9,-6,-13,-5,1,down,1975-11-29
2827,Edwin Starr,1975-11-29,Edwin Starr - Free To Be Myself,51,51,45,43.0,48,Free To Be Myself,5.0,0,3,3,0,1,up,1975-11-29
2828,Edwin Starr,1975-12-06,Edwin Starr - Free To Be Myself,48,51,45,43.0,45,Free To Be Myself,5.0,1,0,3,3,0,stay,1975-11-29
2829,Edwin Starr,1975-12-13,Edwin Starr - Free To Be Myself,45,48,43,43.0,45,Free To Be Myself,5.0,2,2,0,3,1,up,1975-11-29
2830,Edwin Starr,1975-12-20,Edwin Starr - Free To Be Myself,45,45,43,43.0,43,Free To Be Myself,5.0,3,0,2,0,0,stay,1975-11-29
2831,Edwin Starr,1975-12-27,Edwin Starr - Free To Be Myself,43,45,49,43.0,43,Free To Be Myself,5.0,4,-6,0,2,1,down,1975-11-29
2832,Edwin Starr,1976-01-24,Edwin Starr - Free To Be Myself,43,43,51,43.0,49,Free To Be Myself,5.0,5,-2,-6,0,1,down,1975-11-29
2833,Les McCann,1975-11-29,Les McCann - Hustle To Survive,51,51,42,36.0,49,Hustle To Survive,6.0,0,7,2,0,1,up,1975-11-29
2834,Les McCann,1975-12-06,Les McCann - Hustle To Survive,49,51,41,36.0,42,Hustle To Survive,6.0,1,1,7,2,1,up,1975-11-29
2835,Les McCann,1975-12-13,Les McCann - Hustle To Survive,42,49,39,36.0,41,Hustle To Survive,6.0,2,2,1,7,1,up,1975-11-29
2836,Les McCann,1975-12-20,Les McCann - Hustle To Survive,41,42,38,36.0,39,Hustle To Survive,6.0,3,1,2,1,1,up,1975-11-29
2837,Les McCann,1975-12-27,Les McCann - Hustle To Survive,39,41,36,36.0,38,Hustle To Survive,6.0,4,2,1,2,1,up,1975-11-29
2838,Les McCann,1976-01-03,Les McCann - Hustle To Survive,38,39,45,36.0,36,Hustle To Survive,6.0,5,-9,2,1,1,down,1975-11-29
2839,Les McCann,1976-01-10,Les McCann - Hustle To Survive,36,38,51,36.0,45,Hustle To Survive,6.0,6,-6,-9,2,1,down,1975-11-29
2840,The Dells,1975-11-29,The Dells - We Got To Get Our Thing Together,51,51,43,31.0,50,We Got To Get Our Thing Together,6.0,0,7,1,0,1,up,1975-11-29
2841,The Dells,1975-12-06,The Dells - We Got To Get Our Thing Together,50,51,37,31.0,43,We Got To Get Our Thing Together,6.0,1,6,7,1,1,up,1975-11-29
2842,The Dells,1975-12-13,The Dells - We Got To Get Our Thing Together,43,50,37,31.0,37,We Got To Get Our Thing Together,6.0,2,0,6,7,0,stay,1975-11-29
2843,The Dells,1975-12-20,The Dells - We Got To Get Our Thing Together,37,43,34,31.0,37,We Got To Get Our Thing Together,6.0,3,3,0,6,1,up,1975-11-29
2844,The Dells,1975-12-27,The Dells - We Got To Get Our Thing Together,37,37,31,31.0,34,We Got To Get Our Thing Together,6.0,4,3,3,0,1,up,1975-11-29
2845,The Dells,1976-01-03,The Dells - We Got To Get Our Thing Together,34,37,46,31.0,31,We Got To Get Our Thing Together,6.0,5,-15,3,3,1,down,1975-11-29
2846,The Dells,1976-01-10,The Dells - We Got To Get Our Thing Together,31,34,51,31.0,46,We Got To Get Our Thing Together,6.0,6,-5,-15,3,1,down,1975-11-29
2847,"Earth, Wind & Fire",1975-12-06,"Earth, Wind & Fire - Gratitude",51,51,20,1.0,29,Gratitude,27.0,0,9,22,0,1,up,1975-12-06
2848,"Earth, Wind & Fire",1975-12-13,"Earth, Wind & Fire - Gratitude",29,51,5,1.0,20,Gratitude,27.0,1,15,9,22,1,up,1975-12-06
2849,"Earth, Wind & Fire",1975-12-20,"Earth, Wind & Fire - Gratitude",20,29,2,1.0,5,Gratitude,27.0,2,3,15,9,1,up,1975-12-06
2850,"Earth, Wind & Fire",1975-12-27,"Earth, Wind & Fire - Gratitude",5,20,1,1.0,2,Gratitude,27.0,3,1,3,15,1,up,1975-12-06
2851,"Earth, Wind & Fire",1976-01-03,"Earth, Wind & Fire - Gratitude",2,5,1,1.0,1,Gratitude,27.0,4,0,1,3,0,stay,1975-12-06
2852,"Earth, Wind & Fire",1976-01-10,"Earth, Wind & Fire - Gratitude",1,2,1,1.0,1,Gratitude,27.0,5,0,0,1,0,stay,1975-12-06
2853,"Earth, Wind & Fire",1976-01-17,"Earth, Wind & Fire - Gratitude",1,1,3,1.0,1,Gratitude,27.0,6,-2,0,0,1,down,1975-12-06
2854,"Earth, Wind & Fire",1976-01-24,"Earth, Wind & Fire - Gratitude",1,1,3,1.0,3,Gratitude,27.0,7,0,-2,0,0,stay,1975-12-06
2855,"Earth, Wind & Fire",1976-01-31,"Earth, Wind & Fire - Gratitude",3,1,1,1.0,3,Gratitude,27.0,8,2,0,-2,1,up,1975-12-06
2856,"Earth, Wind & Fire",1976-02-07,"Earth, Wind & Fire - Gratitude",3,3,1,1.0,1,Gratitude,27.0,9,0,2,0,0,stay,1975-12-06
2857,"Earth, Wind & Fire",1976-02-14,"Earth, Wind & Fire - Gratitude",1,3,1,1.0,1,Gratitude,27.0,10,0,0,2,0,stay,1975-12-06
2858,"Earth, Wind & Fire",1976-02-21,"Earth, Wind & Fire - Gratitude",1,1,2,1.0,1,Gratitude,27.0,11,-1,0,0,1,down,1975-12-06
2859,"Earth, Wind & Fire",1976-02-28,"Earth, Wind & Fire - Gratitude",1,1,2,1.0,2,Gratitude,27.0,12,0,-1,0,0,stay,1975-12-06
2860,"Earth, Wind & Fire",1976-03-06,"Earth, Wind & Fire - Gratitude",2,1,2,1.0,2,Gratitude,27.0,13,0,0,-1,0,stay,1975-12-06
2861,"Earth, Wind & Fire",1976-03-13,"Earth, Wind & Fire - Gratitude",2,2,2,1.0,2,Gratitude,27.0,14,0,0,0,0,stay,1975-12-06
2862,"Earth, Wind & Fire",1976-03-20,"Earth, Wind & Fire - Gratitude",2,2,2,1.0,2,Gratitude,27.0,15,0,0,0,0,stay,1975-12-06
2863,"Earth, Wind & Fire",1976-03-27,"Earth, Wind & Fire - Gratitude",2,2,3,1.0,2,Gratitude,27.0,16,-1,0,0,1,down,1975-12-06
2864,"Earth, Wind & Fire",1976-04-03,"Earth, Wind & Fire - Gratitude",2,2,5,1.0,3,Gratitude,27.0,17,-2,-1,0,1,down,1975-12-06
2865,"Earth, Wind & Fire",1976-04-10,"Earth, Wind & Fire - Gratitude",3,2,6,1.0,5,Gratitude,27.0,18,-1,-2,-1,1,down,1975-12-06
2866,"Earth, Wind & Fire",1976-04-17,"Earth, Wind & Fire - Gratitude",5,3,6,1.0,6,Gratitude,27.0,19,0,-1,-2,0,stay,1975-12-06
2867,"Earth, Wind & Fire",1976-04-24,"Earth, Wind & Fire - Gratitude",6,5,5,1.0,6,Gratitude,27.0,20,1,0,-1,1,up,1975-12-06
2868,"Earth, Wind & Fire",1976-05-01,"Earth, Wind & Fire - Gratitude",6,6,7,1.0,5,Gratitude,27.0,21,-2,1,0,1,down,1975-12-06
2869,"Earth, Wind & Fire",1976-05-08,"Earth, Wind & Fire - Gratitude",5,6,13,1.0,7,Gratitude,27.0,22,-6,-2,1,1,down,1975-12-06
2870,"Earth, Wind & Fire",1976-05-15,"Earth, Wind & Fire - Gratitude",7,5,14,1.0,13,Gratitude,27.0,23,-1,-6,-2,1,down,1975-12-06
2871,"Earth, Wind & Fire",1976-05-22,"Earth, Wind & Fire - Gratitude",13,7,15,1.0,14,Gratitude,27.0,24,-1,-1,-6,1,down,1975-12-06
2872,"Earth, Wind & Fire",1976-05-29,"Earth, Wind & Fire - Gratitude",14,13,14,1.0,15,Gratitude,27.0,25,1,-1,-1,1,up,1975-12-06
2873,"Earth, Wind & Fire",1976-06-05,"Earth, Wind & Fire - Gratitude",15,14,44,1.0,14,Gratitude,27.0,26,-30,1,-1,1,down,1975-12-06
2874,"Earth, Wind & Fire",1976-06-12,"Earth, Wind & Fire - Gratitude",14,15,51,1.0,44,Gratitude,27.0,27,-7,-30,1,1,down,1975-12-06
2875,The Temptations,1975-12-06,The Temptations - House Party,51,51,28,11.0,35,House Party,9.0,0,7,16,0,1,up,1975-12-06
2876,The Temptations,1975-12-13,The Temptations - House Party,35,51,22,11.0,28,House Party,9.0,1,6,7,16,1,up,1975-12-06
2877,The Temptations,1975-12-20,The Temptations - House Party,28,35,14,11.0,22,House Party,9.0,2,8,6,7,1,up,1975-12-06
2878,The Temptations,1975-12-27,The Temptations - House Party,22,28,13,11.0,14,House Party,9.0,3,1,8,6,1,up,1975-12-06
2879,The Temptations,1976-01-03,The Temptations - House Party,14,22,11,11.0,13,House Party,9.0,4,2,1,8,1,up,1975-12-06
2880,The Temptations,1976-01-10,The Temptations - House Party,13,14,13,11.0,11,House Party,9.0,5,-2,2,1,1,down,1975-12-06
2881,The Temptations,1976-01-17,The Temptations - House Party,11,13,18,11.0,13,House Party,9.0,6,-5,-2,2,1,down,1975-12-06
2882,The Temptations,1976-01-24,The Temptations - House Party,13,11,28,11.0,18,House Party,9.0,7,-10,-5,-2,1,down,1975-12-06
2883,The Temptations,1976-01-31,The Temptations - House Party,18,13,31,11.0,28,House Party,9.0,8,-3,-10,-5,1,down,1975-12-06
2884,The Temptations,1976-02-07,The Temptations - House Party,28,18,51,11.0,31,House Party,9.0,9,-20,-3,-10,1,down,1975-12-06
2885,The Blackbyrds,1975-12-06,The Blackbyrds - City Life,51,51,34,3.0,46,City Life,27.0,0,12,5,0,1,up,1975-12-06
2886,The Blackbyrds,1975-12-13,The Blackbyrds - City Life,46,51,31,3.0,34,City Life,27.0,1,3,12,5,1,up,1975-12-06
2887,The Blackbyrds,1975-12-20,The Blackbyrds - City Life,34,46,25,3.0,31,City Life,27.0,2,6,3,12,1,up,1975-12-06
2888,The Blackbyrds,1975-12-27,The Blackbyrds - City Life,31,34,19,3.0,25,City Life,27.0,3,6,6,3,1,up,1975-12-06
2889,The Blackbyrds,1976-01-03,The Blackbyrds - City Life,25,31,18,3.0,19,City Life,27.0,4,1,6,6,1,up,1975-12-06
2890,The Blackbyrds,1976-01-10,The Blackbyrds - City Life,19,25,23,3.0,18,City Life,27.0,5,-5,1,6,1,down,1975-12-06
2891,The Blackbyrds,1976-01-17,The Blackbyrds - City Life,18,19,27,3.0,23,City Life,27.0,6,-4,-5,1,1,down,1975-12-06
2892,The Blackbyrds,1976-01-24,The Blackbyrds - City Life,23,18,27,3.0,27,City Life,27.0,7,0,-4,-5,0,stay,1975-12-06
2893,The Blackbyrds,1976-01-31,The Blackbyrds - City Life,27,23,27,3.0,27,City Life,27.0,8,0,0,-4,0,stay,1975-12-06
2894,The Blackbyrds,1976-02-07,The Blackbyrds - City Life,27,27,23,3.0,27,City Life,27.0,9,4,0,0,1,up,1975-12-06
2895,The Blackbyrds,1976-02-14,The Blackbyrds - City Life,27,27,16,3.0,23,City Life,27.0,10,7,4,0,1,up,1975-12-06
2896,The Blackbyrds,1976-02-21,The Blackbyrds - City Life,23,27,12,3.0,16,City Life,27.0,11,4,7,4,1,up,1975-12-06
2897,The Blackbyrds,1976-02-28,The Blackbyrds - City Life,16,23,9,3.0,12,City Life,27.0,12,3,4,7,1,up,1975-12-06
2898,The Blackbyrds,1976-03-06,The Blackbyrds - City Life,12,16,9,3.0,9,City Life,27.0,13,0,3,4,0,stay,1975-12-06
2899,The Blackbyrds,1976-03-13,The Blackbyrds - City Life,9,12,7,3.0,9,City Life,27.0,14,2,0,3,1,up,1975-12-06
2900,The Blackbyrds,1976-03-20,The Blackbyrds - City Life,9,9,6,3.0,7,City Life,27.0,15,1,2,0,1,up,1975-12-06
2901,The Blackbyrds,1976-03-27,The Blackbyrds - City Life,7,9,5,3.0,6,City Life,27.0,16,1,1,2,1,up,1975-12-06
2902,The Blackbyrds,1976-04-03,The Blackbyrds - City Life,6,7,4,3.0,5,City Life,27.0,17,1,1,1,1,up,1975-12-06
2903,The Blackbyrds,1976-04-10,The Blackbyrds - City Life,5,6,3,3.0,4,City Life,27.0,18,1,1,1,1,up,1975-12-06
2904,The Blackbyrds,1976-04-17,The Blackbyrds - City Life,4,5,5,3.0,3,City Life,27.0,19,-2,1,1,1,down,1975-12-06
2905,The Blackbyrds,1976-04-24,The Blackbyrds - City Life,3,4,11,3.0,5,City Life,27.0,20,-6,-2,1,1,down,1975-12-06
2906,The Blackbyrds,1976-05-01,The Blackbyrds - City Life,5,3,11,3.0,11,City Life,27.0,21,0,-6,-2,0,stay,1975-12-06
2907,The Blackbyrds,1976-05-08,The Blackbyrds - City Life,11,5,10,3.0,11,City Life,27.0,22,1,0,-6,1,up,1975-12-06
2908,The Blackbyrds,1976-05-15,The Blackbyrds - City Life,11,11,12,3.0,10,City Life,27.0,23,-2,1,0,1,down,1975-12-06
2909,The Blackbyrds,1976-05-22,The Blackbyrds - City Life,10,11,12,3.0,12,City Life,27.0,24,0,-2,1,0,stay,1975-12-06
2910,The Blackbyrds,1976-05-29,The Blackbyrds - City Life,12,10,13,3.0,12,City Life,27.0,25,-1,0,-2,1,down,1975-12-06
2911,The Blackbyrds,1976-06-05,The Blackbyrds - City Life,12,12,29,3.0,13,City Life,27.0,26,-16,-1,0,1,down,1975-12-06
2912,The Blackbyrds,1976-06-12,The Blackbyrds - City Life,13,12,51,3.0,29,City Life,27.0,27,-22,-16,-1,1,down,1975-12-06
2913,Bobby Womack,1975-12-06,Bobby Womack - Safety Zone,51,51,44,40.0,47,Safety Zone,10.0,0,3,4,0,1,up,1975-12-06
2914,Bobby Womack,1975-12-13,Bobby Womack - Safety Zone,47,51,42,40.0,44,Safety Zone,10.0,1,2,3,4,1,up,1975-12-06
2915,Bobby Womack,1975-12-20,Bobby Womack - Safety Zone,44,47,41,40.0,42,Safety Zone,10.0,2,1,2,3,1,up,1975-12-06
2916,Bobby Womack,1975-12-27,Bobby Womack - Safety Zone,42,44,41,40.0,41,Safety Zone,10.0,3,0,1,2,0,stay,1975-12-06
2917,Bobby Womack,1976-01-03,Bobby Womack - Safety Zone,41,42,40,40.0,41,Safety Zone,10.0,4,1,0,1,1,up,1975-12-06
2918,Bobby Womack,1976-01-10,Bobby Womack - Safety Zone,41,41,46,40.0,40,Safety Zone,10.0,5,-6,1,0,1,down,1975-12-06
2919,Bobby Womack,1976-04-17,Bobby Womack - Safety Zone,40,41,41,40.0,46,Safety Zone,10.0,6,5,-6,1,1,up,1975-12-06
2920,Bobby Womack,1976-04-24,Bobby Womack - Safety Zone,46,40,46,40.0,41,Safety Zone,10.0,7,-5,5,-6,1,down,1975-12-06
2921,Bobby Womack,1976-05-01,Bobby Womack - Safety Zone,41,46,46,40.0,46,Safety Zone,10.0,8,0,-5,5,0,stay,1975-12-06
2922,Bobby Womack,1976-05-08,Bobby Womack - Safety Zone,46,41,42,40.0,46,Safety Zone,10.0,9,4,0,-5,1,up,1975-12-06
2923,Bobby Womack,1976-05-15,Bobby Womack - Safety Zone,46,46,51,40.0,42,Safety Zone,10.0,10,-9,4,0,1,down,1975-12-06
2924,Harold Melvin And The Blue Notes,1975-12-06,Harold Melvin And The Blue Notes - Wake Up Everybody,51,51,39,1.0,48,Wake Up Everybody,26.0,0,9,3,0,1,up,1975-12-06
2925,Harold Melvin And The Blue Notes,1975-12-13,Harold Melvin And The Blue Notes - Wake Up Everybody,48,51,21,1.0,39,Wake Up Everybody,26.0,1,18,9,3,1,up,1975-12-06
2926,Harold Melvin And The Blue Notes,1975-12-20,Harold Melvin And The Blue Notes - Wake Up Everybody,39,48,9,1.0,21,Wake Up Everybody,26.0,2,12,18,9,1,up,1975-12-06
2927,Harold Melvin And The Blue Notes,1975-12-27,Harold Melvin And The Blue Notes - Wake Up Everybody,21,39,3,1.0,9,Wake Up Everybody,26.0,3,6,12,18,1,up,1975-12-06
2928,Harold Melvin And The Blue Notes,1976-01-03,Harold Melvin And The Blue Notes - Wake Up Everybody,9,21,2,1.0,3,Wake Up Everybody,26.0,4,1,6,12,1,up,1975-12-06
2929,Harold Melvin And The Blue Notes,1976-01-10,Harold Melvin And The Blue Notes - Wake Up Everybody,3,9,2,1.0,2,Wake Up Everybody,26.0,5,0,1,6,0,stay,1975-12-06
2930,Harold Melvin And The Blue Notes,1976-01-17,Harold Melvin And The Blue Notes - Wake Up Everybody,2,3,1,1.0,2,Wake Up Everybody,26.0,6,1,0,1,1,up,1975-12-06
2931,Harold Melvin And The Blue Notes,1976-01-24,Harold Melvin And The Blue Notes - Wake Up Everybody,2,2,1,1.0,1,Wake Up Everybody,26.0,7,0,1,0,0,stay,1975-12-06
2932,Harold Melvin And The Blue Notes,1976-01-31,Harold Melvin And The Blue Notes - Wake Up Everybody,1,2,2,1.0,1,Wake Up Everybody,26.0,8,-1,0,1,1,down,1975-12-06
2933,Harold Melvin And The Blue Notes,1976-02-07,Harold Melvin And The Blue Notes - Wake Up Everybody,1,1,2,1.0,2,Wake Up Everybody,26.0,9,0,-1,0,0,stay,1975-12-06
2934,Harold Melvin And The Blue Notes,1976-02-14,Harold Melvin And The Blue Notes - Wake Up Everybody,2,1,3,1.0,2,Wake Up Everybody,26.0,10,-1,0,-1,1,down,1975-12-06
2935,Harold Melvin And The Blue Notes,1976-02-21,Harold Melvin And The Blue Notes - Wake Up Everybody,2,2,3,1.0,3,Wake Up Everybody,26.0,11,0,-1,0,0,stay,1975-12-06
2936,Harold Melvin And The Blue Notes,1976-02-28,Harold Melvin And The Blue Notes - Wake Up Everybody,3,2,3,1.0,3,Wake Up Everybody,26.0,12,0,0,-1,0,stay,1975-12-06
2937,Harold Melvin And The Blue Notes,1976-03-06,Harold Melvin And The Blue Notes - Wake Up Everybody,3,3,3,1.0,3,Wake Up Everybody,26.0,13,0,0,0,0,stay,1975-12-06
2938,Harold Melvin And The Blue Notes,1976-03-13,Harold Melvin And The Blue Notes - Wake Up Everybody,3,3,3,1.0,3,Wake Up Everybody,26.0,14,0,0,0,0,stay,1975-12-06
2939,Harold Melvin And The Blue Notes,1976-03-20,Harold Melvin And The Blue Notes - Wake Up Everybody,3,3,12,1.0,3,Wake Up Everybody,26.0,15,-9,0,0,1,down,1975-12-06
2940,Harold Melvin And The Blue Notes,1976-03-27,Harold Melvin And The Blue Notes - Wake Up Everybody,3,3,12,1.0,12,Wake Up Everybody,26.0,16,0,-9,0,0,stay,1975-12-06
2941,Harold Melvin And The Blue Notes,1976-04-03,Harold Melvin And The Blue Notes - Wake Up Everybody,12,3,12,1.0,12,Wake Up Everybody,26.0,17,0,0,-9,0,stay,1975-12-06
2942,Harold Melvin And The Blue Notes,1976-04-10,Harold Melvin And The Blue Notes - Wake Up Everybody,12,12,13,1.0,12,Wake Up Everybody,26.0,18,-1,0,0,1,down,1975-12-06
2943,Harold Melvin And The Blue Notes,1976-04-17,Harold Melvin And The Blue Notes - Wake Up Everybody,12,12,13,1.0,13,Wake Up Everybody,26.0,19,0,-1,0,0,stay,1975-12-06
2944,Harold Melvin And The Blue Notes,1976-04-24,Harold Melvin And The Blue Notes - Wake Up Everybody,13,12,13,1.0,13,Wake Up Everybody,26.0,20,0,0,-1,0,stay,1975-12-06
2945,Harold Melvin And The Blue Notes,1976-05-01,Harold Melvin And The Blue Notes - Wake Up Everybody,13,13,16,1.0,13,Wake Up Everybody,26.0,21,-3,0,0,1,down,1975-12-06
2946,Harold Melvin And The Blue Notes,1976-05-08,Harold Melvin And The Blue Notes - Wake Up Everybody,13,13,16,1.0,16,Wake Up Everybody,26.0,22,0,-3,0,0,stay,1975-12-06
2947,Harold Melvin And The Blue Notes,1976-05-15,Harold Melvin And The Blue Notes - Wake Up Everybody,16,13,16,1.0,16,Wake Up Everybody,26.0,23,0,0,-3,0,stay,1975-12-06
2948,Harold Melvin And The Blue Notes,1976-05-22,Harold Melvin And The Blue Notes - Wake Up Everybody,16,16,18,1.0,16,Wake Up Everybody,26.0,24,-2,0,0,1,down,1975-12-06
2949,Harold Melvin And The Blue Notes,1976-05-29,Harold Melvin And The Blue Notes - Wake Up Everybody,16,16,27,1.0,18,Wake Up Everybody,26.0,25,-9,-2,0,1,down,1975-12-06
2950,Harold Melvin And The Blue Notes,1976-06-05,Harold Melvin And The Blue Notes - Wake Up Everybody,18,16,51,1.0,27,Wake Up Everybody,26.0,26,-24,-9,-2,1,down,1975-12-06
2951,The Main Ingredient,1975-12-06,The Main Ingredient - Shame On The World,51,51,40,27.0,50,Shame On The World,9.0,0,10,1,0,1,up,1975-12-06
2952,The Main Ingredient,1975-12-13,The Main Ingredient - Shame On The World,50,51,32,27.0,40,Shame On The World,9.0,1,8,10,1,1,up,1975-12-06
2953,The Main Ingredient,1975-12-20,The Main Ingredient - Shame On The World,40,50,28,27.0,32,Shame On The World,9.0,2,4,8,10,1,up,1975-12-06
2954,The Main Ingredient,1975-12-27,The Main Ingredient - Shame On The World,32,40,27,27.0,28,Shame On The World,9.0,3,1,4,8,1,up,1975-12-06
2955,The Main Ingredient,1976-01-03,The Main Ingredient - Shame On The World,28,32,36,27.0,27,Shame On The World,9.0,4,-9,1,4,1,down,1975-12-06
2956,The Main Ingredient,1976-01-10,The Main Ingredient - Shame On The World,27,28,38,27.0,36,Shame On The World,9.0,5,-2,-9,1,1,down,1975-12-06
2957,The Main Ingredient,1976-01-17,The Main Ingredient - Shame On The World,36,27,35,27.0,38,Shame On The World,9.0,6,3,-2,-9,1,up,1975-12-06
2958,The Main Ingredient,1976-01-24,The Main Ingredient - Shame On The World,38,36,35,27.0,35,Shame On The World,9.0,7,0,3,-2,0,stay,1975-12-06
2959,The Main Ingredient,1976-01-31,The Main Ingredient - Shame On The World,35,38,38,27.0,35,Shame On The World,9.0,8,-3,0,3,1,down,1975-12-06
2960,The Main Ingredient,1976-02-07,The Main Ingredient - Shame On The World,35,35,51,27.0,38,Shame On The World,9.0,9,-13,-3,0,1,down,1975-12-06
2961,Coke Escovedo,1975-12-13,Coke Escovedo - Coke,51,51,44,44.0,48,Coke,2.0,0,4,3,0,1,up,1975-12-13
2962,Coke Escovedo,1975-12-20,Coke Escovedo - Coke,48,51,44,44.0,44,Coke,2.0,1,0,4,3,0,stay,1975-12-13
2963,Coke Escovedo,1975-12-27,Coke Escovedo - Coke,44,48,51,44.0,44,Coke,2.0,2,-7,0,4,1,down,1975-12-13
2964,Billy Paul,1975-12-13,Billy Paul - When Love Is New,51,51,38,17.0,49,When Love Is New,16.0,0,11,2,0,1,up,1975-12-13
2965,Billy Paul,1975-12-20,Billy Paul - When Love Is New,49,51,29,17.0,38,When Love Is New,16.0,1,9,11,2,1,up,1975-12-13
2966,Billy Paul,1975-12-27,Billy Paul - When Love Is New,38,49,23,17.0,29,When Love Is New,16.0,2,6,9,11,1,up,1975-12-13
2967,Billy Paul,1976-01-03,Billy Paul - When Love Is New,29,38,20,17.0,23,When Love Is New,16.0,3,3,6,9,1,up,1975-12-13
2968,Billy Paul,1976-01-10,Billy Paul - When Love Is New,23,29,17,17.0,20,When Love Is New,16.0,4,3,3,6,1,up,1975-12-13
2969,Billy Paul,1976-01-17,Billy Paul - When Love Is New,20,23,17,17.0,17,When Love Is New,16.0,5,0,3,3,0,stay,1975-12-13
2970,Billy Paul,1976-01-24,Billy Paul - When Love Is New,17,20,18,17.0,17,When Love Is New,16.0,6,-1,0,3,1,down,1975-12-13
2971,Billy Paul,1976-01-31,Billy Paul - When Love Is New,17,17,23,17.0,18,When Love Is New,16.0,7,-5,-1,0,1,down,1975-12-13
2972,Billy Paul,1976-02-07,Billy Paul - When Love Is New,18,17,28,17.0,23,When Love Is New,16.0,8,-5,-5,-1,1,down,1975-12-13
2973,Billy Paul,1976-02-14,Billy Paul - When Love Is New,23,18,38,17.0,28,When Love Is New,16.0,9,-10,-5,-5,1,down,1975-12-13
2974,Billy Paul,1976-02-21,Billy Paul - When Love Is New,28,23,34,17.0,38,When Love Is New,16.0,10,4,-10,-5,1,up,1975-12-13
2975,Billy Paul,1976-02-28,Billy Paul - When Love Is New,38,28,35,17.0,34,When Love Is New,16.0,11,-1,4,-10,1,down,1975-12-13
2976,Billy Paul,1976-03-06,Billy Paul - When Love Is New,34,38,35,17.0,35,When Love Is New,16.0,12,0,-1,4,0,stay,1975-12-13
2977,Billy Paul,1976-03-13,Billy Paul - When Love Is New,35,34,29,17.0,35,When Love Is New,16.0,13,6,0,-1,1,up,1975-12-13
2978,Billy Paul,1976-03-20,Billy Paul - When Love Is New,35,35,29,17.0,29,When Love Is New,16.0,14,0,6,0,0,stay,1975-12-13
2979,Billy Paul,1976-03-27,Billy Paul - When Love Is New,29,35,31,17.0,29,When Love Is New,16.0,15,-2,0,6,1,down,1975-12-13
2980,Billy Paul,1976-04-03,Billy Paul - When Love Is New,29,29,51,17.0,31,When Love Is New,16.0,16,-20,-2,0,1,down,1975-12-13
2981,Dionne Warwick,1975-12-13,Dionne Warwick - Track Of The Cat,51,51,48,15.0,50,Track Of The Cat,12.0,0,2,1,0,1,up,1975-12-13
2982,Dionne Warwick,1975-12-20,Dionne Warwick - Track Of The Cat,50,51,37,15.0,48,Track Of The Cat,12.0,1,11,2,1,1,up,1975-12-13
2983,Dionne Warwick,1975-12-27,Dionne Warwick - Track Of The Cat,48,50,29,15.0,37,Track Of The Cat,12.0,2,8,11,2,1,up,1975-12-13
2984,Dionne Warwick,1976-01-03,Dionne Warwick - Track Of The Cat,37,48,23,15.0,29,Track Of The Cat,12.0,3,6,8,11,1,up,1975-12-13
2985,Dionne Warwick,1976-01-10,Dionne Warwick - Track Of The Cat,29,37,18,15.0,23,Track Of The Cat,12.0,4,5,6,8,1,up,1975-12-13
2986,Dionne Warwick,1976-01-17,Dionne Warwick - Track Of The Cat,23,29,16,15.0,18,Track Of The Cat,12.0,5,2,5,6,1,up,1975-12-13
2987,Dionne Warwick,1976-01-24,Dionne Warwick - Track Of The Cat,18,23,15,15.0,16,Track Of The Cat,12.0,6,1,2,5,1,up,1975-12-13
2988,Dionne Warwick,1976-01-31,Dionne Warwick - Track Of The Cat,16,18,19,15.0,15,Track Of The Cat,12.0,7,-4,1,2,1,down,1975-12-13
2989,Dionne Warwick,1976-02-07,Dionne Warwick - Track Of The Cat,15,16,30,15.0,19,Track Of The Cat,12.0,8,-11,-4,1,1,down,1975-12-13
2990,Dionne Warwick,1976-02-14,Dionne Warwick - Track Of The Cat,19,15,30,15.0,30,Track Of The Cat,12.0,9,0,-11,-4,0,stay,1975-12-13
2991,Dionne Warwick,1976-02-21,Dionne Warwick - Track Of The Cat,30,19,41,15.0,30,Track Of The Cat,12.0,10,-11,0,-11,1,down,1975-12-13
2992,Dionne Warwick,1976-02-28,Dionne Warwick - Track Of The Cat,30,30,41,15.0,41,Track Of The Cat,12.0,11,0,-11,0,0,stay,1975-12-13
2993,Dionne Warwick,1976-03-06,Dionne Warwick - Track Of The Cat,41,30,51,15.0,41,Track Of The Cat,12.0,12,-10,0,-11,1,down,1975-12-13
2994,The Spinners,1975-12-20,The Spinners - Spinners Live,51,51,22,4.0,47,Spinners Live,16.0,0,25,4,0,1,up,1975-12-20
2995,The Spinners,1975-12-27,The Spinners - Spinners Live,47,51,16,4.0,22,Spinners Live,16.0,1,6,25,4,1,up,1975-12-20
2996,The Spinners,1976-01-03,The Spinners - Spinners Live,22,47,10,4.0,16,Spinners Live,16.0,2,6,6,25,1,up,1975-12-20
2997,The Spinners,1976-01-10,The Spinners - Spinners Live,16,22,5,4.0,10,Spinners Live,16.0,3,5,6,6,1,up,1975-12-20
2998,The Spinners,1976-01-17,The Spinners - Spinners Live,10,16,5,4.0,5,Spinners Live,16.0,4,0,5,6,0,stay,1975-12-20
2999,The Spinners,1976-01-24,The Spinners - Spinners Live,5,10,4,4.0,5,Spinners Live,16.0,5,1,0,5,1,up,1975-12-20
3000,The Spinners,1976-01-31,The Spinners - Spinners Live,5,5,4,4.0,4,Spinners Live,16.0,6,0,1,0,0,stay,1975-12-20
3001,The Spinners,1976-02-07,The Spinners - Spinners Live,4,5,7,4.0,4,Spinners Live,16.0,7,-3,0,1,1,down,1975-12-20
3002,The Spinners,1976-02-14,The Spinners - Spinners Live,4,4,7,4.0,7,Spinners Live,16.0,8,0,-3,0,0,stay,1975-12-20
3003,The Spinners,1976-02-21,The Spinners - Spinners Live,7,4,8,4.0,7,Spinners Live,16.0,9,-1,0,-3,1,down,1975-12-20
3004,The Spinners,1976-02-28,The Spinners - Spinners Live,7,7,8,4.0,8,Spinners Live,16.0,10,0,-1,0,0,stay,1975-12-20
3005,The Spinners,1976-03-06,The Spinners - Spinners Live,8,7,12,4.0,8,Spinners Live,16.0,11,-4,0,-1,1,down,1975-12-20
3006,The Spinners,1976-03-13,The Spinners - Spinners Live,8,8,12,4.0,12,Spinners Live,16.0,12,0,-4,0,0,stay,1975-12-20
3007,The Spinners,1976-03-20,The Spinners - Spinners Live,12,8,22,4.0,12,Spinners Live,16.0,13,-10,0,-4,1,down,1975-12-20
3008,The Spinners,1976-03-27,The Spinners - Spinners Live,12,12,44,4.0,22,Spinners Live,16.0,14,-22,-10,0,1,down,1975-12-20
3009,The Spinners,1976-04-03,The Spinners - Spinners Live,22,12,40,4.0,44,Spinners Live,16.0,15,4,-22,-10,1,up,1975-12-20
3010,The Spinners,1976-04-10,The Spinners - Spinners Live,44,22,51,4.0,40,Spinners Live,16.0,16,-11,4,-22,1,down,1975-12-20
3011,Creative Source,1975-12-20,Creative Source - Pass The Feelin' On,51,51,51,49.0,49,Pass The Feelin' On,0.0,0,-2,2,0,1,down,1975-12-20
3012,Soul Train Gang,1975-12-20,Soul Train Gang - Don Cornelius Presents The Soul Train Gang,51,51,39,31.0,50,Don Cornelius Presents The Soul Train Gang,6.0,0,11,1,0,1,up,1975-12-20
3013,Soul Train Gang,1975-12-27,Soul Train Gang - Don Cornelius Presents The Soul Train Gang,50,51,34,31.0,39,Don Cornelius Presents The Soul Train Gang,6.0,1,5,11,1,1,up,1975-12-20
3014,Soul Train Gang,1976-01-03,Soul Train Gang - Don Cornelius Presents The Soul Train Gang,39,50,33,31.0,34,Don Cornelius Presents The Soul Train Gang,6.0,2,1,5,11,1,up,1975-12-20
3015,Soul Train Gang,1976-01-10,Soul Train Gang - Don Cornelius Presents The Soul Train Gang,34,39,31,31.0,33,Don Cornelius Presents The Soul Train Gang,6.0,3,2,1,5,1,up,1975-12-20
3016,Soul Train Gang,1976-01-17,Soul Train Gang - Don Cornelius Presents The Soul Train Gang,33,34,31,31.0,31,Don Cornelius Presents The Soul Train Gang,6.0,4,0,2,1,0,stay,1975-12-20
3017,Soul Train Gang,1976-01-24,Soul Train Gang - Don Cornelius Presents The Soul Train Gang,31,33,39,31.0,31,Don Cornelius Presents The Soul Train Gang,6.0,5,-8,0,2,1,down,1975-12-20
3018,Soul Train Gang,1976-01-31,Soul Train Gang - Don Cornelius Presents The Soul Train Gang,31,31,51,31.0,39,Don Cornelius Presents The Soul Train Gang,6.0,6,-12,-8,0,1,down,1975-12-20
3019,The Salsoul Orchestra,1975-12-27,The Salsoul Orchestra - The Salsoul Orchestra,51,51,32,20.0,40,The Salsoul Orchestra,15.0,0,8,11,0,1,up,1975-12-27
3020,The Salsoul Orchestra,1976-01-03,The Salsoul Orchestra - The Salsoul Orchestra,40,51,24,20.0,32,The Salsoul Orchestra,15.0,1,8,8,11,1,up,1975-12-27
3021,The Salsoul Orchestra,1976-01-10,The Salsoul Orchestra - The Salsoul Orchestra,32,40,21,20.0,24,The Salsoul Orchestra,15.0,2,3,8,8,1,up,1975-12-27
3022,The Salsoul Orchestra,1976-01-17,The Salsoul Orchestra - The Salsoul Orchestra,24,32,20,20.0,21,The Salsoul Orchestra,15.0,3,1,3,8,1,up,1975-12-27
3023,The Salsoul Orchestra,1976-01-24,The Salsoul Orchestra - The Salsoul Orchestra,21,24,21,20.0,20,The Salsoul Orchestra,15.0,4,-1,1,3,1,down,1975-12-27
3024,The Salsoul Orchestra,1976-01-31,The Salsoul Orchestra - The Salsoul Orchestra,20,21,29,20.0,21,The Salsoul Orchestra,15.0,5,-8,-1,1,1,down,1975-12-27
3025,The Salsoul Orchestra,1976-02-07,The Salsoul Orchestra - The Salsoul Orchestra,21,20,29,20.0,29,The Salsoul Orchestra,15.0,6,0,-8,-1,0,stay,1975-12-27
3026,The Salsoul Orchestra,1976-02-14,The Salsoul Orchestra - The Salsoul Orchestra,29,21,28,20.0,29,The Salsoul Orchestra,15.0,7,1,0,-8,1,up,1975-12-27
3027,The Salsoul Orchestra,1976-02-21,The Salsoul Orchestra - The Salsoul Orchestra,29,29,25,20.0,28,The Salsoul Orchestra,15.0,8,3,1,0,1,up,1975-12-27
3028,The Salsoul Orchestra,1976-02-28,The Salsoul Orchestra - The Salsoul Orchestra,28,29,31,20.0,25,The Salsoul Orchestra,15.0,9,-6,3,1,1,down,1975-12-27
3029,The Salsoul Orchestra,1976-03-06,The Salsoul Orchestra - The Salsoul Orchestra,25,28,31,20.0,31,The Salsoul Orchestra,15.0,10,0,-6,3,0,stay,1975-12-27
3030,The Salsoul Orchestra,1976-03-13,The Salsoul Orchestra - The Salsoul Orchestra,31,25,40,20.0,31,The Salsoul Orchestra,15.0,11,-9,0,-6,1,down,1975-12-27
3031,The Salsoul Orchestra,1976-03-20,The Salsoul Orchestra - The Salsoul Orchestra,31,31,47,20.0,40,The Salsoul Orchestra,15.0,12,-7,-9,0,1,down,1975-12-27
3032,The Salsoul Orchestra,1976-03-27,The Salsoul Orchestra - The Salsoul Orchestra,40,31,39,20.0,47,The Salsoul Orchestra,15.0,13,8,-7,-9,1,up,1975-12-27
3033,The Salsoul Orchestra,1976-04-03,The Salsoul Orchestra - The Salsoul Orchestra,47,40,48,20.0,39,The Salsoul Orchestra,15.0,14,-9,8,-7,1,down,1975-12-27
3034,The Salsoul Orchestra,1976-04-10,The Salsoul Orchestra - The Salsoul Orchestra,39,47,51,20.0,48,The Salsoul Orchestra,15.0,15,-3,-9,8,1,down,1975-12-27
3035,Ohio Players,1975-12-27,Ohio Players - Rattlesnake,51,51,33,8.0,45,Rattlesnake,11.0,0,12,6,0,1,up,1975-12-27
3036,Ohio Players,1976-01-03,Ohio Players - Rattlesnake,45,51,29,8.0,33,Rattlesnake,11.0,1,4,12,6,1,up,1975-12-27
3037,Ohio Players,1976-01-10,Ohio Players - Rattlesnake,33,45,19,8.0,29,Rattlesnake,11.0,2,10,4,12,1,up,1975-12-27
3038,Ohio Players,1976-01-17,Ohio Players - Rattlesnake,29,33,15,8.0,19,Rattlesnake,11.0,3,4,10,4,1,up,1975-12-27
3039,Ohio Players,1976-01-24,Ohio Players - Rattlesnake,19,29,9,8.0,15,Rattlesnake,11.0,4,6,4,10,1,up,1975-12-27
3040,Ohio Players,1976-01-31,Ohio Players - Rattlesnake,15,19,8,8.0,9,Rattlesnake,11.0,5,1,6,4,1,up,1975-12-27
3041,Ohio Players,1976-02-07,Ohio Players - Rattlesnake,9,15,8,8.0,8,Rattlesnake,11.0,6,0,1,6,0,stay,1975-12-27
3042,Ohio Players,1976-02-14,Ohio Players - Rattlesnake,8,9,10,8.0,8,Rattlesnake,11.0,7,-2,0,1,1,down,1975-12-27
3043,Ohio Players,1976-02-21,Ohio Players - Rattlesnake,8,8,9,8.0,10,Rattlesnake,11.0,8,1,-2,0,1,up,1975-12-27
3044,Ohio Players,1976-02-28,Ohio Players - Rattlesnake,10,8,16,8.0,9,Rattlesnake,11.0,9,-7,1,-2,1,down,1975-12-27
3045,Ohio Players,1976-03-06,Ohio Players - Rattlesnake,9,10,21,8.0,16,Rattlesnake,11.0,10,-5,-7,1,1,down,1975-12-27
3046,Ohio Players,1976-03-13,Ohio Players - Rattlesnake,16,9,51,8.0,21,Rattlesnake,11.0,11,-30,-5,-7,1,down,1975-12-27
3047,Tom Scott,1975-12-27,Tom Scott - New York Connection,51,51,37,15.0,47,New York Connection,15.0,0,10,4,0,1,up,1975-12-27
3048,Tom Scott,1976-01-03,Tom Scott - New York Connection,47,51,30,15.0,37,New York Connection,15.0,1,7,10,4,1,up,1975-12-27
3049,Tom Scott,1976-01-10,Tom Scott - New York Connection,37,47,24,15.0,30,New York Connection,15.0,2,6,7,10,1,up,1975-12-27
3050,Tom Scott,1976-01-17,Tom Scott - New York Connection,30,37,24,15.0,24,New York Connection,15.0,3,0,6,7,0,stay,1975-12-27
3051,Tom Scott,1976-01-24,Tom Scott - New York Connection,24,30,26,15.0,24,New York Connection,15.0,4,-2,0,6,1,down,1975-12-27
3052,Tom Scott,1976-01-31,Tom Scott - New York Connection,24,24,20,15.0,26,New York Connection,15.0,5,6,-2,0,1,up,1975-12-27
3053,Tom Scott,1976-02-07,Tom Scott - New York Connection,26,24,19,15.0,20,New York Connection,15.0,6,1,6,-2,1,up,1975-12-27
3054,Tom Scott,1976-02-14,Tom Scott - New York Connection,20,26,18,15.0,19,New York Connection,15.0,7,1,1,6,1,up,1975-12-27
3055,Tom Scott,1976-02-21,Tom Scott - New York Connection,19,20,16,15.0,18,New York Connection,15.0,8,2,1,1,1,up,1975-12-27
3056,Tom Scott,1976-02-28,Tom Scott - New York Connection,18,19,17,15.0,16,New York Connection,15.0,9,-1,2,1,1,down,1975-12-27
3057,Tom Scott,1976-03-06,Tom Scott - New York Connection,16,18,15,15.0,17,New York Connection,15.0,10,2,-1,2,1,up,1975-12-27
3058,Tom Scott,1976-03-13,Tom Scott - New York Connection,17,16,18,15.0,15,New York Connection,15.0,11,-3,2,-1,1,down,1975-12-27
3059,Tom Scott,1976-03-20,Tom Scott - New York Connection,15,17,32,15.0,18,New York Connection,15.0,12,-14,-3,2,1,down,1975-12-27
3060,Tom Scott,1976-03-27,Tom Scott - New York Connection,18,15,47,15.0,32,New York Connection,15.0,13,-15,-14,-3,1,down,1975-12-27
3061,Tom Scott,1976-04-03,Tom Scott - New York Connection,32,18,47,15.0,47,New York Connection,15.0,14,0,-15,-14,0,stay,1975-12-27
3062,Tom Scott,1976-04-10,Tom Scott - New York Connection,47,32,51,15.0,47,New York Connection,15.0,15,-4,0,-15,1,down,1975-12-27
3063,"Hamilton, Joe Frank & Reynolds",1975-12-27,"Hamilton, Joe Frank & Reynolds - Fallin' In Love",51,51,50,46.0,48,Fallin' In Love,5.0,0,-2,3,0,1,down,1975-12-27
3064,"Hamilton, Joe Frank & Reynolds",1976-01-03,"Hamilton, Joe Frank & Reynolds - Fallin' In Love",48,51,48,46.0,50,Fallin' In Love,5.0,1,2,-2,3,1,up,1975-12-27
3065,"Hamilton, Joe Frank & Reynolds",1976-01-31,"Hamilton, Joe Frank & Reynolds - Fallin' In Love",50,48,46,46.0,48,Fallin' In Love,5.0,2,2,2,-2,1,up,1975-12-27
3066,"Hamilton, Joe Frank & Reynolds",1976-02-07,"Hamilton, Joe Frank & Reynolds - Fallin' In Love",48,50,46,46.0,46,Fallin' In Love,5.0,3,0,2,2,0,stay,1975-12-27
3067,"Hamilton, Joe Frank & Reynolds",1976-02-14,"Hamilton, Joe Frank & Reynolds - Fallin' In Love",46,48,50,46.0,46,Fallin' In Love,5.0,4,-4,0,2,1,down,1975-12-27
3068,"Hamilton, Joe Frank & Reynolds",1976-02-21,"Hamilton, Joe Frank & Reynolds - Fallin' In Love",46,46,51,46.0,50,Fallin' In Love,5.0,5,-1,-4,0,1,down,1975-12-27
3069,The Mighty Clouds Of Joy,1975-12-27,The Mighty Clouds Of Joy - Kickin',51,51,39,34.0,49,Kickin',6.0,0,10,2,0,1,up,1975-12-27
3070,The Mighty Clouds Of Joy,1976-01-03,The Mighty Clouds Of Joy - Kickin',49,51,34,34.0,39,Kickin',6.0,1,5,10,2,1,up,1975-12-27
3071,The Mighty Clouds Of Joy,1976-01-10,The Mighty Clouds Of Joy - Kickin',39,49,35,34.0,34,Kickin',6.0,2,-1,5,10,1,down,1975-12-27
3072,The Mighty Clouds Of Joy,1976-01-17,The Mighty Clouds Of Joy - Kickin',34,39,39,34.0,35,Kickin',6.0,3,-4,-1,5,1,down,1975-12-27
3073,The Mighty Clouds Of Joy,1976-01-24,The Mighty Clouds Of Joy - Kickin',35,34,40,34.0,39,Kickin',6.0,4,-1,-4,-1,1,down,1975-12-27
3074,The Mighty Clouds Of Joy,1976-01-31,The Mighty Clouds Of Joy - Kickin',39,35,44,34.0,40,Kickin',6.0,5,-4,-1,-4,1,down,1975-12-27
3075,The Mighty Clouds Of Joy,1976-02-07,The Mighty Clouds Of Joy - Kickin',40,39,51,34.0,44,Kickin',6.0,6,-7,-4,-1,1,down,1975-12-27
3076,Archie Bell & The Drells,1975-12-27,Archie Bell & The Drells - Dance Your Troubles Away,51,51,40,11.0,50,Dance Your Troubles Away,19.0,0,10,1,0,1,up,1975-12-27
3077,Archie Bell & The Drells,1976-01-03,Archie Bell & The Drells - Dance Your Troubles Away,50,51,35,11.0,40,Dance Your Troubles Away,19.0,1,5,10,1,1,up,1975-12-27
3078,Archie Bell & The Drells,1976-01-10,Archie Bell & The Drells - Dance Your Troubles Away,40,50,32,11.0,35,Dance Your Troubles Away,19.0,2,3,5,10,1,up,1975-12-27
3079,Archie Bell & The Drells,1976-01-17,Archie Bell & The Drells - Dance Your Troubles Away,35,40,29,11.0,32,Dance Your Troubles Away,19.0,3,3,3,5,1,up,1975-12-27
3080,Archie Bell & The Drells,1976-01-24,Archie Bell & The Drells - Dance Your Troubles Away,32,35,23,11.0,29,Dance Your Troubles Away,19.0,4,6,3,3,1,up,1975-12-27
3081,Archie Bell & The Drells,1976-01-31,Archie Bell & The Drells - Dance Your Troubles Away,29,32,17,11.0,23,Dance Your Troubles Away,19.0,5,6,6,3,1,up,1975-12-27
3082,Archie Bell & The Drells,1976-02-07,Archie Bell & The Drells - Dance Your Troubles Away,23,29,13,11.0,17,Dance Your Troubles Away,19.0,6,4,6,6,1,up,1975-12-27
3083,Archie Bell & The Drells,1976-02-14,Archie Bell & The Drells - Dance Your Troubles Away,17,23,11,11.0,13,Dance Your Troubles Away,19.0,7,2,4,6,1,up,1975-12-27
3084,Archie Bell & The Drells,1976-02-21,Archie Bell & The Drells - Dance Your Troubles Away,13,17,11,11.0,11,Dance Your Troubles Away,19.0,8,0,2,4,0,stay,1975-12-27
3085,Archie Bell & The Drells,1976-02-28,Archie Bell & The Drells - Dance Your Troubles Away,11,13,15,11.0,11,Dance Your Troubles Away,19.0,9,-4,0,2,1,down,1975-12-27
3086,Archie Bell & The Drells,1976-03-06,Archie Bell & The Drells - Dance Your Troubles Away,11,11,23,11.0,15,Dance Your Troubles Away,19.0,10,-8,-4,0,1,down,1975-12-27
3087,Archie Bell & The Drells,1976-03-13,Archie Bell & The Drells - Dance Your Troubles Away,15,11,27,11.0,23,Dance Your Troubles Away,19.0,11,-4,-8,-4,1,down,1975-12-27
3088,Archie Bell & The Drells,1976-03-20,Archie Bell & The Drells - Dance Your Troubles Away,23,15,27,11.0,27,Dance Your Troubles Away,19.0,12,0,-4,-8,0,stay,1975-12-27
3089,Archie Bell & The Drells,1976-03-27,Archie Bell & The Drells - Dance Your Troubles Away,27,23,30,11.0,27,Dance Your Troubles Away,19.0,13,-3,0,-4,1,down,1975-12-27
3090,Archie Bell & The Drells,1976-04-03,Archie Bell & The Drells - Dance Your Troubles Away,27,27,30,11.0,30,Dance Your Troubles Away,19.0,14,0,-3,0,0,stay,1975-12-27
3091,Archie Bell & The Drells,1976-04-10,Archie Bell & The Drells - Dance Your Troubles Away,30,27,27,11.0,30,Dance Your Troubles Away,19.0,15,3,0,-3,1,up,1975-12-27
3092,Archie Bell & The Drells,1976-04-17,Archie Bell & The Drells - Dance Your Troubles Away,30,30,31,11.0,27,Dance Your Troubles Away,19.0,16,-4,3,0,1,down,1975-12-27
3093,Archie Bell & The Drells,1976-04-24,Archie Bell & The Drells - Dance Your Troubles Away,27,30,34,11.0,31,Dance Your Troubles Away,19.0,17,-3,-4,3,1,down,1975-12-27
3094,Archie Bell & The Drells,1976-05-01,Archie Bell & The Drells - Dance Your Troubles Away,31,27,38,11.0,34,Dance Your Troubles Away,19.0,18,-4,-3,-4,1,down,1975-12-27
3095,Archie Bell & The Drells,1976-05-08,Archie Bell & The Drells - Dance Your Troubles Away,34,31,51,11.0,38,Dance Your Troubles Away,19.0,19,-13,-4,-3,1,down,1975-12-27
3096,South Shore Commission,1976-01-03,South Shore Commission - South Shore Commission,51,51,38,37.0,42,South Shore Commission,4.0,0,4,9,0,1,up,1976-01-03
3097,South Shore Commission,1976-01-10,South Shore Commission - South Shore Commission,42,51,37,37.0,38,South Shore Commission,4.0,1,1,4,9,1,up,1976-01-03
3098,South Shore Commission,1976-01-17,South Shore Commission - South Shore Commission,38,42,37,37.0,37,South Shore Commission,4.0,2,0,1,4,0,stay,1976-01-03
3099,South Shore Commission,1976-01-24,South Shore Commission - South Shore Commission,37,38,46,37.0,37,South Shore Commission,4.0,3,-9,0,1,1,down,1976-01-03
3100,South Shore Commission,1976-01-31,South Shore Commission - South Shore Commission,37,37,51,37.0,46,South Shore Commission,4.0,4,-5,-9,0,1,down,1976-01-03
3101,The Three Degrees,1976-01-03,The Three Degrees - Three Degrees Live,51,51,37,34.0,47,Three Degrees Live,3.0,0,10,4,0,1,up,1976-01-03
3102,The Three Degrees,1976-01-10,The Three Degrees - Three Degrees Live,47,51,34,34.0,37,Three Degrees Live,3.0,1,3,10,4,1,up,1976-01-03
3103,The Three Degrees,1976-01-17,The Three Degrees - Three Degrees Live,37,47,47,34.0,34,Three Degrees Live,3.0,2,-13,3,10,1,down,1976-01-03
3104,The Three Degrees,1976-01-24,The Three Degrees - Three Degrees Live,34,37,51,34.0,47,Three Degrees Live,3.0,3,-4,-13,3,1,down,1976-01-03
3105,Ann Peebles,1976-01-03,Ann Peebles - Tellin' It,51,51,43,41.0,48,Tellin' It,2.0,0,5,3,0,1,up,1976-01-03
3106,Ann Peebles,1976-01-10,Ann Peebles - Tellin' It,48,51,41,41.0,43,Tellin' It,2.0,1,2,5,3,1,up,1976-01-03
3107,Ann Peebles,1976-01-17,Ann Peebles - Tellin' It,43,48,51,41.0,41,Tellin' It,2.0,2,-10,2,5,1,down,1976-01-03
3108,Redd Foxx,1976-01-10,Redd Foxx - You Gotta Wash Your Ass,51,51,29,14.0,42,You Gotta Wash Your Ass,11.0,0,13,9,0,1,up,1976-01-10
3109,Redd Foxx,1976-01-17,Redd Foxx - You Gotta Wash Your Ass,42,51,25,14.0,29,You Gotta Wash Your Ass,11.0,1,4,13,9,1,up,1976-01-10
3110,Redd Foxx,1976-01-24,Redd Foxx - You Gotta Wash Your Ass,29,42,22,14.0,25,You Gotta Wash Your Ass,11.0,2,3,4,13,1,up,1976-01-10
3111,Redd Foxx,1976-01-31,Redd Foxx - You Gotta Wash Your Ass,25,29,15,14.0,22,You Gotta Wash Your Ass,11.0,3,7,3,4,1,up,1976-01-10
3112,Redd Foxx,1976-02-07,Redd Foxx - You Gotta Wash Your Ass,22,25,15,14.0,15,You Gotta Wash Your Ass,11.0,4,0,7,3,0,stay,1976-01-10
3113,Redd Foxx,1976-02-14,Redd Foxx - You Gotta Wash Your Ass,15,22,14,14.0,15,You Gotta Wash Your Ass,11.0,5,1,0,7,1,up,1976-01-10
3114,Redd Foxx,1976-02-21,Redd Foxx - You Gotta Wash Your Ass,15,15,24,14.0,14,You Gotta Wash Your Ass,11.0,6,-10,1,0,1,down,1976-01-10
3115,Redd Foxx,1976-02-28,Redd Foxx - You Gotta Wash Your Ass,14,15,32,14.0,24,You Gotta Wash Your Ass,11.0,7,-8,-10,1,1,down,1976-01-10
3116,Redd Foxx,1976-03-06,Redd Foxx - You Gotta Wash Your Ass,24,14,32,14.0,32,You Gotta Wash Your Ass,11.0,8,0,-8,-10,0,stay,1976-01-10
3117,Redd Foxx,1976-03-13,Redd Foxx - You Gotta Wash Your Ass,32,24,43,14.0,32,You Gotta Wash Your Ass,11.0,9,-11,0,-8,1,down,1976-01-10
3118,Redd Foxx,1976-03-20,Redd Foxx - You Gotta Wash Your Ass,32,32,46,14.0,43,You Gotta Wash Your Ass,11.0,10,-3,-11,0,1,down,1976-01-10
3119,Redd Foxx,1976-03-27,Redd Foxx - You Gotta Wash Your Ass,43,32,51,14.0,46,You Gotta Wash Your Ass,11.0,11,-5,-3,-11,1,down,1976-01-10
3120,Gwen McCrae,1976-01-10,Gwen McCrae - Together,51,51,40,33.0,48,Together,6.0,0,8,3,0,1,up,1976-01-10
3121,Gwen McCrae,1976-01-17,Gwen McCrae - Together,48,51,36,33.0,40,Together,6.0,1,4,8,3,1,up,1976-01-10
3122,Gwen McCrae,1976-01-24,Gwen McCrae - Together,40,48,36,33.0,36,Together,6.0,2,0,4,8,0,stay,1976-01-10
3123,Gwen McCrae,1976-01-31,Gwen McCrae - Together,36,40,33,33.0,36,Together,6.0,3,3,0,4,1,up,1976-01-10
3124,Gwen McCrae,1976-02-07,Gwen McCrae - Together,36,36,33,33.0,33,Together,6.0,4,0,3,0,0,stay,1976-01-10
3125,Gwen McCrae,1976-02-14,Gwen McCrae - Together,33,36,47,33.0,33,Together,6.0,5,-14,0,3,1,down,1976-01-10
3126,Gwen McCrae,1976-02-21,Gwen McCrae - Together,33,33,51,33.0,47,Together,6.0,6,-4,-14,0,1,down,1976-01-10
3127,Love Unlimited Orchestra,1976-01-10,Love Unlimited Orchestra - Music Maestro Please,51,51,33,14.0,50,Music Maestro Please,10.0,0,17,1,0,1,up,1976-01-10
3128,Love Unlimited Orchestra,1976-01-17,Love Unlimited Orchestra - Music Maestro Please,50,51,26,14.0,33,Music Maestro Please,10.0,1,7,17,1,1,up,1976-01-10
3129,Love Unlimited Orchestra,1976-01-24,Love Unlimited Orchestra - Music Maestro Please,33,50,20,14.0,26,Music Maestro Please,10.0,2,6,7,17,1,up,1976-01-10
3130,Love Unlimited Orchestra,1976-01-31,Love Unlimited Orchestra - Music Maestro Please,26,33,14,14.0,20,Music Maestro Please,10.0,3,6,6,7,1,up,1976-01-10
3131,Love Unlimited Orchestra,1976-02-07,Love Unlimited Orchestra - Music Maestro Please,20,26,14,14.0,14,Music Maestro Please,10.0,4,0,6,6,0,stay,1976-01-10
3132,Love Unlimited Orchestra,1976-02-14,Love Unlimited Orchestra - Music Maestro Please,14,20,17,14.0,14,Music Maestro Please,10.0,5,-3,0,6,1,down,1976-01-10
3133,Love Unlimited Orchestra,1976-02-21,Love Unlimited Orchestra - Music Maestro Please,14,14,17,14.0,17,Music Maestro Please,10.0,6,0,-3,0,0,stay,1976-01-10
3134,Love Unlimited Orchestra,1976-02-28,Love Unlimited Orchestra - Music Maestro Please,17,14,25,14.0,17,Music Maestro Please,10.0,7,-8,0,-3,1,down,1976-01-10
3135,Love Unlimited Orchestra,1976-03-06,Love Unlimited Orchestra - Music Maestro Please,17,17,33,14.0,25,Music Maestro Please,10.0,8,-8,-8,0,1,down,1976-01-10
3136,Love Unlimited Orchestra,1976-03-13,Love Unlimited Orchestra - Music Maestro Please,25,17,47,14.0,33,Music Maestro Please,10.0,9,-14,-8,-8,1,down,1976-01-10
3137,Love Unlimited Orchestra,1976-03-20,Love Unlimited Orchestra - Music Maestro Please,33,25,51,14.0,47,Music Maestro Please,10.0,10,-4,-14,-8,1,down,1976-01-10
3138,The Sylvers,1976-01-17,The Sylvers - Showcase,51,51,40,23.0,46,Showcase,14.0,0,6,5,0,1,up,1976-01-17
3139,The Sylvers,1976-01-24,The Sylvers - Showcase,46,51,31,23.0,40,Showcase,14.0,1,9,6,5,1,up,1976-01-17
3140,The Sylvers,1976-01-31,The Sylvers - Showcase,40,46,28,23.0,31,Showcase,14.0,2,3,9,6,1,up,1976-01-17
3141,The Sylvers,1976-02-07,The Sylvers - Showcase,31,40,26,23.0,28,Showcase,14.0,3,2,3,9,1,up,1976-01-17
3142,The Sylvers,1976-02-14,The Sylvers - Showcase,28,31,26,23.0,26,Showcase,14.0,4,0,2,3,0,stay,1976-01-17
3143,The Sylvers,1976-02-21,The Sylvers - Showcase,26,28,23,23.0,26,Showcase,14.0,5,3,0,2,1,up,1976-01-17
3144,The Sylvers,1976-02-28,The Sylvers - Showcase,26,26,29,23.0,23,Showcase,14.0,6,-6,3,0,1,down,1976-01-17
3145,The Sylvers,1976-03-06,The Sylvers - Showcase,23,26,29,23.0,29,Showcase,14.0,7,0,-6,3,0,stay,1976-01-17
3146,The Sylvers,1976-03-13,The Sylvers - Showcase,29,23,32,23.0,29,Showcase,14.0,8,-3,0,-6,1,down,1976-01-17
3147,The Sylvers,1976-03-20,The Sylvers - Showcase,29,29,44,23.0,32,Showcase,14.0,9,-12,-3,0,1,down,1976-01-17
3148,The Sylvers,1976-03-27,The Sylvers - Showcase,32,29,50,23.0,44,Showcase,14.0,10,-6,-12,-3,1,down,1976-01-17
3149,The Sylvers,1976-05-29,The Sylvers - Showcase,44,32,40,23.0,50,Showcase,14.0,11,10,-6,-12,1,up,1976-01-17
3150,The Sylvers,1976-06-05,The Sylvers - Showcase,50,44,38,23.0,40,Showcase,14.0,12,2,10,-6,1,up,1976-01-17
3151,The Sylvers,1976-06-12,The Sylvers - Showcase,40,50,34,23.0,38,Showcase,14.0,13,4,2,10,1,up,1976-01-17
3152,The Sylvers,1976-06-19,The Sylvers - Showcase,38,40,51,23.0,34,Showcase,14.0,14,-17,4,2,1,down,1976-01-17
3153,Hamilton Bohannon,1976-01-17,Hamilton Bohannon - Bohannon,51,51,38,21.0,48,Bohannon,11.0,0,10,3,0,1,up,1976-01-17
3154,Hamilton Bohannon,1976-01-24,Hamilton Bohannon - Bohannon,48,51,30,21.0,38,Bohannon,11.0,1,8,10,3,1,up,1976-01-17
3155,Hamilton Bohannon,1976-01-31,Hamilton Bohannon - Bohannon,38,48,24,21.0,30,Bohannon,11.0,2,6,8,10,1,up,1976-01-17
3156,Hamilton Bohannon,1976-02-07,Hamilton Bohannon - Bohannon,30,38,21,21.0,24,Bohannon,11.0,3,3,6,8,1,up,1976-01-17
3157,Hamilton Bohannon,1976-02-14,Hamilton Bohannon - Bohannon,24,30,29,21.0,21,Bohannon,11.0,4,-8,3,6,1,down,1976-01-17
3158,Hamilton Bohannon,1976-02-21,Hamilton Bohannon - Bohannon,21,24,29,21.0,29,Bohannon,11.0,5,0,-8,3,0,stay,1976-01-17
3159,Hamilton Bohannon,1976-02-28,Hamilton Bohannon - Bohannon,29,21,26,21.0,29,Bohannon,11.0,6,3,0,-8,1,up,1976-01-17
3160,Hamilton Bohannon,1976-03-06,Hamilton Bohannon - Bohannon,29,29,24,21.0,26,Bohannon,11.0,7,2,3,0,1,up,1976-01-17
3161,Hamilton Bohannon,1976-03-13,Hamilton Bohannon - Bohannon,26,29,24,21.0,24,Bohannon,11.0,8,0,2,3,0,stay,1976-01-17
3162,Hamilton Bohannon,1976-03-20,Hamilton Bohannon - Bohannon,24,26,38,21.0,24,Bohannon,11.0,9,-14,0,2,1,down,1976-01-17
3163,Hamilton Bohannon,1976-03-27,Hamilton Bohannon - Bohannon,24,24,45,21.0,38,Bohannon,11.0,10,-7,-14,0,1,down,1976-01-17
3164,Hamilton Bohannon,1976-04-03,Hamilton Bohannon - Bohannon,38,24,51,21.0,45,Bohannon,11.0,11,-6,-7,-14,1,down,1976-01-17
3165,James Brown,1976-01-17,James Brown - Hot,51,51,41,25.0,50,Hot,7.0,0,9,1,0,1,up,1976-01-17
3166,James Brown,1976-01-24,James Brown - Hot,50,51,33,25.0,41,Hot,7.0,1,8,9,1,1,up,1976-01-17
3167,James Brown,1976-01-31,James Brown - Hot,41,50,25,25.0,33,Hot,7.0,2,8,8,9,1,up,1976-01-17
3168,James Brown,1976-02-07,James Brown - Hot,33,41,25,25.0,25,Hot,7.0,3,0,8,8,0,stay,1976-01-17
3169,James Brown,1976-02-14,James Brown - Hot,25,33,27,25.0,25,Hot,7.0,4,-2,0,8,1,down,1976-01-17
3170,James Brown,1976-02-21,James Brown - Hot,25,25,30,25.0,27,Hot,7.0,5,-3,-2,0,1,down,1976-01-17
3171,James Brown,1976-02-28,James Brown - Hot,27,25,34,25.0,30,Hot,7.0,6,-4,-3,-2,1,down,1976-01-17
3172,James Brown,1976-03-06,James Brown - Hot,30,27,51,25.0,34,Hot,7.0,7,-17,-4,-3,1,down,1976-01-17
3173,Isaac Hayes Movement,1976-01-24,Isaac Hayes Movement - Disco Connection,51,51,34,19.0,42,Disco Connection,10.0,0,8,9,0,1,up,1976-01-24
3174,Isaac Hayes Movement,1976-01-31,Isaac Hayes Movement - Disco Connection,42,51,26,19.0,34,Disco Connection,10.0,1,8,8,9,1,up,1976-01-24
3175,Isaac Hayes Movement,1976-02-07,Isaac Hayes Movement - Disco Connection,34,42,20,19.0,26,Disco Connection,10.0,2,6,8,8,1,up,1976-01-24
3176,Isaac Hayes Movement,1976-02-14,Isaac Hayes Movement - Disco Connection,26,34,19,19.0,20,Disco Connection,10.0,3,1,6,8,1,up,1976-01-24
3177,Isaac Hayes Movement,1976-02-21,Isaac Hayes Movement - Disco Connection,20,26,19,19.0,19,Disco Connection,10.0,4,0,1,6,0,stay,1976-01-24
3178,Isaac Hayes Movement,1976-02-28,Isaac Hayes Movement - Disco Connection,19,20,19,19.0,19,Disco Connection,10.0,5,0,0,1,0,stay,1976-01-24
3179,Isaac Hayes Movement,1976-03-06,Isaac Hayes Movement - Disco Connection,19,19,20,19.0,19,Disco Connection,10.0,6,-1,0,0,1,down,1976-01-24
3180,Isaac Hayes Movement,1976-03-13,Isaac Hayes Movement - Disco Connection,19,19,20,19.0,20,Disco Connection,10.0,7,0,-1,0,0,stay,1976-01-24
3181,Isaac Hayes Movement,1976-03-20,Isaac Hayes Movement - Disco Connection,20,19,26,19.0,20,Disco Connection,10.0,8,-6,0,-1,1,down,1976-01-24
3182,Isaac Hayes Movement,1976-03-27,Isaac Hayes Movement - Disco Connection,20,20,36,19.0,26,Disco Connection,10.0,9,-10,-6,0,1,down,1976-01-24
3183,Isaac Hayes Movement,1976-04-03,Isaac Hayes Movement - Disco Connection,26,20,51,19.0,36,Disco Connection,10.0,10,-15,-10,-6,1,down,1976-01-24
3184,Dennis Coffey,1976-01-24,Dennis Coffey - Finger Lickin' Good,51,51,41,31.0,44,Finger Lickin' Good,6.0,0,3,7,0,1,up,1976-01-24
3185,Dennis Coffey,1976-01-31,Dennis Coffey - Finger Lickin' Good,44,51,37,31.0,41,Finger Lickin' Good,6.0,1,4,3,7,1,up,1976-01-24
3186,Dennis Coffey,1976-02-07,Dennis Coffey - Finger Lickin' Good,41,44,35,31.0,37,Finger Lickin' Good,6.0,2,2,4,3,1,up,1976-01-24
3187,Dennis Coffey,1976-02-14,Dennis Coffey - Finger Lickin' Good,37,41,31,31.0,35,Finger Lickin' Good,6.0,3,4,2,4,1,up,1976-01-24
3188,Dennis Coffey,1976-02-21,Dennis Coffey - Finger Lickin' Good,35,37,39,31.0,31,Finger Lickin' Good,6.0,4,-8,4,2,1,down,1976-01-24
3189,Dennis Coffey,1976-02-28,Dennis Coffey - Finger Lickin' Good,31,35,47,31.0,39,Finger Lickin' Good,6.0,5,-8,-8,4,1,down,1976-01-24
3190,Dennis Coffey,1976-03-06,Dennis Coffey - Finger Lickin' Good,39,31,51,31.0,47,Finger Lickin' Good,6.0,6,-4,-8,-8,1,down,1976-01-24
3191,Houston Person,1976-01-24,Houston Person - Get Out'a My Way!,51,51,47,33.0,50,Get Out'a My Way!,5.0,0,3,1,0,1,up,1976-01-24
3192,Houston Person,1976-01-31,Houston Person - Get Out'a My Way!,50,51,36,33.0,47,Get Out'a My Way!,5.0,1,11,3,1,1,up,1976-01-24
3193,Houston Person,1976-02-07,Houston Person - Get Out'a My Way!,47,50,36,33.0,36,Get Out'a My Way!,5.0,2,0,11,3,0,stay,1976-01-24
3194,Houston Person,1976-02-14,Houston Person - Get Out'a My Way!,36,47,33,33.0,36,Get Out'a My Way!,5.0,3,3,0,11,1,up,1976-01-24
3195,Houston Person,1976-02-21,Houston Person - Get Out'a My Way!,36,36,42,33.0,33,Get Out'a My Way!,5.0,4,-9,3,0,1,down,1976-01-24
3196,Houston Person,1976-02-28,Houston Person - Get Out'a My Way!,33,36,51,33.0,42,Get Out'a My Way!,5.0,5,-9,-9,3,1,down,1976-01-24
3197,Roy Ayers Ubiquity,1976-01-31,Roy Ayers Ubiquity - Mystic Voyage,51,51,30,13.0,38,Mystic Voyage,19.0,0,8,13,0,1,up,1976-01-31
3198,Roy Ayers Ubiquity,1976-02-07,Roy Ayers Ubiquity - Mystic Voyage,38,51,24,13.0,30,Mystic Voyage,19.0,1,6,8,13,1,up,1976-01-31
3199,Roy Ayers Ubiquity,1976-02-14,Roy Ayers Ubiquity - Mystic Voyage,30,38,22,13.0,24,Mystic Voyage,19.0,2,2,6,8,1,up,1976-01-31
3200,Roy Ayers Ubiquity,1976-02-21,Roy Ayers Ubiquity - Mystic Voyage,24,30,21,13.0,22,Mystic Voyage,19.0,3,1,2,6,1,up,1976-01-31
3201,Roy Ayers Ubiquity,1976-02-28,Roy Ayers Ubiquity - Mystic Voyage,22,24,18,13.0,21,Mystic Voyage,19.0,4,3,1,2,1,up,1976-01-31
3202,Roy Ayers Ubiquity,1976-03-06,Roy Ayers Ubiquity - Mystic Voyage,21,22,14,13.0,18,Mystic Voyage,19.0,5,4,3,1,1,up,1976-01-31
3203,Roy Ayers Ubiquity,1976-03-13,Roy Ayers Ubiquity - Mystic Voyage,18,21,13,13.0,14,Mystic Voyage,19.0,6,1,4,3,1,up,1976-01-31
3204,Roy Ayers Ubiquity,1976-03-20,Roy Ayers Ubiquity - Mystic Voyage,14,18,14,13.0,13,Mystic Voyage,19.0,7,-1,1,4,1,down,1976-01-31
3205,Roy Ayers Ubiquity,1976-03-27,Roy Ayers Ubiquity - Mystic Voyage,13,14,23,13.0,14,Mystic Voyage,19.0,8,-9,-1,1,1,down,1976-01-31
3206,Roy Ayers Ubiquity,1976-04-03,Roy Ayers Ubiquity - Mystic Voyage,14,13,23,13.0,23,Mystic Voyage,19.0,9,0,-9,-1,0,stay,1976-01-31
3207,Roy Ayers Ubiquity,1976-04-10,Roy Ayers Ubiquity - Mystic Voyage,23,14,28,13.0,23,Mystic Voyage,19.0,10,-5,0,-9,1,down,1976-01-31
3208,Roy Ayers Ubiquity,1976-04-17,Roy Ayers Ubiquity - Mystic Voyage,23,23,28,13.0,28,Mystic Voyage,19.0,11,0,-5,0,0,stay,1976-01-31
3209,Roy Ayers Ubiquity,1976-04-24,Roy Ayers Ubiquity - Mystic Voyage,28,23,26,13.0,28,Mystic Voyage,19.0,12,2,0,-5,1,up,1976-01-31
3210,Roy Ayers Ubiquity,1976-05-01,Roy Ayers Ubiquity - Mystic Voyage,28,28,22,13.0,26,Mystic Voyage,19.0,13,4,2,0,1,up,1976-01-31
3211,Roy Ayers Ubiquity,1976-05-08,Roy Ayers Ubiquity - Mystic Voyage,26,28,18,13.0,22,Mystic Voyage,19.0,14,4,4,2,1,up,1976-01-31
3212,Roy Ayers Ubiquity,1976-05-15,Roy Ayers Ubiquity - Mystic Voyage,22,26,18,13.0,18,Mystic Voyage,19.0,15,0,4,4,0,stay,1976-01-31
3213,Roy Ayers Ubiquity,1976-05-22,Roy Ayers Ubiquity - Mystic Voyage,18,22,27,13.0,18,Mystic Voyage,19.0,16,-9,0,4,1,down,1976-01-31
3214,Roy Ayers Ubiquity,1976-05-29,Roy Ayers Ubiquity - Mystic Voyage,18,18,31,13.0,27,Mystic Voyage,19.0,17,-4,-9,0,1,down,1976-01-31
3215,Roy Ayers Ubiquity,1976-06-05,Roy Ayers Ubiquity - Mystic Voyage,27,18,31,13.0,31,Mystic Voyage,19.0,18,0,-4,-9,0,stay,1976-01-31
3216,Roy Ayers Ubiquity,1976-06-12,Roy Ayers Ubiquity - Mystic Voyage,31,27,51,13.0,31,Mystic Voyage,19.0,19,-20,0,-4,1,down,1976-01-31
3217,The Fatback Band,1976-01-31,The Fatback Band - Raising Hell,51,51,43,37.0,49,Raising Hell,11.0,0,6,2,0,1,up,1976-01-31
3218,The Fatback Band,1976-02-07,The Fatback Band - Raising Hell,49,51,40,37.0,43,Raising Hell,11.0,1,3,6,2,1,up,1976-01-31
3219,The Fatback Band,1976-02-14,The Fatback Band - Raising Hell,43,49,41,37.0,40,Raising Hell,11.0,2,-1,3,6,1,down,1976-01-31
3220,The Fatback Band,1976-02-21,The Fatback Band - Raising Hell,40,43,37,37.0,41,Raising Hell,11.0,3,4,-1,3,1,up,1976-01-31
3221,The Fatback Band,1976-02-28,The Fatback Band - Raising Hell,41,40,37,37.0,37,Raising Hell,11.0,4,0,4,-1,0,stay,1976-01-31
3222,The Fatback Band,1976-03-06,The Fatback Band - Raising Hell,37,41,48,37.0,37,Raising Hell,11.0,5,-11,0,4,1,down,1976-01-31
3223,The Fatback Band,1976-03-27,The Fatback Band - Raising Hell,37,37,42,37.0,48,Raising Hell,11.0,6,6,-11,0,1,up,1976-01-31
3224,The Fatback Band,1976-04-03,The Fatback Band - Raising Hell,48,37,39,37.0,42,Raising Hell,11.0,7,3,6,-11,1,up,1976-01-31
3225,The Fatback Band,1976-04-10,The Fatback Band - Raising Hell,42,48,41,37.0,39,Raising Hell,11.0,8,-2,3,6,1,down,1976-01-31
3226,The Fatback Band,1976-04-17,The Fatback Band - Raising Hell,39,42,42,37.0,41,Raising Hell,11.0,9,-1,-2,3,1,down,1976-01-31
3227,The Fatback Band,1976-04-24,The Fatback Band - Raising Hell,41,39,49,37.0,42,Raising Hell,11.0,10,-7,-1,-2,1,down,1976-01-31
3228,The Fatback Band,1976-05-01,The Fatback Band - Raising Hell,42,41,51,37.0,49,Raising Hell,11.0,11,-2,-7,-1,1,down,1976-01-31
3229,Harvey Mason,1976-01-31,Harvey Mason - Marching In The Street,51,51,47,45.0,50,Marching In The Street,6.0,0,3,1,0,1,up,1976-01-31
3230,Harvey Mason,1976-02-07,Harvey Mason - Marching In The Street,50,51,45,45.0,47,Marching In The Street,6.0,1,2,3,1,1,up,1976-01-31
3231,Harvey Mason,1976-02-14,Harvey Mason - Marching In The Street,47,50,45,45.0,45,Marching In The Street,6.0,2,0,2,3,0,stay,1976-01-31
3232,Harvey Mason,1976-02-21,Harvey Mason - Marching In The Street,45,47,50,45.0,45,Marching In The Street,6.0,3,-5,0,2,1,down,1976-01-31
3233,Harvey Mason,1976-02-28,Harvey Mason - Marching In The Street,45,45,50,45.0,50,Marching In The Street,6.0,4,0,-5,0,0,stay,1976-01-31
3234,Harvey Mason,1976-03-06,Harvey Mason - Marching In The Street,50,45,46,45.0,50,Marching In The Street,6.0,5,4,0,-5,1,up,1976-01-31
3235,Harvey Mason,1976-03-13,Harvey Mason - Marching In The Street,50,50,51,45.0,46,Marching In The Street,6.0,6,-5,4,0,1,down,1976-01-31
3236,Eddie Kendricks,1976-02-07,Eddie Kendricks - He's A Friend,51,51,22,3.0,39,He's A Friend,16.0,0,17,12,0,1,up,1976-02-07
3237,Eddie Kendricks,1976-02-14,Eddie Kendricks - He's A Friend,39,51,15,3.0,22,He's A Friend,16.0,1,7,17,12,1,up,1976-02-07
3238,Eddie Kendricks,1976-02-21,Eddie Kendricks - He's A Friend,22,39,10,3.0,15,He's A Friend,16.0,2,5,7,17,1,up,1976-02-07
3239,Eddie Kendricks,1976-02-28,Eddie Kendricks - He's A Friend,15,22,6,3.0,10,He's A Friend,16.0,3,4,5,7,1,up,1976-02-07
3240,Eddie Kendricks,1976-03-06,Eddie Kendricks - He's A Friend,10,15,4,3.0,6,He's A Friend,16.0,4,2,4,5,1,up,1976-02-07
3241,Eddie Kendricks,1976-03-13,Eddie Kendricks - He's A Friend,6,10,4,3.0,4,He's A Friend,16.0,5,0,2,4,0,stay,1976-02-07
3242,Eddie Kendricks,1976-03-20,Eddie Kendricks - He's A Friend,4,6,3,3.0,4,He's A Friend,16.0,6,1,0,2,1,up,1976-02-07
3243,Eddie Kendricks,1976-03-27,Eddie Kendricks - He's A Friend,4,4,8,3.0,3,He's A Friend,16.0,7,-5,1,0,1,down,1976-02-07
3244,Eddie Kendricks,1976-04-03,Eddie Kendricks - He's A Friend,3,4,9,3.0,8,He's A Friend,16.0,8,-1,-5,1,1,down,1976-02-07
3245,Eddie Kendricks,1976-04-10,Eddie Kendricks - He's A Friend,8,3,20,3.0,9,He's A Friend,16.0,9,-11,-1,-5,1,down,1976-02-07
3246,Eddie Kendricks,1976-04-17,Eddie Kendricks - He's A Friend,9,8,20,3.0,20,He's A Friend,16.0,10,0,-11,-1,0,stay,1976-02-07
3247,Eddie Kendricks,1976-04-24,Eddie Kendricks - He's A Friend,20,9,19,3.0,20,He's A Friend,16.0,11,1,0,-11,1,up,1976-02-07
3248,Eddie Kendricks,1976-05-01,Eddie Kendricks - He's A Friend,20,20,19,3.0,19,He's A Friend,16.0,12,0,1,0,0,stay,1976-02-07
3249,Eddie Kendricks,1976-05-08,Eddie Kendricks - He's A Friend,19,20,19,3.0,19,He's A Friend,16.0,13,0,0,1,0,stay,1976-02-07
3250,Eddie Kendricks,1976-05-15,Eddie Kendricks - He's A Friend,19,19,21,3.0,19,He's A Friend,16.0,14,-2,0,0,1,down,1976-02-07
3251,Eddie Kendricks,1976-05-22,Eddie Kendricks - He's A Friend,19,19,28,3.0,21,He's A Friend,16.0,15,-7,-2,0,1,down,1976-02-07
3252,Eddie Kendricks,1976-05-29,Eddie Kendricks - He's A Friend,21,19,51,3.0,28,He's A Friend,16.0,16,-23,-7,-2,1,down,1976-02-07
3253,Esther Phillips,1976-02-07,Esther Phillips - Confessin' The Blues,51,51,38,35.0,42,Confessin' The Blues,4.0,0,4,9,0,1,up,1976-02-07
3254,Esther Phillips,1976-02-14,Esther Phillips - Confessin' The Blues,42,51,37,35.0,38,Confessin' The Blues,4.0,1,1,4,9,1,up,1976-02-07
3255,Esther Phillips,1976-02-21,Esther Phillips - Confessin' The Blues,38,42,35,35.0,37,Confessin' The Blues,4.0,2,2,1,4,1,up,1976-02-07
3256,Esther Phillips,1976-02-28,Esther Phillips - Confessin' The Blues,37,38,36,35.0,35,Confessin' The Blues,4.0,3,-1,2,1,1,down,1976-02-07
3257,Esther Phillips,1976-03-06,Esther Phillips - Confessin' The Blues,35,37,51,35.0,36,Confessin' The Blues,4.0,4,-15,-1,2,1,down,1976-02-07
3258,Barry White,1976-02-07,Barry White - Let The Music Play,51,51,31,8.0,45,Let The Music Play,15.0,0,14,6,0,1,up,1976-02-07
3259,Barry White,1976-02-14,Barry White - Let The Music Play,45,51,25,8.0,31,Let The Music Play,15.0,1,6,14,6,1,up,1976-02-07
3260,Barry White,1976-02-21,Barry White - Let The Music Play,31,45,15,8.0,25,Let The Music Play,15.0,2,10,6,14,1,up,1976-02-07
3261,Barry White,1976-02-28,Barry White - Let The Music Play,25,31,11,8.0,15,Let The Music Play,15.0,3,4,10,6,1,up,1976-02-07
3262,Barry White,1976-03-06,Barry White - Let The Music Play,15,25,10,8.0,11,Let The Music Play,15.0,4,1,4,10,1,up,1976-02-07
3263,Barry White,1976-03-13,Barry White - Let The Music Play,11,15,9,8.0,10,Let The Music Play,15.0,5,1,1,4,1,up,1976-02-07
3264,Barry White,1976-03-20,Barry White - Let The Music Play,10,11,8,8.0,9,Let The Music Play,15.0,6,1,1,1,1,up,1976-02-07
3265,Barry White,1976-03-27,Barry White - Let The Music Play,9,10,13,8.0,8,Let The Music Play,15.0,7,-5,1,1,1,down,1976-02-07
3266,Barry White,1976-04-03,Barry White - Let The Music Play,8,9,15,8.0,13,Let The Music Play,15.0,8,-2,-5,1,1,down,1976-02-07
3267,Barry White,1976-04-10,Barry White - Let The Music Play,13,8,23,8.0,15,Let The Music Play,15.0,9,-8,-2,-5,1,down,1976-02-07
3268,Barry White,1976-04-17,Barry White - Let The Music Play,15,13,23,8.0,23,Let The Music Play,15.0,10,0,-8,-2,0,stay,1976-02-07
3269,Barry White,1976-04-24,Barry White - Let The Music Play,23,15,25,8.0,23,Let The Music Play,15.0,11,-2,0,-8,1,down,1976-02-07
3270,Barry White,1976-05-01,Barry White - Let The Music Play,23,23,26,8.0,25,Let The Music Play,15.0,12,-1,-2,0,1,down,1976-02-07
3271,Barry White,1976-05-08,Barry White - Let The Music Play,25,23,22,8.0,26,Let The Music Play,15.0,13,4,-1,-2,1,up,1976-02-07
3272,Barry White,1976-05-15,Barry White - Let The Music Play,26,25,23,8.0,22,Let The Music Play,15.0,14,-1,4,-1,1,down,1976-02-07
3273,Barry White,1976-05-22,Barry White - Let The Music Play,22,26,51,8.0,23,Let The Music Play,15.0,15,-28,-1,4,1,down,1976-02-07
3274,S.S.O.,1976-02-07,S.S.O. - Tonight's The Night,51,51,51,48.0,48,Tonight's The Night,0.0,0,-3,3,0,1,down,1976-02-07
3275,Carl Carlton,1976-02-07,Carl Carlton - I Wanna Be With You,51,51,49,49.0,49,I Wanna Be With You,1.0,0,0,2,0,0,stay,1976-02-07
3276,Carl Carlton,1976-02-14,Carl Carlton - I Wanna Be With You,49,51,51,49.0,49,I Wanna Be With You,1.0,1,-2,0,2,1,down,1976-02-07
3277,Gladys Knight And The Pips,1976-02-07,Gladys Knight And The Pips - Best Of Gladys Knight & The Pips,51,51,32,8.0,50,Best Of Gladys Knight & The Pips,15.0,0,18,1,0,1,up,1976-02-07
3278,Gladys Knight And The Pips,1976-02-14,Gladys Knight And The Pips - Best Of Gladys Knight & The Pips,50,51,20,8.0,32,Best Of Gladys Knight & The Pips,15.0,1,12,18,1,1,up,1976-02-07
3279,Gladys Knight And The Pips,1976-02-21,Gladys Knight And The Pips - Best Of Gladys Knight & The Pips,32,50,14,8.0,20,Best Of Gladys Knight & The Pips,15.0,2,6,12,18,1,up,1976-02-07
3280,Gladys Knight And The Pips,1976-02-28,Gladys Knight And The Pips - Best Of Gladys Knight & The Pips,20,32,10,8.0,14,Best Of Gladys Knight & The Pips,15.0,3,4,6,12,1,up,1976-02-07
3281,Gladys Knight And The Pips,1976-03-06,Gladys Knight And The Pips - Best Of Gladys Knight & The Pips,14,20,8,8.0,10,Best Of Gladys Knight & The Pips,15.0,4,2,4,6,1,up,1976-02-07
3282,Gladys Knight And The Pips,1976-03-13,Gladys Knight And The Pips - Best Of Gladys Knight & The Pips,10,14,8,8.0,8,Best Of Gladys Knight & The Pips,15.0,5,0,2,4,0,stay,1976-02-07
3283,Gladys Knight And The Pips,1976-03-20,Gladys Knight And The Pips - Best Of Gladys Knight & The Pips,8,10,15,8.0,8,Best Of Gladys Knight & The Pips,15.0,6,-7,0,2,1,down,1976-02-07
3284,Gladys Knight And The Pips,1976-03-27,Gladys Knight And The Pips - Best Of Gladys Knight & The Pips,8,8,15,8.0,15,Best Of Gladys Knight & The Pips,15.0,7,0,-7,0,0,stay,1976-02-07
3285,Gladys Knight And The Pips,1976-04-03,Gladys Knight And The Pips - Best Of Gladys Knight & The Pips,15,8,29,8.0,15,Best Of Gladys Knight & The Pips,15.0,8,-14,0,-7,1,down,1976-02-07
3286,Gladys Knight And The Pips,1976-04-10,Gladys Knight And The Pips - Best Of Gladys Knight & The Pips,15,15,30,8.0,29,Best Of Gladys Knight & The Pips,15.0,9,-1,-14,0,1,down,1976-02-07
3287,Gladys Knight And The Pips,1976-04-17,Gladys Knight And The Pips - Best Of Gladys Knight & The Pips,29,15,36,8.0,30,Best Of Gladys Knight & The Pips,15.0,10,-6,-1,-14,1,down,1976-02-07
3288,Gladys Knight And The Pips,1976-04-24,Gladys Knight And The Pips - Best Of Gladys Knight & The Pips,30,29,44,8.0,36,Best Of Gladys Knight & The Pips,15.0,11,-8,-6,-1,1,down,1976-02-07
3289,Gladys Knight And The Pips,1976-05-01,Gladys Knight And The Pips - Best Of Gladys Knight & The Pips,36,30,44,8.0,44,Best Of Gladys Knight & The Pips,15.0,12,0,-8,-6,0,stay,1976-02-07
3290,Gladys Knight And The Pips,1976-05-08,Gladys Knight And The Pips - Best Of Gladys Knight & The Pips,44,36,40,8.0,44,Best Of Gladys Knight & The Pips,15.0,13,4,0,-8,1,up,1976-02-07
3291,Gladys Knight And The Pips,1976-05-15,Gladys Knight And The Pips - Best Of Gladys Knight & The Pips,44,44,50,8.0,40,Best Of Gladys Knight & The Pips,15.0,14,-10,4,0,1,down,1976-02-07
3292,Gladys Knight And The Pips,1976-05-22,Gladys Knight And The Pips - Best Of Gladys Knight & The Pips,40,44,51,8.0,50,Best Of Gladys Knight & The Pips,15.0,15,-1,-10,4,1,down,1976-02-07
3293,Tyrone Davis,1976-02-14,Tyrone Davis - Turning Point,51,51,24,10.0,37,Turning Point,11.0,0,13,14,0,1,up,1976-02-14
3294,Tyrone Davis,1976-02-21,Tyrone Davis - Turning Point,37,51,18,10.0,24,Turning Point,11.0,1,6,13,14,1,up,1976-02-14
3295,Tyrone Davis,1976-02-28,Tyrone Davis - Turning Point,24,37,14,10.0,18,Turning Point,11.0,2,4,6,13,1,up,1976-02-14
3296,Tyrone Davis,1976-03-06,Tyrone Davis - Turning Point,18,24,11,10.0,14,Turning Point,11.0,3,3,4,6,1,up,1976-02-14
3297,Tyrone Davis,1976-03-13,Tyrone Davis - Turning Point,14,18,10,10.0,11,Turning Point,11.0,4,1,3,4,1,up,1976-02-14
3298,Tyrone Davis,1976-03-20,Tyrone Davis - Turning Point,11,14,17,10.0,10,Turning Point,11.0,5,-7,1,3,1,down,1976-02-14
3299,Tyrone Davis,1976-03-27,Tyrone Davis - Turning Point,10,11,17,10.0,17,Turning Point,11.0,6,0,-7,1,0,stay,1976-02-14
3300,Tyrone Davis,1976-04-03,Tyrone Davis - Turning Point,17,10,21,10.0,17,Turning Point,11.0,7,-4,0,-7,1,down,1976-02-14
3301,Tyrone Davis,1976-04-10,Tyrone Davis - Turning Point,17,17,31,10.0,21,Turning Point,11.0,8,-10,-4,0,1,down,1976-02-14
3302,Tyrone Davis,1976-04-17,Tyrone Davis - Turning Point,21,17,34,10.0,31,Turning Point,11.0,9,-3,-10,-4,1,down,1976-02-14
3303,Tyrone Davis,1976-04-24,Tyrone Davis - Turning Point,31,21,42,10.0,34,Turning Point,11.0,10,-8,-3,-10,1,down,1976-02-14
3304,Tyrone Davis,1976-05-01,Tyrone Davis - Turning Point,34,31,51,10.0,42,Turning Point,11.0,11,-9,-8,-3,1,down,1976-02-14
3305,George Duke,1976-02-14,"George Duke - I Love The Blues, She Heard My Cry",51,51,39,36.0,42,"I Love The Blues, She Heard My Cry",5.0,0,3,9,0,1,up,1976-02-14
3306,George Duke,1976-02-21,"George Duke - I Love The Blues, She Heard My Cry",42,51,36,36.0,39,"I Love The Blues, She Heard My Cry",5.0,1,3,3,9,1,up,1976-02-14
3307,George Duke,1976-02-28,"George Duke - I Love The Blues, She Heard My Cry",39,42,40,36.0,36,"I Love The Blues, She Heard My Cry",5.0,2,-4,3,3,1,down,1976-02-14
3308,George Duke,1976-03-06,"George Duke - I Love The Blues, She Heard My Cry",36,39,39,36.0,40,"I Love The Blues, She Heard My Cry",5.0,3,1,-4,3,1,up,1976-02-14
3309,George Duke,1976-03-13,"George Duke - I Love The Blues, She Heard My Cry",40,36,49,36.0,39,"I Love The Blues, She Heard My Cry",5.0,4,-10,1,-4,1,down,1976-02-14
3310,George Duke,1976-03-20,"George Duke - I Love The Blues, She Heard My Cry",39,40,51,36.0,49,"I Love The Blues, She Heard My Cry",5.0,5,-2,-10,1,1,down,1976-02-14
3311,Major Harris,1976-02-14,Major Harris - Jealously,51,51,35,33.0,43,Jealously,5.0,0,8,8,0,1,up,1976-02-14
3312,Major Harris,1976-02-21,Major Harris - Jealously,43,51,33,33.0,35,Jealously,5.0,1,2,8,8,1,up,1976-02-14
3313,Major Harris,1976-02-28,Major Harris - Jealously,35,43,33,33.0,33,Jealously,5.0,2,0,2,8,0,stay,1976-02-14
3314,Major Harris,1976-03-06,Major Harris - Jealously,33,35,41,33.0,33,Jealously,5.0,3,-8,0,2,1,down,1976-02-14
3315,Major Harris,1976-03-13,Major Harris - Jealously,33,33,46,33.0,41,Jealously,5.0,4,-5,-8,0,1,down,1976-02-14
3316,Major Harris,1976-03-20,Major Harris - Jealously,41,33,51,33.0,46,Jealously,5.0,5,-5,-5,-8,1,down,1976-02-14
3317,Brass Construction,1976-02-14,Brass Construction - Brass Construction,51,51,36,1.0,44,Brass Construction,29.0,0,8,7,0,1,up,1976-02-14
3318,Brass Construction,1976-02-21,Brass Construction - Brass Construction,44,51,28,1.0,36,Brass Construction,29.0,1,8,8,7,1,up,1976-02-14
3319,Brass Construction,1976-02-28,Brass Construction - Brass Construction,36,44,22,1.0,28,Brass Construction,29.0,2,6,8,8,1,up,1976-02-14
3320,Brass Construction,1976-03-06,Brass Construction - Brass Construction,28,36,18,1.0,22,Brass Construction,29.0,3,4,6,8,1,up,1976-02-14
3321,Brass Construction,1976-03-13,Brass Construction - Brass Construction,22,28,14,1.0,18,Brass Construction,29.0,4,4,4,6,1,up,1976-02-14
3322,Brass Construction,1976-03-20,Brass Construction - Brass Construction,18,22,9,1.0,14,Brass Construction,29.0,5,5,4,4,1,up,1976-02-14
3323,Brass Construction,1976-03-27,Brass Construction - Brass Construction,14,18,4,1.0,9,Brass Construction,29.0,6,5,5,4,1,up,1976-02-14
3324,Brass Construction,1976-04-03,Brass Construction - Brass Construction,9,14,3,1.0,4,Brass Construction,29.0,7,1,5,5,1,up,1976-02-14
3325,Brass Construction,1976-04-10,Brass Construction - Brass Construction,4,9,2,1.0,3,Brass Construction,29.0,8,1,1,5,1,up,1976-02-14
3326,Brass Construction,1976-04-17,Brass Construction - Brass Construction,3,4,1,1.0,2,Brass Construction,29.0,9,1,1,1,1,up,1976-02-14
3327,Brass Construction,1976-04-24,Brass Construction - Brass Construction,2,3,1,1.0,1,Brass Construction,29.0,10,0,1,1,0,stay,1976-02-14
3328,Brass Construction,1976-05-01,Brass Construction - Brass Construction,1,2,1,1.0,1,Brass Construction,29.0,11,0,0,1,0,stay,1976-02-14
3329,Brass Construction,1976-05-08,Brass Construction - Brass Construction,1,1,2,1.0,1,Brass Construction,29.0,12,-1,0,0,1,down,1976-02-14
3330,Brass Construction,1976-05-15,Brass Construction - Brass Construction,1,1,5,1.0,2,Brass Construction,29.0,13,-3,-1,0,1,down,1976-02-14
3331,Brass Construction,1976-05-22,Brass Construction - Brass Construction,2,1,5,1.0,5,Brass Construction,29.0,14,0,-3,-1,0,stay,1976-02-14
3332,Brass Construction,1976-05-29,Brass Construction - Brass Construction,5,2,7,1.0,5,Brass Construction,29.0,15,-2,0,-3,1,down,1976-02-14
3333,Brass Construction,1976-06-05,Brass Construction - Brass Construction,5,5,8,1.0,7,Brass Construction,29.0,16,-1,-2,0,1,down,1976-02-14
3334,Brass Construction,1976-06-12,Brass Construction - Brass Construction,7,5,20,1.0,8,Brass Construction,29.0,17,-12,-1,-2,1,down,1976-02-14
3335,Brass Construction,1976-06-19,Brass Construction - Brass Construction,8,7,19,1.0,20,Brass Construction,29.0,18,1,-12,-1,1,up,1976-02-14
3336,Brass Construction,1976-06-26,Brass Construction - Brass Construction,20,8,19,1.0,19,Brass Construction,29.0,19,0,1,-12,0,stay,1976-02-14
3337,Brass Construction,1976-07-04,Brass Construction - Brass Construction,19,20,19,1.0,19,Brass Construction,29.0,20,0,0,1,0,stay,1976-02-14
3338,Brass Construction,1976-07-10,Brass Construction - Brass Construction,19,19,37,1.0,19,Brass Construction,29.0,21,-18,0,0,1,down,1976-02-14
3339,Brass Construction,1976-07-17,Brass Construction - Brass Construction,19,19,38,1.0,37,Brass Construction,29.0,22,-1,-18,0,1,down,1976-02-14
3340,Brass Construction,1976-07-24,Brass Construction - Brass Construction,37,19,46,1.0,38,Brass Construction,29.0,23,-8,-1,-18,1,down,1976-02-14
3341,Brass Construction,1976-08-07,Brass Construction - Brass Construction,38,37,42,1.0,46,Brass Construction,29.0,24,4,-8,-1,1,up,1976-02-14
3342,Brass Construction,1976-08-14,Brass Construction - Brass Construction,46,38,43,1.0,42,Brass Construction,29.0,25,-1,4,-8,1,down,1976-02-14
3343,Brass Construction,1976-08-21,Brass Construction - Brass Construction,42,46,37,1.0,43,Brass Construction,29.0,26,6,-1,4,1,up,1976-02-14
3344,Brass Construction,1976-08-28,Brass Construction - Brass Construction,43,42,34,1.0,37,Brass Construction,29.0,27,3,6,-1,1,up,1976-02-14
3345,Brass Construction,1976-09-04,Brass Construction - Brass Construction,37,43,34,1.0,34,Brass Construction,29.0,28,0,3,6,0,stay,1976-02-14
3346,Brass Construction,1976-09-11,Brass Construction - Brass Construction,34,37,51,1.0,34,Brass Construction,29.0,29,-17,0,3,1,down,1976-02-14
3347,Parliament,1976-02-14,Parliament - Mothership Connection,51,51,34,4.0,47,Mothership Connection,31.0,0,13,4,0,1,up,1976-02-14
3348,Parliament,1976-02-21,Parliament - Mothership Connection,47,51,26,4.0,34,Mothership Connection,31.0,1,8,13,4,1,up,1976-02-14
3349,Parliament,1976-02-28,Parliament - Mothership Connection,34,47,21,4.0,26,Mothership Connection,31.0,2,5,8,13,1,up,1976-02-14
3350,Parliament,1976-03-06,Parliament - Mothership Connection,26,34,17,4.0,21,Mothership Connection,31.0,3,4,5,8,1,up,1976-02-14
3351,Parliament,1976-03-13,Parliament - Mothership Connection,21,26,11,4.0,17,Mothership Connection,31.0,4,6,4,5,1,up,1976-02-14
3352,Parliament,1976-03-20,Parliament - Mothership Connection,17,21,10,4.0,11,Mothership Connection,31.0,5,1,6,4,1,up,1976-02-14
3353,Parliament,1976-03-27,Parliament - Mothership Connection,11,17,10,4.0,10,Mothership Connection,31.0,6,0,1,6,0,stay,1976-02-14
3354,Parliament,1976-04-03,Parliament - Mothership Connection,10,11,8,4.0,10,Mothership Connection,31.0,7,2,0,1,1,up,1976-02-14
3355,Parliament,1976-04-10,Parliament - Mothership Connection,10,10,8,4.0,8,Mothership Connection,31.0,8,0,2,0,0,stay,1976-02-14
3356,Parliament,1976-04-17,Parliament - Mothership Connection,8,10,8,4.0,8,Mothership Connection,31.0,9,0,0,2,0,stay,1976-02-14
3357,Parliament,1976-04-24,Parliament - Mothership Connection,8,8,10,4.0,8,Mothership Connection,31.0,10,-2,0,0,1,down,1976-02-14
3358,Parliament,1976-05-01,Parliament - Mothership Connection,8,8,13,4.0,10,Mothership Connection,31.0,11,-3,-2,0,1,down,1976-02-14
3359,Parliament,1976-05-08,Parliament - Mothership Connection,10,8,11,4.0,13,Mothership Connection,31.0,12,2,-3,-2,1,up,1976-02-14
3360,Parliament,1976-05-15,Parliament - Mothership Connection,13,10,10,4.0,11,Mothership Connection,31.0,13,1,2,-3,1,up,1976-02-14
3361,Parliament,1976-05-22,Parliament - Mothership Connection,11,13,7,4.0,10,Mothership Connection,31.0,14,3,1,2,1,up,1976-02-14
3362,Parliament,1976-05-29,Parliament - Mothership Connection,10,11,5,4.0,7,Mothership Connection,31.0,15,2,3,1,1,up,1976-02-14
3363,Parliament,1976-06-05,Parliament - Mothership Connection,7,10,4,4.0,5,Mothership Connection,31.0,16,1,2,3,1,up,1976-02-14
3364,Parliament,1976-06-12,Parliament - Mothership Connection,5,7,4,4.0,4,Mothership Connection,31.0,17,0,1,2,0,stay,1976-02-14
3365,Parliament,1976-06-19,Parliament - Mothership Connection,4,5,4,4.0,4,Mothership Connection,31.0,18,0,0,1,0,stay,1976-02-14
3366,Parliament,1976-06-26,Parliament - Mothership Connection,4,4,9,4.0,4,Mothership Connection,31.0,19,-5,0,0,1,down,1976-02-14
3367,Parliament,1976-07-04,Parliament - Mothership Connection,4,4,11,4.0,9,Mothership Connection,31.0,20,-2,-5,0,1,down,1976-02-14
3368,Parliament,1976-07-10,Parliament - Mothership Connection,9,4,12,4.0,11,Mothership Connection,31.0,21,-1,-2,-5,1,down,1976-02-14
3369,Parliament,1976-07-17,Parliament - Mothership Connection,11,9,12,4.0,12,Mothership Connection,31.0,22,0,-1,-2,0,stay,1976-02-14
3370,Parliament,1976-07-24,Parliament - Mothership Connection,12,11,11,4.0,12,Mothership Connection,31.0,23,1,0,-1,1,up,1976-02-14
3371,Parliament,1976-07-31,Parliament - Mothership Connection,12,12,11,4.0,11,Mothership Connection,31.0,24,0,1,0,0,stay,1976-02-14
3372,Parliament,1976-08-07,Parliament - Mothership Connection,11,12,14,4.0,11,Mothership Connection,31.0,25,-3,0,1,1,down,1976-02-14
3373,Parliament,1976-08-14,Parliament - Mothership Connection,11,11,17,4.0,14,Mothership Connection,31.0,26,-3,-3,0,1,down,1976-02-14
3374,Parliament,1976-08-21,Parliament - Mothership Connection,14,11,17,4.0,17,Mothership Connection,31.0,27,0,-3,-3,0,stay,1976-02-14
3375,Parliament,1976-08-28,Parliament - Mothership Connection,17,14,21,4.0,17,Mothership Connection,31.0,28,-4,0,-3,1,down,1976-02-14
3376,Parliament,1976-09-04,Parliament - Mothership Connection,17,17,39,4.0,21,Mothership Connection,31.0,29,-18,-4,0,1,down,1976-02-14
3377,Parliament,1976-09-11,Parliament - Mothership Connection,21,17,40,4.0,39,Mothership Connection,31.0,30,-1,-18,-4,1,down,1976-02-14
3378,Parliament,1976-09-18,Parliament - Mothership Connection,39,21,51,4.0,40,Mothership Connection,31.0,31,-11,-1,-18,1,down,1976-02-14
3379,The Atlanta Disco Band,1976-02-14,The Atlanta Disco Band - Bad Luck,51,51,46,46.0,48,Bad Luck,1.0,0,2,3,0,1,up,1976-02-14
3380,The Atlanta Disco Band,1976-02-21,The Atlanta Disco Band - Bad Luck,48,51,51,46.0,46,Bad Luck,1.0,1,-5,2,3,1,down,1976-02-14
3381,Mandrill,1976-02-14,Mandrill - Beast From The East,51,51,40,28.0,50,Beast From The East,5.0,0,10,1,0,1,up,1976-02-14
3382,Mandrill,1976-02-21,Mandrill - Beast From The East,50,51,31,28.0,40,Beast From The East,5.0,1,9,10,1,1,up,1976-02-14
3383,Mandrill,1976-02-28,Mandrill - Beast From The East,40,50,28,28.0,31,Beast From The East,5.0,2,3,9,10,1,up,1976-02-14
3384,Mandrill,1976-03-06,Mandrill - Beast From The East,31,40,28,28.0,28,Beast From The East,5.0,3,0,3,9,0,stay,1976-02-14
3385,Mandrill,1976-03-13,Mandrill - Beast From The East,28,31,50,28.0,28,Beast From The East,5.0,4,-22,0,3,1,down,1976-02-14
3386,Mandrill,1976-03-20,Mandrill - Beast From The East,28,28,51,28.0,50,Beast From The East,5.0,5,-1,-22,0,1,down,1976-02-14
3387,Various Artists,1976-02-21,Various Artists - Discotech #3,51,51,49,48.0,48,Discotech #3,1.0,0,-1,3,0,1,down,1976-02-21
3388,Various Artists,1976-02-28,Various Artists - Discotech #3,48,51,51,48.0,49,Discotech #3,1.0,1,-2,-1,3,1,down,1976-02-21
3389,Gene Page,1976-02-21,Gene Page - Lovelock!,51,51,45,45.0,49,Lovelock!,1.0,0,4,2,0,1,up,1976-02-21
3390,Gene Page,1976-02-28,Gene Page - Lovelock!,49,51,51,45.0,45,Lovelock!,1.0,1,-6,4,2,1,down,1976-02-21
3391,Isaac Hayes,1976-02-28,Isaac Hayes - Groove-a-thon,51,51,23,11.0,32,Groove-a-thon,12.0,0,9,19,0,1,up,1976-02-28
3392,Isaac Hayes,1976-03-06,Isaac Hayes - Groove-a-thon,32,51,19,11.0,23,Groove-a-thon,12.0,1,4,9,19,1,up,1976-02-28
3393,Isaac Hayes,1976-03-13,Isaac Hayes - Groove-a-thon,23,32,15,11.0,19,Groove-a-thon,12.0,2,4,4,9,1,up,1976-02-28
3394,Isaac Hayes,1976-03-20,Isaac Hayes - Groove-a-thon,19,23,11,11.0,15,Groove-a-thon,12.0,3,4,4,4,1,up,1976-02-28
3395,Isaac Hayes,1976-03-27,Isaac Hayes - Groove-a-thon,15,19,11,11.0,11,Groove-a-thon,12.0,4,0,4,4,0,stay,1976-02-28
3396,Isaac Hayes,1976-04-03,Isaac Hayes - Groove-a-thon,11,15,16,11.0,11,Groove-a-thon,12.0,5,-5,0,4,1,down,1976-02-28
3397,Isaac Hayes,1976-04-10,Isaac Hayes - Groove-a-thon,11,11,25,11.0,16,Groove-a-thon,12.0,6,-9,-5,0,1,down,1976-02-28
3398,Isaac Hayes,1976-04-17,Isaac Hayes - Groove-a-thon,16,11,25,11.0,25,Groove-a-thon,12.0,7,0,-9,-5,0,stay,1976-02-28
3399,Isaac Hayes,1976-04-24,Isaac Hayes - Groove-a-thon,25,16,31,11.0,25,Groove-a-thon,12.0,8,-6,0,-9,1,down,1976-02-28
3400,Isaac Hayes,1976-05-01,Isaac Hayes - Groove-a-thon,25,25,29,11.0,31,Groove-a-thon,12.0,9,2,-6,0,1,up,1976-02-28
3401,Isaac Hayes,1976-05-08,Isaac Hayes - Groove-a-thon,31,25,29,11.0,29,Groove-a-thon,12.0,10,0,2,-6,0,stay,1976-02-28
3402,Isaac Hayes,1976-05-15,Isaac Hayes - Groove-a-thon,29,31,44,11.0,29,Groove-a-thon,12.0,11,-15,0,2,1,down,1976-02-28
3403,Isaac Hayes,1976-05-22,Isaac Hayes - Groove-a-thon,29,29,51,11.0,44,Groove-a-thon,12.0,12,-7,-15,0,1,down,1976-02-28
3404,The Tymes,1976-02-28,The Tymes - Tymes Up,51,51,42,40.0,46,Tymes Up,2.0,0,4,5,0,1,up,1976-02-28
3405,The Tymes,1976-03-06,The Tymes - Tymes Up,46,51,40,40.0,42,Tymes Up,2.0,1,2,4,5,1,up,1976-02-28
3406,The Tymes,1976-03-13,The Tymes - Tymes Up,42,46,51,40.0,40,Tymes Up,2.0,2,-11,2,4,1,down,1976-02-28
3407,Jr. Walker & The All Stars,1976-02-28,Jr. Walker & The All Stars - Hot Shot,51,51,45,45.0,47,Hot Shot,1.0,0,2,4,0,1,up,1976-02-28
3408,Jr. Walker & The All Stars,1976-03-06,Jr. Walker & The All Stars - Hot Shot,47,51,51,45.0,45,Hot Shot,1.0,1,-6,2,4,1,down,1976-02-28
3409,Oliver Sain,1976-02-28,Oliver Sain - Blue Max,51,51,48,48.0,48,Blue Max,1.0,0,0,3,0,0,stay,1976-02-28
3410,Oliver Sain,1976-03-06,Oliver Sain - Blue Max,48,51,51,48.0,48,Blue Max,1.0,1,-3,0,3,1,down,1976-02-28
3411,Diana Ross,1976-03-06,Diana Ross - Diana Ross (II),51,51,22,4.0,30,Diana Ross (II),22.0,0,8,21,0,1,up,1976-03-06
3412,Diana Ross,1976-03-13,Diana Ross - Diana Ross (II),30,51,17,4.0,22,Diana Ross (II),22.0,1,5,8,21,1,up,1976-03-06
3413,Diana Ross,1976-03-20,Diana Ross - Diana Ross (II),22,30,13,4.0,17,Diana Ross (II),22.0,2,4,5,8,1,up,1976-03-06
3414,Diana Ross,1976-03-27,Diana Ross - Diana Ross (II),17,22,9,4.0,13,Diana Ross (II),22.0,3,4,4,5,1,up,1976-03-06
3415,Diana Ross,1976-04-03,Diana Ross - Diana Ross (II),13,17,6,4.0,9,Diana Ross (II),22.0,4,3,4,4,1,up,1976-03-06
3416,Diana Ross,1976-04-10,Diana Ross - Diana Ross (II),9,13,5,4.0,6,Diana Ross (II),22.0,5,1,3,4,1,up,1976-03-06
3417,Diana Ross,1976-04-17,Diana Ross - Diana Ross (II),6,9,4,4.0,5,Diana Ross (II),22.0,6,1,1,3,1,up,1976-03-06
3418,Diana Ross,1976-04-24,Diana Ross - Diana Ross (II),5,6,7,4.0,4,Diana Ross (II),22.0,7,-3,1,1,1,down,1976-03-06
3419,Diana Ross,1976-05-01,Diana Ross - Diana Ross (II),4,5,8,4.0,7,Diana Ross (II),22.0,8,-1,-3,1,1,down,1976-03-06
3420,Diana Ross,1976-05-08,Diana Ross - Diana Ross (II),7,4,8,4.0,8,Diana Ross (II),22.0,9,0,-1,-3,0,stay,1976-03-06
3421,Diana Ross,1976-05-15,Diana Ross - Diana Ross (II),8,7,7,4.0,8,Diana Ross (II),22.0,10,1,0,-1,1,up,1976-03-06
3422,Diana Ross,1976-05-22,Diana Ross - Diana Ross (II),8,8,6,4.0,7,Diana Ross (II),22.0,11,1,1,0,1,up,1976-03-06
3423,Diana Ross,1976-05-29,Diana Ross - Diana Ross (II),7,8,6,4.0,6,Diana Ross (II),22.0,12,0,1,1,0,stay,1976-03-06
3424,Diana Ross,1976-06-05,Diana Ross - Diana Ross (II),6,7,9,4.0,6,Diana Ross (II),22.0,13,-3,0,1,1,down,1976-03-06
3425,Diana Ross,1976-06-12,Diana Ross - Diana Ross (II),6,6,8,4.0,9,Diana Ross (II),22.0,14,1,-3,0,1,up,1976-03-06
3426,Diana Ross,1976-06-19,Diana Ross - Diana Ross (II),9,6,9,4.0,8,Diana Ross (II),22.0,15,-1,1,-3,1,down,1976-03-06
3427,Diana Ross,1976-06-26,Diana Ross - Diana Ross (II),8,9,14,4.0,9,Diana Ross (II),22.0,16,-5,-1,1,1,down,1976-03-06
3428,Diana Ross,1976-07-04,Diana Ross - Diana Ross (II),9,8,17,4.0,14,Diana Ross (II),22.0,17,-3,-5,-1,1,down,1976-03-06
3429,Diana Ross,1976-07-10,Diana Ross - Diana Ross (II),14,9,31,4.0,17,Diana Ross (II),22.0,18,-14,-3,-5,1,down,1976-03-06
3430,Diana Ross,1976-07-17,Diana Ross - Diana Ross (II),17,14,31,4.0,31,Diana Ross (II),22.0,19,0,-14,-3,0,stay,1976-03-06
3431,Diana Ross,1976-07-24,Diana Ross - Diana Ross (II),31,17,41,4.0,31,Diana Ross (II),22.0,20,-10,0,-14,1,down,1976-03-06
3432,Diana Ross,1976-07-31,Diana Ross - Diana Ross (II),31,31,41,4.0,41,Diana Ross (II),22.0,21,0,-10,0,0,stay,1976-03-06
3433,Diana Ross,1976-08-07,Diana Ross - Diana Ross (II),41,31,51,4.0,41,Diana Ross (II),22.0,22,-10,0,-10,1,down,1976-03-06
3434,The Wing & A Prayer Fife & Drum Corps,1976-03-06,The Wing & A Prayer Fife & Drum Corps - Babyface,51,51,30,19.0,46,Babyface,5.0,0,16,5,0,1,up,1976-03-06
3435,The Wing & A Prayer Fife & Drum Corps,1976-03-13,The Wing & A Prayer Fife & Drum Corps - Babyface,46,51,25,19.0,30,Babyface,5.0,1,5,16,5,1,up,1976-03-06
3436,The Wing & A Prayer Fife & Drum Corps,1976-03-20,The Wing & A Prayer Fife & Drum Corps - Babyface,30,46,19,19.0,25,Babyface,5.0,2,6,5,16,1,up,1976-03-06
3437,The Wing & A Prayer Fife & Drum Corps,1976-03-27,The Wing & A Prayer Fife & Drum Corps - Babyface,25,30,19,19.0,19,Babyface,5.0,3,0,6,5,0,stay,1976-03-06
3438,The Wing & A Prayer Fife & Drum Corps,1976-04-03,The Wing & A Prayer Fife & Drum Corps - Babyface,19,25,41,19.0,19,Babyface,5.0,4,-22,0,6,1,down,1976-03-06
3439,The Wing & A Prayer Fife & Drum Corps,1976-04-10,The Wing & A Prayer Fife & Drum Corps - Babyface,19,19,51,19.0,41,Babyface,5.0,5,-10,-22,0,1,down,1976-03-06
3440,Hank Crawford,1976-03-06,Hank Crawford - I Hear A Symphony,51,51,37,17.0,49,I Hear A Symphony,10.0,0,12,2,0,1,up,1976-03-06
3441,Hank Crawford,1976-03-13,Hank Crawford - I Hear A Symphony,49,51,30,17.0,37,I Hear A Symphony,10.0,1,7,12,2,1,up,1976-03-06
3442,Hank Crawford,1976-03-20,Hank Crawford - I Hear A Symphony,37,49,24,17.0,30,I Hear A Symphony,10.0,2,6,7,12,1,up,1976-03-06
3443,Hank Crawford,1976-03-27,Hank Crawford - I Hear A Symphony,30,37,22,17.0,24,I Hear A Symphony,10.0,3,2,6,7,1,up,1976-03-06
3444,Hank Crawford,1976-04-03,Hank Crawford - I Hear A Symphony,24,30,20,17.0,22,I Hear A Symphony,10.0,4,2,2,6,1,up,1976-03-06
3445,Hank Crawford,1976-04-10,Hank Crawford - I Hear A Symphony,22,24,17,17.0,20,I Hear A Symphony,10.0,5,3,2,2,1,up,1976-03-06
3446,Hank Crawford,1976-04-17,Hank Crawford - I Hear A Symphony,20,22,21,17.0,17,I Hear A Symphony,10.0,6,-4,3,2,1,down,1976-03-06
3447,Hank Crawford,1976-04-24,Hank Crawford - I Hear A Symphony,17,20,23,17.0,21,I Hear A Symphony,10.0,7,-2,-4,3,1,down,1976-03-06
3448,Hank Crawford,1976-05-01,Hank Crawford - I Hear A Symphony,21,17,34,17.0,23,I Hear A Symphony,10.0,8,-11,-2,-4,1,down,1976-03-06
3449,Hank Crawford,1976-05-08,Hank Crawford - I Hear A Symphony,23,21,34,17.0,34,I Hear A Symphony,10.0,9,0,-11,-2,0,stay,1976-03-06
3450,Hank Crawford,1976-05-15,Hank Crawford - I Hear A Symphony,34,23,51,17.0,34,I Hear A Symphony,10.0,10,-17,0,-11,1,down,1976-03-06
3451,Rhythm Heritage,1976-03-13,Rhythm Heritage - Disco-fied,51,51,26,20.0,34,Disco-fied,11.0,0,8,17,0,1,up,1976-03-13
3452,Rhythm Heritage,1976-03-20,Rhythm Heritage - Disco-fied,34,51,20,20.0,26,Disco-fied,11.0,1,6,8,17,1,up,1976-03-13
3453,Rhythm Heritage,1976-03-27,Rhythm Heritage - Disco-fied,26,34,20,20.0,20,Disco-fied,11.0,2,0,6,8,0,stay,1976-03-13
3454,Rhythm Heritage,1976-04-03,Rhythm Heritage - Disco-fied,20,26,31,20.0,20,Disco-fied,11.0,3,-11,0,6,1,down,1976-03-13
3455,Rhythm Heritage,1976-04-10,Rhythm Heritage - Disco-fied,20,20,29,20.0,31,Disco-fied,11.0,4,2,-11,0,1,up,1976-03-13
3456,Rhythm Heritage,1976-04-17,Rhythm Heritage - Disco-fied,31,20,32,20.0,29,Disco-fied,11.0,5,-3,2,-11,1,down,1976-03-13
3457,Rhythm Heritage,1976-04-24,Rhythm Heritage - Disco-fied,29,31,32,20.0,32,Disco-fied,11.0,6,0,-3,2,0,stay,1976-03-13
3458,Rhythm Heritage,1976-05-01,Rhythm Heritage - Disco-fied,32,29,30,20.0,32,Disco-fied,11.0,7,2,0,-3,1,up,1976-03-13
3459,Rhythm Heritage,1976-05-08,Rhythm Heritage - Disco-fied,32,32,30,20.0,30,Disco-fied,11.0,8,0,2,0,0,stay,1976-03-13
3460,Rhythm Heritage,1976-05-15,Rhythm Heritage - Disco-fied,30,32,25,20.0,30,Disco-fied,11.0,9,5,0,2,1,up,1976-03-13
3461,Rhythm Heritage,1976-05-22,Rhythm Heritage - Disco-fied,30,30,23,20.0,25,Disco-fied,11.0,10,2,5,0,1,up,1976-03-13
3462,Rhythm Heritage,1976-05-29,Rhythm Heritage - Disco-fied,25,30,51,20.0,23,Disco-fied,11.0,11,-28,2,5,1,down,1976-03-13
3463,Smokey Robinson,1976-03-13,Smokey Robinson - Smokey's Family Robinson,51,51,28,9.0,36,Smokey's Family Robinson,12.0,0,8,15,0,1,up,1976-03-13
3464,Smokey Robinson,1976-03-20,Smokey Robinson - Smokey's Family Robinson,36,51,18,9.0,28,Smokey's Family Robinson,12.0,1,10,8,15,1,up,1976-03-13
3465,Smokey Robinson,1976-03-27,Smokey Robinson - Smokey's Family Robinson,28,36,14,9.0,18,Smokey's Family Robinson,12.0,2,4,10,8,1,up,1976-03-13
3466,Smokey Robinson,1976-04-03,Smokey Robinson - Smokey's Family Robinson,18,28,10,9.0,14,Smokey's Family Robinson,12.0,3,4,4,10,1,up,1976-03-13
3467,Smokey Robinson,1976-04-10,Smokey Robinson - Smokey's Family Robinson,14,18,9,9.0,10,Smokey's Family Robinson,12.0,4,1,4,4,1,up,1976-03-13
3468,Smokey Robinson,1976-04-17,Smokey Robinson - Smokey's Family Robinson,10,14,19,9.0,9,Smokey's Family Robinson,12.0,5,-10,1,4,1,down,1976-03-13
3469,Smokey Robinson,1976-04-24,Smokey Robinson - Smokey's Family Robinson,9,10,28,9.0,19,Smokey's Family Robinson,12.0,6,-9,-10,1,1,down,1976-03-13
3470,Smokey Robinson,1976-05-01,Smokey Robinson - Smokey's Family Robinson,19,9,28,9.0,28,Smokey's Family Robinson,12.0,7,0,-9,-10,0,stay,1976-03-13
3471,Smokey Robinson,1976-05-08,Smokey Robinson - Smokey's Family Robinson,28,19,27,9.0,28,Smokey's Family Robinson,12.0,8,1,0,-9,1,up,1976-03-13
3472,Smokey Robinson,1976-05-15,Smokey Robinson - Smokey's Family Robinson,28,28,31,9.0,27,Smokey's Family Robinson,12.0,9,-4,1,0,1,down,1976-03-13
3473,Smokey Robinson,1976-05-22,Smokey Robinson - Smokey's Family Robinson,27,28,39,9.0,31,Smokey's Family Robinson,12.0,10,-8,-4,1,1,down,1976-03-13
3474,Smokey Robinson,1976-05-29,Smokey Robinson - Smokey's Family Robinson,31,27,42,9.0,39,Smokey's Family Robinson,12.0,11,-3,-8,-4,1,down,1976-03-13
3475,Smokey Robinson,1976-06-05,Smokey Robinson - Smokey's Family Robinson,39,31,51,9.0,42,Smokey's Family Robinson,12.0,12,-9,-3,-8,1,down,1976-03-13
3476,The Brothers Johnson,1976-03-13,The Brothers Johnson - Look Out For #1,51,51,38,1.0,42,Look Out For #1,31.0,0,4,9,0,1,up,1976-03-13
3477,The Brothers Johnson,1976-03-20,The Brothers Johnson - Look Out For #1,42,51,36,1.0,38,Look Out For #1,31.0,1,2,4,9,1,up,1976-03-13
3478,The Brothers Johnson,1976-03-27,The Brothers Johnson - Look Out For #1,38,42,29,1.0,36,Look Out For #1,31.0,2,7,2,4,1,up,1976-03-13
3479,The Brothers Johnson,1976-04-03,The Brothers Johnson - Look Out For #1,36,38,19,1.0,29,Look Out For #1,31.0,3,10,7,2,1,up,1976-03-13
3480,The Brothers Johnson,1976-04-10,The Brothers Johnson - Look Out For #1,29,36,15,1.0,19,Look Out For #1,31.0,4,4,10,7,1,up,1976-03-13
3481,The Brothers Johnson,1976-04-17,The Brothers Johnson - Look Out For #1,19,29,11,1.0,15,Look Out For #1,31.0,5,4,4,10,1,up,1976-03-13
3482,The Brothers Johnson,1976-04-24,The Brothers Johnson - Look Out For #1,15,19,8,1.0,11,Look Out For #1,31.0,6,3,4,4,1,up,1976-03-13
3483,The Brothers Johnson,1976-05-01,The Brothers Johnson - Look Out For #1,11,15,5,1.0,8,Look Out For #1,31.0,7,3,3,4,1,up,1976-03-13
3484,The Brothers Johnson,1976-05-08,The Brothers Johnson - Look Out For #1,8,11,4,1.0,5,Look Out For #1,31.0,8,1,3,3,1,up,1976-03-13
3485,The Brothers Johnson,1976-05-15,The Brothers Johnson - Look Out For #1,5,8,3,1.0,4,Look Out For #1,31.0,9,1,1,3,1,up,1976-03-13
3486,The Brothers Johnson,1976-05-22,The Brothers Johnson - Look Out For #1,4,5,1,1.0,3,Look Out For #1,31.0,10,2,1,1,1,up,1976-03-13
3487,The Brothers Johnson,1976-05-29,The Brothers Johnson - Look Out For #1,3,4,1,1.0,1,Look Out For #1,31.0,11,0,2,1,0,stay,1976-03-13
3488,The Brothers Johnson,1976-06-05,The Brothers Johnson - Look Out For #1,1,3,1,1.0,1,Look Out For #1,31.0,12,0,0,2,0,stay,1976-03-13
3489,The Brothers Johnson,1976-06-12,The Brothers Johnson - Look Out For #1,1,1,1,1.0,1,Look Out For #1,31.0,13,0,0,0,0,stay,1976-03-13
3490,The Brothers Johnson,1976-06-19,The Brothers Johnson - Look Out For #1,1,1,3,1.0,1,Look Out For #1,31.0,14,-2,0,0,1,down,1976-03-13
3491,The Brothers Johnson,1976-06-26,The Brothers Johnson - Look Out For #1,1,1,2,1.0,3,Look Out For #1,31.0,15,1,-2,0,1,up,1976-03-13
3492,The Brothers Johnson,1976-07-04,The Brothers Johnson - Look Out For #1,3,1,6,1.0,2,Look Out For #1,31.0,16,-4,1,-2,1,down,1976-03-13
3493,The Brothers Johnson,1976-07-10,The Brothers Johnson - Look Out For #1,2,3,6,1.0,6,Look Out For #1,31.0,17,0,-4,1,0,stay,1976-03-13
3494,The Brothers Johnson,1976-07-17,The Brothers Johnson - Look Out For #1,6,2,5,1.0,6,Look Out For #1,31.0,18,1,0,-4,1,up,1976-03-13
3495,The Brothers Johnson,1976-07-24,The Brothers Johnson - Look Out For #1,6,6,4,1.0,5,Look Out For #1,31.0,19,1,1,0,1,up,1976-03-13
3496,The Brothers Johnson,1976-07-31,The Brothers Johnson - Look Out For #1,5,6,4,1.0,4,Look Out For #1,31.0,20,0,1,1,0,stay,1976-03-13
3497,The Brothers Johnson,1976-08-07,The Brothers Johnson - Look Out For #1,4,5,5,1.0,4,Look Out For #1,31.0,21,-1,0,1,1,down,1976-03-13
3498,The Brothers Johnson,1976-08-14,The Brothers Johnson - Look Out For #1,4,4,11,1.0,5,Look Out For #1,31.0,22,-6,-1,0,1,down,1976-03-13
3499,The Brothers Johnson,1976-08-21,The Brothers Johnson - Look Out For #1,5,4,10,1.0,11,Look Out For #1,31.0,23,1,-6,-1,1,up,1976-03-13
3500,The Brothers Johnson,1976-08-28,The Brothers Johnson - Look Out For #1,11,5,14,1.0,10,Look Out For #1,31.0,24,-4,1,-6,1,down,1976-03-13
3501,The Brothers Johnson,1976-09-04,The Brothers Johnson - Look Out For #1,10,11,22,1.0,14,Look Out For #1,31.0,25,-8,-4,1,1,down,1976-03-13
3502,The Brothers Johnson,1976-09-11,The Brothers Johnson - Look Out For #1,14,10,16,1.0,22,Look Out For #1,31.0,26,6,-8,-4,1,up,1976-03-13
3503,The Brothers Johnson,1976-09-18,The Brothers Johnson - Look Out For #1,22,14,16,1.0,16,Look Out For #1,31.0,27,0,6,-8,0,stay,1976-03-13
3504,The Brothers Johnson,1976-09-25,The Brothers Johnson - Look Out For #1,16,22,23,1.0,16,Look Out For #1,31.0,28,-7,0,6,1,down,1976-03-13
3505,The Brothers Johnson,1976-10-02,The Brothers Johnson - Look Out For #1,16,16,23,1.0,23,Look Out For #1,31.0,29,0,-7,0,0,stay,1976-03-13
3506,The Brothers Johnson,1976-10-09,The Brothers Johnson - Look Out For #1,23,16,35,1.0,23,Look Out For #1,31.0,30,-12,0,-7,1,down,1976-03-13
3507,The Brothers Johnson,1976-10-16,The Brothers Johnson - Look Out For #1,23,23,51,1.0,35,Look Out For #1,31.0,31,-16,-12,0,1,down,1976-03-13
3508,Albert King,1976-03-13,Albert King - Truckload Of Lovin',51,51,35,26.0,43,Truckload Of Lovin',9.0,0,8,8,0,1,up,1976-03-13
3509,Albert King,1976-03-20,Albert King - Truckload Of Lovin',43,51,28,26.0,35,Truckload Of Lovin',9.0,1,7,8,8,1,up,1976-03-13
3510,Albert King,1976-03-27,Albert King - Truckload Of Lovin',35,43,28,26.0,28,Truckload Of Lovin',9.0,2,0,7,8,0,stay,1976-03-13
3511,Albert King,1976-04-03,Albert King - Truckload Of Lovin',28,35,26,26.0,28,Truckload Of Lovin',9.0,3,2,0,7,1,up,1976-03-13
3512,Albert King,1976-04-10,Albert King - Truckload Of Lovin',28,28,26,26.0,26,Truckload Of Lovin',9.0,4,0,2,0,0,stay,1976-03-13
3513,Albert King,1976-04-17,Albert King - Truckload Of Lovin',26,28,26,26.0,26,Truckload Of Lovin',9.0,5,0,0,2,0,stay,1976-03-13
3514,Albert King,1976-04-24,Albert King - Truckload Of Lovin',26,26,29,26.0,26,Truckload Of Lovin',9.0,6,-3,0,0,1,down,1976-03-13
3515,Albert King,1976-05-01,Albert King - Truckload Of Lovin',26,26,31,26.0,29,Truckload Of Lovin',9.0,7,-2,-3,0,1,down,1976-03-13
3516,Albert King,1976-05-08,Albert King - Truckload Of Lovin',29,26,33,26.0,31,Truckload Of Lovin',9.0,8,-2,-2,-3,1,down,1976-03-13
3517,Albert King,1976-05-15,Albert King - Truckload Of Lovin',31,29,51,26.0,33,Truckload Of Lovin',9.0,9,-18,-2,-2,1,down,1976-03-13
3518,Phoebe Snow,1976-03-13,Phoebe Snow - Second Childhood,51,51,37,33.0,44,Second Childhood,4.0,0,7,7,0,1,up,1976-03-13
3519,Phoebe Snow,1976-03-20,Phoebe Snow - Second Childhood,44,51,33,33.0,37,Second Childhood,4.0,1,4,7,7,1,up,1976-03-13
3520,Phoebe Snow,1976-03-27,Phoebe Snow - Second Childhood,37,44,37,33.0,33,Second Childhood,4.0,2,-4,4,7,1,down,1976-03-13
3521,Phoebe Snow,1976-04-03,Phoebe Snow - Second Childhood,33,37,37,33.0,37,Second Childhood,4.0,3,0,-4,4,0,stay,1976-03-13
3522,Phoebe Snow,1976-04-10,Phoebe Snow - Second Childhood,37,33,51,33.0,37,Second Childhood,4.0,4,-14,0,-4,1,down,1976-03-13
3523,The Brecker Brothers,1976-03-13,The Brecker Brothers - Back To Back,51,51,39,32.0,45,Back To Back,9.0,0,6,6,0,1,up,1976-03-13
3524,The Brecker Brothers,1976-03-20,The Brecker Brothers - Back To Back,45,51,35,32.0,39,Back To Back,9.0,1,4,6,6,1,up,1976-03-13
3525,The Brecker Brothers,1976-03-27,The Brecker Brothers - Back To Back,39,45,35,32.0,35,Back To Back,9.0,2,0,4,6,0,stay,1976-03-13
3526,The Brecker Brothers,1976-04-03,The Brecker Brothers - Back To Back,35,39,34,32.0,35,Back To Back,9.0,3,1,0,4,1,up,1976-03-13
3527,The Brecker Brothers,1976-04-10,The Brecker Brothers - Back To Back,35,35,32,32.0,34,Back To Back,9.0,4,2,1,0,1,up,1976-03-13
3528,The Brecker Brothers,1976-04-17,The Brecker Brothers - Back To Back,34,35,33,32.0,32,Back To Back,9.0,5,-1,2,1,1,down,1976-03-13
3529,The Brecker Brothers,1976-04-24,The Brecker Brothers - Back To Back,32,34,41,32.0,33,Back To Back,9.0,6,-8,-1,2,1,down,1976-03-13
3530,The Brecker Brothers,1976-05-01,The Brecker Brothers - Back To Back,33,32,41,32.0,41,Back To Back,9.0,7,0,-8,-1,0,stay,1976-03-13
3531,The Brecker Brothers,1976-05-08,The Brecker Brothers - Back To Back,41,33,44,32.0,41,Back To Back,9.0,8,-3,0,-8,1,down,1976-03-13
3532,The Brecker Brothers,1976-05-15,The Brecker Brothers - Back To Back,41,41,51,32.0,44,Back To Back,9.0,9,-7,-3,0,1,down,1976-03-13
3533,The Impressions,1976-03-13,The Impressions - Loving Power,51,51,36,24.0,47,Loving Power,5.0,0,11,4,0,1,up,1976-03-13
3534,The Impressions,1976-03-20,The Impressions - Loving Power,47,51,30,24.0,36,Loving Power,5.0,1,6,11,4,1,up,1976-03-13
3535,The Impressions,1976-03-27,The Impressions - Loving Power,36,47,24,24.0,30,Loving Power,5.0,2,6,6,11,1,up,1976-03-13
3536,The Impressions,1976-04-03,The Impressions - Loving Power,30,36,24,24.0,24,Loving Power,5.0,3,0,6,6,0,stay,1976-03-13
3537,The Impressions,1976-04-10,The Impressions - Loving Power,24,30,33,24.0,24,Loving Power,5.0,4,-9,0,6,1,down,1976-03-13
3538,The Impressions,1976-04-17,The Impressions - Loving Power,24,24,51,24.0,33,Loving Power,5.0,5,-18,-9,0,1,down,1976-03-13
3539,Leroy Hutson,1976-03-13,Leroy Hutson - Feel The Spirit,51,51,31,21.0,48,Feel The Spirit,6.0,0,17,3,0,1,up,1976-03-13
3540,Leroy Hutson,1976-03-20,Leroy Hutson - Feel The Spirit,48,51,23,21.0,31,Feel The Spirit,6.0,1,8,17,3,1,up,1976-03-13
3541,Leroy Hutson,1976-03-27,Leroy Hutson - Feel The Spirit,31,48,21,21.0,23,Feel The Spirit,6.0,2,2,8,17,1,up,1976-03-13
3542,Leroy Hutson,1976-04-03,Leroy Hutson - Feel The Spirit,23,31,35,21.0,21,Feel The Spirit,6.0,3,-14,2,8,1,down,1976-03-13
3543,Leroy Hutson,1976-04-10,Leroy Hutson - Feel The Spirit,21,23,40,21.0,35,Feel The Spirit,6.0,4,-5,-14,2,1,down,1976-03-13
3544,Leroy Hutson,1976-04-17,Leroy Hutson - Feel The Spirit,35,21,48,21.0,40,Feel The Spirit,6.0,5,-8,-5,-14,1,down,1976-03-13
3545,Leroy Hutson,1976-04-24,Leroy Hutson - Feel The Spirit,40,35,51,21.0,48,Feel The Spirit,6.0,6,-3,-8,-5,1,down,1976-03-13
3546,Willie Hutch,1976-03-13,Willie Hutch - Concert In Blues,51,51,33,22.0,49,Concert In Blues,8.0,0,16,2,0,1,up,1976-03-13
3547,Willie Hutch,1976-03-20,Willie Hutch - Concert In Blues,49,51,31,22.0,33,Concert In Blues,8.0,1,2,16,2,1,up,1976-03-13
3548,Willie Hutch,1976-03-27,Willie Hutch - Concert In Blues,33,49,26,22.0,31,Concert In Blues,8.0,2,5,2,16,1,up,1976-03-13
3549,Willie Hutch,1976-04-03,Willie Hutch - Concert In Blues,31,33,25,22.0,26,Concert In Blues,8.0,3,1,5,2,1,up,1976-03-13
3550,Willie Hutch,1976-04-10,Willie Hutch - Concert In Blues,26,31,22,22.0,25,Concert In Blues,8.0,4,3,1,5,1,up,1976-03-13
3551,Willie Hutch,1976-04-17,Willie Hutch - Concert In Blues,25,26,49,22.0,22,Concert In Blues,8.0,5,-27,3,1,1,down,1976-03-13
3552,Willie Hutch,1976-04-24,Willie Hutch - Concert In Blues,22,25,45,22.0,49,Concert In Blues,8.0,6,4,-27,3,1,up,1976-03-13
3553,Willie Hutch,1976-05-01,Willie Hutch - Concert In Blues,49,22,40,22.0,45,Concert In Blues,8.0,7,5,4,-27,1,up,1976-03-13
3554,Willie Hutch,1976-05-08,Willie Hutch - Concert In Blues,45,49,51,22.0,40,Concert In Blues,8.0,8,-11,5,4,1,down,1976-03-13
3555,Esther Phillips With Joe Beck,1976-03-13,Esther Phillips With Joe Beck - For All We Know,51,51,44,33.0,50,For All We Know,7.0,0,6,1,0,1,up,1976-03-13
3556,Esther Phillips With Joe Beck,1976-03-20,Esther Phillips With Joe Beck - For All We Know,50,51,42,33.0,44,For All We Know,7.0,1,2,6,1,1,up,1976-03-13
3557,Esther Phillips With Joe Beck,1976-03-27,Esther Phillips With Joe Beck - For All We Know,44,50,38,33.0,42,For All We Know,7.0,2,4,2,6,1,up,1976-03-13
3558,Esther Phillips With Joe Beck,1976-04-03,Esther Phillips With Joe Beck - For All We Know,42,44,33,33.0,38,For All We Know,7.0,3,5,4,2,1,up,1976-03-13
3559,Esther Phillips With Joe Beck,1976-04-10,Esther Phillips With Joe Beck - For All We Know,38,42,35,33.0,33,For All We Know,7.0,4,-2,5,4,1,down,1976-03-13
3560,Esther Phillips With Joe Beck,1976-04-17,Esther Phillips With Joe Beck - For All We Know,33,38,37,33.0,35,For All We Know,7.0,5,-2,-2,5,1,down,1976-03-13
3561,Esther Phillips With Joe Beck,1976-04-24,Esther Phillips With Joe Beck - For All We Know,35,33,33,33.0,37,For All We Know,7.0,6,4,-2,-2,1,up,1976-03-13
3562,Esther Phillips With Joe Beck,1976-05-01,Esther Phillips With Joe Beck - For All We Know,37,35,51,33.0,33,For All We Know,7.0,7,-18,4,-2,1,down,1976-03-13
3563,Johnnie Taylor,1976-03-20,Johnnie Taylor - Eargasm,51,51,5,1.0,21,Eargasm,25.0,0,16,30,0,1,up,1976-03-20
3564,Johnnie Taylor,1976-03-27,Johnnie Taylor - Eargasm,21,51,2,1.0,5,Eargasm,25.0,1,3,16,30,1,up,1976-03-20
3565,Johnnie Taylor,1976-04-03,Johnnie Taylor - Eargasm,5,21,1,1.0,2,Eargasm,25.0,2,1,3,16,1,up,1976-03-20
3566,Johnnie Taylor,1976-04-10,Johnnie Taylor - Eargasm,2,5,1,1.0,1,Eargasm,25.0,3,0,1,3,0,stay,1976-03-20
3567,Johnnie Taylor,1976-04-17,Johnnie Taylor - Eargasm,1,2,2,1.0,1,Eargasm,25.0,4,-1,0,1,1,down,1976-03-20
3568,Johnnie Taylor,1976-04-24,Johnnie Taylor - Eargasm,1,1,3,1.0,2,Eargasm,25.0,5,-1,-1,0,1,down,1976-03-20
3569,Johnnie Taylor,1976-05-01,Johnnie Taylor - Eargasm,2,1,4,1.0,3,Eargasm,25.0,6,-1,-1,-1,1,down,1976-03-20
3570,Johnnie Taylor,1976-05-08,Johnnie Taylor - Eargasm,3,2,5,1.0,4,Eargasm,25.0,7,-1,-1,-1,1,down,1976-03-20
3571,Johnnie Taylor,1976-05-15,Johnnie Taylor - Eargasm,4,3,4,1.0,5,Eargasm,25.0,8,1,-1,-1,1,up,1976-03-20
3572,Johnnie Taylor,1976-05-22,Johnnie Taylor - Eargasm,5,4,4,1.0,4,Eargasm,25.0,9,0,1,-1,0,stay,1976-03-20
3573,Johnnie Taylor,1976-05-29,Johnnie Taylor - Eargasm,4,5,4,1.0,4,Eargasm,25.0,10,0,0,1,0,stay,1976-03-20
3574,Johnnie Taylor,1976-06-05,Johnnie Taylor - Eargasm,4,4,6,1.0,4,Eargasm,25.0,11,-2,0,0,1,down,1976-03-20
3575,Johnnie Taylor,1976-06-12,Johnnie Taylor - Eargasm,4,4,16,1.0,6,Eargasm,25.0,12,-10,-2,0,1,down,1976-03-20
3576,Johnnie Taylor,1976-06-19,Johnnie Taylor - Eargasm,6,4,16,1.0,16,Eargasm,25.0,13,0,-10,-2,0,stay,1976-03-20
3577,Johnnie Taylor,1976-06-26,Johnnie Taylor - Eargasm,16,6,22,1.0,16,Eargasm,25.0,14,-6,0,-10,1,down,1976-03-20
3578,Johnnie Taylor,1976-07-04,Johnnie Taylor - Eargasm,16,16,33,1.0,22,Eargasm,25.0,15,-11,-6,0,1,down,1976-03-20
3579,Johnnie Taylor,1976-07-10,Johnnie Taylor - Eargasm,22,16,33,1.0,33,Eargasm,25.0,16,0,-11,-6,0,stay,1976-03-20
3580,Johnnie Taylor,1976-07-17,Johnnie Taylor - Eargasm,33,22,33,1.0,33,Eargasm,25.0,17,0,0,-11,0,stay,1976-03-20
3581,Johnnie Taylor,1976-07-24,Johnnie Taylor - Eargasm,33,33,34,1.0,33,Eargasm,25.0,18,-1,0,0,1,down,1976-03-20
3582,Johnnie Taylor,1976-07-31,Johnnie Taylor - Eargasm,33,33,35,1.0,34,Eargasm,25.0,19,-1,-1,0,1,down,1976-03-20
3583,Johnnie Taylor,1976-08-07,Johnnie Taylor - Eargasm,34,33,37,1.0,35,Eargasm,25.0,20,-2,-1,-1,1,down,1976-03-20
3584,Johnnie Taylor,1976-08-14,Johnnie Taylor - Eargasm,35,34,37,1.0,37,Eargasm,25.0,21,0,-2,-1,0,stay,1976-03-20
3585,Johnnie Taylor,1976-08-21,Johnnie Taylor - Eargasm,37,35,33,1.0,37,Eargasm,25.0,22,4,0,-2,1,up,1976-03-20
3586,Johnnie Taylor,1976-08-28,Johnnie Taylor - Eargasm,37,37,38,1.0,33,Eargasm,25.0,23,-5,4,0,1,down,1976-03-20
3587,Johnnie Taylor,1976-09-04,Johnnie Taylor - Eargasm,33,37,47,1.0,38,Eargasm,25.0,24,-9,-5,4,1,down,1976-03-20
3588,Johnnie Taylor,1976-09-11,Johnnie Taylor - Eargasm,38,33,51,1.0,47,Eargasm,25.0,25,-4,-9,-5,1,down,1976-03-20
3589,Al Green,1976-03-20,Al Green - Full Of Fire,51,51,25,12.0,34,Full Of Fire,11.0,0,9,17,0,1,up,1976-03-20
3590,Al Green,1976-03-27,Al Green - Full Of Fire,34,51,18,12.0,25,Full Of Fire,11.0,1,7,9,17,1,up,1976-03-20
3591,Al Green,1976-04-03,Al Green - Full Of Fire,25,34,13,12.0,18,Full Of Fire,11.0,2,5,7,9,1,up,1976-03-20
3592,Al Green,1976-04-10,Al Green - Full Of Fire,18,25,12,12.0,13,Full Of Fire,11.0,3,1,5,7,1,up,1976-03-20
3593,Al Green,1976-04-17,Al Green - Full Of Fire,13,18,14,12.0,12,Full Of Fire,11.0,4,-2,1,5,1,down,1976-03-20
3594,Al Green,1976-04-24,Al Green - Full Of Fire,12,13,14,12.0,14,Full Of Fire,11.0,5,0,-2,1,0,stay,1976-03-20
3595,Al Green,1976-05-01,Al Green - Full Of Fire,14,12,17,12.0,14,Full Of Fire,11.0,6,-3,0,-2,1,down,1976-03-20
3596,Al Green,1976-05-08,Al Green - Full Of Fire,14,14,17,12.0,17,Full Of Fire,11.0,7,0,-3,0,0,stay,1976-03-20
3597,Al Green,1976-05-15,Al Green - Full Of Fire,17,14,19,12.0,17,Full Of Fire,11.0,8,-2,0,-3,1,down,1976-03-20
3598,Al Green,1976-05-22,Al Green - Full Of Fire,17,17,35,12.0,19,Full Of Fire,11.0,9,-16,-2,0,1,down,1976-03-20
3599,Al Green,1976-05-29,Al Green - Full Of Fire,19,17,46,12.0,35,Full Of Fire,11.0,10,-11,-16,-2,1,down,1976-03-20
3600,Al Green,1976-06-05,Al Green - Full Of Fire,35,19,51,12.0,46,Full Of Fire,11.0,11,-5,-11,-16,1,down,1976-03-20
3601,Chick Corea,1976-03-20,Chick Corea - Leprechaun,51,51,37,32.0,45,Leprechaun,6.0,0,8,6,0,1,up,1976-03-20
3602,Chick Corea,1976-03-27,Chick Corea - Leprechaun,45,51,32,32.0,37,Leprechaun,6.0,1,5,8,6,1,up,1976-03-20
3603,Chick Corea,1976-04-03,Chick Corea - Leprechaun,37,45,32,32.0,32,Leprechaun,6.0,2,0,5,8,0,stay,1976-03-20
3604,Chick Corea,1976-04-10,Chick Corea - Leprechaun,32,37,36,32.0,32,Leprechaun,6.0,3,-4,0,5,1,down,1976-03-20
3605,Chick Corea,1976-04-17,Chick Corea - Leprechaun,32,32,39,32.0,36,Leprechaun,6.0,4,-3,-4,0,1,down,1976-03-20
3606,Chick Corea,1976-04-24,Chick Corea - Leprechaun,36,32,37,32.0,39,Leprechaun,6.0,5,2,-3,-4,1,up,1976-03-20
3607,Chick Corea,1976-05-01,Chick Corea - Leprechaun,39,36,51,32.0,37,Leprechaun,6.0,6,-14,2,-3,1,down,1976-03-20
3608,Patrice Rushen,1976-03-20,Patrice Rushen - Before The Dawn,51,51,49,48.0,48,Before The Dawn,1.0,0,-1,3,0,1,down,1976-03-20
3609,Patrice Rushen,1976-03-27,Patrice Rushen - Before The Dawn,48,51,51,48.0,49,Before The Dawn,1.0,1,-2,-1,3,1,down,1976-03-20
3610,Chocolate Milk,1976-03-27,Chocolate Milk - Chocolate Milk,51,51,27,18.0,41,Chocolate Milk,6.0,0,14,10,0,1,up,1976-03-27
3611,Chocolate Milk,1976-04-03,Chocolate Milk - Chocolate Milk,41,51,18,18.0,27,Chocolate Milk,6.0,1,9,14,10,1,up,1976-03-27
3612,Chocolate Milk,1976-04-10,Chocolate Milk - Chocolate Milk,27,41,18,18.0,18,Chocolate Milk,6.0,2,0,9,14,0,stay,1976-03-27
3613,Chocolate Milk,1976-04-17,Chocolate Milk - Chocolate Milk,18,27,22,18.0,18,Chocolate Milk,6.0,3,-4,0,9,1,down,1976-03-27
3614,Chocolate Milk,1976-04-24,Chocolate Milk - Chocolate Milk,18,18,30,18.0,22,Chocolate Milk,6.0,4,-8,-4,0,1,down,1976-03-27
3615,Chocolate Milk,1976-05-01,Chocolate Milk - Chocolate Milk,22,18,33,18.0,30,Chocolate Milk,6.0,5,-3,-8,-4,1,down,1976-03-27
3616,Chocolate Milk,1976-05-08,Chocolate Milk - Chocolate Milk,30,22,51,18.0,33,Chocolate Milk,6.0,6,-18,-3,-8,1,down,1976-03-27
3617,Kool & The Gang,1976-03-27,Kool & The Gang - Love & Understanding,51,51,25,9.0,43,Love & Understanding,17.0,0,18,8,0,1,up,1976-03-27
3618,Kool & The Gang,1976-04-03,Kool & The Gang - Love & Understanding,43,51,14,9.0,25,Love & Understanding,17.0,1,11,18,8,1,up,1976-03-27
3619,Kool & The Gang,1976-04-10,Kool & The Gang - Love & Understanding,25,43,10,9.0,14,Love & Understanding,17.0,2,4,11,18,1,up,1976-03-27
3620,Kool & The Gang,1976-04-17,Kool & The Gang - Love & Understanding,14,25,9,9.0,10,Love & Understanding,17.0,3,1,4,11,1,up,1976-03-27
3621,Kool & The Gang,1976-04-24,Kool & The Gang - Love & Understanding,10,14,9,9.0,9,Love & Understanding,17.0,4,0,1,4,0,stay,1976-03-27
3622,Kool & The Gang,1976-05-01,Kool & The Gang - Love & Understanding,9,10,12,9.0,9,Love & Understanding,17.0,5,-3,0,1,1,down,1976-03-27
3623,Kool & The Gang,1976-05-08,Kool & The Gang - Love & Understanding,9,9,14,9.0,12,Love & Understanding,17.0,6,-2,-3,0,1,down,1976-03-27
3624,Kool & The Gang,1976-05-15,Kool & The Gang - Love & Understanding,12,9,13,9.0,14,Love & Understanding,17.0,7,1,-2,-3,1,up,1976-03-27
3625,Kool & The Gang,1976-05-22,Kool & The Gang - Love & Understanding,14,12,11,9.0,13,Love & Understanding,17.0,8,2,1,-2,1,up,1976-03-27
3626,Kool & The Gang,1976-05-29,Kool & The Gang - Love & Understanding,13,14,24,9.0,11,Love & Understanding,17.0,9,-13,2,1,1,down,1976-03-27
3627,Kool & The Gang,1976-06-05,Kool & The Gang - Love & Understanding,11,13,27,9.0,24,Love & Understanding,17.0,10,-3,-13,2,1,down,1976-03-27
3628,Kool & The Gang,1976-06-12,Kool & The Gang - Love & Understanding,24,11,40,9.0,27,Love & Understanding,17.0,11,-13,-3,-13,1,down,1976-03-27
3629,Kool & The Gang,1976-06-19,Kool & The Gang - Love & Understanding,27,24,37,9.0,40,Love & Understanding,17.0,12,3,-13,-3,1,up,1976-03-27
3630,Kool & The Gang,1976-06-26,Kool & The Gang - Love & Understanding,40,27,32,9.0,37,Love & Understanding,17.0,13,5,3,-13,1,up,1976-03-27
3631,Kool & The Gang,1976-07-04,Kool & The Gang - Love & Understanding,37,40,41,9.0,32,Love & Understanding,17.0,14,-9,5,3,1,down,1976-03-27
3632,Kool & The Gang,1976-07-10,Kool & The Gang - Love & Understanding,32,37,45,9.0,41,Love & Understanding,17.0,15,-4,-9,5,1,down,1976-03-27
3633,Kool & The Gang,1976-07-17,Kool & The Gang - Love & Understanding,41,32,43,9.0,45,Love & Understanding,17.0,16,2,-4,-9,1,up,1976-03-27
3634,Kool & The Gang,1976-07-24,Kool & The Gang - Love & Understanding,45,41,51,9.0,43,Love & Understanding,17.0,17,-8,2,-4,1,down,1976-03-27
3635,Eddie Harris,1976-03-27,Eddie Harris - That Is Why You're Overweight,51,51,48,44.0,50,That Is Why You're Overweight,3.0,0,2,1,0,1,up,1976-03-27
3636,Eddie Harris,1976-04-03,Eddie Harris - That Is Why You're Overweight,50,51,46,44.0,48,That Is Why You're Overweight,3.0,1,2,2,1,1,up,1976-03-27
3637,Eddie Harris,1976-04-10,Eddie Harris - That Is Why You're Overweight,48,50,44,44.0,46,That Is Why You're Overweight,3.0,2,2,2,2,1,up,1976-03-27
3638,Eddie Harris,1976-04-17,Eddie Harris - That Is Why You're Overweight,46,48,51,44.0,44,That Is Why You're Overweight,3.0,3,-7,2,2,1,down,1976-03-27
3639,The Temptations,1976-04-03,The Temptations - Wings Of Love,51,51,27,3.0,40,Wings Of Love,14.0,0,13,11,0,1,up,1976-04-03
3640,The Temptations,1976-04-10,The Temptations - Wings Of Love,40,51,19,3.0,27,Wings Of Love,14.0,1,8,13,11,1,up,1976-04-03
3641,The Temptations,1976-04-17,The Temptations - Wings Of Love,27,40,10,3.0,19,Wings Of Love,14.0,2,9,8,13,1,up,1976-04-03
3642,The Temptations,1976-04-24,The Temptations - Wings Of Love,19,27,4,3.0,10,Wings Of Love,14.0,3,6,9,8,1,up,1976-04-03
3643,The Temptations,1976-05-01,The Temptations - Wings Of Love,10,19,3,3.0,4,Wings Of Love,14.0,4,1,6,9,1,up,1976-04-03
3644,The Temptations,1976-05-08,The Temptations - Wings Of Love,4,10,3,3.0,3,Wings Of Love,14.0,5,0,1,6,0,stay,1976-04-03
3645,The Temptations,1976-05-15,The Temptations - Wings Of Love,3,4,9,3.0,3,Wings Of Love,14.0,6,-6,0,1,1,down,1976-04-03
3646,The Temptations,1976-05-22,The Temptations - Wings Of Love,3,3,10,3.0,9,Wings Of Love,14.0,7,-1,-6,0,1,down,1976-04-03
3647,The Temptations,1976-05-29,The Temptations - Wings Of Love,9,3,15,3.0,10,Wings Of Love,14.0,8,-5,-1,-6,1,down,1976-04-03
3648,The Temptations,1976-06-05,The Temptations - Wings Of Love,10,9,21,3.0,15,Wings Of Love,14.0,9,-6,-5,-1,1,down,1976-04-03
3649,The Temptations,1976-06-12,The Temptations - Wings Of Love,15,10,46,3.0,21,Wings Of Love,14.0,10,-25,-6,-5,1,down,1976-04-03
3650,The Temptations,1976-06-19,The Temptations - Wings Of Love,21,15,49,3.0,46,Wings Of Love,14.0,11,-3,-25,-6,1,down,1976-04-03
3651,The Temptations,1976-07-04,The Temptations - Wings Of Love,46,21,48,3.0,49,Wings Of Love,14.0,12,1,-3,-25,1,up,1976-04-03
3652,The Temptations,1976-07-10,The Temptations - Wings Of Love,49,46,50,3.0,48,Wings Of Love,14.0,13,-2,1,-3,1,down,1976-04-03
3653,The Temptations,1976-07-17,The Temptations - Wings Of Love,48,49,51,3.0,50,Wings Of Love,14.0,14,-1,-2,1,1,down,1976-04-03
3654,Donna Summer,1976-04-03,Donna Summer - A Love Trilogy,51,51,28,16.0,43,A Love Trilogy,19.0,0,15,8,0,1,up,1976-04-03
3655,Donna Summer,1976-04-10,Donna Summer - A Love Trilogy,43,51,21,16.0,28,A Love Trilogy,19.0,1,7,15,8,1,up,1976-04-03
3656,Donna Summer,1976-04-17,Donna Summer - A Love Trilogy,28,43,18,16.0,21,A Love Trilogy,19.0,2,3,7,15,1,up,1976-04-03
3657,Donna Summer,1976-04-24,Donna Summer - A Love Trilogy,21,28,16,16.0,18,A Love Trilogy,19.0,3,2,3,7,1,up,1976-04-03
3658,Donna Summer,1976-05-01,Donna Summer - A Love Trilogy,18,21,21,16.0,16,A Love Trilogy,19.0,4,-5,2,3,1,down,1976-04-03
3659,Donna Summer,1976-05-08,Donna Summer - A Love Trilogy,16,18,26,16.0,21,A Love Trilogy,19.0,5,-5,-5,2,1,down,1976-04-03
3660,Donna Summer,1976-05-15,Donna Summer - A Love Trilogy,21,16,29,16.0,26,A Love Trilogy,19.0,6,-3,-5,-5,1,down,1976-04-03
3661,Donna Summer,1976-05-22,Donna Summer - A Love Trilogy,26,21,25,16.0,29,A Love Trilogy,19.0,7,4,-3,-5,1,up,1976-04-03
3662,Donna Summer,1976-05-29,Donna Summer - A Love Trilogy,29,26,29,16.0,25,A Love Trilogy,19.0,8,-4,4,-3,1,down,1976-04-03
3663,Donna Summer,1976-06-05,Donna Summer - A Love Trilogy,25,29,26,16.0,29,A Love Trilogy,19.0,9,3,-4,4,1,up,1976-04-03
3664,Donna Summer,1976-06-12,Donna Summer - A Love Trilogy,29,25,45,16.0,26,A Love Trilogy,19.0,10,-19,3,-4,1,down,1976-04-03
3665,Donna Summer,1976-06-26,Donna Summer - A Love Trilogy,26,29,39,16.0,45,A Love Trilogy,19.0,11,6,-19,3,1,up,1976-04-03
3666,Donna Summer,1976-07-04,Donna Summer - A Love Trilogy,45,26,39,16.0,39,A Love Trilogy,19.0,12,0,6,-19,0,stay,1976-04-03
3667,Donna Summer,1976-07-10,Donna Summer - A Love Trilogy,39,45,40,16.0,39,A Love Trilogy,19.0,13,-1,0,6,1,down,1976-04-03
3668,Donna Summer,1976-07-17,Donna Summer - A Love Trilogy,39,39,40,16.0,40,A Love Trilogy,19.0,14,0,-1,0,0,stay,1976-04-03
3669,Donna Summer,1976-07-24,Donna Summer - A Love Trilogy,40,39,48,16.0,40,A Love Trilogy,19.0,15,-8,0,-1,1,down,1976-04-03
3670,Donna Summer,1976-07-31,Donna Summer - A Love Trilogy,40,40,42,16.0,48,A Love Trilogy,19.0,16,6,-8,0,1,up,1976-04-03
3671,Donna Summer,1976-08-07,Donna Summer - A Love Trilogy,48,40,48,16.0,42,A Love Trilogy,19.0,17,-6,6,-8,1,down,1976-04-03
3672,Donna Summer,1976-08-21,Donna Summer - A Love Trilogy,42,48,48,16.0,48,A Love Trilogy,19.0,18,0,-6,6,0,stay,1976-04-03
3673,Donna Summer,1976-08-28,Donna Summer - A Love Trilogy,48,42,51,16.0,48,A Love Trilogy,19.0,19,-3,0,-6,1,down,1976-04-03
3674,Charles Earland,1976-04-03,Charles Earland - Odyssey,51,51,44,20.0,46,Odyssey,9.0,0,2,5,0,1,up,1976-04-03
3675,Charles Earland,1976-04-10,Charles Earland - Odyssey,46,51,34,20.0,44,Odyssey,9.0,1,10,2,5,1,up,1976-04-03
3676,Charles Earland,1976-04-17,Charles Earland - Odyssey,44,46,27,20.0,34,Odyssey,9.0,2,7,10,2,1,up,1976-04-03
3677,Charles Earland,1976-04-24,Charles Earland - Odyssey,34,44,20,20.0,27,Odyssey,9.0,3,7,7,10,1,up,1976-04-03
3678,Charles Earland,1976-05-01,Charles Earland - Odyssey,27,34,20,20.0,20,Odyssey,9.0,4,0,7,7,0,stay,1976-04-03
3679,Charles Earland,1976-05-08,Charles Earland - Odyssey,20,27,23,20.0,20,Odyssey,9.0,5,-3,0,7,1,down,1976-04-03
3680,Charles Earland,1976-05-15,Charles Earland - Odyssey,20,20,41,20.0,23,Odyssey,9.0,6,-18,-3,0,1,down,1976-04-03
3681,Charles Earland,1976-05-22,Charles Earland - Odyssey,23,20,37,20.0,41,Odyssey,9.0,7,4,-18,-3,1,up,1976-04-03
3682,Charles Earland,1976-05-29,Charles Earland - Odyssey,41,23,37,20.0,37,Odyssey,9.0,8,0,4,-18,0,stay,1976-04-03
3683,Charles Earland,1976-06-05,Charles Earland - Odyssey,37,41,51,20.0,37,Odyssey,9.0,9,-14,0,4,1,down,1976-04-03
3684,The Isley Brothers,1976-04-03,The Isley Brothers - The Best...Isley Brothers,51,51,49,49.0,49,The Best...Isley Brothers,1.0,0,0,2,0,0,stay,1976-04-03
3685,The Isley Brothers,1976-04-10,The Isley Brothers - The Best...Isley Brothers,49,51,51,49.0,49,The Best...Isley Brothers,1.0,1,-2,0,2,1,down,1976-04-03
3686,Marvin Gaye,1976-04-10,Marvin Gaye - I Want You,51,51,4,1.0,22,I Want You,25.0,0,18,29,0,1,up,1976-04-10
3687,Marvin Gaye,1976-04-17,Marvin Gaye - I Want You,22,51,3,1.0,4,I Want You,25.0,1,1,18,29,1,up,1976-04-10
3688,Marvin Gaye,1976-04-24,Marvin Gaye - I Want You,4,22,2,1.0,3,I Want You,25.0,2,1,1,18,1,up,1976-04-10
3689,Marvin Gaye,1976-05-01,Marvin Gaye - I Want You,3,4,2,1.0,2,I Want You,25.0,3,0,1,1,0,stay,1976-04-10
3690,Marvin Gaye,1976-05-08,Marvin Gaye - I Want You,2,3,1,1.0,2,I Want You,25.0,4,1,0,1,1,up,1976-04-10
3691,Marvin Gaye,1976-05-15,Marvin Gaye - I Want You,2,2,2,1.0,1,I Want You,25.0,5,-1,1,0,1,down,1976-04-10
3692,Marvin Gaye,1976-05-22,Marvin Gaye - I Want You,1,2,3,1.0,2,I Want You,25.0,6,-1,-1,1,1,down,1976-04-10
3693,Marvin Gaye,1976-05-29,Marvin Gaye - I Want You,2,1,2,1.0,3,I Want You,25.0,7,1,-1,-1,1,up,1976-04-10
3694,Marvin Gaye,1976-06-05,Marvin Gaye - I Want You,3,2,2,1.0,2,I Want You,25.0,8,0,1,-1,0,stay,1976-04-10
3695,Marvin Gaye,1976-06-12,Marvin Gaye - I Want You,2,3,5,1.0,2,I Want You,25.0,9,-3,0,1,1,down,1976-04-10
3696,Marvin Gaye,1976-06-19,Marvin Gaye - I Want You,2,2,7,1.0,5,I Want You,25.0,10,-2,-3,0,1,down,1976-04-10
3697,Marvin Gaye,1976-06-26,Marvin Gaye - I Want You,5,2,4,1.0,7,I Want You,25.0,11,3,-2,-3,1,up,1976-04-10
3698,Marvin Gaye,1976-07-04,Marvin Gaye - I Want You,7,5,4,1.0,4,I Want You,25.0,12,0,3,-2,0,stay,1976-04-10
3699,Marvin Gaye,1976-07-10,Marvin Gaye - I Want You,4,7,5,1.0,4,I Want You,25.0,13,-1,0,3,1,down,1976-04-10
3700,Marvin Gaye,1976-07-17,Marvin Gaye - I Want You,4,4,9,1.0,5,I Want You,25.0,14,-4,-1,0,1,down,1976-04-10
3701,Marvin Gaye,1976-07-24,Marvin Gaye - I Want You,5,4,10,1.0,9,I Want You,25.0,15,-1,-4,-1,1,down,1976-04-10
3702,Marvin Gaye,1976-07-31,Marvin Gaye - I Want You,9,5,19,1.0,10,I Want You,25.0,16,-9,-1,-4,1,down,1976-04-10
3703,Marvin Gaye,1976-08-07,Marvin Gaye - I Want You,10,9,20,1.0,19,I Want You,25.0,17,-1,-9,-1,1,down,1976-04-10
3704,Marvin Gaye,1976-08-14,Marvin Gaye - I Want You,19,10,22,1.0,20,I Want You,25.0,18,-2,-1,-9,1,down,1976-04-10
3705,Marvin Gaye,1976-08-21,Marvin Gaye - I Want You,20,19,29,1.0,22,I Want You,25.0,19,-7,-2,-1,1,down,1976-04-10
3706,Marvin Gaye,1976-08-28,Marvin Gaye - I Want You,22,20,31,1.0,29,I Want You,25.0,20,-2,-7,-2,1,down,1976-04-10
3707,Marvin Gaye,1976-09-04,Marvin Gaye - I Want You,29,22,46,1.0,31,I Want You,25.0,21,-15,-2,-7,1,down,1976-04-10
3708,Marvin Gaye,1976-09-11,Marvin Gaye - I Want You,31,29,42,1.0,46,I Want You,25.0,22,4,-15,-2,1,up,1976-04-10
3709,Marvin Gaye,1976-09-18,Marvin Gaye - I Want You,46,31,42,1.0,42,I Want You,25.0,23,0,4,-15,0,stay,1976-04-10
3710,Marvin Gaye,1976-09-25,Marvin Gaye - I Want You,42,46,48,1.0,42,I Want You,25.0,24,-6,0,4,1,down,1976-04-10
3711,Marvin Gaye,1976-10-02,Marvin Gaye - I Want You,42,42,51,1.0,48,I Want You,25.0,25,-3,-6,0,1,down,1976-04-10
3712,The Five Stairsteps,1976-04-10,The Five Stairsteps - 2nd Ressurection,51,51,37,37.0,38,2nd Ressurection,3.0,0,1,13,0,1,up,1976-04-10
3713,The Five Stairsteps,1976-04-17,The Five Stairsteps - 2nd Ressurection,38,51,47,37.0,37,2nd Ressurection,3.0,1,-10,1,13,1,down,1976-04-10
3714,The Five Stairsteps,1976-04-24,The Five Stairsteps - 2nd Ressurection,37,38,50,37.0,47,2nd Ressurection,3.0,2,-3,-10,1,1,down,1976-04-10
3715,The Five Stairsteps,1976-05-01,The Five Stairsteps - 2nd Ressurection,47,37,51,37.0,50,2nd Ressurection,3.0,3,-1,-3,-10,1,down,1976-04-10
3716,Silver Convention,1976-04-10,Silver Convention - Silver Convention,51,51,24,9.0,42,Silver Convention,11.0,0,18,9,0,1,up,1976-04-10
3717,Silver Convention,1976-04-17,Silver Convention - Silver Convention,42,51,16,9.0,24,Silver Convention,11.0,1,8,18,9,1,up,1976-04-10
3718,Silver Convention,1976-04-24,Silver Convention - Silver Convention,24,42,12,9.0,16,Silver Convention,11.0,2,4,8,18,1,up,1976-04-10
3719,Silver Convention,1976-05-01,Silver Convention - Silver Convention,16,24,9,9.0,12,Silver Convention,11.0,3,3,4,8,1,up,1976-04-10
3720,Silver Convention,1976-05-08,Silver Convention - Silver Convention,12,16,9,9.0,9,Silver Convention,11.0,4,0,3,4,0,stay,1976-04-10
3721,Silver Convention,1976-05-15,Silver Convention - Silver Convention,9,12,11,9.0,9,Silver Convention,11.0,5,-2,0,3,1,down,1976-04-10
3722,Silver Convention,1976-05-22,Silver Convention - Silver Convention,9,9,14,9.0,11,Silver Convention,11.0,6,-3,-2,0,1,down,1976-04-10
3723,Silver Convention,1976-05-29,Silver Convention - Silver Convention,11,9,12,9.0,14,Silver Convention,11.0,7,2,-3,-2,1,up,1976-04-10
3724,Silver Convention,1976-06-05,Silver Convention - Silver Convention,14,11,28,9.0,12,Silver Convention,11.0,8,-16,2,-3,1,down,1976-04-10
3725,Silver Convention,1976-06-12,Silver Convention - Silver Convention,12,14,27,9.0,28,Silver Convention,11.0,9,1,-16,2,1,up,1976-04-10
3726,Silver Convention,1976-06-19,Silver Convention - Silver Convention,28,12,25,9.0,27,Silver Convention,11.0,10,2,1,-16,1,up,1976-04-10
3727,Silver Convention,1976-06-26,Silver Convention - Silver Convention,27,28,51,9.0,25,Silver Convention,11.0,11,-26,2,1,1,down,1976-04-10
3728,Hugh Masekela,1976-04-10,Hugh Masekela - Colonial Man,51,51,42,42.0,45,Colonial Man,1.0,0,3,6,0,1,up,1976-04-10
3729,Hugh Masekela,1976-04-17,Hugh Masekela - Colonial Man,45,51,51,42.0,42,Colonial Man,1.0,1,-9,3,6,1,down,1976-04-10
3730,Lonnie Liston Smith,1976-04-10,Lonnie Liston Smith - Reflections Of A Golden Dream,51,51,38,18.0,50,Reflections Of A Golden Dream,7.0,0,12,1,0,1,up,1976-04-10
3731,Lonnie Liston Smith,1976-04-17,Lonnie Liston Smith - Reflections Of A Golden Dream,50,51,29,18.0,38,Reflections Of A Golden Dream,7.0,1,9,12,1,1,up,1976-04-10
3732,Lonnie Liston Smith,1976-04-24,Lonnie Liston Smith - Reflections Of A Golden Dream,38,50,21,18.0,29,Reflections Of A Golden Dream,7.0,2,8,9,12,1,up,1976-04-10
3733,Lonnie Liston Smith,1976-05-01,Lonnie Liston Smith - Reflections Of A Golden Dream,29,38,18,18.0,21,Reflections Of A Golden Dream,7.0,3,3,8,9,1,up,1976-04-10
3734,Lonnie Liston Smith,1976-05-08,Lonnie Liston Smith - Reflections Of A Golden Dream,21,29,20,18.0,18,Reflections Of A Golden Dream,7.0,4,-2,3,8,1,down,1976-04-10
3735,Lonnie Liston Smith,1976-05-15,Lonnie Liston Smith - Reflections Of A Golden Dream,18,21,22,18.0,20,Reflections Of A Golden Dream,7.0,5,-2,-2,3,1,down,1976-04-10
3736,Lonnie Liston Smith,1976-05-22,Lonnie Liston Smith - Reflections Of A Golden Dream,20,18,49,18.0,22,Reflections Of A Golden Dream,7.0,6,-27,-2,-2,1,down,1976-04-10
3737,Lonnie Liston Smith,1976-05-29,Lonnie Liston Smith - Reflections Of A Golden Dream,22,20,51,18.0,49,Reflections Of A Golden Dream,7.0,7,-2,-27,-2,1,down,1976-04-10
3738,Santana,1976-04-17,Santana - Amigos,51,51,30,8.0,43,Amigos,12.0,0,13,8,0,1,up,1976-04-17
3739,Santana,1976-04-24,Santana - Amigos,43,51,22,8.0,30,Amigos,12.0,1,8,13,8,1,up,1976-04-17
3740,Santana,1976-05-01,Santana - Amigos,30,43,15,8.0,22,Amigos,12.0,2,7,8,13,1,up,1976-04-17
3741,Santana,1976-05-08,Santana - Amigos,22,30,12,8.0,15,Amigos,12.0,3,3,7,8,1,up,1976-04-17
3742,Santana,1976-05-15,Santana - Amigos,15,22,8,8.0,12,Amigos,12.0,4,4,3,7,1,up,1976-04-17
3743,Santana,1976-05-22,Santana - Amigos,12,15,8,8.0,8,Amigos,12.0,5,0,4,3,0,stay,1976-04-17
3744,Santana,1976-05-29,Santana - Amigos,8,12,22,8.0,8,Amigos,12.0,6,-14,0,4,1,down,1976-04-17
3745,Santana,1976-06-05,Santana - Amigos,8,8,46,8.0,22,Amigos,12.0,7,-24,-14,0,1,down,1976-04-17
3746,Santana,1976-06-12,Santana - Amigos,22,8,44,8.0,46,Amigos,12.0,8,2,-24,-14,1,up,1976-04-17
3747,Santana,1976-06-19,Santana - Amigos,46,22,40,8.0,44,Amigos,12.0,9,4,2,-24,1,up,1976-04-17
3748,Santana,1976-06-26,Santana - Amigos,44,46,33,8.0,40,Amigos,12.0,10,7,4,2,1,up,1976-04-17
3749,Santana,1976-07-04,Santana - Amigos,40,44,42,8.0,33,Amigos,12.0,11,-9,7,4,1,down,1976-04-17
3750,Santana,1976-07-10,Santana - Amigos,33,40,51,8.0,42,Amigos,12.0,12,-9,-9,7,1,down,1976-04-17
3751,George Benson,1976-04-17,George Benson - Breezin',51,51,24,1.0,45,Breezin',39.0,0,21,6,0,1,up,1976-04-17
3752,George Benson,1976-04-24,George Benson - Breezin',45,51,18,1.0,24,Breezin',39.0,1,6,21,6,1,up,1976-04-17
3753,George Benson,1976-05-01,George Benson - Breezin',24,45,10,1.0,18,Breezin',39.0,2,8,6,21,1,up,1976-04-17
3754,George Benson,1976-05-08,George Benson - Breezin',18,24,7,1.0,10,Breezin',39.0,3,3,8,6,1,up,1976-04-17
3755,George Benson,1976-05-15,George Benson - Breezin',10,18,1,1.0,7,Breezin',39.0,4,6,3,8,1,up,1976-04-17
3756,George Benson,1976-05-22,George Benson - Breezin',7,10,2,1.0,1,Breezin',39.0,5,-1,6,3,1,down,1976-04-17
3757,George Benson,1976-05-29,George Benson - Breezin',1,7,3,1.0,2,Breezin',39.0,6,-1,-1,6,1,down,1976-04-17
3758,George Benson,1976-06-05,George Benson - Breezin',2,1,3,1.0,3,Breezin',39.0,7,0,-1,-1,0,stay,1976-04-17
3759,George Benson,1976-06-12,George Benson - Breezin',3,2,3,1.0,3,Breezin',39.0,8,0,0,-1,0,stay,1976-04-17
3760,George Benson,1976-06-19,George Benson - Breezin',3,3,2,1.0,3,Breezin',39.0,9,1,0,0,1,up,1976-04-17
3761,George Benson,1976-06-26,George Benson - Breezin',3,3,1,1.0,2,Breezin',39.0,10,1,1,0,1,up,1976-04-17
3762,George Benson,1976-07-04,George Benson - Breezin',2,3,1,1.0,1,Breezin',39.0,11,0,1,1,0,stay,1976-04-17
3763,George Benson,1976-07-10,George Benson - Breezin',1,2,1,1.0,1,Breezin',39.0,12,0,0,1,0,stay,1976-04-17
3764,George Benson,1976-07-17,George Benson - Breezin',1,1,3,1.0,1,Breezin',39.0,13,-2,0,0,1,down,1976-04-17
3765,George Benson,1976-07-24,George Benson - Breezin',1,1,3,1.0,3,Breezin',39.0,14,0,-2,0,0,stay,1976-04-17
3766,George Benson,1976-07-31,George Benson - Breezin',3,1,1,1.0,3,Breezin',39.0,15,2,0,-2,1,up,1976-04-17
3767,George Benson,1976-08-07,George Benson - Breezin',3,3,1,1.0,1,Breezin',39.0,16,0,2,0,0,stay,1976-04-17
3768,George Benson,1976-08-14,George Benson - Breezin',1,3,4,1.0,1,Breezin',39.0,17,-3,0,2,1,down,1976-04-17
3769,George Benson,1976-08-21,George Benson - Breezin',1,1,5,1.0,4,Breezin',39.0,18,-1,-3,0,1,down,1976-04-17
3770,George Benson,1976-08-28,George Benson - Breezin',4,1,4,1.0,5,Breezin',39.0,19,1,-1,-3,1,up,1976-04-17
3771,George Benson,1976-09-04,George Benson - Breezin',5,4,3,1.0,4,Breezin',39.0,20,1,1,-1,1,up,1976-04-17
3772,George Benson,1976-09-11,George Benson - Breezin',4,5,5,1.0,3,Breezin',39.0,21,-2,1,1,1,down,1976-04-17
3773,George Benson,1976-09-18,George Benson - Breezin',3,4,4,1.0,5,Breezin',39.0,22,1,-2,1,1,up,1976-04-17
3774,George Benson,1976-09-25,George Benson - Breezin',5,3,4,1.0,4,Breezin',39.0,23,0,1,-2,0,stay,1976-04-17
3775,George Benson,1976-10-02,George Benson - Breezin',4,5,14,1.0,4,Breezin',39.0,24,-10,0,1,1,down,1976-04-17
3776,George Benson,1976-10-09,George Benson - Breezin',4,4,19,1.0,14,Breezin',39.0,25,-5,-10,0,1,down,1976-04-17
3777,George Benson,1976-10-16,George Benson - Breezin',14,4,17,1.0,19,Breezin',39.0,26,2,-5,-10,1,up,1976-04-17
3778,George Benson,1976-10-23,George Benson - Breezin',19,14,19,1.0,17,Breezin',39.0,27,-2,2,-5,1,down,1976-04-17
3779,George Benson,1976-10-30,George Benson - Breezin',17,19,19,1.0,19,Breezin',39.0,28,0,-2,2,0,stay,1976-04-17
3780,George Benson,1976-11-06,George Benson - Breezin',19,17,22,1.0,19,Breezin',39.0,29,-3,0,-2,1,down,1976-04-17
3781,George Benson,1976-11-13,George Benson - Breezin',19,19,38,1.0,22,Breezin',39.0,30,-16,-3,0,1,down,1976-04-17
3782,George Benson,1976-11-20,George Benson - Breezin',22,19,41,1.0,38,Breezin',39.0,31,-3,-16,-3,1,down,1976-04-17
3783,George Benson,1976-11-27,George Benson - Breezin',38,22,48,1.0,41,Breezin',39.0,32,-7,-3,-16,1,down,1976-04-17
3784,George Benson,1976-12-11,George Benson - Breezin',41,38,48,1.0,48,Breezin',39.0,33,0,-7,-3,0,stay,1976-04-17
3785,George Benson,1976-12-18,George Benson - Breezin',48,41,44,1.0,48,Breezin',39.0,34,4,0,-7,1,up,1976-04-17
3786,George Benson,1976-12-25,George Benson - Breezin',48,48,44,1.0,44,Breezin',39.0,35,0,4,0,0,stay,1976-04-17
3787,George Benson,1977-01-01,George Benson - Breezin',44,48,49,1.0,44,Breezin',39.0,36,-5,0,4,1,down,1976-04-17
3788,George Benson,1977-04-23,George Benson - Breezin',44,44,42,1.0,49,Breezin',39.0,37,7,-5,0,1,up,1976-04-17
3789,George Benson,1977-04-30,George Benson - Breezin',49,44,42,1.0,42,Breezin',39.0,38,0,7,-5,0,stay,1976-04-17
3790,George Benson,1977-05-07,George Benson - Breezin',42,49,51,1.0,42,Breezin',39.0,39,-9,0,7,1,down,1976-04-17
3791,Ashford & Simpson,1976-04-17,Ashford & Simpson - Come As You Are,51,51,43,35.0,47,Come As You Are,10.0,0,4,4,0,1,up,1976-04-17
3792,Ashford & Simpson,1976-04-24,Ashford & Simpson - Come As You Are,47,51,38,35.0,43,Come As You Are,10.0,1,5,4,4,1,up,1976-04-17
3793,Ashford & Simpson,1976-05-01,Ashford & Simpson - Come As You Are,43,47,35,35.0,38,Come As You Are,10.0,2,3,5,4,1,up,1976-04-17
3794,Ashford & Simpson,1976-05-08,Ashford & Simpson - Come As You Are,38,43,35,35.0,35,Come As You Are,10.0,3,0,3,5,0,stay,1976-04-17
3795,Ashford & Simpson,1976-05-15,Ashford & Simpson - Come As You Are,35,38,42,35.0,35,Come As You Are,10.0,4,-7,0,3,1,down,1976-04-17
3796,Ashford & Simpson,1976-05-22,Ashford & Simpson - Come As You Are,35,35,43,35.0,42,Come As You Are,10.0,5,-1,-7,0,1,down,1976-04-17
3797,Ashford & Simpson,1976-05-29,Ashford & Simpson - Come As You Are,42,35,43,35.0,43,Come As You Are,10.0,6,0,-1,-7,0,stay,1976-04-17
3798,Ashford & Simpson,1976-06-05,Ashford & Simpson - Come As You Are,43,42,48,35.0,43,Come As You Are,10.0,7,-5,0,-1,1,down,1976-04-17
3799,Ashford & Simpson,1976-06-19,Ashford & Simpson - Come As You Are,43,43,42,35.0,48,Come As You Are,10.0,8,6,-5,0,1,up,1976-04-17
3800,Ashford & Simpson,1976-06-26,Ashford & Simpson - Come As You Are,48,43,48,35.0,42,Come As You Are,10.0,9,-6,6,-5,1,down,1976-04-17
3801,Ashford & Simpson,1976-07-04,Ashford & Simpson - Come As You Are,42,48,51,35.0,48,Come As You Are,10.0,10,-3,-6,6,1,down,1976-04-17
3802,D.J. Rogers,1976-04-17,D.J. Rogers - It's Good To Be Alive,51,51,38,36.0,48,It's Good To Be Alive,3.0,0,10,3,0,1,up,1976-04-17
3803,D.J. Rogers,1976-04-24,D.J. Rogers - It's Good To Be Alive,48,51,36,36.0,38,It's Good To Be Alive,3.0,1,2,10,3,1,up,1976-04-17
3804,D.J. Rogers,1976-05-01,D.J. Rogers - It's Good To Be Alive,38,48,36,36.0,36,It's Good To Be Alive,3.0,2,0,2,10,0,stay,1976-04-17
3805,D.J. Rogers,1976-05-08,D.J. Rogers - It's Good To Be Alive,36,38,51,36.0,36,It's Good To Be Alive,3.0,3,-15,0,2,1,down,1976-04-17
3806,John Tropea,1976-04-17,John Tropea - Tropea,51,51,40,40.0,49,Tropea,4.0,0,9,2,0,1,up,1976-04-17
3807,John Tropea,1976-04-24,John Tropea - Tropea,49,51,47,40.0,40,Tropea,4.0,1,-7,9,2,1,down,1976-04-17
3808,John Tropea,1976-05-01,John Tropea - Tropea,40,49,42,40.0,47,Tropea,4.0,2,5,-7,9,1,up,1976-04-17
3809,John Tropea,1976-05-08,John Tropea - Tropea,47,40,48,40.0,42,Tropea,4.0,3,-6,5,-7,1,down,1976-04-17
3810,John Tropea,1976-05-15,John Tropea - Tropea,42,47,51,40.0,48,Tropea,4.0,4,-3,-6,5,1,down,1976-04-17
3811,The Choice Four,1976-04-17,The Choice Four - On Top Of Clear,51,51,46,43.0,50,On Top Of Clear,2.0,0,4,1,0,1,up,1976-04-17
3812,The Choice Four,1976-04-24,The Choice Four - On Top Of Clear,50,51,43,43.0,46,On Top Of Clear,2.0,1,3,4,1,1,up,1976-04-17
3813,The Choice Four,1976-05-01,The Choice Four - On Top Of Clear,46,50,51,43.0,43,On Top Of Clear,2.0,2,-8,3,4,1,down,1976-04-17
3814,Return To Forever,1976-04-24,Return To Forever - Romantic Warrior,51,51,27,23.0,35,Romantic Warrior,4.0,0,8,16,0,1,up,1976-04-24
3815,Return To Forever,1976-05-01,Return To Forever - Romantic Warrior,35,51,23,23.0,27,Romantic Warrior,4.0,1,4,8,16,1,up,1976-04-24
3816,Return To Forever,1976-05-08,Return To Forever - Romantic Warrior,27,35,25,23.0,23,Romantic Warrior,4.0,2,-2,4,8,1,down,1976-04-24
3817,Return To Forever,1976-05-15,Return To Forever - Romantic Warrior,23,27,30,23.0,25,Romantic Warrior,4.0,3,-5,-2,4,1,down,1976-04-24
3818,Return To Forever,1976-05-22,Return To Forever - Romantic Warrior,25,23,51,23.0,30,Romantic Warrior,4.0,4,-21,-5,-2,1,down,1976-04-24
3819,William Bootsy Collins,1976-04-24,William Bootsy Collins - Stretchin' Out In Bootsy's Rubber Band,51,51,39,10.0,44,Stretchin' Out In Bootsy's Rubber Band,25.0,0,5,7,0,1,up,1976-04-24
3820,William Bootsy Collins,1976-05-01,William Bootsy Collins - Stretchin' Out In Bootsy's Rubber Band,44,51,37,10.0,39,Stretchin' Out In Bootsy's Rubber Band,25.0,1,2,5,7,1,up,1976-04-24
3821,William Bootsy Collins,1976-05-08,William Bootsy Collins - Stretchin' Out In Bootsy's Rubber Band,39,44,36,10.0,37,Stretchin' Out In Bootsy's Rubber Band,25.0,2,1,2,5,1,up,1976-04-24
3822,William Bootsy Collins,1976-05-15,William Bootsy Collins - Stretchin' Out In Bootsy's Rubber Band,37,39,33,10.0,36,Stretchin' Out In Bootsy's Rubber Band,25.0,3,3,1,2,1,up,1976-04-24
3823,William Bootsy Collins,1976-05-22,William Bootsy Collins - Stretchin' Out In Bootsy's Rubber Band,36,37,24,10.0,33,Stretchin' Out In Bootsy's Rubber Band,25.0,4,9,3,1,1,up,1976-04-24
3824,William Bootsy Collins,1976-05-29,William Bootsy Collins - Stretchin' Out In Bootsy's Rubber Band,33,36,18,10.0,24,Stretchin' Out In Bootsy's Rubber Band,25.0,5,6,9,3,1,up,1976-04-24
3825,William Bootsy Collins,1976-06-05,William Bootsy Collins - Stretchin' Out In Bootsy's Rubber Band,24,33,14,10.0,18,Stretchin' Out In Bootsy's Rubber Band,25.0,6,4,6,9,1,up,1976-04-24
3826,William Bootsy Collins,1976-06-12,William Bootsy Collins - Stretchin' Out In Bootsy's Rubber Band,18,24,14,10.0,14,Stretchin' Out In Bootsy's Rubber Band,25.0,7,0,4,6,0,stay,1976-04-24
3827,William Bootsy Collins,1976-06-19,William Bootsy Collins - Stretchin' Out In Bootsy's Rubber Band,14,18,14,10.0,14,Stretchin' Out In Bootsy's Rubber Band,25.0,8,0,0,4,0,stay,1976-04-24
3828,William Bootsy Collins,1976-06-26,William Bootsy Collins - Stretchin' Out In Bootsy's Rubber Band,14,14,13,10.0,14,Stretchin' Out In Bootsy's Rubber Band,25.0,9,1,0,0,1,up,1976-04-24
3829,William Bootsy Collins,1976-07-04,William Bootsy Collins - Stretchin' Out In Bootsy's Rubber Band,14,14,22,10.0,13,Stretchin' Out In Bootsy's Rubber Band,25.0,10,-9,1,0,1,down,1976-04-24
3830,William Bootsy Collins,1976-07-10,William Bootsy Collins - Stretchin' Out In Bootsy's Rubber Band,13,14,21,10.0,22,Stretchin' Out In Bootsy's Rubber Band,25.0,11,1,-9,1,1,up,1976-04-24
3831,William Bootsy Collins,1976-07-17,William Bootsy Collins - Stretchin' Out In Bootsy's Rubber Band,22,13,19,10.0,21,Stretchin' Out In Bootsy's Rubber Band,25.0,12,2,1,-9,1,up,1976-04-24
3832,William Bootsy Collins,1976-07-24,William Bootsy Collins - Stretchin' Out In Bootsy's Rubber Band,21,22,19,10.0,19,Stretchin' Out In Bootsy's Rubber Band,25.0,13,0,2,1,0,stay,1976-04-24
3833,William Bootsy Collins,1976-07-31,William Bootsy Collins - Stretchin' Out In Bootsy's Rubber Band,19,21,13,10.0,19,Stretchin' Out In Bootsy's Rubber Band,25.0,14,6,0,2,1,up,1976-04-24
3834,William Bootsy Collins,1976-08-07,William Bootsy Collins - Stretchin' Out In Bootsy's Rubber Band,19,19,11,10.0,13,Stretchin' Out In Bootsy's Rubber Band,25.0,15,2,6,0,1,up,1976-04-24
3835,William Bootsy Collins,1976-08-14,William Bootsy Collins - Stretchin' Out In Bootsy's Rubber Band,13,19,10,10.0,11,Stretchin' Out In Bootsy's Rubber Band,25.0,16,1,2,6,1,up,1976-04-24
3836,William Bootsy Collins,1976-08-21,William Bootsy Collins - Stretchin' Out In Bootsy's Rubber Band,11,13,15,10.0,10,Stretchin' Out In Bootsy's Rubber Band,25.0,17,-5,1,2,1,down,1976-04-24
3837,William Bootsy Collins,1976-08-28,William Bootsy Collins - Stretchin' Out In Bootsy's Rubber Band,10,11,19,10.0,15,Stretchin' Out In Bootsy's Rubber Band,25.0,18,-4,-5,1,1,down,1976-04-24
3838,William Bootsy Collins,1976-09-04,William Bootsy Collins - Stretchin' Out In Bootsy's Rubber Band,15,10,19,10.0,19,Stretchin' Out In Bootsy's Rubber Band,25.0,19,0,-4,-5,0,stay,1976-04-24
3839,William Bootsy Collins,1976-09-11,William Bootsy Collins - Stretchin' Out In Bootsy's Rubber Band,19,15,28,10.0,19,Stretchin' Out In Bootsy's Rubber Band,25.0,20,-9,0,-4,1,down,1976-04-24
3840,William Bootsy Collins,1976-09-18,William Bootsy Collins - Stretchin' Out In Bootsy's Rubber Band,19,19,21,10.0,28,Stretchin' Out In Bootsy's Rubber Band,25.0,21,7,-9,0,1,up,1976-04-24
3841,William Bootsy Collins,1976-09-25,William Bootsy Collins - Stretchin' Out In Bootsy's Rubber Band,28,19,20,10.0,21,Stretchin' Out In Bootsy's Rubber Band,25.0,22,1,7,-9,1,up,1976-04-24
3842,William Bootsy Collins,1976-10-02,William Bootsy Collins - Stretchin' Out In Bootsy's Rubber Band,21,28,28,10.0,20,Stretchin' Out In Bootsy's Rubber Band,25.0,23,-8,1,7,1,down,1976-04-24
3843,William Bootsy Collins,1976-10-09,William Bootsy Collins - Stretchin' Out In Bootsy's Rubber Band,20,21,44,10.0,28,Stretchin' Out In Bootsy's Rubber Band,25.0,24,-16,-8,1,1,down,1976-04-24
3844,William Bootsy Collins,1976-10-16,William Bootsy Collins - Stretchin' Out In Bootsy's Rubber Band,28,20,51,10.0,44,Stretchin' Out In Bootsy's Rubber Band,25.0,25,-7,-16,-8,1,down,1976-04-24
3845,Lee Oskar,1976-04-24,Lee Oskar - Lee Oskar,51,51,35,10.0,45,Lee Oskar,17.0,0,10,6,0,1,up,1976-04-24
3846,Lee Oskar,1976-05-01,Lee Oskar - Lee Oskar,45,51,27,10.0,35,Lee Oskar,17.0,1,8,10,6,1,up,1976-04-24
3847,Lee Oskar,1976-05-08,Lee Oskar - Lee Oskar,35,45,21,10.0,27,Lee Oskar,17.0,2,6,8,10,1,up,1976-04-24
3848,Lee Oskar,1976-05-15,Lee Oskar - Lee Oskar,27,35,17,10.0,21,Lee Oskar,17.0,3,4,6,8,1,up,1976-04-24
3849,Lee Oskar,1976-05-22,Lee Oskar - Lee Oskar,21,27,13,10.0,17,Lee Oskar,17.0,4,4,4,6,1,up,1976-04-24
3850,Lee Oskar,1976-05-29,Lee Oskar - Lee Oskar,17,21,11,10.0,13,Lee Oskar,17.0,5,2,4,4,1,up,1976-04-24
3851,Lee Oskar,1976-06-05,Lee Oskar - Lee Oskar,13,17,10,10.0,11,Lee Oskar,17.0,6,1,2,4,1,up,1976-04-24
3852,Lee Oskar,1976-06-12,Lee Oskar - Lee Oskar,11,13,22,10.0,10,Lee Oskar,17.0,7,-12,1,2,1,down,1976-04-24
3853,Lee Oskar,1976-06-19,Lee Oskar - Lee Oskar,10,11,27,10.0,22,Lee Oskar,17.0,8,-5,-12,1,1,down,1976-04-24
3854,Lee Oskar,1976-06-26,Lee Oskar - Lee Oskar,22,10,27,10.0,27,Lee Oskar,17.0,9,0,-5,-12,0,stay,1976-04-24
3855,Lee Oskar,1976-07-04,Lee Oskar - Lee Oskar,27,22,27,10.0,27,Lee Oskar,17.0,10,0,0,-5,0,stay,1976-04-24
3856,Lee Oskar,1976-07-10,Lee Oskar - Lee Oskar,27,27,27,10.0,27,Lee Oskar,17.0,11,0,0,0,0,stay,1976-04-24
3857,Lee Oskar,1976-07-17,Lee Oskar - Lee Oskar,27,27,27,10.0,27,Lee Oskar,17.0,12,0,0,0,0,stay,1976-04-24
3858,Lee Oskar,1976-07-24,Lee Oskar - Lee Oskar,27,27,27,10.0,27,Lee Oskar,17.0,13,0,0,0,0,stay,1976-04-24
3859,Lee Oskar,1976-07-31,Lee Oskar - Lee Oskar,27,27,34,10.0,27,Lee Oskar,17.0,14,-7,0,0,1,down,1976-04-24
3860,Lee Oskar,1976-08-07,Lee Oskar - Lee Oskar,27,27,34,10.0,34,Lee Oskar,17.0,15,0,-7,0,0,stay,1976-04-24
3861,Lee Oskar,1976-08-14,Lee Oskar - Lee Oskar,34,27,35,10.0,34,Lee Oskar,17.0,16,-1,0,-7,1,down,1976-04-24
3862,Lee Oskar,1976-08-21,Lee Oskar - Lee Oskar,34,34,51,10.0,35,Lee Oskar,17.0,17,-16,-1,0,1,down,1976-04-24
3863,11th Hour,1976-04-24,11th Hour - Hollywood Hot,51,51,40,32.0,50,Hollywood Hot,4.0,0,10,1,0,1,up,1976-04-24
3864,11th Hour,1976-05-01,11th Hour - Hollywood Hot,50,51,32,32.0,40,Hollywood Hot,4.0,1,8,10,1,1,up,1976-04-24
3865,11th Hour,1976-05-08,11th Hour - Hollywood Hot,40,50,32,32.0,32,Hollywood Hot,4.0,2,0,8,10,0,stay,1976-04-24
3866,11th Hour,1976-05-15,11th Hour - Hollywood Hot,32,40,43,32.0,32,Hollywood Hot,4.0,3,-11,0,8,1,down,1976-04-24
3867,11th Hour,1976-05-22,11th Hour - Hollywood Hot,32,32,51,32.0,43,Hollywood Hot,4.0,4,-8,-11,0,1,down,1976-04-24
3868,Weather Report,1976-05-01,Weather Report - Black Market,51,51,43,20.0,48,Black Market,5.0,0,5,3,0,1,up,1976-05-01
3869,Weather Report,1976-05-08,Weather Report - Black Market,48,51,43,20.0,43,Black Market,5.0,1,0,5,3,0,stay,1976-05-01
3870,Weather Report,1976-05-15,Weather Report - Black Market,43,48,20,20.0,43,Black Market,5.0,2,23,0,5,1,up,1976-05-01
3871,Weather Report,1976-05-22,Weather Report - Black Market,43,43,20,20.0,20,Black Market,5.0,3,0,23,0,0,stay,1976-05-01
3872,Weather Report,1976-05-29,Weather Report - Black Market,20,43,32,20.0,20,Black Market,5.0,4,-12,0,23,1,down,1976-05-01
3873,Weather Report,1976-06-05,Weather Report - Black Market,20,20,51,20.0,32,Black Market,5.0,5,-19,-12,0,1,down,1976-05-01
3874,The Manhattans,1976-05-08,The Manhattans - The Manhattans,51,51,31,6.0,39,The Manhattans,20.0,0,8,12,0,1,up,1976-05-08
3875,The Manhattans,1976-05-15,The Manhattans - The Manhattans,39,51,24,6.0,31,The Manhattans,20.0,1,7,8,12,1,up,1976-05-08
3876,The Manhattans,1976-05-22,The Manhattans - The Manhattans,31,39,17,6.0,24,The Manhattans,20.0,2,7,7,8,1,up,1976-05-08
3877,The Manhattans,1976-05-29,The Manhattans - The Manhattans,24,31,8,6.0,17,The Manhattans,20.0,3,9,7,7,1,up,1976-05-08
3878,The Manhattans,1976-06-05,The Manhattans - The Manhattans,17,24,7,6.0,8,The Manhattans,20.0,4,1,9,7,1,up,1976-05-08
3879,The Manhattans,1976-06-12,The Manhattans - The Manhattans,8,17,6,6.0,7,The Manhattans,20.0,5,1,1,9,1,up,1976-05-08
3880,The Manhattans,1976-06-19,The Manhattans - The Manhattans,7,8,8,6.0,6,The Manhattans,20.0,6,-2,1,1,1,down,1976-05-08
3881,The Manhattans,1976-06-26,The Manhattans - The Manhattans,6,7,8,6.0,8,The Manhattans,20.0,7,0,-2,1,0,stay,1976-05-08
3882,The Manhattans,1976-07-04,The Manhattans - The Manhattans,8,6,8,6.0,8,The Manhattans,20.0,8,0,0,-2,0,stay,1976-05-08
3883,The Manhattans,1976-07-10,The Manhattans - The Manhattans,8,8,14,6.0,8,The Manhattans,20.0,9,-6,0,0,1,down,1976-05-08
3884,The Manhattans,1976-07-17,The Manhattans - The Manhattans,8,8,11,6.0,14,The Manhattans,20.0,10,3,-6,0,1,up,1976-05-08
3885,The Manhattans,1976-07-24,The Manhattans - The Manhattans,14,8,13,6.0,11,The Manhattans,20.0,11,-2,3,-6,1,down,1976-05-08
3886,The Manhattans,1976-07-31,The Manhattans - The Manhattans,11,14,14,6.0,13,The Manhattans,20.0,12,-1,-2,3,1,down,1976-05-08
3887,The Manhattans,1976-08-07,The Manhattans - The Manhattans,13,11,16,6.0,14,The Manhattans,20.0,13,-2,-1,-2,1,down,1976-05-08
3888,The Manhattans,1976-08-14,The Manhattans - The Manhattans,14,13,20,6.0,16,The Manhattans,20.0,14,-4,-2,-1,1,down,1976-05-08
3889,The Manhattans,1976-08-21,The Manhattans - The Manhattans,16,14,20,6.0,20,The Manhattans,20.0,15,0,-4,-2,0,stay,1976-05-08
3890,The Manhattans,1976-08-28,The Manhattans - The Manhattans,20,16,25,6.0,20,The Manhattans,20.0,16,-5,0,-4,1,down,1976-05-08
3891,The Manhattans,1976-09-04,The Manhattans - The Manhattans,20,20,26,6.0,25,The Manhattans,20.0,17,-1,-5,0,1,down,1976-05-08
3892,The Manhattans,1976-09-11,The Manhattans - The Manhattans,25,20,32,6.0,26,The Manhattans,20.0,18,-6,-1,-5,1,down,1976-05-08
3893,The Manhattans,1976-09-18,The Manhattans - The Manhattans,26,25,40,6.0,32,The Manhattans,20.0,19,-8,-6,-1,1,down,1976-05-08
3894,The Manhattans,1976-09-25,The Manhattans - The Manhattans,32,26,51,6.0,40,The Manhattans,20.0,20,-11,-8,-6,1,down,1976-05-08
3895,Melba Moore,1976-05-08,Melba Moore - This Is It,51,51,41,32.0,45,This Is It,7.0,0,4,6,0,1,up,1976-05-08
3896,Melba Moore,1976-05-15,Melba Moore - This Is It,45,51,36,32.0,41,This Is It,7.0,1,5,4,6,1,up,1976-05-08
3897,Melba Moore,1976-05-22,Melba Moore - This Is It,41,45,32,32.0,36,This Is It,7.0,2,4,5,4,1,up,1976-05-08
3898,Melba Moore,1976-05-29,Melba Moore - This Is It,36,41,33,32.0,32,This Is It,7.0,3,-1,4,5,1,down,1976-05-08
3899,Melba Moore,1976-06-05,Melba Moore - This Is It,32,36,41,32.0,33,This Is It,7.0,4,-8,-1,4,1,down,1976-05-08
3900,Melba Moore,1976-06-12,Melba Moore - This Is It,33,32,41,32.0,41,This Is It,7.0,5,0,-8,-1,0,stay,1976-05-08
3901,Melba Moore,1976-06-19,Melba Moore - This Is It,41,33,50,32.0,41,This Is It,7.0,6,-9,0,-8,1,down,1976-05-08
3902,Melba Moore,1976-06-26,Melba Moore - This Is It,41,41,51,32.0,50,This Is It,7.0,7,-1,-9,0,1,down,1976-05-08
3903,Gloria Lynne,1976-05-08,Gloria Lynne - I Don't Know How To Love Him,51,51,49,47.0,47,I Don't Know How To Love Him,1.0,0,-2,4,0,1,down,1976-05-08
3904,Gloria Lynne,1976-05-22,Gloria Lynne - I Don't Know How To Love Him,47,51,51,47.0,49,I Don't Know How To Love Him,1.0,1,-2,-2,4,1,down,1976-05-08
3905,Millie Jackson,1976-05-08,Millie Jackson - Free And In Love,51,51,37,17.0,48,Free And In Love,8.0,0,11,3,0,1,up,1976-05-08
3906,Millie Jackson,1976-05-15,Millie Jackson - Free And In Love,48,51,27,17.0,37,Free And In Love,8.0,1,10,11,3,1,up,1976-05-08
3907,Millie Jackson,1976-05-22,Millie Jackson - Free And In Love,37,48,21,17.0,27,Free And In Love,8.0,2,6,10,11,1,up,1976-05-08
3908,Millie Jackson,1976-05-29,Millie Jackson - Free And In Love,27,37,20,17.0,21,Free And In Love,8.0,3,1,6,10,1,up,1976-05-08
3909,Millie Jackson,1976-06-05,Millie Jackson - Free And In Love,21,27,17,17.0,20,Free And In Love,8.0,4,3,1,6,1,up,1976-05-08
3910,Millie Jackson,1976-06-12,Millie Jackson - Free And In Love,20,21,19,17.0,17,Free And In Love,8.0,5,-2,3,1,1,down,1976-05-08
3911,Millie Jackson,1976-06-19,Millie Jackson - Free And In Love,17,20,29,17.0,19,Free And In Love,8.0,6,-10,-2,3,1,down,1976-05-08
3912,Millie Jackson,1976-06-26,Millie Jackson - Free And In Love,19,17,35,17.0,29,Free And In Love,8.0,7,-6,-10,-2,1,down,1976-05-08
3913,Millie Jackson,1976-07-04,Millie Jackson - Free And In Love,29,19,51,17.0,35,Free And In Love,8.0,8,-16,-6,-10,1,down,1976-05-08
3914,Flora Purim,1976-05-08,Flora Purim - Open Your Eyes You Can Fly,51,51,39,38.0,49,Open Your Eyes You Can Fly,3.0,0,10,2,0,1,up,1976-05-08
3915,Flora Purim,1976-05-15,Flora Purim - Open Your Eyes You Can Fly,49,51,38,38.0,39,Open Your Eyes You Can Fly,3.0,1,1,10,2,1,up,1976-05-08
3916,Flora Purim,1976-05-22,Flora Purim - Open Your Eyes You Can Fly,39,49,40,38.0,38,Open Your Eyes You Can Fly,3.0,2,-2,1,10,1,down,1976-05-08
3917,Flora Purim,1976-05-29,Flora Purim - Open Your Eyes You Can Fly,38,39,51,38.0,40,Open Your Eyes You Can Fly,3.0,3,-11,-2,1,1,down,1976-05-08
3918,Nancy Wilson,1976-05-15,Nancy Wilson - This Mother's Daughter,51,51,26,26.0,38,This Mother's Daughter,7.0,0,12,13,0,1,up,1976-05-15
3919,Nancy Wilson,1976-05-22,Nancy Wilson - This Mother's Daughter,38,51,26,26.0,26,This Mother's Daughter,7.0,1,0,12,13,0,stay,1976-05-15
3920,Nancy Wilson,1976-05-29,Nancy Wilson - This Mother's Daughter,26,38,38,26.0,26,This Mother's Daughter,7.0,2,-12,0,12,1,down,1976-05-15
3921,Nancy Wilson,1976-06-05,Nancy Wilson - This Mother's Daughter,26,26,47,26.0,38,This Mother's Daughter,7.0,3,-9,-12,0,1,down,1976-05-15
3922,Nancy Wilson,1976-06-12,Nancy Wilson - This Mother's Daughter,38,26,42,26.0,47,This Mother's Daughter,7.0,4,5,-9,-12,1,up,1976-05-15
3923,Nancy Wilson,1976-06-19,Nancy Wilson - This Mother's Daughter,47,38,49,26.0,42,This Mother's Daughter,7.0,5,-7,5,-9,1,down,1976-05-15
3924,Nancy Wilson,1976-07-31,Nancy Wilson - This Mother's Daughter,42,47,49,26.0,49,This Mother's Daughter,7.0,6,0,-7,5,0,stay,1976-05-15
3925,Nancy Wilson,1976-08-07,Nancy Wilson - This Mother's Daughter,49,42,51,26.0,49,This Mother's Daughter,7.0,7,-2,0,-7,1,down,1976-05-15
3926,The Supremes,1976-05-15,The Supremes - High Energy,51,51,35,24.0,46,High Energy,6.0,0,11,5,0,1,up,1976-05-15
3927,The Supremes,1976-05-22,The Supremes - High Energy,46,51,31,24.0,35,High Energy,6.0,1,4,11,5,1,up,1976-05-15
3928,The Supremes,1976-05-29,The Supremes - High Energy,35,46,25,24.0,31,High Energy,6.0,2,6,4,11,1,up,1976-05-15
3929,The Supremes,1976-06-05,The Supremes - High Energy,31,35,24,24.0,25,High Energy,6.0,3,1,6,4,1,up,1976-05-15
3930,The Supremes,1976-06-12,The Supremes - High Energy,25,31,24,24.0,24,High Energy,6.0,4,0,1,6,0,stay,1976-05-15
3931,The Supremes,1976-06-19,The Supremes - High Energy,24,25,36,24.0,24,High Energy,6.0,5,-12,0,1,1,down,1976-05-15
3932,The Supremes,1976-06-26,The Supremes - High Energy,24,24,51,24.0,36,High Energy,6.0,6,-15,-12,0,1,down,1976-05-15
3933,Van Mccoy,1976-05-15,Van Mccoy - Real Mccoy,51,51,37,22.0,49,Real Mccoy,4.0,0,12,2,0,1,up,1976-05-15
3934,Van Mccoy,1976-05-22,Van Mccoy - Real Mccoy,49,51,29,22.0,37,Real Mccoy,4.0,1,8,12,2,1,up,1976-05-15
3935,Van Mccoy,1976-05-29,Van Mccoy - Real Mccoy,37,49,26,22.0,29,Real Mccoy,4.0,2,3,8,12,1,up,1976-05-15
3936,Van Mccoy,1976-06-05,Van Mccoy - Real Mccoy,29,37,22,22.0,26,Real Mccoy,4.0,3,4,3,8,1,up,1976-05-15
3937,Van Mccoy,1976-06-12,Van Mccoy - Real Mccoy,26,29,51,22.0,22,Real Mccoy,4.0,4,-29,4,3,1,down,1976-05-15
3938,Norman Connors,1976-05-15,Norman Connors - You Are My Starship,51,51,39,5.0,50,You Are My Starship,33.0,0,11,1,0,1,up,1976-05-15
3939,Norman Connors,1976-05-22,Norman Connors - You Are My Starship,50,51,36,5.0,39,You Are My Starship,33.0,1,3,11,1,1,up,1976-05-15
3940,Norman Connors,1976-05-29,Norman Connors - You Are My Starship,39,50,34,5.0,36,You Are My Starship,33.0,2,2,3,11,1,up,1976-05-15
3941,Norman Connors,1976-06-05,Norman Connors - You Are My Starship,36,39,35,5.0,34,You Are My Starship,33.0,3,-1,2,3,1,down,1976-05-15
3942,Norman Connors,1976-06-12,Norman Connors - You Are My Starship,34,36,35,5.0,35,You Are My Starship,33.0,4,0,-1,2,0,stay,1976-05-15
3943,Norman Connors,1976-06-19,Norman Connors - You Are My Starship,35,34,34,5.0,35,You Are My Starship,33.0,5,1,0,-1,1,up,1976-05-15
3944,Norman Connors,1976-06-26,Norman Connors - You Are My Starship,35,35,31,5.0,34,You Are My Starship,33.0,6,3,1,0,1,up,1976-05-15
3945,Norman Connors,1976-07-04,Norman Connors - You Are My Starship,34,35,36,5.0,31,You Are My Starship,33.0,7,-5,3,1,1,down,1976-05-15
3946,Norman Connors,1976-07-10,Norman Connors - You Are My Starship,31,34,39,5.0,36,You Are My Starship,33.0,8,-3,-5,3,1,down,1976-05-15
3947,Norman Connors,1976-07-17,Norman Connors - You Are My Starship,36,31,39,5.0,39,You Are My Starship,33.0,9,0,-3,-5,0,stay,1976-05-15
3948,Norman Connors,1976-07-24,Norman Connors - You Are My Starship,39,36,30,5.0,39,You Are My Starship,33.0,10,9,0,-3,1,up,1976-05-15
3949,Norman Connors,1976-07-31,Norman Connors - You Are My Starship,39,39,24,5.0,30,You Are My Starship,33.0,11,6,9,0,1,up,1976-05-15
3950,Norman Connors,1976-08-07,Norman Connors - You Are My Starship,30,39,18,5.0,24,You Are My Starship,33.0,12,6,6,9,1,up,1976-05-15
3951,Norman Connors,1976-08-14,Norman Connors - You Are My Starship,24,30,14,5.0,18,You Are My Starship,33.0,13,4,6,6,1,up,1976-05-15
3952,Norman Connors,1976-08-21,Norman Connors - You Are My Starship,18,24,12,5.0,14,You Are My Starship,33.0,14,2,4,6,1,up,1976-05-15
3953,Norman Connors,1976-08-28,Norman Connors - You Are My Starship,14,18,9,5.0,12,You Are My Starship,33.0,15,3,2,4,1,up,1976-05-15
3954,Norman Connors,1976-09-04,Norman Connors - You Are My Starship,12,14,8,5.0,9,You Are My Starship,33.0,16,1,3,2,1,up,1976-05-15
3955,Norman Connors,1976-09-11,Norman Connors - You Are My Starship,9,12,8,5.0,8,You Are My Starship,33.0,17,0,1,3,0,stay,1976-05-15
3956,Norman Connors,1976-09-18,Norman Connors - You Are My Starship,8,9,7,5.0,8,You Are My Starship,33.0,18,1,0,1,1,up,1976-05-15
3957,Norman Connors,1976-09-25,Norman Connors - You Are My Starship,8,8,6,5.0,7,You Are My Starship,33.0,19,1,1,0,1,up,1976-05-15
3958,Norman Connors,1976-10-02,Norman Connors - You Are My Starship,7,8,5,5.0,6,You Are My Starship,33.0,20,1,1,1,1,up,1976-05-15
3959,Norman Connors,1976-10-09,Norman Connors - You Are My Starship,6,7,7,5.0,5,You Are My Starship,33.0,21,-2,1,1,1,down,1976-05-15
3960,Norman Connors,1976-10-16,Norman Connors - You Are My Starship,5,6,8,5.0,7,You Are My Starship,33.0,22,-1,-2,1,1,down,1976-05-15
3961,Norman Connors,1976-10-23,Norman Connors - You Are My Starship,7,5,8,5.0,8,You Are My Starship,33.0,23,0,-1,-2,0,stay,1976-05-15
3962,Norman Connors,1976-10-30,Norman Connors - You Are My Starship,8,7,10,5.0,8,You Are My Starship,33.0,24,-2,0,-1,1,down,1976-05-15
3963,Norman Connors,1976-11-06,Norman Connors - You Are My Starship,8,8,11,5.0,10,You Are My Starship,33.0,25,-1,-2,0,1,down,1976-05-15
3964,Norman Connors,1976-11-13,Norman Connors - You Are My Starship,10,8,12,5.0,11,You Are My Starship,33.0,26,-1,-1,-2,1,down,1976-05-15
3965,Norman Connors,1976-11-20,Norman Connors - You Are My Starship,11,10,28,5.0,12,You Are My Starship,33.0,27,-16,-1,-1,1,down,1976-05-15
3966,Norman Connors,1976-11-27,Norman Connors - You Are My Starship,12,11,29,5.0,28,You Are My Starship,33.0,28,-1,-16,-1,1,down,1976-05-15
3967,Norman Connors,1976-12-04,Norman Connors - You Are My Starship,28,12,39,5.0,29,You Are My Starship,33.0,29,-10,-1,-16,1,down,1976-05-15
3968,Norman Connors,1976-12-11,Norman Connors - You Are My Starship,29,28,43,5.0,39,You Are My Starship,33.0,30,-4,-10,-1,1,down,1976-05-15
3969,Norman Connors,1976-12-18,Norman Connors - You Are My Starship,39,29,39,5.0,43,You Are My Starship,33.0,31,4,-4,-10,1,up,1976-05-15
3970,Norman Connors,1976-12-25,Norman Connors - You Are My Starship,43,39,39,5.0,39,You Are My Starship,33.0,32,0,4,-4,0,stay,1976-05-15
3971,Norman Connors,1977-01-01,Norman Connors - You Are My Starship,39,43,51,5.0,39,You Are My Starship,33.0,33,-12,0,4,1,down,1976-05-15
3972,Bob Marley And The Wailers,1976-05-22,Bob Marley And The Wailers - Rastaman Vibration,51,51,22,11.0,28,Rastaman Vibration,15.0,0,6,23,0,1,up,1976-05-22
3973,Bob Marley And The Wailers,1976-05-29,Bob Marley And The Wailers - Rastaman Vibration,28,51,16,11.0,22,Rastaman Vibration,15.0,1,6,6,23,1,up,1976-05-22
3974,Bob Marley And The Wailers,1976-06-05,Bob Marley And The Wailers - Rastaman Vibration,22,28,12,11.0,16,Rastaman Vibration,15.0,2,4,6,6,1,up,1976-05-22
3975,Bob Marley And The Wailers,1976-06-12,Bob Marley And The Wailers - Rastaman Vibration,16,22,11,11.0,12,Rastaman Vibration,15.0,3,1,4,6,1,up,1976-05-22
3976,Bob Marley And The Wailers,1976-06-19,Bob Marley And The Wailers - Rastaman Vibration,12,16,12,11.0,11,Rastaman Vibration,15.0,4,-1,1,4,1,down,1976-05-22
3977,Bob Marley And The Wailers,1976-06-26,Bob Marley And The Wailers - Rastaman Vibration,11,12,12,11.0,12,Rastaman Vibration,15.0,5,0,-1,1,0,stay,1976-05-22
3978,Bob Marley And The Wailers,1976-07-04,Bob Marley And The Wailers - Rastaman Vibration,12,11,15,11.0,12,Rastaman Vibration,15.0,6,-3,0,-1,1,down,1976-05-22
3979,Bob Marley And The Wailers,1976-07-10,Bob Marley And The Wailers - Rastaman Vibration,12,12,15,11.0,15,Rastaman Vibration,15.0,7,0,-3,0,0,stay,1976-05-22
3980,Bob Marley And The Wailers,1976-07-17,Bob Marley And The Wailers - Rastaman Vibration,15,12,15,11.0,15,Rastaman Vibration,15.0,8,0,0,-3,0,stay,1976-05-22
3981,Bob Marley And The Wailers,1976-07-24,Bob Marley And The Wailers - Rastaman Vibration,15,15,24,11.0,15,Rastaman Vibration,15.0,9,-9,0,0,1,down,1976-05-22
3982,Bob Marley And The Wailers,1976-07-31,Bob Marley And The Wailers - Rastaman Vibration,15,15,26,11.0,24,Rastaman Vibration,15.0,10,-2,-9,0,1,down,1976-05-22
3983,Bob Marley And The Wailers,1976-08-07,Bob Marley And The Wailers - Rastaman Vibration,24,15,31,11.0,26,Rastaman Vibration,15.0,11,-5,-2,-9,1,down,1976-05-22
3984,Bob Marley And The Wailers,1976-08-14,Bob Marley And The Wailers - Rastaman Vibration,26,24,38,11.0,31,Rastaman Vibration,15.0,12,-7,-5,-2,1,down,1976-05-22
3985,Bob Marley And The Wailers,1976-08-21,Bob Marley And The Wailers - Rastaman Vibration,31,26,42,11.0,38,Rastaman Vibration,15.0,13,-4,-7,-5,1,down,1976-05-22
3986,Bob Marley And The Wailers,1976-08-28,Bob Marley And The Wailers - Rastaman Vibration,38,31,46,11.0,42,Rastaman Vibration,15.0,14,-4,-4,-7,1,down,1976-05-22
3987,Bob Marley And The Wailers,1976-09-04,Bob Marley And The Wailers - Rastaman Vibration,42,38,51,11.0,46,Rastaman Vibration,15.0,15,-5,-4,-4,1,down,1976-05-22
3988,The Trammps,1976-05-22,The Trammps - Where The Happy People Go,51,51,19,13.0,32,Where The Happy People Go,10.0,0,13,19,0,1,up,1976-05-22
3989,The Trammps,1976-05-29,The Trammps - Where The Happy People Go,32,51,17,13.0,19,Where The Happy People Go,10.0,1,2,13,19,1,up,1976-05-22
3990,The Trammps,1976-06-05,The Trammps - Where The Happy People Go,19,32,13,13.0,17,Where The Happy People Go,10.0,2,4,2,13,1,up,1976-05-22
3991,The Trammps,1976-06-12,The Trammps - Where The Happy People Go,17,19,13,13.0,13,Where The Happy People Go,10.0,3,0,4,2,0,stay,1976-05-22
3992,The Trammps,1976-06-19,The Trammps - Where The Happy People Go,13,17,26,13.0,13,Where The Happy People Go,10.0,4,-13,0,4,1,down,1976-05-22
3993,The Trammps,1976-06-26,The Trammps - Where The Happy People Go,13,13,28,13.0,26,Where The Happy People Go,10.0,5,-2,-13,0,1,down,1976-05-22
3994,The Trammps,1976-07-04,The Trammps - Where The Happy People Go,26,13,35,13.0,28,Where The Happy People Go,10.0,6,-7,-2,-13,1,down,1976-05-22
3995,The Trammps,1976-07-10,The Trammps - Where The Happy People Go,28,26,47,13.0,35,Where The Happy People Go,10.0,7,-12,-7,-2,1,down,1976-05-22
3996,The Trammps,1976-07-17,The Trammps - Where The Happy People Go,35,28,45,13.0,47,Where The Happy People Go,10.0,8,2,-12,-7,1,up,1976-05-22
3997,The Trammps,1976-07-24,The Trammps - Where The Happy People Go,47,35,47,13.0,45,Where The Happy People Go,10.0,9,-2,2,-12,1,down,1976-05-22
3998,The Trammps,1976-07-31,The Trammps - Where The Happy People Go,45,47,51,13.0,47,Where The Happy People Go,10.0,10,-4,-2,2,1,down,1976-05-22
3999,Natalie Cole,1976-05-22,Natalie Cole - Natalie,51,51,30,3.0,40,Natalie,26.0,0,10,11,0,1,up,1976-05-22
4000,Natalie Cole,1976-05-29,Natalie Cole - Natalie,40,51,19,3.0,30,Natalie,26.0,1,11,10,11,1,up,1976-05-22
4001,Natalie Cole,1976-06-05,Natalie Cole - Natalie,30,40,11,3.0,19,Natalie,26.0,2,8,11,10,1,up,1976-05-22
4002,Natalie Cole,1976-06-12,Natalie Cole - Natalie,19,30,7,3.0,11,Natalie,26.0,3,4,8,11,1,up,1976-05-22
4003,Natalie Cole,1976-06-19,Natalie Cole - Natalie,11,19,6,3.0,7,Natalie,26.0,4,1,4,8,1,up,1976-05-22
4004,Natalie Cole,1976-06-26,Natalie Cole - Natalie,7,11,5,3.0,6,Natalie,26.0,5,1,1,4,1,up,1976-05-22
4005,Natalie Cole,1976-07-04,Natalie Cole - Natalie,6,7,3,3.0,5,Natalie,26.0,6,2,1,1,1,up,1976-05-22
4006,Natalie Cole,1976-07-10,Natalie Cole - Natalie,5,6,3,3.0,3,Natalie,26.0,7,0,2,1,0,stay,1976-05-22
4007,Natalie Cole,1976-07-17,Natalie Cole - Natalie,3,5,4,3.0,3,Natalie,26.0,8,-1,0,2,1,down,1976-05-22
4008,Natalie Cole,1976-07-24,Natalie Cole - Natalie,3,3,8,3.0,4,Natalie,26.0,9,-4,-1,0,1,down,1976-05-22
4009,Natalie Cole,1976-07-31,Natalie Cole - Natalie,4,3,8,3.0,8,Natalie,26.0,10,0,-4,-1,0,stay,1976-05-22
4010,Natalie Cole,1976-08-07,Natalie Cole - Natalie,8,4,13,3.0,8,Natalie,26.0,11,-5,0,-4,1,down,1976-05-22
4011,Natalie Cole,1976-08-14,Natalie Cole - Natalie,8,8,16,3.0,13,Natalie,26.0,12,-3,-5,0,1,down,1976-05-22
4012,Natalie Cole,1976-08-21,Natalie Cole - Natalie,13,8,14,3.0,16,Natalie,26.0,13,2,-3,-5,1,up,1976-05-22
4013,Natalie Cole,1976-08-28,Natalie Cole - Natalie,16,13,13,3.0,14,Natalie,26.0,14,1,2,-3,1,up,1976-05-22
4014,Natalie Cole,1976-09-04,Natalie Cole - Natalie,14,16,11,3.0,13,Natalie,26.0,15,2,1,2,1,up,1976-05-22
4015,Natalie Cole,1976-09-11,Natalie Cole - Natalie,13,14,11,3.0,11,Natalie,26.0,16,0,2,1,0,stay,1976-05-22
4016,Natalie Cole,1976-09-18,Natalie Cole - Natalie,11,13,12,3.0,11,Natalie,26.0,17,-1,0,2,1,down,1976-05-22
4017,Natalie Cole,1976-09-25,Natalie Cole - Natalie,11,11,15,3.0,12,Natalie,26.0,18,-3,-1,0,1,down,1976-05-22
4018,Natalie Cole,1976-10-02,Natalie Cole - Natalie,12,11,19,3.0,15,Natalie,26.0,19,-4,-3,-1,1,down,1976-05-22
4019,Natalie Cole,1976-10-09,Natalie Cole - Natalie,15,12,21,3.0,19,Natalie,26.0,20,-2,-4,-3,1,down,1976-05-22
4020,Natalie Cole,1976-10-16,Natalie Cole - Natalie,19,15,33,3.0,21,Natalie,26.0,21,-12,-2,-4,1,down,1976-05-22
4021,Natalie Cole,1976-10-23,Natalie Cole - Natalie,21,19,32,3.0,33,Natalie,26.0,22,1,-12,-2,1,up,1976-05-22
4022,Natalie Cole,1976-10-30,Natalie Cole - Natalie,33,21,29,3.0,32,Natalie,26.0,23,3,1,-12,1,up,1976-05-22
4023,Natalie Cole,1976-11-06,Natalie Cole - Natalie,32,33,39,3.0,29,Natalie,26.0,24,-10,3,1,1,down,1976-05-22
4024,Natalie Cole,1976-11-13,Natalie Cole - Natalie,29,32,49,3.0,39,Natalie,26.0,25,-10,-10,3,1,down,1976-05-22
4025,Natalie Cole,1976-11-20,Natalie Cole - Natalie,39,29,51,3.0,49,Natalie,26.0,26,-2,-10,-10,1,down,1976-05-22
4026,Ramsey Lewis,1976-05-22,Ramsey Lewis - Salongo,51,51,33,17.0,46,Salongo,7.0,0,13,5,0,1,up,1976-05-22
4027,Ramsey Lewis,1976-05-29,Ramsey Lewis - Salongo,46,51,23,17.0,33,Salongo,7.0,1,10,13,5,1,up,1976-05-22
4028,Ramsey Lewis,1976-06-05,Ramsey Lewis - Salongo,33,46,18,17.0,23,Salongo,7.0,2,5,10,13,1,up,1976-05-22
4029,Ramsey Lewis,1976-06-12,Ramsey Lewis - Salongo,23,33,17,17.0,18,Salongo,7.0,3,1,5,10,1,up,1976-05-22
4030,Ramsey Lewis,1976-06-19,Ramsey Lewis - Salongo,18,23,22,17.0,17,Salongo,7.0,4,-5,1,5,1,down,1976-05-22
4031,Ramsey Lewis,1976-06-26,Ramsey Lewis - Salongo,17,18,30,17.0,22,Salongo,7.0,5,-8,-5,1,1,down,1976-05-22
4032,Ramsey Lewis,1976-07-04,Ramsey Lewis - Salongo,22,17,29,17.0,30,Salongo,7.0,6,1,-8,-5,1,up,1976-05-22
4033,Ramsey Lewis,1976-07-10,Ramsey Lewis - Salongo,30,22,51,17.0,29,Salongo,7.0,7,-22,1,-8,1,down,1976-05-22
4034,Alphonso Johnson,1976-05-22,Alphonso Johnson - Moonshadows,51,51,51,47.0,47,Moonshadows,0.0,0,-4,4,0,1,down,1976-05-22
4035,Dee Dee Sharp Gamble,1976-05-22,Dee Dee Sharp Gamble - Happy 'bout The Whole Thing,51,51,48,48.0,48,Happy 'bout The Whole Thing,1.0,0,0,3,0,0,stay,1976-05-22
4036,Dee Dee Sharp Gamble,1976-05-29,Dee Dee Sharp Gamble - Happy 'bout The Whole Thing,48,51,51,48.0,48,Happy 'bout The Whole Thing,1.0,1,-3,0,3,1,down,1976-05-22
4037,The Isley Brothers,1976-05-29,The Isley Brothers - Harvest For The World,51,51,10,1.0,34,Harvest For The World,26.0,0,24,17,0,1,up,1976-05-29
4038,The Isley Brothers,1976-06-05,The Isley Brothers - Harvest For The World,34,51,5,1.0,10,Harvest For The World,26.0,1,5,24,17,1,up,1976-05-29
4039,The Isley Brothers,1976-06-12,The Isley Brothers - Harvest For The World,10,34,2,1.0,5,Harvest For The World,26.0,2,3,5,24,1,up,1976-05-29
4040,The Isley Brothers,1976-06-19,The Isley Brothers - Harvest For The World,5,10,1,1.0,2,Harvest For The World,26.0,3,1,3,5,1,up,1976-05-29
4041,The Isley Brothers,1976-06-26,The Isley Brothers - Harvest For The World,2,5,7,1.0,1,Harvest For The World,26.0,4,-6,1,3,1,down,1976-05-29
4042,The Isley Brothers,1976-07-04,The Isley Brothers - Harvest For The World,1,2,7,1.0,7,Harvest For The World,26.0,5,0,-6,1,0,stay,1976-05-29
4043,The Isley Brothers,1976-07-10,The Isley Brothers - Harvest For The World,7,1,7,1.0,7,Harvest For The World,26.0,6,0,0,-6,0,stay,1976-05-29
4044,The Isley Brothers,1976-07-17,The Isley Brothers - Harvest For The World,7,7,6,1.0,7,Harvest For The World,26.0,7,1,0,0,1,up,1976-05-29
4045,The Isley Brothers,1976-07-24,The Isley Brothers - Harvest For The World,7,7,5,1.0,6,Harvest For The World,26.0,8,1,1,0,1,up,1976-05-29
4046,The Isley Brothers,1976-07-31,The Isley Brothers - Harvest For The World,6,7,5,1.0,5,Harvest For The World,26.0,9,0,1,1,0,stay,1976-05-29
4047,The Isley Brothers,1976-08-07,The Isley Brothers - Harvest For The World,5,6,6,1.0,5,Harvest For The World,26.0,10,-1,0,1,1,down,1976-05-29
4048,The Isley Brothers,1976-08-14,The Isley Brothers - Harvest For The World,5,5,6,1.0,6,Harvest For The World,26.0,11,0,-1,0,0,stay,1976-05-29
4049,The Isley Brothers,1976-08-21,The Isley Brothers - Harvest For The World,6,5,6,1.0,6,Harvest For The World,26.0,12,0,0,-1,0,stay,1976-05-29
4050,The Isley Brothers,1976-08-28,The Isley Brothers - Harvest For The World,6,6,7,1.0,6,Harvest For The World,26.0,13,-1,0,0,1,down,1976-05-29
4051,The Isley Brothers,1976-09-04,The Isley Brothers - Harvest For The World,6,6,9,1.0,7,Harvest For The World,26.0,14,-2,-1,0,1,down,1976-05-29
4052,The Isley Brothers,1976-09-11,The Isley Brothers - Harvest For The World,7,6,15,1.0,9,Harvest For The World,26.0,15,-6,-2,-1,1,down,1976-05-29
4053,The Isley Brothers,1976-09-18,The Isley Brothers - Harvest For The World,9,7,18,1.0,15,Harvest For The World,26.0,16,-3,-6,-2,1,down,1976-05-29
4054,The Isley Brothers,1976-09-25,The Isley Brothers - Harvest For The World,15,9,18,1.0,18,Harvest For The World,26.0,17,0,-3,-6,0,stay,1976-05-29
4055,The Isley Brothers,1976-10-02,The Isley Brothers - Harvest For The World,18,15,21,1.0,18,Harvest For The World,26.0,18,-3,0,-3,1,down,1976-05-29
4056,The Isley Brothers,1976-10-09,The Isley Brothers - Harvest For The World,18,18,26,1.0,21,Harvest For The World,26.0,19,-5,-3,0,1,down,1976-05-29
4057,The Isley Brothers,1976-10-16,The Isley Brothers - Harvest For The World,21,18,26,1.0,26,Harvest For The World,26.0,20,0,-5,-3,0,stay,1976-05-29
4058,The Isley Brothers,1976-10-23,The Isley Brothers - Harvest For The World,26,21,29,1.0,26,Harvest For The World,26.0,21,-3,0,-5,1,down,1976-05-29
4059,The Isley Brothers,1976-10-30,The Isley Brothers - Harvest For The World,26,26,25,1.0,29,Harvest For The World,26.0,22,4,-3,0,1,up,1976-05-29
4060,The Isley Brothers,1976-11-06,The Isley Brothers - Harvest For The World,29,26,26,1.0,25,Harvest For The World,26.0,23,-1,4,-3,1,down,1976-05-29
4061,The Isley Brothers,1976-11-13,The Isley Brothers - Harvest For The World,25,29,48,1.0,26,Harvest For The World,26.0,24,-22,-1,4,1,down,1976-05-29
4062,The Isley Brothers,1976-11-20,The Isley Brothers - Harvest For The World,26,25,48,1.0,48,Harvest For The World,26.0,25,0,-22,-1,0,stay,1976-05-29
4063,The Isley Brothers,1976-11-27,The Isley Brothers - Harvest For The World,48,26,51,1.0,48,Harvest For The World,26.0,26,-3,0,-22,1,down,1976-05-29
4064,Dorothy Moore,1976-05-29,Dorothy Moore - Misty Blue,51,51,21,10.0,41,Misty Blue,17.0,0,20,10,0,1,up,1976-05-29
4065,Dorothy Moore,1976-06-05,Dorothy Moore - Misty Blue,41,51,15,10.0,21,Misty Blue,17.0,1,6,20,10,1,up,1976-05-29
4066,Dorothy Moore,1976-06-12,Dorothy Moore - Misty Blue,21,41,10,10.0,15,Misty Blue,17.0,2,5,6,20,1,up,1976-05-29
4067,Dorothy Moore,1976-06-19,Dorothy Moore - Misty Blue,15,21,10,10.0,10,Misty Blue,17.0,3,0,5,6,0,stay,1976-05-29
4068,Dorothy Moore,1976-06-26,Dorothy Moore - Misty Blue,10,15,20,10.0,10,Misty Blue,17.0,4,-10,0,5,1,down,1976-05-29
4069,Dorothy Moore,1976-07-04,Dorothy Moore - Misty Blue,10,10,18,10.0,20,Misty Blue,17.0,5,2,-10,0,1,up,1976-05-29
4070,Dorothy Moore,1976-07-10,Dorothy Moore - Misty Blue,20,10,18,10.0,18,Misty Blue,17.0,6,0,2,-10,0,stay,1976-05-29
4071,Dorothy Moore,1976-07-17,Dorothy Moore - Misty Blue,18,20,28,10.0,18,Misty Blue,17.0,7,-10,0,2,1,down,1976-05-29
4072,Dorothy Moore,1976-07-24,Dorothy Moore - Misty Blue,18,18,29,10.0,28,Misty Blue,17.0,8,-1,-10,0,1,down,1976-05-29
4073,Dorothy Moore,1976-07-31,Dorothy Moore - Misty Blue,28,18,31,10.0,29,Misty Blue,17.0,9,-2,-1,-10,1,down,1976-05-29
4074,Dorothy Moore,1976-08-07,Dorothy Moore - Misty Blue,29,28,33,10.0,31,Misty Blue,17.0,10,-2,-2,-1,1,down,1976-05-29
4075,Dorothy Moore,1976-08-14,Dorothy Moore - Misty Blue,31,29,39,10.0,33,Misty Blue,17.0,11,-6,-2,-2,1,down,1976-05-29
4076,Dorothy Moore,1976-08-21,Dorothy Moore - Misty Blue,33,31,38,10.0,39,Misty Blue,17.0,12,1,-6,-2,1,up,1976-05-29
4077,Dorothy Moore,1976-08-28,Dorothy Moore - Misty Blue,39,33,32,10.0,38,Misty Blue,17.0,13,6,1,-6,1,up,1976-05-29
4078,Dorothy Moore,1976-09-04,Dorothy Moore - Misty Blue,38,39,32,10.0,32,Misty Blue,17.0,14,0,6,1,0,stay,1976-05-29
4079,Dorothy Moore,1976-09-11,Dorothy Moore - Misty Blue,32,38,36,10.0,32,Misty Blue,17.0,15,-4,0,6,1,down,1976-05-29
4080,Dorothy Moore,1976-09-18,Dorothy Moore - Misty Blue,32,32,44,10.0,36,Misty Blue,17.0,16,-8,-4,0,1,down,1976-05-29
4081,Dorothy Moore,1976-09-25,Dorothy Moore - Misty Blue,36,32,51,10.0,44,Misty Blue,17.0,17,-7,-8,-4,1,down,1976-05-29
4082,Brother To Brother,1976-05-29,Brother To Brother - Let Your Mind Be Free,51,51,36,33.0,44,Let Your Mind Be Free,7.0,0,8,7,0,1,up,1976-05-29
4083,Brother To Brother,1976-06-05,Brother To Brother - Let Your Mind Be Free,44,51,36,33.0,36,Let Your Mind Be Free,7.0,1,0,8,7,0,stay,1976-05-29
4084,Brother To Brother,1976-06-12,Brother To Brother - Let Your Mind Be Free,36,44,36,33.0,36,Let Your Mind Be Free,7.0,2,0,0,8,0,stay,1976-05-29
4085,Brother To Brother,1976-06-19,Brother To Brother - Let Your Mind Be Free,36,36,33,33.0,36,Let Your Mind Be Free,7.0,3,3,0,0,1,up,1976-05-29
4086,Brother To Brother,1976-06-26,Brother To Brother - Let Your Mind Be Free,36,36,50,33.0,33,Let Your Mind Be Free,7.0,4,-17,3,0,1,down,1976-05-29
4087,Brother To Brother,1976-07-10,Brother To Brother - Let Your Mind Be Free,33,36,46,33.0,50,Let Your Mind Be Free,7.0,5,4,-17,3,1,up,1976-05-29
4088,Brother To Brother,1976-07-17,Brother To Brother - Let Your Mind Be Free,50,33,48,33.0,46,Let Your Mind Be Free,7.0,6,-2,4,-17,1,down,1976-05-29
4089,Brother To Brother,1976-07-24,Brother To Brother - Let Your Mind Be Free,46,50,51,33.0,48,Let Your Mind Be Free,7.0,7,-3,-2,4,1,down,1976-05-29
4090,The Crusaders,1976-05-29,The Crusaders - Those Southern Knights,51,51,30,9.0,45,Those Southern Knights,16.0,0,15,6,0,1,up,1976-05-29
4091,The Crusaders,1976-06-05,The Crusaders - Those Southern Knights,45,51,19,9.0,30,Those Southern Knights,16.0,1,11,15,6,1,up,1976-05-29
4092,The Crusaders,1976-06-12,The Crusaders - Those Southern Knights,30,45,15,9.0,19,Those Southern Knights,16.0,2,4,11,15,1,up,1976-05-29
4093,The Crusaders,1976-06-19,The Crusaders - Those Southern Knights,19,30,13,9.0,15,Those Southern Knights,16.0,3,2,4,11,1,up,1976-05-29
4094,The Crusaders,1976-06-26,The Crusaders - Those Southern Knights,15,19,11,9.0,13,Those Southern Knights,16.0,4,2,2,4,1,up,1976-05-29
4095,The Crusaders,1976-07-04,The Crusaders - Those Southern Knights,13,15,10,9.0,11,Those Southern Knights,16.0,5,1,2,2,1,up,1976-05-29
4096,The Crusaders,1976-07-10,The Crusaders - Those Southern Knights,11,13,9,9.0,10,Those Southern Knights,16.0,6,1,1,2,1,up,1976-05-29
4097,The Crusaders,1976-07-17,The Crusaders - Those Southern Knights,10,11,24,9.0,9,Those Southern Knights,16.0,7,-15,1,1,1,down,1976-05-29
4098,The Crusaders,1976-07-24,The Crusaders - Those Southern Knights,9,10,21,9.0,24,Those Southern Knights,16.0,8,3,-15,1,1,up,1976-05-29
4099,The Crusaders,1976-07-31,The Crusaders - Those Southern Knights,24,9,20,9.0,21,Those Southern Knights,16.0,9,1,3,-15,1,up,1976-05-29
4100,The Crusaders,1976-08-07,The Crusaders - Those Southern Knights,21,24,23,9.0,20,Those Southern Knights,16.0,10,-3,1,3,1,down,1976-05-29
4101,The Crusaders,1976-08-14,The Crusaders - Those Southern Knights,20,21,23,9.0,23,Those Southern Knights,16.0,11,0,-3,1,0,stay,1976-05-29
4102,The Crusaders,1976-08-21,The Crusaders - Those Southern Knights,23,20,23,9.0,23,Those Southern Knights,16.0,12,0,0,-3,0,stay,1976-05-29
4103,The Crusaders,1976-08-28,The Crusaders - Those Southern Knights,23,23,30,9.0,23,Those Southern Knights,16.0,13,-7,0,0,1,down,1976-05-29
4104,The Crusaders,1976-09-04,The Crusaders - Those Southern Knights,23,23,43,9.0,30,Those Southern Knights,16.0,14,-13,-7,0,1,down,1976-05-29
4105,The Crusaders,1976-09-11,The Crusaders - Those Southern Knights,30,23,47,9.0,43,Those Southern Knights,16.0,15,-4,-13,-7,1,down,1976-05-29
4106,The Crusaders,1976-09-18,The Crusaders - Those Southern Knights,43,30,51,9.0,47,Those Southern Knights,16.0,16,-4,-4,-13,1,down,1976-05-29
4107,John Handy,1976-05-29,John Handy - Hard Work,51,51,39,10.0,46,Hard Work,17.0,0,7,5,0,1,up,1976-05-29
4108,John Handy,1976-06-05,John Handy - Hard Work,46,51,25,10.0,39,Hard Work,17.0,1,14,7,5,1,up,1976-05-29
4109,John Handy,1976-06-12,John Handy - Hard Work,39,46,21,10.0,25,Hard Work,17.0,2,4,14,7,1,up,1976-05-29
4110,John Handy,1976-06-19,John Handy - Hard Work,25,39,17,10.0,21,Hard Work,17.0,3,4,4,14,1,up,1976-05-29
4111,John Handy,1976-06-26,John Handy - Hard Work,21,25,15,10.0,17,Hard Work,17.0,4,2,4,4,1,up,1976-05-29
4112,John Handy,1976-07-04,John Handy - Hard Work,17,21,12,10.0,15,Hard Work,17.0,5,3,2,4,1,up,1976-05-29
4113,John Handy,1976-07-10,John Handy - Hard Work,15,17,11,10.0,12,Hard Work,17.0,6,1,3,2,1,up,1976-05-29
4114,John Handy,1976-07-17,John Handy - Hard Work,12,15,10,10.0,11,Hard Work,17.0,7,1,1,3,1,up,1976-05-29
4115,John Handy,1976-07-24,John Handy - Hard Work,11,12,15,10.0,10,Hard Work,17.0,8,-5,1,1,1,down,1976-05-29
4116,John Handy,1976-07-31,John Handy - Hard Work,10,11,15,10.0,15,Hard Work,17.0,9,0,-5,1,0,stay,1976-05-29
4117,John Handy,1976-08-07,John Handy - Hard Work,15,10,19,10.0,15,Hard Work,17.0,10,-4,0,-5,1,down,1976-05-29
4118,John Handy,1976-08-14,John Handy - Hard Work,15,15,19,10.0,19,Hard Work,17.0,11,0,-4,0,0,stay,1976-05-29
4119,John Handy,1976-08-21,John Handy - Hard Work,19,15,22,10.0,19,Hard Work,17.0,12,-3,0,-4,1,down,1976-05-29
4120,John Handy,1976-08-28,John Handy - Hard Work,19,19,29,10.0,22,Hard Work,17.0,13,-7,-3,0,1,down,1976-05-29
4121,John Handy,1976-09-04,John Handy - Hard Work,22,19,33,10.0,29,Hard Work,17.0,14,-4,-7,-3,1,down,1976-05-29
4122,John Handy,1976-09-11,John Handy - Hard Work,29,22,37,10.0,33,Hard Work,17.0,15,-4,-4,-7,1,down,1976-05-29
4123,John Handy,1976-09-18,John Handy - Hard Work,33,29,43,10.0,37,Hard Work,17.0,16,-6,-4,-4,1,down,1976-05-29
4124,John Handy,1976-09-25,John Handy - Hard Work,37,33,51,10.0,43,Hard Work,17.0,17,-8,-6,-4,1,down,1976-05-29
4125,Tower Of Power,1976-05-29,Tower Of Power - Live And In Living Color,51,51,35,29.0,47,Live And In Living Color,5.0,0,12,4,0,1,up,1976-05-29
4126,Tower Of Power,1976-06-05,Tower Of Power - Live And In Living Color,47,51,30,29.0,35,Live And In Living Color,5.0,1,5,12,4,1,up,1976-05-29
4127,Tower Of Power,1976-06-12,Tower Of Power - Live And In Living Color,35,47,29,29.0,30,Live And In Living Color,5.0,2,1,5,12,1,up,1976-05-29
4128,Tower Of Power,1976-06-19,Tower Of Power - Live And In Living Color,30,35,30,29.0,29,Live And In Living Color,5.0,3,-1,1,5,1,down,1976-05-29
4129,Tower Of Power,1976-06-26,Tower Of Power - Live And In Living Color,29,30,34,29.0,30,Live And In Living Color,5.0,4,-4,-1,1,1,down,1976-05-29
4130,Tower Of Power,1976-07-04,Tower Of Power - Live And In Living Color,30,29,51,29.0,34,Live And In Living Color,5.0,5,-17,-4,-1,1,down,1976-05-29
4131,B.T. Express,1976-06-05,B.T. Express - Energy To Burn,51,51,16,11.0,28,Energy To Burn,15.0,0,12,23,0,1,up,1976-06-05
4132,B.T. Express,1976-06-12,B.T. Express - Energy To Burn,28,51,12,11.0,16,Energy To Burn,15.0,1,4,12,23,1,up,1976-06-05
4133,B.T. Express,1976-06-19,B.T. Express - Energy To Burn,16,28,11,11.0,12,Energy To Burn,15.0,2,1,4,12,1,up,1976-06-05
4134,B.T. Express,1976-06-26,B.T. Express - Energy To Burn,12,16,21,11.0,11,Energy To Burn,15.0,3,-10,1,4,1,down,1976-06-05
4135,B.T. Express,1976-07-04,B.T. Express - Energy To Burn,11,12,24,11.0,21,Energy To Burn,15.0,4,-3,-10,1,1,down,1976-06-05
4136,B.T. Express,1976-07-10,B.T. Express - Energy To Burn,21,11,30,11.0,24,Energy To Burn,15.0,5,-6,-3,-10,1,down,1976-06-05
4137,B.T. Express,1976-07-17,B.T. Express - Energy To Burn,24,21,29,11.0,30,Energy To Burn,15.0,6,1,-6,-3,1,up,1976-06-05
4138,B.T. Express,1976-07-24,B.T. Express - Energy To Burn,30,24,33,11.0,29,Energy To Burn,15.0,7,-4,1,-6,1,down,1976-06-05
4139,B.T. Express,1976-07-31,B.T. Express - Energy To Burn,29,30,33,11.0,33,Energy To Burn,15.0,8,0,-4,1,0,stay,1976-06-05
4140,B.T. Express,1976-08-07,B.T. Express - Energy To Burn,33,29,35,11.0,33,Energy To Burn,15.0,9,-2,0,-4,1,down,1976-06-05
4141,B.T. Express,1976-08-14,B.T. Express - Energy To Burn,33,33,41,11.0,35,Energy To Burn,15.0,10,-6,-2,0,1,down,1976-06-05
4142,B.T. Express,1976-08-21,B.T. Express - Energy To Burn,35,33,39,11.0,41,Energy To Burn,15.0,11,2,-6,-2,1,up,1976-06-05
4143,B.T. Express,1976-08-28,B.T. Express - Energy To Burn,41,35,36,11.0,39,Energy To Burn,15.0,12,3,2,-6,1,up,1976-06-05
4144,B.T. Express,1976-09-04,B.T. Express - Energy To Burn,39,41,42,11.0,36,Energy To Burn,15.0,13,-6,3,2,1,down,1976-06-05
4145,B.T. Express,1976-09-11,B.T. Express - Energy To Burn,36,39,44,11.0,42,Energy To Burn,15.0,14,-2,-6,3,1,down,1976-06-05
4146,B.T. Express,1976-09-18,B.T. Express - Energy To Burn,42,36,51,11.0,44,Energy To Burn,15.0,15,-7,-2,-6,1,down,1976-06-05
4147,David Ruffin,1976-06-05,David Ruffin - Everything's Coming Up Love,51,51,34,16.0,41,Everything's Coming Up Love,10.0,0,7,10,0,1,up,1976-06-05
4148,David Ruffin,1976-06-12,David Ruffin - Everything's Coming Up Love,41,51,26,16.0,34,Everything's Coming Up Love,10.0,1,8,7,10,1,up,1976-06-05
4149,David Ruffin,1976-06-19,David Ruffin - Everything's Coming Up Love,34,41,20,16.0,26,Everything's Coming Up Love,10.0,2,6,8,7,1,up,1976-06-05
4150,David Ruffin,1976-06-26,David Ruffin - Everything's Coming Up Love,26,34,16,16.0,20,Everything's Coming Up Love,10.0,3,4,6,8,1,up,1976-06-05
4151,David Ruffin,1976-07-04,David Ruffin - Everything's Coming Up Love,20,26,16,16.0,16,Everything's Coming Up Love,10.0,4,0,4,6,0,stay,1976-06-05
4152,David Ruffin,1976-07-10,David Ruffin - Everything's Coming Up Love,16,20,16,16.0,16,Everything's Coming Up Love,10.0,5,0,0,4,0,stay,1976-06-05
4153,David Ruffin,1976-07-17,David Ruffin - Everything's Coming Up Love,16,16,36,16.0,16,Everything's Coming Up Love,10.0,6,-20,0,0,1,down,1976-06-05
4154,David Ruffin,1976-07-24,David Ruffin - Everything's Coming Up Love,16,16,36,16.0,36,Everything's Coming Up Love,10.0,7,0,-20,0,0,stay,1976-06-05
4155,David Ruffin,1976-07-31,David Ruffin - Everything's Coming Up Love,36,16,39,16.0,36,Everything's Coming Up Love,10.0,8,-3,0,-20,1,down,1976-06-05
4156,David Ruffin,1976-08-07,David Ruffin - Everything's Coming Up Love,36,36,41,16.0,39,Everything's Coming Up Love,10.0,9,-2,-3,0,1,down,1976-06-05
4157,David Ruffin,1976-08-14,David Ruffin - Everything's Coming Up Love,39,36,51,16.0,41,Everything's Coming Up Love,10.0,10,-10,-2,-3,1,down,1976-06-05
4158,Bill Cosby,1976-06-05,"Bill Cosby - Bill Cosby Is Not Himself These Days-rat Own, Rat",51,51,33,23.0,44,"Bill Cosby Is Not Himself These Days-rat Own, Rat",6.0,0,11,7,0,1,up,1976-06-05
4159,Bill Cosby,1976-06-12,"Bill Cosby - Bill Cosby Is Not Himself These Days-rat Own, Rat",44,51,25,23.0,33,"Bill Cosby Is Not Himself These Days-rat Own, Rat",6.0,1,8,11,7,1,up,1976-06-05
4160,Bill Cosby,1976-06-19,"Bill Cosby - Bill Cosby Is Not Himself These Days-rat Own, Rat",33,44,23,23.0,25,"Bill Cosby Is Not Himself These Days-rat Own, Rat",6.0,2,2,8,11,1,up,1976-06-05
4161,Bill Cosby,1976-06-26,"Bill Cosby - Bill Cosby Is Not Himself These Days-rat Own, Rat",25,33,24,23.0,23,"Bill Cosby Is Not Himself These Days-rat Own, Rat",6.0,3,-1,2,8,1,down,1976-06-05
4162,Bill Cosby,1976-07-04,"Bill Cosby - Bill Cosby Is Not Himself These Days-rat Own, Rat",23,25,25,23.0,24,"Bill Cosby Is Not Himself These Days-rat Own, Rat",6.0,4,-1,-1,2,1,down,1976-06-05
4163,Bill Cosby,1976-07-10,"Bill Cosby - Bill Cosby Is Not Himself These Days-rat Own, Rat",24,23,49,23.0,25,"Bill Cosby Is Not Himself These Days-rat Own, Rat",6.0,5,-24,-1,-1,1,down,1976-06-05
4164,Bill Cosby,1976-07-17,"Bill Cosby - Bill Cosby Is Not Himself These Days-rat Own, Rat",25,24,51,23.0,49,"Bill Cosby Is Not Himself These Days-rat Own, Rat",6.0,6,-2,-24,-1,1,down,1976-06-05
4165,Pleasure,1976-06-05,Pleasure - Accept No Substitutes,51,51,43,32.0,47,Accept No Substitutes,13.0,0,4,4,0,1,up,1976-06-05
4166,Pleasure,1976-06-12,Pleasure - Accept No Substitutes,47,51,43,32.0,43,Accept No Substitutes,13.0,1,0,4,4,0,stay,1976-06-05
4167,Pleasure,1976-06-19,Pleasure - Accept No Substitutes,43,47,50,32.0,43,Accept No Substitutes,13.0,2,-7,0,4,1,down,1976-06-05
4168,Pleasure,1976-07-04,Pleasure - Accept No Substitutes,43,43,40,32.0,50,Accept No Substitutes,13.0,3,10,-7,0,1,up,1976-06-05
4169,Pleasure,1976-07-10,Pleasure - Accept No Substitutes,50,43,35,32.0,40,Accept No Substitutes,13.0,4,5,10,-7,1,up,1976-06-05
4170,Pleasure,1976-07-17,Pleasure - Accept No Substitutes,40,50,34,32.0,35,Accept No Substitutes,13.0,5,1,5,10,1,up,1976-06-05
4171,Pleasure,1976-07-24,Pleasure - Accept No Substitutes,35,40,32,32.0,34,Accept No Substitutes,13.0,6,2,1,5,1,up,1976-06-05
4172,Pleasure,1976-07-31,Pleasure - Accept No Substitutes,34,35,36,32.0,32,Accept No Substitutes,13.0,7,-4,2,1,1,down,1976-06-05
4173,Pleasure,1976-08-07,Pleasure - Accept No Substitutes,32,34,36,32.0,36,Accept No Substitutes,13.0,8,0,-4,2,0,stay,1976-06-05
4174,Pleasure,1976-08-14,Pleasure - Accept No Substitutes,36,32,46,32.0,36,Accept No Substitutes,13.0,9,-10,0,-4,1,down,1976-06-05
4175,Pleasure,1976-08-21,Pleasure - Accept No Substitutes,36,36,47,32.0,46,Accept No Substitutes,13.0,10,-1,-10,0,1,down,1976-06-05
4176,Pleasure,1976-08-28,Pleasure - Accept No Substitutes,46,36,50,32.0,47,Accept No Substitutes,13.0,11,-3,-1,-10,1,down,1976-06-05
4177,Pleasure,1976-09-04,Pleasure - Accept No Substitutes,47,46,49,32.0,50,Accept No Substitutes,13.0,12,1,-3,-1,1,up,1976-06-05
4178,Pleasure,1976-10-02,Pleasure - Accept No Substitutes,50,47,51,32.0,49,Accept No Substitutes,13.0,13,-2,1,-3,1,down,1976-06-05
4179,Coke Escovedo,1976-06-05,Coke Escovedo - Comin' At Ya,51,51,37,37.0,48,Comin' At Ya,2.0,0,11,3,0,1,up,1976-06-05
4180,Coke Escovedo,1976-06-12,Coke Escovedo - Comin' At Ya,48,51,37,37.0,37,Comin' At Ya,2.0,1,0,11,3,0,stay,1976-06-05
4181,Coke Escovedo,1976-06-19,Coke Escovedo - Comin' At Ya,37,48,51,37.0,37,Comin' At Ya,2.0,2,-14,0,11,1,down,1976-06-05
4182,Muscle Shoals Horns,1976-06-05,Muscle Shoals Horns - Born To Get Down,51,51,39,26.0,50,Born To Get Down,10.0,0,11,1,0,1,up,1976-06-05
4183,Muscle Shoals Horns,1976-06-12,Muscle Shoals Horns - Born To Get Down,50,51,31,26.0,39,Born To Get Down,10.0,1,8,11,1,1,up,1976-06-05
4184,Muscle Shoals Horns,1976-06-19,Muscle Shoals Horns - Born To Get Down,39,50,28,26.0,31,Born To Get Down,10.0,2,3,8,11,1,up,1976-06-05
4185,Muscle Shoals Horns,1976-06-26,Muscle Shoals Horns - Born To Get Down,31,39,26,26.0,28,Born To Get Down,10.0,3,2,3,8,1,up,1976-06-05
4186,Muscle Shoals Horns,1976-07-04,Muscle Shoals Horns - Born To Get Down,28,31,26,26.0,26,Born To Get Down,10.0,4,0,2,3,0,stay,1976-06-05
4187,Muscle Shoals Horns,1976-07-10,Muscle Shoals Horns - Born To Get Down,26,28,28,26.0,26,Born To Get Down,10.0,5,-2,0,2,1,down,1976-06-05
4188,Muscle Shoals Horns,1976-07-17,Muscle Shoals Horns - Born To Get Down,26,26,30,26.0,28,Born To Get Down,10.0,6,-2,-2,0,1,down,1976-06-05
4189,Muscle Shoals Horns,1976-07-24,Muscle Shoals Horns - Born To Get Down,28,26,43,26.0,30,Born To Get Down,10.0,7,-13,-2,-2,1,down,1976-06-05
4190,Muscle Shoals Horns,1976-07-31,Muscle Shoals Horns - Born To Get Down,30,28,43,26.0,43,Born To Get Down,10.0,8,0,-13,-2,0,stay,1976-06-05
4191,Muscle Shoals Horns,1976-08-07,Muscle Shoals Horns - Born To Get Down,43,30,45,26.0,43,Born To Get Down,10.0,9,-2,0,-13,1,down,1976-06-05
4192,Muscle Shoals Horns,1976-08-14,Muscle Shoals Horns - Born To Get Down,43,43,51,26.0,45,Born To Get Down,10.0,10,-6,-2,0,1,down,1976-06-05
4193,Ohio Players,1976-06-12,Ohio Players - Contradiction,51,51,9,1.0,23,Contradiction,19.0,0,14,28,0,1,up,1976-06-12
4194,Ohio Players,1976-06-19,Ohio Players - Contradiction,23,51,5,1.0,9,Contradiction,19.0,1,4,14,28,1,up,1976-06-12
4195,Ohio Players,1976-06-26,Ohio Players - Contradiction,9,23,3,1.0,5,Contradiction,19.0,2,2,4,14,1,up,1976-06-12
4196,Ohio Players,1976-07-04,Ohio Players - Contradiction,5,9,2,1.0,3,Contradiction,19.0,3,1,2,4,1,up,1976-06-12
4197,Ohio Players,1976-07-10,Ohio Players - Contradiction,3,5,2,1.0,2,Contradiction,19.0,4,0,1,2,0,stay,1976-06-12
4198,Ohio Players,1976-07-17,Ohio Players - Contradiction,2,3,1,1.0,2,Contradiction,19.0,5,1,0,1,1,up,1976-06-12
4199,Ohio Players,1976-07-24,Ohio Players - Contradiction,2,2,2,1.0,1,Contradiction,19.0,6,-1,1,0,1,down,1976-06-12
4200,Ohio Players,1976-07-31,Ohio Players - Contradiction,1,2,9,1.0,2,Contradiction,19.0,7,-7,-1,1,1,down,1976-06-12
4201,Ohio Players,1976-08-07,Ohio Players - Contradiction,2,1,8,1.0,9,Contradiction,19.0,8,1,-7,-1,1,up,1976-06-12
4202,Ohio Players,1976-08-14,Ohio Players - Contradiction,9,2,7,1.0,8,Contradiction,19.0,9,1,1,-7,1,up,1976-06-12
4203,Ohio Players,1976-08-21,Ohio Players - Contradiction,8,9,8,1.0,7,Contradiction,19.0,10,-1,1,1,1,down,1976-06-12
4204,Ohio Players,1976-08-28,Ohio Players - Contradiction,7,8,11,1.0,8,Contradiction,19.0,11,-3,-1,1,1,down,1976-06-12
4205,Ohio Players,1976-09-04,Ohio Players - Contradiction,8,7,12,1.0,11,Contradiction,19.0,12,-1,-3,-1,1,down,1976-06-12
4206,Ohio Players,1976-09-11,Ohio Players - Contradiction,11,8,19,1.0,12,Contradiction,19.0,13,-7,-1,-3,1,down,1976-06-12
4207,Ohio Players,1976-09-18,Ohio Players - Contradiction,12,11,24,1.0,19,Contradiction,19.0,14,-5,-7,-1,1,down,1976-06-12
4208,Ohio Players,1976-09-25,Ohio Players - Contradiction,19,12,35,1.0,24,Contradiction,19.0,15,-11,-5,-7,1,down,1976-06-12
4209,Ohio Players,1976-10-02,Ohio Players - Contradiction,24,19,36,1.0,35,Contradiction,19.0,16,-1,-11,-5,1,down,1976-06-12
4210,Ohio Players,1976-10-09,Ohio Players - Contradiction,35,24,36,1.0,36,Contradiction,19.0,17,0,-1,-11,0,stay,1976-06-12
4211,Ohio Players,1976-10-16,Ohio Players - Contradiction,36,35,47,1.0,36,Contradiction,19.0,18,-11,0,-1,1,down,1976-06-12
4212,Ohio Players,1976-10-23,Ohio Players - Contradiction,36,36,51,1.0,47,Contradiction,19.0,19,-4,-11,0,1,down,1976-06-12
4213,Lou Rawls,1976-06-12,Lou Rawls - All Things In Time,51,51,18,1.0,32,All Things In Time,26.0,0,14,19,0,1,up,1976-06-12
4214,Lou Rawls,1976-06-19,Lou Rawls - All Things In Time,32,51,15,1.0,18,All Things In Time,26.0,1,3,14,19,1,up,1976-06-12
4215,Lou Rawls,1976-06-26,Lou Rawls - All Things In Time,18,32,10,1.0,15,All Things In Time,26.0,2,5,3,14,1,up,1976-06-12
4216,Lou Rawls,1976-07-04,Lou Rawls - All Things In Time,15,18,9,1.0,10,All Things In Time,26.0,3,1,5,3,1,up,1976-06-12
4217,Lou Rawls,1976-07-10,Lou Rawls - All Things In Time,10,15,8,1.0,9,All Things In Time,26.0,4,1,1,5,1,up,1976-06-12
4218,Lou Rawls,1976-07-17,Lou Rawls - All Things In Time,9,10,7,1.0,8,All Things In Time,26.0,5,1,1,1,1,up,1976-06-12
4219,Lou Rawls,1976-07-24,Lou Rawls - All Things In Time,8,9,6,1.0,7,All Things In Time,26.0,6,1,1,1,1,up,1976-06-12
4220,Lou Rawls,1976-07-31,Lou Rawls - All Things In Time,7,8,3,1.0,6,All Things In Time,26.0,7,3,1,1,1,up,1976-06-12
4221,Lou Rawls,1976-08-07,Lou Rawls - All Things In Time,6,7,2,1.0,3,All Things In Time,26.0,8,1,3,1,1,up,1976-06-12
4222,Lou Rawls,1976-08-14,Lou Rawls - All Things In Time,3,6,1,1.0,2,All Things In Time,26.0,9,1,1,3,1,up,1976-06-12
4223,Lou Rawls,1976-08-21,Lou Rawls - All Things In Time,2,3,3,1.0,1,All Things In Time,26.0,10,-2,1,1,1,down,1976-06-12
4224,Lou Rawls,1976-08-28,Lou Rawls - All Things In Time,1,2,3,1.0,3,All Things In Time,26.0,11,0,-2,1,0,stay,1976-06-12
4225,Lou Rawls,1976-09-04,Lou Rawls - All Things In Time,3,1,4,1.0,3,All Things In Time,26.0,12,-1,0,-2,1,down,1976-06-12
4226,Lou Rawls,1976-09-11,Lou Rawls - All Things In Time,3,3,3,1.0,4,All Things In Time,26.0,13,1,-1,0,1,up,1976-06-12
4227,Lou Rawls,1976-09-18,Lou Rawls - All Things In Time,4,3,6,1.0,3,All Things In Time,26.0,14,-3,1,-1,1,down,1976-06-12
4228,Lou Rawls,1976-09-25,Lou Rawls - All Things In Time,3,4,14,1.0,6,All Things In Time,26.0,15,-8,-3,1,1,down,1976-06-12
4229,Lou Rawls,1976-10-02,Lou Rawls - All Things In Time,6,3,16,1.0,14,All Things In Time,26.0,16,-2,-8,-3,1,down,1976-06-12
4230,Lou Rawls,1976-10-09,Lou Rawls - All Things In Time,14,6,17,1.0,16,All Things In Time,26.0,17,-1,-2,-8,1,down,1976-06-12
4231,Lou Rawls,1976-10-16,Lou Rawls - All Things In Time,16,14,19,1.0,17,All Things In Time,26.0,18,-2,-1,-2,1,down,1976-06-12
4232,Lou Rawls,1976-10-23,Lou Rawls - All Things In Time,17,16,20,1.0,19,All Things In Time,26.0,19,-1,-2,-1,1,down,1976-06-12
4233,Lou Rawls,1976-10-30,Lou Rawls - All Things In Time,19,17,20,1.0,20,All Things In Time,26.0,20,0,-1,-2,0,stay,1976-06-12
4234,Lou Rawls,1976-11-06,Lou Rawls - All Things In Time,20,19,19,1.0,20,All Things In Time,26.0,21,1,0,-1,1,up,1976-06-12
4235,Lou Rawls,1976-11-13,Lou Rawls - All Things In Time,20,20,33,1.0,19,All Things In Time,26.0,22,-14,1,0,1,down,1976-06-12
4236,Lou Rawls,1976-11-20,Lou Rawls - All Things In Time,19,20,34,1.0,33,All Things In Time,26.0,23,-1,-14,1,1,down,1976-06-12
4237,Lou Rawls,1976-11-27,Lou Rawls - All Things In Time,33,19,45,1.0,34,All Things In Time,26.0,24,-11,-1,-14,1,down,1976-06-12
4238,Lou Rawls,1976-12-04,Lou Rawls - All Things In Time,34,33,47,1.0,45,All Things In Time,26.0,25,-2,-11,-1,1,down,1976-06-12
4239,Lou Rawls,1976-12-11,Lou Rawls - All Things In Time,45,34,51,1.0,47,All Things In Time,26.0,26,-4,-2,-11,1,down,1976-06-12
4240,Tavares,1976-06-12,Tavares - Sky High!,51,51,30,20.0,40,Sky High!,23.0,0,10,11,0,1,up,1976-06-12
4241,Tavares,1976-06-19,Tavares - Sky High!,40,51,24,20.0,30,Sky High!,23.0,1,6,10,11,1,up,1976-06-12
4242,Tavares,1976-06-26,Tavares - Sky High!,30,40,23,20.0,24,Sky High!,23.0,2,1,6,10,1,up,1976-06-12
4243,Tavares,1976-07-04,Tavares - Sky High!,24,30,21,20.0,23,Sky High!,23.0,3,2,1,6,1,up,1976-06-12
4244,Tavares,1976-07-10,Tavares - Sky High!,23,24,20,20.0,21,Sky High!,23.0,4,1,2,1,1,up,1976-06-12
4245,Tavares,1976-07-17,Tavares - Sky High!,21,23,21,20.0,20,Sky High!,23.0,5,-1,1,2,1,down,1976-06-12
4246,Tavares,1976-07-24,Tavares - Sky High!,20,21,20,20.0,21,Sky High!,23.0,6,1,-1,1,1,up,1976-06-12
4247,Tavares,1976-07-31,Tavares - Sky High!,21,20,22,20.0,20,Sky High!,23.0,7,-2,1,-1,1,down,1976-06-12
4248,Tavares,1976-08-07,Tavares - Sky High!,20,21,24,20.0,22,Sky High!,23.0,8,-2,-2,1,1,down,1976-06-12
4249,Tavares,1976-08-14,Tavares - Sky High!,22,20,28,20.0,24,Sky High!,23.0,9,-4,-2,-2,1,down,1976-06-12
4250,Tavares,1976-08-21,Tavares - Sky High!,24,22,28,20.0,28,Sky High!,23.0,10,0,-4,-2,0,stay,1976-06-12
4251,Tavares,1976-08-28,Tavares - Sky High!,28,24,27,20.0,28,Sky High!,23.0,11,1,0,-4,1,up,1976-06-12
4252,Tavares,1976-09-04,Tavares - Sky High!,28,28,21,20.0,27,Sky High!,23.0,12,6,1,0,1,up,1976-06-12
4253,Tavares,1976-09-11,Tavares - Sky High!,27,28,21,20.0,21,Sky High!,23.0,13,0,6,1,0,stay,1976-06-12
4254,Tavares,1976-09-18,Tavares - Sky High!,21,27,31,20.0,21,Sky High!,23.0,14,-10,0,6,1,down,1976-06-12
4255,Tavares,1976-09-25,Tavares - Sky High!,21,21,37,20.0,31,Sky High!,23.0,15,-6,-10,0,1,down,1976-06-12
4256,Tavares,1976-10-02,Tavares - Sky High!,31,21,37,20.0,37,Sky High!,23.0,16,0,-6,-10,0,stay,1976-06-12
4257,Tavares,1976-10-09,Tavares - Sky High!,37,31,34,20.0,37,Sky High!,23.0,17,3,0,-6,1,up,1976-06-12
4258,Tavares,1976-10-16,Tavares - Sky High!,37,37,36,20.0,34,Sky High!,23.0,18,-2,3,0,1,down,1976-06-12
4259,Tavares,1976-10-23,Tavares - Sky High!,34,37,33,20.0,36,Sky High!,23.0,19,3,-2,3,1,up,1976-06-12
4260,Tavares,1976-10-30,Tavares - Sky High!,36,34,33,20.0,33,Sky High!,23.0,20,0,3,-2,0,stay,1976-06-12
4261,Tavares,1976-11-06,Tavares - Sky High!,33,36,46,20.0,33,Sky High!,23.0,21,-13,0,3,1,down,1976-06-12
4262,Tavares,1976-11-13,Tavares - Sky High!,33,33,46,20.0,46,Sky High!,23.0,22,0,-13,0,0,stay,1976-06-12
4263,Tavares,1976-11-20,Tavares - Sky High!,46,33,51,20.0,46,Sky High!,23.0,23,-5,0,-13,1,down,1976-06-12
4264,Ronnie Laws,1976-06-12,Ronnie Laws - Fever,51,51,28,13.0,42,Fever,15.0,0,14,9,0,1,up,1976-06-12
4265,Ronnie Laws,1976-06-19,Ronnie Laws - Fever,42,51,21,13.0,28,Fever,15.0,1,7,14,9,1,up,1976-06-12
4266,Ronnie Laws,1976-06-26,Ronnie Laws - Fever,28,42,17,13.0,21,Fever,15.0,2,4,7,14,1,up,1976-06-12
4267,Ronnie Laws,1976-07-04,Ronnie Laws - Fever,21,28,13,13.0,17,Fever,15.0,3,4,4,7,1,up,1976-06-12
4268,Ronnie Laws,1976-07-10,Ronnie Laws - Fever,17,21,13,13.0,13,Fever,15.0,4,0,4,4,0,stay,1976-06-12
4269,Ronnie Laws,1976-07-17,Ronnie Laws - Fever,13,17,25,13.0,13,Fever,15.0,5,-12,0,4,1,down,1976-06-12
4270,Ronnie Laws,1976-07-24,Ronnie Laws - Fever,13,13,26,13.0,25,Fever,15.0,6,-1,-12,0,1,down,1976-06-12
4271,Ronnie Laws,1976-07-31,Ronnie Laws - Fever,25,13,32,13.0,26,Fever,15.0,7,-6,-1,-12,1,down,1976-06-12
4272,Ronnie Laws,1976-08-07,Ronnie Laws - Fever,26,25,32,13.0,32,Fever,15.0,8,0,-6,-1,0,stay,1976-06-12
4273,Ronnie Laws,1976-08-14,Ronnie Laws - Fever,32,26,32,13.0,32,Fever,15.0,9,0,0,-6,0,stay,1976-06-12
4274,Ronnie Laws,1976-08-21,Ronnie Laws - Fever,32,32,32,13.0,32,Fever,15.0,10,0,0,0,0,stay,1976-06-12
4275,Ronnie Laws,1976-08-28,Ronnie Laws - Fever,32,32,28,13.0,32,Fever,15.0,11,4,0,0,1,up,1976-06-12
4276,Ronnie Laws,1976-09-04,Ronnie Laws - Fever,32,32,27,13.0,28,Fever,15.0,12,1,4,0,1,up,1976-06-12
4277,Ronnie Laws,1976-09-11,Ronnie Laws - Fever,28,32,34,13.0,27,Fever,15.0,13,-7,1,4,1,down,1976-06-12
4278,Ronnie Laws,1976-09-18,Ronnie Laws - Fever,27,28,50,13.0,34,Fever,15.0,14,-16,-7,1,1,down,1976-06-12
4279,Ronnie Laws,1976-09-25,Ronnie Laws - Fever,34,27,51,13.0,50,Fever,15.0,15,-1,-16,-7,1,down,1976-06-12
4280,The Stylistics,1976-06-12,The Stylistics - Fabulous,51,51,33,32.0,45,Fabulous,3.0,0,12,6,0,1,up,1976-06-12
4281,The Stylistics,1976-06-19,The Stylistics - Fabulous,45,51,32,32.0,33,Fabulous,3.0,1,1,12,6,1,up,1976-06-12
4282,The Stylistics,1976-06-26,The Stylistics - Fabulous,33,45,41,32.0,32,Fabulous,3.0,2,-9,1,12,1,down,1976-06-12
4283,The Stylistics,1976-07-04,The Stylistics - Fabulous,32,33,51,32.0,41,Fabulous,3.0,3,-10,-9,1,1,down,1976-06-12
4284,Maxine Nightingale,1976-06-12,Maxine Nightingale - Right Back Where We Started From,51,51,38,38.0,48,Right Back Where We Started From,2.0,0,10,3,0,1,up,1976-06-12
4285,Maxine Nightingale,1976-06-19,Maxine Nightingale - Right Back Where We Started From,48,51,38,38.0,38,Right Back Where We Started From,2.0,1,0,10,3,0,stay,1976-06-12
4286,Maxine Nightingale,1976-06-26,Maxine Nightingale - Right Back Where We Started From,38,48,51,38.0,38,Right Back Where We Started From,2.0,2,-13,0,10,1,down,1976-06-12
4287,The Dells,1976-06-12,The Dells - No Way Back,51,51,47,47.0,50,No Way Back,1.0,0,3,1,0,1,up,1976-06-12
4288,The Dells,1976-06-19,The Dells - No Way Back,50,51,51,47.0,47,No Way Back,1.0,1,-4,3,1,1,down,1976-06-12
4289,Aretha Franklin,1976-06-19,Aretha Franklin - Sparkle,51,51,18,1.0,32,Sparkle,27.0,0,14,19,0,1,up,1976-06-19
4290,Aretha Franklin,1976-06-26,Aretha Franklin - Sparkle,32,51,6,1.0,18,Sparkle,27.0,1,12,14,19,1,up,1976-06-19
4291,Aretha Franklin,1976-07-04,Aretha Franklin - Sparkle,18,32,5,1.0,6,Sparkle,27.0,2,1,12,14,1,up,1976-06-19
4292,Aretha Franklin,1976-07-10,Aretha Franklin - Sparkle,6,18,4,1.0,5,Sparkle,27.0,3,1,1,12,1,up,1976-06-19
4293,Aretha Franklin,1976-07-17,Aretha Franklin - Sparkle,5,6,2,1.0,4,Sparkle,27.0,4,2,1,1,1,up,1976-06-19
4294,Aretha Franklin,1976-07-24,Aretha Franklin - Sparkle,4,5,1,1.0,2,Sparkle,27.0,5,1,2,1,1,up,1976-06-19
4295,Aretha Franklin,1976-07-31,Aretha Franklin - Sparkle,2,4,2,1.0,1,Sparkle,27.0,6,-1,1,2,1,down,1976-06-19
4296,Aretha Franklin,1976-08-07,Aretha Franklin - Sparkle,1,2,3,1.0,2,Sparkle,27.0,7,-1,-1,1,1,down,1976-06-19
4297,Aretha Franklin,1976-08-14,Aretha Franklin - Sparkle,2,1,2,1.0,3,Sparkle,27.0,8,1,-1,-1,1,up,1976-06-19
4298,Aretha Franklin,1976-08-21,Aretha Franklin - Sparkle,3,2,2,1.0,2,Sparkle,27.0,9,0,1,-1,0,stay,1976-06-19
4299,Aretha Franklin,1976-08-28,Aretha Franklin - Sparkle,2,3,5,1.0,2,Sparkle,27.0,10,-3,0,1,1,down,1976-06-19
4300,Aretha Franklin,1976-09-04,Aretha Franklin - Sparkle,2,2,6,1.0,5,Sparkle,27.0,11,-1,-3,0,1,down,1976-06-19
4301,Aretha Franklin,1976-09-11,Aretha Franklin - Sparkle,5,2,7,1.0,6,Sparkle,27.0,12,-1,-1,-3,1,down,1976-06-19
4302,Aretha Franklin,1976-09-18,Aretha Franklin - Sparkle,6,5,14,1.0,7,Sparkle,27.0,13,-7,-1,-1,1,down,1976-06-19
4303,Aretha Franklin,1976-09-25,Aretha Franklin - Sparkle,7,6,19,1.0,14,Sparkle,27.0,14,-5,-7,-1,1,down,1976-06-19
4304,Aretha Franklin,1976-10-02,Aretha Franklin - Sparkle,14,7,27,1.0,19,Sparkle,27.0,15,-8,-5,-7,1,down,1976-06-19
4305,Aretha Franklin,1976-10-09,Aretha Franklin - Sparkle,19,14,27,1.0,27,Sparkle,27.0,16,0,-8,-5,0,stay,1976-06-19
4306,Aretha Franklin,1976-10-16,Aretha Franklin - Sparkle,27,19,38,1.0,27,Sparkle,27.0,17,-11,0,-8,1,down,1976-06-19
4307,Aretha Franklin,1976-10-23,Aretha Franklin - Sparkle,27,27,37,1.0,38,Sparkle,27.0,18,1,-11,0,1,up,1976-06-19
4308,Aretha Franklin,1976-10-30,Aretha Franklin - Sparkle,38,27,37,1.0,37,Sparkle,27.0,19,0,1,-11,0,stay,1976-06-19
4309,Aretha Franklin,1976-11-06,Aretha Franklin - Sparkle,37,38,45,1.0,37,Sparkle,27.0,20,-8,0,1,1,down,1976-06-19
4310,Aretha Franklin,1976-11-13,Aretha Franklin - Sparkle,37,37,45,1.0,45,Sparkle,27.0,21,0,-8,0,0,stay,1976-06-19
4311,Aretha Franklin,1976-11-20,Aretha Franklin - Sparkle,45,37,46,1.0,45,Sparkle,27.0,22,-1,0,-8,1,down,1976-06-19
4312,Aretha Franklin,1976-11-27,Aretha Franklin - Sparkle,45,45,43,1.0,46,Sparkle,27.0,23,3,-1,0,1,up,1976-06-19
4313,Aretha Franklin,1976-12-04,Aretha Franklin - Sparkle,46,45,44,1.0,43,Sparkle,27.0,24,-1,3,-1,1,down,1976-06-19
4314,Aretha Franklin,1976-12-18,Aretha Franklin - Sparkle,43,46,42,1.0,44,Sparkle,27.0,25,2,-1,3,1,up,1976-06-19
4315,Aretha Franklin,1976-12-25,Aretha Franklin - Sparkle,44,43,42,1.0,42,Sparkle,27.0,26,0,2,-1,0,stay,1976-06-19
4316,Aretha Franklin,1977-01-01,Aretha Franklin - Sparkle,42,44,51,1.0,42,Sparkle,27.0,27,-9,0,2,1,down,1976-06-19
4317,Al Wilson,1976-06-19,Al Wilson - I've Got A Feeling,51,51,43,43.0,45,I've Got A Feeling,4.0,0,2,6,0,1,up,1976-06-19
4318,Al Wilson,1976-06-26,Al Wilson - I've Got A Feeling,45,51,43,43.0,43,I've Got A Feeling,4.0,1,0,2,6,0,stay,1976-06-19
4319,Al Wilson,1976-07-04,Al Wilson - I've Got A Feeling,43,45,44,43.0,43,I've Got A Feeling,4.0,2,-1,0,2,1,down,1976-06-19
4320,Al Wilson,1976-07-10,Al Wilson - I've Got A Feeling,43,43,44,43.0,44,I've Got A Feeling,4.0,3,0,-1,0,0,stay,1976-06-19
4321,Al Wilson,1976-07-17,Al Wilson - I've Got A Feeling,44,43,51,43.0,44,I've Got A Feeling,4.0,4,-7,0,-1,1,down,1976-06-19
4322,Andrea True Connection,1976-06-19,"Andrea True Connection - More, More, More",51,51,49,49.0,49,"More, More, More",1.0,0,0,2,0,0,stay,1976-06-19
4323,Andrea True Connection,1976-06-26,"Andrea True Connection - More, More, More",49,51,51,49.0,49,"More, More, More",1.0,1,-2,0,2,1,down,1976-06-19
4324,Bohannon,1976-06-19,Bohannon - Dance Your Ass Off,51,51,47,47.0,50,Dance Your Ass Off,2.0,0,3,1,0,1,up,1976-06-19
4325,Bohannon,1976-06-26,Bohannon - Dance Your Ass Off,50,51,47,47.0,47,Dance Your Ass Off,2.0,1,0,3,1,0,stay,1976-06-19
4326,Bohannon,1976-07-04,Bohannon - Dance Your Ass Off,47,50,51,47.0,47,Dance Your Ass Off,2.0,2,-4,0,3,1,down,1976-06-19
4327,Graham Central Station,1976-06-26,Graham Central Station - Mirror,51,51,18,7.0,35,Mirror,15.0,0,17,16,0,1,up,1976-06-26
4328,Graham Central Station,1976-07-04,Graham Central Station - Mirror,35,51,14,7.0,18,Mirror,15.0,1,4,17,16,1,up,1976-06-26
4329,Graham Central Station,1976-07-10,Graham Central Station - Mirror,18,35,10,7.0,14,Mirror,15.0,2,4,4,17,1,up,1976-06-26
4330,Graham Central Station,1976-07-17,Graham Central Station - Mirror,14,18,8,7.0,10,Mirror,15.0,3,2,4,4,1,up,1976-06-26
4331,Graham Central Station,1976-07-24,Graham Central Station - Mirror,10,14,7,7.0,8,Mirror,15.0,4,1,2,4,1,up,1976-06-26
4332,Graham Central Station,1976-07-31,Graham Central Station - Mirror,8,10,7,7.0,7,Mirror,15.0,5,0,1,2,0,stay,1976-06-26
4333,Graham Central Station,1976-08-07,Graham Central Station - Mirror,7,8,15,7.0,7,Mirror,15.0,6,-8,0,1,1,down,1976-06-26
4334,Graham Central Station,1976-08-14,Graham Central Station - Mirror,7,7,15,7.0,15,Mirror,15.0,7,0,-8,0,0,stay,1976-06-26
4335,Graham Central Station,1976-08-21,Graham Central Station - Mirror,15,7,16,7.0,15,Mirror,15.0,8,-1,0,-8,1,down,1976-06-26
4336,Graham Central Station,1976-08-28,Graham Central Station - Mirror,15,15,20,7.0,16,Mirror,15.0,9,-4,-1,0,1,down,1976-06-26
4337,Graham Central Station,1976-09-04,Graham Central Station - Mirror,16,15,20,7.0,20,Mirror,15.0,10,0,-4,-1,0,stay,1976-06-26
4338,Graham Central Station,1976-09-11,Graham Central Station - Mirror,20,16,20,7.0,20,Mirror,15.0,11,0,0,-4,0,stay,1976-06-26
4339,Graham Central Station,1976-09-18,Graham Central Station - Mirror,20,20,25,7.0,20,Mirror,15.0,12,-5,0,0,1,down,1976-06-26
4340,Graham Central Station,1976-09-25,Graham Central Station - Mirror,20,20,25,7.0,25,Mirror,15.0,13,0,-5,0,0,stay,1976-06-26
4341,Graham Central Station,1976-10-02,Graham Central Station - Mirror,25,20,34,7.0,25,Mirror,15.0,14,-9,0,-5,1,down,1976-06-26
4342,Graham Central Station,1976-10-09,Graham Central Station - Mirror,25,25,51,7.0,34,Mirror,15.0,15,-17,-9,0,1,down,1976-06-26
4343,People's Choice,1976-06-26,People's Choice - We Got The Rhythm,51,51,38,38.0,41,We Got The Rhythm,4.0,0,3,10,0,1,up,1976-06-26
4344,People's Choice,1976-07-04,People's Choice - We Got The Rhythm,41,51,49,38.0,38,We Got The Rhythm,4.0,1,-11,3,10,1,down,1976-06-26
4345,People's Choice,1976-07-10,People's Choice - We Got The Rhythm,38,41,49,38.0,49,We Got The Rhythm,4.0,2,0,-11,3,0,stay,1976-06-26
4346,People's Choice,1976-09-04,People's Choice - We Got The Rhythm,49,38,48,38.0,49,We Got The Rhythm,4.0,3,1,0,-11,1,up,1976-06-26
4347,People's Choice,1976-09-11,People's Choice - We Got The Rhythm,49,49,51,38.0,48,We Got The Rhythm,4.0,4,-3,1,0,1,down,1976-06-26
4348,George Benson,1976-06-26,George Benson - Good King Bad,51,51,25,18.0,44,Good King Bad,16.0,0,19,7,0,1,up,1976-06-26
4349,George Benson,1976-07-04,George Benson - Good King Bad,44,51,20,18.0,25,Good King Bad,16.0,1,5,19,7,1,up,1976-06-26
4350,George Benson,1976-07-10,George Benson - Good King Bad,25,44,19,18.0,20,Good King Bad,16.0,2,1,5,19,1,up,1976-06-26
4351,George Benson,1976-07-17,George Benson - Good King Bad,20,25,18,18.0,19,Good King Bad,16.0,3,1,1,5,1,up,1976-06-26
4352,George Benson,1976-07-24,George Benson - Good King Bad,19,20,22,18.0,18,Good King Bad,16.0,4,-4,1,1,1,down,1976-06-26
4353,George Benson,1976-07-31,George Benson - Good King Bad,18,19,25,18.0,22,Good King Bad,16.0,5,-3,-4,1,1,down,1976-06-26
4354,George Benson,1976-08-07,George Benson - Good King Bad,22,18,27,18.0,25,Good King Bad,16.0,6,-2,-3,-4,1,down,1976-06-26
4355,George Benson,1976-08-14,George Benson - Good King Bad,25,22,31,18.0,27,Good King Bad,16.0,7,-4,-2,-3,1,down,1976-06-26
4356,George Benson,1976-08-21,George Benson - Good King Bad,27,25,40,18.0,31,Good King Bad,16.0,8,-9,-4,-2,1,down,1976-06-26
4357,George Benson,1976-08-28,George Benson - Good King Bad,31,27,35,18.0,40,Good King Bad,16.0,9,5,-9,-4,1,up,1976-06-26
4358,George Benson,1976-09-04,George Benson - Good King Bad,40,31,35,18.0,35,Good King Bad,16.0,10,0,5,-9,0,stay,1976-06-26
4359,George Benson,1976-09-11,George Benson - Good King Bad,35,40,29,18.0,35,Good King Bad,16.0,11,6,0,5,1,up,1976-06-26
4360,George Benson,1976-09-18,George Benson - Good King Bad,35,35,28,18.0,29,Good King Bad,16.0,12,1,6,0,1,up,1976-06-26
4361,George Benson,1976-09-25,George Benson - Good King Bad,29,35,28,18.0,28,Good King Bad,16.0,13,0,1,6,0,stay,1976-06-26
4362,George Benson,1976-10-02,George Benson - Good King Bad,28,29,38,18.0,28,Good King Bad,16.0,14,-10,0,1,1,down,1976-06-26
4363,George Benson,1976-10-09,George Benson - Good King Bad,28,28,48,18.0,38,Good King Bad,16.0,15,-10,-10,0,1,down,1976-06-26
4364,George Benson,1976-10-16,George Benson - Good King Bad,38,28,51,18.0,48,Good King Bad,16.0,16,-3,-10,-10,1,down,1976-06-26
4365,Stanley Turrentine,1976-06-26,Stanley Turrentine - Everybody Come On Out,51,51,36,29.0,46,Everybody Come On Out,6.0,0,10,5,0,1,up,1976-06-26
4366,Stanley Turrentine,1976-07-04,Stanley Turrentine - Everybody Come On Out,46,51,30,29.0,36,Everybody Come On Out,6.0,1,6,10,5,1,up,1976-06-26
4367,Stanley Turrentine,1976-07-10,Stanley Turrentine - Everybody Come On Out,36,46,29,29.0,30,Everybody Come On Out,6.0,2,1,6,10,1,up,1976-06-26
4368,Stanley Turrentine,1976-07-17,Stanley Turrentine - Everybody Come On Out,30,36,37,29.0,29,Everybody Come On Out,6.0,3,-8,1,6,1,down,1976-06-26
4369,Stanley Turrentine,1976-07-24,Stanley Turrentine - Everybody Come On Out,29,30,35,29.0,37,Everybody Come On Out,6.0,4,2,-8,1,1,up,1976-06-26
4370,Stanley Turrentine,1976-07-31,Stanley Turrentine - Everybody Come On Out,37,29,44,29.0,35,Everybody Come On Out,6.0,5,-9,2,-8,1,down,1976-06-26
4371,Stanley Turrentine,1976-08-07,Stanley Turrentine - Everybody Come On Out,35,37,51,29.0,44,Everybody Come On Out,6.0,6,-7,-9,2,1,down,1976-06-26
4372,Candi Staton,1976-06-26,Candi Staton - Young Hearts Run Free,51,51,29,14.0,48,Young Hearts Run Free,10.0,0,19,3,0,1,up,1976-06-26
4373,Candi Staton,1976-07-04,Candi Staton - Young Hearts Run Free,48,51,23,14.0,29,Young Hearts Run Free,10.0,1,6,19,3,1,up,1976-06-26
4374,Candi Staton,1976-07-10,Candi Staton - Young Hearts Run Free,29,48,17,14.0,23,Young Hearts Run Free,10.0,2,6,6,19,1,up,1976-06-26
4375,Candi Staton,1976-07-17,Candi Staton - Young Hearts Run Free,23,29,14,14.0,17,Young Hearts Run Free,10.0,3,3,6,6,1,up,1976-06-26
4376,Candi Staton,1976-07-24,Candi Staton - Young Hearts Run Free,17,23,14,14.0,14,Young Hearts Run Free,10.0,4,0,3,6,0,stay,1976-06-26
4377,Candi Staton,1976-07-31,Candi Staton - Young Hearts Run Free,14,17,21,14.0,14,Young Hearts Run Free,10.0,5,-7,0,3,1,down,1976-06-26
4378,Candi Staton,1976-08-07,Candi Staton - Young Hearts Run Free,14,14,28,14.0,21,Young Hearts Run Free,10.0,6,-7,-7,0,1,down,1976-06-26
4379,Candi Staton,1976-08-14,Candi Staton - Young Hearts Run Free,21,14,33,14.0,28,Young Hearts Run Free,10.0,7,-5,-7,-7,1,down,1976-06-26
4380,Candi Staton,1976-08-21,Candi Staton - Young Hearts Run Free,28,21,41,14.0,33,Young Hearts Run Free,10.0,8,-8,-5,-7,1,down,1976-06-26
4381,Candi Staton,1976-08-28,Candi Staton - Young Hearts Run Free,33,28,47,14.0,41,Young Hearts Run Free,10.0,9,-6,-8,-5,1,down,1976-06-26
4382,Candi Staton,1976-09-04,Candi Staton - Young Hearts Run Free,41,33,51,14.0,47,Young Hearts Run Free,10.0,10,-4,-6,-8,1,down,1976-06-26
4383,Curtis Mayfield,1976-07-04,"Curtis Mayfield - Give, Get, Take & Have",51,51,28,16.0,40,"Give, Get, Take & Have",14.0,0,12,11,0,1,up,1976-07-04
4384,Curtis Mayfield,1976-07-10,"Curtis Mayfield - Give, Get, Take & Have",40,51,22,16.0,28,"Give, Get, Take & Have",14.0,1,6,12,11,1,up,1976-07-04
4385,Curtis Mayfield,1976-07-17,"Curtis Mayfield - Give, Get, Take & Have",28,40,17,16.0,22,"Give, Get, Take & Have",14.0,2,5,6,12,1,up,1976-07-04
4386,Curtis Mayfield,1976-07-24,"Curtis Mayfield - Give, Get, Take & Have",22,28,17,16.0,17,"Give, Get, Take & Have",14.0,3,0,5,6,0,stay,1976-07-04
4387,Curtis Mayfield,1976-07-31,"Curtis Mayfield - Give, Get, Take & Have",17,22,16,16.0,17,"Give, Get, Take & Have",14.0,4,1,0,5,1,up,1976-07-04
4388,Curtis Mayfield,1976-08-07,"Curtis Mayfield - Give, Get, Take & Have",17,17,22,16.0,16,"Give, Get, Take & Have",14.0,5,-6,1,0,1,down,1976-07-04
4389,Curtis Mayfield,1976-08-14,"Curtis Mayfield - Give, Get, Take & Have",16,17,21,16.0,22,"Give, Get, Take & Have",14.0,6,1,-6,1,1,up,1976-07-04
4390,Curtis Mayfield,1976-08-21,"Curtis Mayfield - Give, Get, Take & Have",22,16,18,16.0,21,"Give, Get, Take & Have",14.0,7,3,1,-6,1,up,1976-07-04
4391,Curtis Mayfield,1976-08-28,"Curtis Mayfield - Give, Get, Take & Have",21,22,16,16.0,18,"Give, Get, Take & Have",14.0,8,2,3,1,1,up,1976-07-04
4392,Curtis Mayfield,1976-09-04,"Curtis Mayfield - Give, Get, Take & Have",18,21,16,16.0,16,"Give, Get, Take & Have",14.0,9,0,2,3,0,stay,1976-07-04
4393,Curtis Mayfield,1976-09-11,"Curtis Mayfield - Give, Get, Take & Have",16,18,31,16.0,16,"Give, Get, Take & Have",14.0,10,-15,0,2,1,down,1976-07-04
4394,Curtis Mayfield,1976-09-18,"Curtis Mayfield - Give, Get, Take & Have",16,16,26,16.0,31,"Give, Get, Take & Have",14.0,11,5,-15,0,1,up,1976-07-04
4395,Curtis Mayfield,1976-09-25,"Curtis Mayfield - Give, Get, Take & Have",31,16,26,16.0,26,"Give, Get, Take & Have",14.0,12,0,5,-15,0,stay,1976-07-04
4396,Curtis Mayfield,1976-10-02,"Curtis Mayfield - Give, Get, Take & Have",26,31,46,16.0,26,"Give, Get, Take & Have",14.0,13,-20,0,5,1,down,1976-07-04
4397,Curtis Mayfield,1976-10-09,"Curtis Mayfield - Give, Get, Take & Have",26,26,51,16.0,46,"Give, Get, Take & Have",14.0,14,-5,-20,0,1,down,1976-07-04
4398,Harold Melvin And The Blue Notes,1976-07-04,Harold Melvin And The Blue Notes - All Their Greatest Hits,51,51,31,23.0,42,All Their Greatest Hits,7.0,0,11,9,0,1,up,1976-07-04
4399,Harold Melvin And The Blue Notes,1976-07-10,Harold Melvin And The Blue Notes - All Their Greatest Hits,42,51,26,23.0,31,All Their Greatest Hits,7.0,1,5,11,9,1,up,1976-07-04
4400,Harold Melvin And The Blue Notes,1976-07-17,Harold Melvin And The Blue Notes - All Their Greatest Hits,31,42,23,23.0,26,All Their Greatest Hits,7.0,2,3,5,11,1,up,1976-07-04
4401,Harold Melvin And The Blue Notes,1976-07-24,Harold Melvin And The Blue Notes - All Their Greatest Hits,26,31,25,23.0,23,All Their Greatest Hits,7.0,3,-2,3,5,1,down,1976-07-04
4402,Harold Melvin And The Blue Notes,1976-07-31,Harold Melvin And The Blue Notes - All Their Greatest Hits,23,26,37,23.0,25,All Their Greatest Hits,7.0,4,-12,-2,3,1,down,1976-07-04
4403,Harold Melvin And The Blue Notes,1976-08-07,Harold Melvin And The Blue Notes - All Their Greatest Hits,25,23,39,23.0,37,All Their Greatest Hits,7.0,5,-2,-12,-2,1,down,1976-07-04
4404,Harold Melvin And The Blue Notes,1976-08-14,Harold Melvin And The Blue Notes - All Their Greatest Hits,37,25,34,23.0,39,All Their Greatest Hits,7.0,6,5,-2,-12,1,up,1976-07-04
4405,Harold Melvin And The Blue Notes,1976-08-21,Harold Melvin And The Blue Notes - All Their Greatest Hits,39,37,51,23.0,34,All Their Greatest Hits,7.0,7,-17,5,-2,1,down,1976-07-04
4406,MFSB,1976-07-04,MFSB - Summertime,51,51,34,18.0,44,Summertime,9.0,0,10,7,0,1,up,1976-07-04
4407,MFSB,1976-07-10,MFSB - Summertime,44,51,24,18.0,34,Summertime,9.0,1,10,10,7,1,up,1976-07-04
4408,MFSB,1976-07-17,MFSB - Summertime,34,44,20,18.0,24,Summertime,9.0,2,4,10,10,1,up,1976-07-04
4409,MFSB,1976-07-24,MFSB - Summertime,24,34,18,18.0,20,Summertime,9.0,3,2,4,10,1,up,1976-07-04
4410,MFSB,1976-07-31,MFSB - Summertime,20,24,23,18.0,18,Summertime,9.0,4,-5,2,4,1,down,1976-07-04
4411,MFSB,1976-08-07,MFSB - Summertime,18,20,29,18.0,23,Summertime,9.0,5,-6,-5,2,1,down,1976-07-04
4412,MFSB,1976-08-14,MFSB - Summertime,23,18,30,18.0,29,Summertime,9.0,6,-1,-6,-5,1,down,1976-07-04
4413,MFSB,1976-08-21,MFSB - Summertime,29,23,31,18.0,30,Summertime,9.0,7,-1,-1,-6,1,down,1976-07-04
4414,MFSB,1976-08-28,MFSB - Summertime,30,29,43,18.0,31,Summertime,9.0,8,-12,-1,-1,1,down,1976-07-04
4415,MFSB,1976-09-04,MFSB - Summertime,31,30,51,18.0,43,Summertime,9.0,9,-8,-12,-1,1,down,1976-07-04
4416,Special Delivery Featuring Terry Huff,1976-07-04,Special Delivery Featuring Terry Huff - The Lonely One,51,51,37,34.0,45,The Lonely One,4.0,0,8,6,0,1,up,1976-07-04
4417,Special Delivery Featuring Terry Huff,1976-07-10,Special Delivery Featuring Terry Huff - The Lonely One,45,51,34,34.0,37,The Lonely One,4.0,1,3,8,6,1,up,1976-07-04
4418,Special Delivery Featuring Terry Huff,1976-07-17,Special Delivery Featuring Terry Huff - The Lonely One,37,45,46,34.0,34,The Lonely One,4.0,2,-12,3,8,1,down,1976-07-04
4419,Special Delivery Featuring Terry Huff,1976-07-24,Special Delivery Featuring Terry Huff - The Lonely One,34,37,44,34.0,46,The Lonely One,4.0,3,2,-12,3,1,up,1976-07-04
4420,Special Delivery Featuring Terry Huff,1976-07-31,Special Delivery Featuring Terry Huff - The Lonely One,46,34,51,34.0,44,The Lonely One,4.0,4,-7,2,-12,1,down,1976-07-04
4421,Bob James,1976-07-04,Bob James - Three,51,51,38,23.0,46,Three,13.0,0,8,5,0,1,up,1976-07-04
4422,Bob James,1976-07-10,Bob James - Three,46,51,32,23.0,38,Three,13.0,1,6,8,5,1,up,1976-07-04
4423,Bob James,1976-07-17,Bob James - Three,38,46,26,23.0,32,Three,13.0,2,6,6,8,1,up,1976-07-04
4424,Bob James,1976-07-24,Bob James - Three,32,38,23,23.0,26,Three,13.0,3,3,6,6,1,up,1976-07-04
4425,Bob James,1976-07-31,Bob James - Three,26,32,30,23.0,23,Three,13.0,4,-7,3,6,1,down,1976-07-04
4426,Bob James,1976-08-07,Bob James - Three,23,26,30,23.0,30,Three,13.0,5,0,-7,3,0,stay,1976-07-04
4427,Bob James,1976-08-14,Bob James - Three,30,23,26,23.0,30,Three,13.0,6,4,0,-7,1,up,1976-07-04
4428,Bob James,1976-08-21,Bob James - Three,30,30,25,23.0,26,Three,13.0,7,1,4,0,1,up,1976-07-04
4429,Bob James,1976-08-28,Bob James - Three,26,30,23,23.0,25,Three,13.0,8,2,1,4,1,up,1976-07-04
4430,Bob James,1976-09-04,Bob James - Three,25,26,23,23.0,23,Three,13.0,9,0,2,1,0,stay,1976-07-04
4431,Bob James,1976-09-11,Bob James - Three,23,25,26,23.0,23,Three,13.0,10,-3,0,2,1,down,1976-07-04
4432,Bob James,1976-09-18,Bob James - Three,23,23,32,23.0,26,Three,13.0,11,-6,-3,0,1,down,1976-07-04
4433,Bob James,1976-09-25,Bob James - Three,26,23,38,23.0,32,Three,13.0,12,-6,-6,-3,1,down,1976-07-04
4434,Bob James,1976-10-02,Bob James - Three,32,26,51,23.0,38,Three,13.0,13,-13,-6,-6,1,down,1976-07-04
4435,Commodores,1976-07-10,Commodores - Hot On The Tracks,51,51,23,1.0,32,Hot On The Tracks,30.0,0,9,19,0,1,up,1976-07-10
4436,Commodores,1976-07-17,Commodores - Hot On The Tracks,32,51,13,1.0,23,Hot On The Tracks,30.0,1,10,9,19,1,up,1976-07-10
4437,Commodores,1976-07-24,Commodores - Hot On The Tracks,23,32,9,1.0,13,Hot On The Tracks,30.0,2,4,10,9,1,up,1976-07-10
4438,Commodores,1976-07-31,Commodores - Hot On The Tracks,13,23,6,1.0,9,Hot On The Tracks,30.0,3,3,4,10,1,up,1976-07-10
4439,Commodores,1976-08-07,Commodores - Hot On The Tracks,9,13,4,1.0,6,Hot On The Tracks,30.0,4,2,3,4,1,up,1976-07-10
4440,Commodores,1976-08-14,Commodores - Hot On The Tracks,6,9,3,1.0,4,Hot On The Tracks,30.0,5,1,2,3,1,up,1976-07-10
4441,Commodores,1976-08-21,Commodores - Hot On The Tracks,4,6,1,1.0,3,Hot On The Tracks,30.0,6,2,1,2,1,up,1976-07-10
4442,Commodores,1976-08-28,Commodores - Hot On The Tracks,3,4,1,1.0,1,Hot On The Tracks,30.0,7,0,2,1,0,stay,1976-07-10
4443,Commodores,1976-09-04,Commodores - Hot On The Tracks,1,3,2,1.0,1,Hot On The Tracks,30.0,8,-1,0,2,1,down,1976-07-10
4444,Commodores,1976-09-11,Commodores - Hot On The Tracks,1,1,1,1.0,2,Hot On The Tracks,30.0,9,1,-1,0,1,up,1976-07-10
4445,Commodores,1976-09-18,Commodores - Hot On The Tracks,2,1,1,1.0,1,Hot On The Tracks,30.0,10,0,1,-1,0,stay,1976-07-10
4446,Commodores,1976-09-25,Commodores - Hot On The Tracks,1,2,1,1.0,1,Hot On The Tracks,30.0,11,0,0,1,0,stay,1976-07-10
4447,Commodores,1976-10-02,Commodores - Hot On The Tracks,1,1,1,1.0,1,Hot On The Tracks,30.0,12,0,0,0,0,stay,1976-07-10
4448,Commodores,1976-10-09,Commodores - Hot On The Tracks,1,1,2,1.0,1,Hot On The Tracks,30.0,13,-1,0,0,1,down,1976-07-10
4449,Commodores,1976-10-16,Commodores - Hot On The Tracks,1,1,2,1.0,2,Hot On The Tracks,30.0,14,0,-1,0,0,stay,1976-07-10
4450,Commodores,1976-10-23,Commodores - Hot On The Tracks,2,1,5,1.0,2,Hot On The Tracks,30.0,15,-3,0,-1,1,down,1976-07-10
4451,Commodores,1976-10-30,Commodores - Hot On The Tracks,2,2,5,1.0,5,Hot On The Tracks,30.0,16,0,-3,0,0,stay,1976-07-10
4452,Commodores,1976-11-06,Commodores - Hot On The Tracks,5,2,6,1.0,5,Hot On The Tracks,30.0,17,-1,0,-3,1,down,1976-07-10
4453,Commodores,1976-11-13,Commodores - Hot On The Tracks,5,5,6,1.0,6,Hot On The Tracks,30.0,18,0,-1,0,0,stay,1976-07-10
4454,Commodores,1976-11-20,Commodores - Hot On The Tracks,6,5,8,1.0,6,Hot On The Tracks,30.0,19,-2,0,-1,1,down,1976-07-10
4455,Commodores,1976-11-27,Commodores - Hot On The Tracks,6,6,9,1.0,8,Hot On The Tracks,30.0,20,-1,-2,0,1,down,1976-07-10
4456,Commodores,1976-12-04,Commodores - Hot On The Tracks,8,6,19,1.0,9,Hot On The Tracks,30.0,21,-10,-1,-2,1,down,1976-07-10
4457,Commodores,1976-12-11,Commodores - Hot On The Tracks,9,8,19,1.0,19,Hot On The Tracks,30.0,22,0,-10,-1,0,stay,1976-07-10
4458,Commodores,1976-12-18,Commodores - Hot On The Tracks,19,9,19,1.0,19,Hot On The Tracks,30.0,23,0,0,-10,0,stay,1976-07-10
4459,Commodores,1976-12-25,Commodores - Hot On The Tracks,19,19,19,1.0,19,Hot On The Tracks,30.0,24,0,0,0,0,stay,1976-07-10
4460,Commodores,1977-01-01,Commodores - Hot On The Tracks,19,19,21,1.0,19,Hot On The Tracks,30.0,25,-2,0,0,1,down,1976-07-10
4461,Commodores,1977-01-08,Commodores - Hot On The Tracks,19,19,39,1.0,21,Hot On The Tracks,30.0,26,-18,-2,0,1,down,1976-07-10
4462,Commodores,1977-01-15,Commodores - Hot On The Tracks,21,19,39,1.0,39,Hot On The Tracks,30.0,27,0,-18,-2,0,stay,1976-07-10
4463,Commodores,1977-01-22,Commodores - Hot On The Tracks,39,21,38,1.0,39,Hot On The Tracks,30.0,28,1,0,-18,1,up,1976-07-10
4464,Commodores,1977-01-29,Commodores - Hot On The Tracks,39,39,43,1.0,38,Hot On The Tracks,30.0,29,-5,1,0,1,down,1976-07-10
4465,Commodores,1977-02-05,Commodores - Hot On The Tracks,38,39,51,1.0,43,Hot On The Tracks,30.0,30,-8,-5,1,1,down,1976-07-10
4466,Jackson 5,1976-07-10,Jackson 5 - Jackson 5 Anthology,51,51,36,32.0,43,Jackson 5 Anthology,3.0,0,7,8,0,1,up,1976-07-10
4467,Jackson 5,1976-07-17,Jackson 5 - Jackson 5 Anthology,43,51,32,32.0,36,Jackson 5 Anthology,3.0,1,4,7,8,1,up,1976-07-10
4468,Jackson 5,1976-07-24,Jackson 5 - Jackson 5 Anthology,36,43,46,32.0,32,Jackson 5 Anthology,3.0,2,-14,4,7,1,down,1976-07-10
4469,Jackson 5,1976-07-31,Jackson 5 - Jackson 5 Anthology,32,36,51,32.0,46,Jackson 5 Anthology,3.0,3,-5,-14,4,1,down,1976-07-10
4470,Johnny Guitar Watson,1976-07-10,Johnny Guitar Watson - Ain't That A Bitch,51,51,41,4.0,45,Ain't That A Bitch,33.0,0,4,6,0,1,up,1976-07-10
4471,Johnny Guitar Watson,1976-07-17,Johnny Guitar Watson - Ain't That A Bitch,45,51,41,4.0,41,Ain't That A Bitch,33.0,1,0,4,6,0,stay,1976-07-10
4472,Johnny Guitar Watson,1976-07-24,Johnny Guitar Watson - Ain't That A Bitch,41,45,37,4.0,41,Ain't That A Bitch,33.0,2,4,0,4,1,up,1976-07-10
4473,Johnny Guitar Watson,1976-07-31,Johnny Guitar Watson - Ain't That A Bitch,41,41,28,4.0,37,Ain't That A Bitch,33.0,3,9,4,0,1,up,1976-07-10
4474,Johnny Guitar Watson,1976-08-07,Johnny Guitar Watson - Ain't That A Bitch,37,41,25,4.0,28,Ain't That A Bitch,33.0,4,3,9,4,1,up,1976-07-10
4475,Johnny Guitar Watson,1976-08-14,Johnny Guitar Watson - Ain't That A Bitch,28,37,24,4.0,25,Ain't That A Bitch,33.0,5,1,3,9,1,up,1976-07-10
4476,Johnny Guitar Watson,1976-08-21,Johnny Guitar Watson - Ain't That A Bitch,25,28,24,4.0,24,Ain't That A Bitch,33.0,6,0,1,3,0,stay,1976-07-10
4477,Johnny Guitar Watson,1976-08-28,Johnny Guitar Watson - Ain't That A Bitch,24,25,15,4.0,24,Ain't That A Bitch,33.0,7,9,0,1,1,up,1976-07-10
4478,Johnny Guitar Watson,1976-09-04,Johnny Guitar Watson - Ain't That A Bitch,24,24,10,4.0,15,Ain't That A Bitch,33.0,8,5,9,0,1,up,1976-07-10
4479,Johnny Guitar Watson,1976-09-11,Johnny Guitar Watson - Ain't That A Bitch,15,24,9,4.0,10,Ain't That A Bitch,33.0,9,1,5,9,1,up,1976-07-10
4480,Johnny Guitar Watson,1976-09-18,Johnny Guitar Watson - Ain't That A Bitch,10,15,8,4.0,9,Ain't That A Bitch,33.0,10,1,1,5,1,up,1976-07-10
4481,Johnny Guitar Watson,1976-09-25,Johnny Guitar Watson - Ain't That A Bitch,9,10,5,4.0,8,Ain't That A Bitch,33.0,11,3,1,1,1,up,1976-07-10
4482,Johnny Guitar Watson,1976-10-02,Johnny Guitar Watson - Ain't That A Bitch,8,9,4,4.0,5,Ain't That A Bitch,33.0,12,1,3,1,1,up,1976-07-10
4483,Johnny Guitar Watson,1976-10-09,Johnny Guitar Watson - Ain't That A Bitch,5,8,6,4.0,4,Ain't That A Bitch,33.0,13,-2,1,3,1,down,1976-07-10
4484,Johnny Guitar Watson,1976-10-16,Johnny Guitar Watson - Ain't That A Bitch,4,5,7,4.0,6,Ain't That A Bitch,33.0,14,-1,-2,1,1,down,1976-07-10
4485,Johnny Guitar Watson,1976-10-23,Johnny Guitar Watson - Ain't That A Bitch,6,4,6,4.0,7,Ain't That A Bitch,33.0,15,1,-1,-2,1,up,1976-07-10
4486,Johnny Guitar Watson,1976-10-30,Johnny Guitar Watson - Ain't That A Bitch,7,6,9,4.0,6,Ain't That A Bitch,33.0,16,-3,1,-1,1,down,1976-07-10
4487,Johnny Guitar Watson,1976-11-06,Johnny Guitar Watson - Ain't That A Bitch,6,7,9,4.0,9,Ain't That A Bitch,33.0,17,0,-3,1,0,stay,1976-07-10
4488,Johnny Guitar Watson,1976-11-13,Johnny Guitar Watson - Ain't That A Bitch,9,6,11,4.0,9,Ain't That A Bitch,33.0,18,-2,0,-3,1,down,1976-07-10
4489,Johnny Guitar Watson,1976-11-20,Johnny Guitar Watson - Ain't That A Bitch,9,9,11,4.0,11,Ain't That A Bitch,33.0,19,0,-2,0,0,stay,1976-07-10
4490,Johnny Guitar Watson,1976-11-27,Johnny Guitar Watson - Ain't That A Bitch,11,9,23,4.0,11,Ain't That A Bitch,33.0,20,-12,0,-2,1,down,1976-07-10
4491,Johnny Guitar Watson,1976-12-04,Johnny Guitar Watson - Ain't That A Bitch,11,11,23,4.0,23,Ain't That A Bitch,33.0,21,0,-12,0,0,stay,1976-07-10
4492,Johnny Guitar Watson,1976-12-11,Johnny Guitar Watson - Ain't That A Bitch,23,11,23,4.0,23,Ain't That A Bitch,33.0,22,0,0,-12,0,stay,1976-07-10
4493,Johnny Guitar Watson,1976-12-18,Johnny Guitar Watson - Ain't That A Bitch,23,23,20,4.0,23,Ain't That A Bitch,33.0,23,3,0,0,1,up,1976-07-10
4494,Johnny Guitar Watson,1976-12-25,Johnny Guitar Watson - Ain't That A Bitch,23,23,20,4.0,20,Ain't That A Bitch,33.0,24,0,3,0,0,stay,1976-07-10
4495,Johnny Guitar Watson,1977-01-01,Johnny Guitar Watson - Ain't That A Bitch,20,23,36,4.0,20,Ain't That A Bitch,33.0,25,-16,0,3,1,down,1976-07-10
4496,Johnny Guitar Watson,1977-01-08,Johnny Guitar Watson - Ain't That A Bitch,20,20,34,4.0,36,Ain't That A Bitch,33.0,26,2,-16,0,1,up,1976-07-10
4497,Johnny Guitar Watson,1977-01-15,Johnny Guitar Watson - Ain't That A Bitch,36,20,30,4.0,34,Ain't That A Bitch,33.0,27,4,2,-16,1,up,1976-07-10
4498,Johnny Guitar Watson,1977-01-22,Johnny Guitar Watson - Ain't That A Bitch,34,36,36,4.0,30,Ain't That A Bitch,33.0,28,-6,4,2,1,down,1976-07-10
4499,Johnny Guitar Watson,1977-01-29,Johnny Guitar Watson - Ain't That A Bitch,30,34,39,4.0,36,Ain't That A Bitch,33.0,29,-3,-6,4,1,down,1976-07-10
4500,Johnny Guitar Watson,1977-02-05,Johnny Guitar Watson - Ain't That A Bitch,36,30,39,4.0,39,Ain't That A Bitch,33.0,30,0,-3,-6,0,stay,1976-07-10
4501,Johnny Guitar Watson,1977-02-12,Johnny Guitar Watson - Ain't That A Bitch,39,36,42,4.0,39,Ain't That A Bitch,33.0,31,-3,0,-3,1,down,1976-07-10
4502,Johnny Guitar Watson,1977-02-19,Johnny Guitar Watson - Ain't That A Bitch,39,39,49,4.0,42,Ain't That A Bitch,33.0,32,-7,-3,0,1,down,1976-07-10
4503,Johnny Guitar Watson,1977-02-26,Johnny Guitar Watson - Ain't That A Bitch,42,39,51,4.0,49,Ain't That A Bitch,33.0,33,-2,-7,-3,1,down,1976-07-10
4504,Joe Simon,1976-07-10,Joe Simon - Joe Simon Today,51,51,38,35.0,46,Joe Simon Today,6.0,0,8,5,0,1,up,1976-07-10
4505,Joe Simon,1976-07-17,Joe Simon - Joe Simon Today,46,51,35,35.0,38,Joe Simon Today,6.0,1,3,8,5,1,up,1976-07-10
4506,Joe Simon,1976-07-24,Joe Simon - Joe Simon Today,38,46,45,35.0,35,Joe Simon Today,6.0,2,-10,3,8,1,down,1976-07-10
4507,Joe Simon,1976-07-31,Joe Simon - Joe Simon Today,35,38,45,35.0,45,Joe Simon Today,6.0,3,0,-10,3,0,stay,1976-07-10
4508,Joe Simon,1976-08-07,Joe Simon - Joe Simon Today,45,35,44,35.0,45,Joe Simon Today,6.0,4,1,0,-10,1,up,1976-07-10
4509,Joe Simon,1976-08-14,Joe Simon - Joe Simon Today,45,45,47,35.0,44,Joe Simon Today,6.0,5,-3,1,0,1,down,1976-07-10
4510,Joe Simon,1976-08-21,Joe Simon - Joe Simon Today,44,45,51,35.0,47,Joe Simon Today,6.0,6,-4,-3,1,1,down,1976-07-10
4511,Jimmy McGriff,1976-07-10,Jimmy McGriff - The Mean Machine,51,51,43,43.0,47,The Mean Machine,2.0,0,4,4,0,1,up,1976-07-10
4512,Jimmy McGriff,1976-07-17,Jimmy McGriff - The Mean Machine,47,51,44,43.0,43,The Mean Machine,2.0,1,-1,4,4,1,down,1976-07-10
4513,Jimmy McGriff,1976-07-24,Jimmy McGriff - The Mean Machine,43,47,51,43.0,44,The Mean Machine,2.0,2,-7,-1,4,1,down,1976-07-10
4514,Bobby Bland & B.B. King,1976-07-17,Bobby Bland & B.B. King - Together Again...Live,51,51,16,9.0,25,Together Again...Live,11.0,0,9,26,0,1,up,1976-07-17
4515,Bobby Bland & B.B. King,1976-07-24,Bobby Bland & B.B. King - Together Again...Live,25,51,12,9.0,16,Together Again...Live,11.0,1,4,9,26,1,up,1976-07-17
4516,Bobby Bland & B.B. King,1976-07-31,Bobby Bland & B.B. King - Together Again...Live,16,25,10,9.0,12,Together Again...Live,11.0,2,2,4,9,1,up,1976-07-17
4517,Bobby Bland & B.B. King,1976-08-07,Bobby Bland & B.B. King - Together Again...Live,12,16,9,9.0,10,Together Again...Live,11.0,3,1,2,4,1,up,1976-07-17
4518,Bobby Bland & B.B. King,1976-08-14,Bobby Bland & B.B. King - Together Again...Live,10,12,13,9.0,9,Together Again...Live,11.0,4,-4,1,2,1,down,1976-07-17
4519,Bobby Bland & B.B. King,1976-08-21,Bobby Bland & B.B. King - Together Again...Live,9,10,13,9.0,13,Together Again...Live,11.0,5,0,-4,1,0,stay,1976-07-17
4520,Bobby Bland & B.B. King,1976-08-28,Bobby Bland & B.B. King - Together Again...Live,13,9,12,9.0,13,Together Again...Live,11.0,6,1,0,-4,1,up,1976-07-17
4521,Bobby Bland & B.B. King,1976-09-04,Bobby Bland & B.B. King - Together Again...Live,13,13,18,9.0,12,Together Again...Live,11.0,7,-6,1,0,1,down,1976-07-17
4522,Bobby Bland & B.B. King,1976-09-11,Bobby Bland & B.B. King - Together Again...Live,12,13,30,9.0,18,Together Again...Live,11.0,8,-12,-6,1,1,down,1976-07-17
4523,Bobby Bland & B.B. King,1976-09-18,Bobby Bland & B.B. King - Together Again...Live,18,12,38,9.0,30,Together Again...Live,11.0,9,-8,-12,-6,1,down,1976-07-17
4524,Bobby Bland & B.B. King,1976-09-25,Bobby Bland & B.B. King - Together Again...Live,30,18,47,9.0,38,Together Again...Live,11.0,10,-9,-8,-12,1,down,1976-07-17
4525,Bobby Bland & B.B. King,1976-10-02,Bobby Bland & B.B. King - Together Again...Live,38,30,51,9.0,47,Together Again...Live,11.0,11,-4,-9,-8,1,down,1976-07-17
4526,Average White Band,1976-07-17,Average White Band - Soul Searching,51,51,22,2.0,42,Soul Searching,25.0,0,20,9,0,1,up,1976-07-17
4527,Average White Band,1976-07-24,Average White Band - Soul Searching,42,51,16,2.0,22,Soul Searching,25.0,1,6,20,9,1,up,1976-07-17
4528,Average White Band,1976-07-31,Average White Band - Soul Searching,22,42,12,2.0,16,Soul Searching,25.0,2,4,6,20,1,up,1976-07-17
4529,Average White Band,1976-08-07,Average White Band - Soul Searching,16,22,10,2.0,12,Soul Searching,25.0,3,2,4,6,1,up,1976-07-17
4530,Average White Band,1976-08-14,Average White Band - Soul Searching,12,16,8,2.0,10,Soul Searching,25.0,4,2,2,4,1,up,1976-07-17
4531,Average White Band,1976-08-21,Average White Band - Soul Searching,10,12,7,2.0,8,Soul Searching,25.0,5,1,2,2,1,up,1976-07-17
4532,Average White Band,1976-08-28,Average White Band - Soul Searching,8,10,6,2.0,7,Soul Searching,25.0,6,1,1,2,1,up,1976-07-17
4533,Average White Band,1976-09-04,Average White Band - Soul Searching,7,8,5,2.0,6,Soul Searching,25.0,7,1,1,1,1,up,1976-07-17
4534,Average White Band,1976-09-11,Average White Band - Soul Searching,6,7,4,2.0,5,Soul Searching,25.0,8,1,1,1,1,up,1976-07-17
4535,Average White Band,1976-09-18,Average White Band - Soul Searching,5,6,3,2.0,4,Soul Searching,25.0,9,1,1,1,1,up,1976-07-17
4536,Average White Band,1976-09-25,Average White Band - Soul Searching,4,5,2,2.0,3,Soul Searching,25.0,10,1,1,1,1,up,1976-07-17
4537,Average White Band,1976-10-02,Average White Band - Soul Searching,3,4,2,2.0,2,Soul Searching,25.0,11,0,1,1,0,stay,1976-07-17
4538,Average White Band,1976-10-09,Average White Band - Soul Searching,2,3,3,2.0,2,Soul Searching,25.0,12,-1,0,1,1,down,1976-07-17
4539,Average White Band,1976-10-16,Average White Band - Soul Searching,2,2,6,2.0,3,Soul Searching,25.0,13,-3,-1,0,1,down,1976-07-17
4540,Average White Band,1976-10-23,Average White Band - Soul Searching,3,2,13,2.0,6,Soul Searching,25.0,14,-7,-3,-1,1,down,1976-07-17
4541,Average White Band,1976-10-30,Average White Band - Soul Searching,6,3,13,2.0,13,Soul Searching,25.0,15,0,-7,-3,0,stay,1976-07-17
4542,Average White Band,1976-11-06,Average White Band - Soul Searching,13,6,13,2.0,13,Soul Searching,25.0,16,0,0,-7,0,stay,1976-07-17
4543,Average White Band,1976-11-13,Average White Band - Soul Searching,13,13,25,2.0,13,Soul Searching,25.0,17,-12,0,0,1,down,1976-07-17
4544,Average White Band,1976-11-20,Average White Band - Soul Searching,13,13,20,2.0,25,Soul Searching,25.0,18,5,-12,0,1,up,1976-07-17
4545,Average White Band,1976-11-27,Average White Band - Soul Searching,25,13,20,2.0,20,Soul Searching,25.0,19,0,5,-12,0,stay,1976-07-17
4546,Average White Band,1976-12-04,Average White Band - Soul Searching,20,25,32,2.0,20,Soul Searching,25.0,20,-12,0,5,1,down,1976-07-17
4547,Average White Band,1976-12-11,Average White Band - Soul Searching,20,20,33,2.0,32,Soul Searching,25.0,21,-1,-12,0,1,down,1976-07-17
4548,Average White Band,1976-12-18,Average White Band - Soul Searching,32,20,47,2.0,33,Soul Searching,25.0,22,-14,-1,-12,1,down,1976-07-17
4549,Average White Band,1976-12-25,Average White Band - Soul Searching,33,32,47,2.0,47,Soul Searching,25.0,23,0,-14,-1,0,stay,1976-07-17
4550,Average White Band,1977-01-01,Average White Band - Soul Searching,47,33,44,2.0,47,Soul Searching,25.0,24,3,0,-14,1,up,1976-07-17
4551,Average White Band,1977-01-08,Average White Band - Soul Searching,47,47,51,2.0,44,Soul Searching,25.0,25,-7,3,0,1,down,1976-07-17
4552,The Whispers,1976-07-17,The Whispers - One For The Money,51,51,42,40.0,48,One For The Money,3.0,0,6,3,0,1,up,1976-07-17
4553,The Whispers,1976-07-24,The Whispers - One For The Money,48,51,40,40.0,42,One For The Money,3.0,1,2,6,3,1,up,1976-07-17
4554,The Whispers,1976-07-31,The Whispers - One For The Money,42,48,47,40.0,40,One For The Money,3.0,2,-7,2,6,1,down,1976-07-17
4555,The Whispers,1976-08-07,The Whispers - One For The Money,40,42,51,40.0,47,One For The Money,3.0,3,-4,-7,2,1,down,1976-07-17
4556,Margie Joseph,1976-07-24,"Margie Joseph - Hear The Words, Feel The Feeling",51,51,42,38.0,47,"Hear The Words, Feel The Feeling",3.0,0,5,4,0,1,up,1976-07-24
4557,Margie Joseph,1976-07-31,"Margie Joseph - Hear The Words, Feel The Feeling",47,51,38,38.0,42,"Hear The Words, Feel The Feeling",3.0,1,4,5,4,1,up,1976-07-24
4558,Margie Joseph,1976-08-07,"Margie Joseph - Hear The Words, Feel The Feeling",42,47,48,38.0,38,"Hear The Words, Feel The Feeling",3.0,2,-10,4,5,1,down,1976-07-24
4559,Margie Joseph,1976-08-14,"Margie Joseph - Hear The Words, Feel The Feeling",38,42,51,38.0,48,"Hear The Words, Feel The Feeling",3.0,3,-3,-10,4,1,down,1976-07-24
4560,The New Birth,1976-07-24,The New Birth - Love Potion,51,51,39,22.0,49,Love Potion,10.0,0,10,2,0,1,up,1976-07-24
4561,The New Birth,1976-07-31,The New Birth - Love Potion,49,51,29,22.0,39,Love Potion,10.0,1,10,10,2,1,up,1976-07-24
4562,The New Birth,1976-08-07,The New Birth - Love Potion,39,49,26,22.0,29,Love Potion,10.0,2,3,10,10,1,up,1976-07-24
4563,The New Birth,1976-08-14,The New Birth - Love Potion,29,39,36,22.0,26,Love Potion,10.0,3,-10,3,10,1,down,1976-07-24
4564,The New Birth,1976-08-21,The New Birth - Love Potion,26,29,35,22.0,36,Love Potion,10.0,4,1,-10,3,1,up,1976-07-24
4565,The New Birth,1976-08-28,The New Birth - Love Potion,36,26,37,22.0,35,Love Potion,10.0,5,-2,1,-10,1,down,1976-07-24
4566,The New Birth,1976-09-04,The New Birth - Love Potion,35,36,31,22.0,37,Love Potion,10.0,6,6,-2,1,1,up,1976-07-24
4567,The New Birth,1976-09-11,The New Birth - Love Potion,37,35,25,22.0,31,Love Potion,10.0,7,6,6,-2,1,up,1976-07-24
4568,The New Birth,1976-09-18,The New Birth - Love Potion,31,37,22,22.0,25,Love Potion,10.0,8,3,6,6,1,up,1976-07-24
4569,The New Birth,1976-09-25,The New Birth - Love Potion,25,31,22,22.0,22,Love Potion,10.0,9,0,3,6,0,stay,1976-07-24
4570,The New Birth,1976-10-02,The New Birth - Love Potion,22,25,51,22.0,22,Love Potion,10.0,10,-29,0,3,1,down,1976-07-24
4571,Wild Cherry,1976-07-24,Wild Cherry - Wild Cherry,51,51,31,1.0,50,Wild Cherry,18.0,0,19,1,0,1,up,1976-07-24
4572,Wild Cherry,1976-07-31,Wild Cherry - Wild Cherry,50,51,17,1.0,31,Wild Cherry,18.0,1,14,19,1,1,up,1976-07-24
4573,Wild Cherry,1976-08-07,Wild Cherry - Wild Cherry,31,50,7,1.0,17,Wild Cherry,18.0,2,10,14,19,1,up,1976-07-24
4574,Wild Cherry,1976-08-14,Wild Cherry - Wild Cherry,17,31,5,1.0,7,Wild Cherry,18.0,3,2,10,14,1,up,1976-07-24
4575,Wild Cherry,1976-08-21,Wild Cherry - Wild Cherry,7,17,4,1.0,5,Wild Cherry,18.0,4,1,2,10,1,up,1976-07-24
4576,Wild Cherry,1976-08-28,Wild Cherry - Wild Cherry,5,7,2,1.0,4,Wild Cherry,18.0,5,2,1,2,1,up,1976-07-24
4577,Wild Cherry,1976-09-04,Wild Cherry - Wild Cherry,4,5,1,1.0,2,Wild Cherry,18.0,6,1,2,1,1,up,1976-07-24
4578,Wild Cherry,1976-09-11,Wild Cherry - Wild Cherry,2,4,2,1.0,1,Wild Cherry,18.0,7,-1,1,2,1,down,1976-07-24
4579,Wild Cherry,1976-09-18,Wild Cherry - Wild Cherry,1,2,2,1.0,2,Wild Cherry,18.0,8,0,-1,1,0,stay,1976-07-24
4580,Wild Cherry,1976-09-25,Wild Cherry - Wild Cherry,2,1,3,1.0,2,Wild Cherry,18.0,9,-1,0,-1,1,down,1976-07-24
4581,Wild Cherry,1976-10-02,Wild Cherry - Wild Cherry,2,2,3,1.0,3,Wild Cherry,18.0,10,0,-1,0,0,stay,1976-07-24
4582,Wild Cherry,1976-10-09,Wild Cherry - Wild Cherry,3,2,4,1.0,3,Wild Cherry,18.0,11,-1,0,-1,1,down,1976-07-24
4583,Wild Cherry,1976-10-16,Wild Cherry - Wild Cherry,3,3,11,1.0,4,Wild Cherry,18.0,12,-7,-1,0,1,down,1976-07-24
4584,Wild Cherry,1976-10-23,Wild Cherry - Wild Cherry,4,3,18,1.0,11,Wild Cherry,18.0,13,-7,-7,-1,1,down,1976-07-24
4585,Wild Cherry,1976-10-30,Wild Cherry - Wild Cherry,11,4,21,1.0,18,Wild Cherry,18.0,14,-3,-7,-7,1,down,1976-07-24
4586,Wild Cherry,1976-11-06,Wild Cherry - Wild Cherry,18,11,24,1.0,21,Wild Cherry,18.0,15,-3,-3,-7,1,down,1976-07-24
4587,Wild Cherry,1976-11-13,Wild Cherry - Wild Cherry,21,18,42,1.0,24,Wild Cherry,18.0,16,-18,-3,-3,1,down,1976-07-24
4588,Wild Cherry,1976-11-20,Wild Cherry - Wild Cherry,24,21,42,1.0,42,Wild Cherry,18.0,17,0,-18,-3,0,stay,1976-07-24
4589,Wild Cherry,1976-11-27,Wild Cherry - Wild Cherry,42,24,51,1.0,42,Wild Cherry,18.0,18,-9,0,-18,1,down,1976-07-24
4590,The Spinners,1976-07-31,The Spinners - Happiness Is Being With The Spinners,51,51,18,5.0,28,Happiness Is Being With The Spinners,27.0,0,10,23,0,1,up,1976-07-31
4591,The Spinners,1976-08-07,The Spinners - Happiness Is Being With The Spinners,28,51,12,5.0,18,Happiness Is Being With The Spinners,27.0,1,6,10,23,1,up,1976-07-31
4592,The Spinners,1976-08-14,The Spinners - Happiness Is Being With The Spinners,18,28,9,5.0,12,Happiness Is Being With The Spinners,27.0,2,3,6,10,1,up,1976-07-31
4593,The Spinners,1976-08-21,The Spinners - Happiness Is Being With The Spinners,12,18,9,5.0,9,Happiness Is Being With The Spinners,27.0,3,0,3,6,0,stay,1976-07-31
4594,The Spinners,1976-08-28,The Spinners - Happiness Is Being With The Spinners,9,12,8,5.0,9,Happiness Is Being With The Spinners,27.0,4,1,0,3,1,up,1976-07-31
4595,The Spinners,1976-09-04,The Spinners - Happiness Is Being With The Spinners,9,9,7,5.0,8,Happiness Is Being With The Spinners,27.0,5,1,1,0,1,up,1976-07-31
4596,The Spinners,1976-09-11,The Spinners - Happiness Is Being With The Spinners,8,9,6,5.0,7,Happiness Is Being With The Spinners,27.0,6,1,1,1,1,up,1976-07-31
4597,The Spinners,1976-09-18,The Spinners - Happiness Is Being With The Spinners,7,8,5,5.0,6,Happiness Is Being With The Spinners,27.0,7,1,1,1,1,up,1976-07-31
4598,The Spinners,1976-09-25,The Spinners - Happiness Is Being With The Spinners,6,7,8,5.0,5,Happiness Is Being With The Spinners,27.0,8,-3,1,1,1,down,1976-07-31
4599,The Spinners,1976-10-02,The Spinners - Happiness Is Being With The Spinners,5,6,7,5.0,8,Happiness Is Being With The Spinners,27.0,9,1,-3,1,1,up,1976-07-31
4600,The Spinners,1976-10-09,The Spinners - Happiness Is Being With The Spinners,8,5,18,5.0,7,Happiness Is Being With The Spinners,27.0,10,-11,1,-3,1,down,1976-07-31
4601,The Spinners,1976-10-16,The Spinners - Happiness Is Being With The Spinners,7,8,28,5.0,18,Happiness Is Being With The Spinners,27.0,11,-10,-11,1,1,down,1976-07-31
4602,The Spinners,1976-10-23,The Spinners - Happiness Is Being With The Spinners,18,7,36,5.0,28,Happiness Is Being With The Spinners,27.0,12,-8,-10,-11,1,down,1976-07-31
4603,The Spinners,1976-10-30,The Spinners - Happiness Is Being With The Spinners,28,18,35,5.0,36,Happiness Is Being With The Spinners,27.0,13,1,-8,-10,1,up,1976-07-31
4604,The Spinners,1976-11-06,The Spinners - Happiness Is Being With The Spinners,36,28,32,5.0,35,Happiness Is Being With The Spinners,27.0,14,3,1,-8,1,up,1976-07-31
4605,The Spinners,1976-11-13,The Spinners - Happiness Is Being With The Spinners,35,36,30,5.0,32,Happiness Is Being With The Spinners,27.0,15,2,3,1,1,up,1976-07-31
4606,The Spinners,1976-11-20,The Spinners - Happiness Is Being With The Spinners,32,35,26,5.0,30,Happiness Is Being With The Spinners,27.0,16,4,2,3,1,up,1976-07-31
4607,The Spinners,1976-11-27,The Spinners - Happiness Is Being With The Spinners,30,32,26,5.0,26,Happiness Is Being With The Spinners,27.0,17,0,4,2,0,stay,1976-07-31
4608,The Spinners,1976-12-04,The Spinners - Happiness Is Being With The Spinners,26,30,28,5.0,26,Happiness Is Being With The Spinners,27.0,18,-2,0,4,1,down,1976-07-31
4609,The Spinners,1976-12-11,The Spinners - Happiness Is Being With The Spinners,26,26,25,5.0,28,Happiness Is Being With The Spinners,27.0,19,3,-2,0,1,up,1976-07-31
4610,The Spinners,1976-12-18,The Spinners - Happiness Is Being With The Spinners,28,26,22,5.0,25,Happiness Is Being With The Spinners,27.0,20,3,3,-2,1,up,1976-07-31
4611,The Spinners,1976-12-25,The Spinners - Happiness Is Being With The Spinners,25,28,22,5.0,22,Happiness Is Being With The Spinners,27.0,21,0,3,3,0,stay,1976-07-31
4612,The Spinners,1977-01-01,The Spinners - Happiness Is Being With The Spinners,22,25,20,5.0,22,Happiness Is Being With The Spinners,27.0,22,2,0,3,1,up,1976-07-31
4613,The Spinners,1977-01-08,The Spinners - Happiness Is Being With The Spinners,22,22,17,5.0,20,Happiness Is Being With The Spinners,27.0,23,3,2,0,1,up,1976-07-31
4614,The Spinners,1977-01-15,The Spinners - Happiness Is Being With The Spinners,20,22,22,5.0,17,Happiness Is Being With The Spinners,27.0,24,-5,3,2,1,down,1976-07-31
4615,The Spinners,1977-01-22,The Spinners - Happiness Is Being With The Spinners,17,20,32,5.0,22,Happiness Is Being With The Spinners,27.0,25,-10,-5,3,1,down,1976-07-31
4616,The Spinners,1977-01-29,The Spinners - Happiness Is Being With The Spinners,22,17,48,5.0,32,Happiness Is Being With The Spinners,27.0,26,-16,-10,-5,1,down,1976-07-31
4617,The Spinners,1977-02-05,The Spinners - Happiness Is Being With The Spinners,32,22,51,5.0,48,Happiness Is Being With The Spinners,27.0,27,-3,-16,-10,1,down,1976-07-31
4618,Isaac Hayes,1976-07-31,Isaac Hayes - Juicy Fruit (disco Freak),51,51,27,18.0,38,Juicy Fruit (disco Freak),6.0,0,11,13,0,1,up,1976-07-31
4619,Isaac Hayes,1976-08-07,Isaac Hayes - Juicy Fruit (disco Freak),38,51,21,18.0,27,Juicy Fruit (disco Freak),6.0,1,6,11,13,1,up,1976-07-31
4620,Isaac Hayes,1976-08-14,Isaac Hayes - Juicy Fruit (disco Freak),27,38,18,18.0,21,Juicy Fruit (disco Freak),6.0,2,3,6,11,1,up,1976-07-31
4621,Isaac Hayes,1976-08-21,Isaac Hayes - Juicy Fruit (disco Freak),21,27,27,18.0,18,Juicy Fruit (disco Freak),6.0,3,-9,3,6,1,down,1976-07-31
4622,Isaac Hayes,1976-08-28,Isaac Hayes - Juicy Fruit (disco Freak),18,21,41,18.0,27,Juicy Fruit (disco Freak),6.0,4,-14,-9,3,1,down,1976-07-31
4623,Isaac Hayes,1976-09-04,Isaac Hayes - Juicy Fruit (disco Freak),27,18,45,18.0,41,Juicy Fruit (disco Freak),6.0,5,-4,-14,-9,1,down,1976-07-31
4624,Isaac Hayes,1976-09-11,Isaac Hayes - Juicy Fruit (disco Freak),41,27,51,18.0,45,Juicy Fruit (disco Freak),6.0,6,-6,-4,-14,1,down,1976-07-31
4625,Jim Gilstrap,1976-07-31,Jim Gilstrap - Love Talk,51,51,40,36.0,50,Love Talk,7.0,0,10,1,0,1,up,1976-07-31
4626,Jim Gilstrap,1976-08-07,Jim Gilstrap - Love Talk,50,51,40,36.0,40,Love Talk,7.0,1,0,10,1,0,stay,1976-07-31
4627,Jim Gilstrap,1976-08-14,Jim Gilstrap - Love Talk,40,50,40,36.0,40,Love Talk,7.0,2,0,0,10,0,stay,1976-07-31
4628,Jim Gilstrap,1976-08-21,Jim Gilstrap - Love Talk,40,40,36,36.0,40,Love Talk,7.0,3,4,0,0,1,up,1976-07-31
4629,Jim Gilstrap,1976-08-28,Jim Gilstrap - Love Talk,40,40,50,36.0,36,Love Talk,7.0,4,-14,4,0,1,down,1976-07-31
4630,Jim Gilstrap,1976-09-11,Jim Gilstrap - Love Talk,36,40,50,36.0,50,Love Talk,7.0,5,0,-14,4,0,stay,1976-07-31
4631,Jim Gilstrap,1976-09-18,Jim Gilstrap - Love Talk,50,36,48,36.0,50,Love Talk,7.0,6,2,0,-14,1,up,1976-07-31
4632,Jim Gilstrap,1976-09-25,Jim Gilstrap - Love Talk,50,50,51,36.0,48,Love Talk,7.0,7,-3,2,0,1,down,1976-07-31
4633,The Ritchie Family,1976-08-07,The Ritchie Family - Arabian Nights,51,51,38,23.0,48,Arabian Nights,13.0,0,10,3,0,1,up,1976-08-07
4634,The Ritchie Family,1976-08-14,The Ritchie Family - Arabian Nights,48,51,29,23.0,38,Arabian Nights,13.0,1,9,10,3,1,up,1976-08-07
4635,The Ritchie Family,1976-08-21,The Ritchie Family - Arabian Nights,38,48,26,23.0,29,Arabian Nights,13.0,2,3,9,10,1,up,1976-08-07
4636,The Ritchie Family,1976-08-28,The Ritchie Family - Arabian Nights,29,38,24,23.0,26,Arabian Nights,13.0,3,2,3,9,1,up,1976-08-07
4637,The Ritchie Family,1976-09-04,The Ritchie Family - Arabian Nights,26,29,24,23.0,24,Arabian Nights,13.0,4,0,2,3,0,stay,1976-08-07
4638,The Ritchie Family,1976-09-11,The Ritchie Family - Arabian Nights,24,26,23,23.0,24,Arabian Nights,13.0,5,1,0,2,1,up,1976-08-07
4639,The Ritchie Family,1976-09-18,The Ritchie Family - Arabian Nights,24,24,23,23.0,23,Arabian Nights,13.0,6,0,1,0,0,stay,1976-08-07
4640,The Ritchie Family,1976-09-25,The Ritchie Family - Arabian Nights,23,24,34,23.0,23,Arabian Nights,13.0,7,-11,0,1,1,down,1976-08-07
4641,The Ritchie Family,1976-10-02,The Ritchie Family - Arabian Nights,23,23,45,23.0,34,Arabian Nights,13.0,8,-11,-11,0,1,down,1976-08-07
4642,The Ritchie Family,1976-10-09,The Ritchie Family - Arabian Nights,34,23,45,23.0,45,Arabian Nights,13.0,9,0,-11,-11,0,stay,1976-08-07
4643,The Ritchie Family,1976-10-16,The Ritchie Family - Arabian Nights,45,34,41,23.0,45,Arabian Nights,13.0,10,4,0,-11,1,up,1976-08-07
4644,The Ritchie Family,1976-10-23,The Ritchie Family - Arabian Nights,45,45,41,23.0,41,Arabian Nights,13.0,11,0,4,0,0,stay,1976-08-07
4645,The Ritchie Family,1976-10-30,The Ritchie Family - Arabian Nights,41,45,44,23.0,41,Arabian Nights,13.0,12,-3,0,4,1,down,1976-08-07
4646,The Ritchie Family,1976-11-06,The Ritchie Family - Arabian Nights,41,41,51,23.0,44,Arabian Nights,13.0,13,-7,-3,0,1,down,1976-08-07
4647,The Main Ingredient,1976-08-07,The Main Ingredient - Super Hits,51,51,46,46.0,50,Super Hits,1.0,0,4,1,0,1,up,1976-08-07
4648,The Main Ingredient,1976-08-14,The Main Ingredient - Super Hits,50,51,51,46.0,46,Super Hits,1.0,1,-5,4,1,1,down,1976-08-07
4649,Diana Ross,1976-08-14,Diana Ross - Diana Ross' Greatest Hits,51,51,12,10.0,17,Diana Ross' Greatest Hits,7.0,0,5,34,0,1,up,1976-08-14
4650,Diana Ross,1976-08-21,Diana Ross - Diana Ross' Greatest Hits,17,51,11,10.0,12,Diana Ross' Greatest Hits,7.0,1,1,5,34,1,up,1976-08-14
4651,Diana Ross,1976-08-28,Diana Ross - Diana Ross' Greatest Hits,12,17,10,10.0,11,Diana Ross' Greatest Hits,7.0,2,1,1,5,1,up,1976-08-14
4652,Diana Ross,1976-09-04,Diana Ross - Diana Ross' Greatest Hits,11,12,13,10.0,10,Diana Ross' Greatest Hits,7.0,3,-3,1,1,1,down,1976-08-14
4653,Diana Ross,1976-09-11,Diana Ross - Diana Ross' Greatest Hits,10,11,27,10.0,13,Diana Ross' Greatest Hits,7.0,4,-14,-3,1,1,down,1976-08-14
4654,Diana Ross,1976-09-18,Diana Ross - Diana Ross' Greatest Hits,13,10,36,10.0,27,Diana Ross' Greatest Hits,7.0,5,-9,-14,-3,1,down,1976-08-14
4655,Diana Ross,1976-09-25,Diana Ross - Diana Ross' Greatest Hits,27,13,50,10.0,36,Diana Ross' Greatest Hits,7.0,6,-14,-9,-14,1,down,1976-08-14
4656,Diana Ross,1976-10-02,Diana Ross - Diana Ross' Greatest Hits,36,27,51,10.0,50,Diana Ross' Greatest Hits,7.0,7,-1,-14,-9,1,down,1976-08-14
4657,Roy Ayers Ubiquity,1976-08-14,Roy Ayers Ubiquity - Everybody Loves The Sunshine,51,51,27,10.0,43,Everybody Loves The Sunshine,16.0,0,16,8,0,1,up,1976-08-14
4658,Roy Ayers Ubiquity,1976-08-21,Roy Ayers Ubiquity - Everybody Loves The Sunshine,43,51,21,10.0,27,Everybody Loves The Sunshine,16.0,1,6,16,8,1,up,1976-08-14
4659,Roy Ayers Ubiquity,1976-08-28,Roy Ayers Ubiquity - Everybody Loves The Sunshine,27,43,18,10.0,21,Everybody Loves The Sunshine,16.0,2,3,6,16,1,up,1976-08-14
4660,Roy Ayers Ubiquity,1976-09-04,Roy Ayers Ubiquity - Everybody Loves The Sunshine,21,27,15,10.0,18,Everybody Loves The Sunshine,16.0,3,3,3,6,1,up,1976-08-14
4661,Roy Ayers Ubiquity,1976-09-11,Roy Ayers Ubiquity - Everybody Loves The Sunshine,18,21,13,10.0,15,Everybody Loves The Sunshine,16.0,4,2,3,3,1,up,1976-08-14
4662,Roy Ayers Ubiquity,1976-09-18,Roy Ayers Ubiquity - Everybody Loves The Sunshine,15,18,11,10.0,13,Everybody Loves The Sunshine,16.0,5,2,2,3,1,up,1976-08-14
4663,Roy Ayers Ubiquity,1976-09-25,Roy Ayers Ubiquity - Everybody Loves The Sunshine,13,15,10,10.0,11,Everybody Loves The Sunshine,16.0,6,1,2,2,1,up,1976-08-14
4664,Roy Ayers Ubiquity,1976-10-02,Roy Ayers Ubiquity - Everybody Loves The Sunshine,11,13,11,10.0,10,Everybody Loves The Sunshine,16.0,7,-1,1,2,1,down,1976-08-14
4665,Roy Ayers Ubiquity,1976-10-09,Roy Ayers Ubiquity - Everybody Loves The Sunshine,10,11,14,10.0,11,Everybody Loves The Sunshine,16.0,8,-3,-1,1,1,down,1976-08-14
4666,Roy Ayers Ubiquity,1976-10-16,Roy Ayers Ubiquity - Everybody Loves The Sunshine,11,10,14,10.0,14,Everybody Loves The Sunshine,16.0,9,0,-3,-1,0,stay,1976-08-14
4667,Roy Ayers Ubiquity,1976-10-23,Roy Ayers Ubiquity - Everybody Loves The Sunshine,14,11,26,10.0,14,Everybody Loves The Sunshine,16.0,10,-12,0,-3,1,down,1976-08-14
4668,Roy Ayers Ubiquity,1976-10-30,Roy Ayers Ubiquity - Everybody Loves The Sunshine,14,14,26,10.0,26,Everybody Loves The Sunshine,16.0,11,0,-12,0,0,stay,1976-08-14
4669,Roy Ayers Ubiquity,1976-11-06,Roy Ayers Ubiquity - Everybody Loves The Sunshine,26,14,29,10.0,26,Everybody Loves The Sunshine,16.0,12,-3,0,-12,1,down,1976-08-14
4670,Roy Ayers Ubiquity,1976-11-13,Roy Ayers Ubiquity - Everybody Loves The Sunshine,26,26,39,10.0,29,Everybody Loves The Sunshine,16.0,13,-10,-3,0,1,down,1976-08-14
4671,Roy Ayers Ubiquity,1976-11-20,Roy Ayers Ubiquity - Everybody Loves The Sunshine,29,26,47,10.0,39,Everybody Loves The Sunshine,16.0,14,-8,-10,-3,1,down,1976-08-14
4672,Roy Ayers Ubiquity,1976-11-27,Roy Ayers Ubiquity - Everybody Loves The Sunshine,39,29,47,10.0,47,Everybody Loves The Sunshine,16.0,15,0,-8,-10,0,stay,1976-08-14
4673,Roy Ayers Ubiquity,1976-12-04,Roy Ayers Ubiquity - Everybody Loves The Sunshine,47,39,51,10.0,47,Everybody Loves The Sunshine,16.0,16,-4,0,-8,1,down,1976-08-14
4674,The Emotions,1976-08-14,The Emotions - Flowers,51,51,42,5.0,47,Flowers,30.0,0,5,4,0,1,up,1976-08-14
4675,The Emotions,1976-08-21,The Emotions - Flowers,47,51,34,5.0,42,Flowers,30.0,1,8,5,4,1,up,1976-08-14
4676,The Emotions,1976-08-28,The Emotions - Flowers,42,47,26,5.0,34,Flowers,30.0,2,8,8,5,1,up,1976-08-14
4677,The Emotions,1976-09-04,The Emotions - Flowers,34,42,25,5.0,26,Flowers,30.0,3,1,8,8,1,up,1976-08-14
4678,The Emotions,1976-09-11,The Emotions - Flowers,26,34,18,5.0,25,Flowers,30.0,4,7,1,8,1,up,1976-08-14
4679,The Emotions,1976-09-18,The Emotions - Flowers,25,26,17,5.0,18,Flowers,30.0,5,1,7,1,1,up,1976-08-14
4680,The Emotions,1976-09-25,The Emotions - Flowers,18,25,13,5.0,17,Flowers,30.0,6,4,1,7,1,up,1976-08-14
4681,The Emotions,1976-10-02,The Emotions - Flowers,17,18,9,5.0,13,Flowers,30.0,7,4,4,1,1,up,1976-08-14
4682,The Emotions,1976-10-09,The Emotions - Flowers,13,17,9,5.0,9,Flowers,30.0,8,0,4,4,0,stay,1976-08-14
4683,The Emotions,1976-10-16,The Emotions - Flowers,9,13,10,5.0,9,Flowers,30.0,9,-1,0,4,1,down,1976-08-14
4684,The Emotions,1976-10-23,The Emotions - Flowers,9,9,11,5.0,10,Flowers,30.0,10,-1,-1,0,1,down,1976-08-14
4685,The Emotions,1976-10-30,The Emotions - Flowers,10,9,11,5.0,11,Flowers,30.0,11,0,-1,-1,0,stay,1976-08-14
4686,The Emotions,1976-11-06,The Emotions - Flowers,11,10,10,5.0,11,Flowers,30.0,12,1,0,-1,1,up,1976-08-14
4687,The Emotions,1976-11-13,The Emotions - Flowers,11,11,9,5.0,10,Flowers,30.0,13,1,1,0,1,up,1976-08-14
4688,The Emotions,1976-11-20,The Emotions - Flowers,10,11,5,5.0,9,Flowers,30.0,14,4,1,1,1,up,1976-08-14
4689,The Emotions,1976-11-27,The Emotions - Flowers,9,10,5,5.0,5,Flowers,30.0,15,0,4,1,0,stay,1976-08-14
4690,The Emotions,1976-12-04,The Emotions - Flowers,5,9,8,5.0,5,Flowers,30.0,16,-3,0,4,1,down,1976-08-14
4691,The Emotions,1976-12-11,The Emotions - Flowers,5,5,8,5.0,8,Flowers,30.0,17,0,-3,0,0,stay,1976-08-14
4692,The Emotions,1976-12-18,The Emotions - Flowers,8,5,9,5.0,8,Flowers,30.0,18,-1,0,-3,1,down,1976-08-14
4693,The Emotions,1976-12-25,The Emotions - Flowers,8,8,9,5.0,9,Flowers,30.0,19,0,-1,0,0,stay,1976-08-14
4694,The Emotions,1977-01-01,The Emotions - Flowers,9,8,11,5.0,9,Flowers,30.0,20,-2,0,-1,1,down,1976-08-14
4695,The Emotions,1977-01-08,The Emotions - Flowers,9,9,10,5.0,11,Flowers,30.0,21,1,-2,0,1,up,1976-08-14
4696,The Emotions,1977-01-15,The Emotions - Flowers,11,9,10,5.0,10,Flowers,30.0,22,0,1,-2,0,stay,1976-08-14
4697,The Emotions,1977-01-22,The Emotions - Flowers,10,11,14,5.0,10,Flowers,30.0,23,-4,0,1,1,down,1976-08-14
4698,The Emotions,1977-01-29,The Emotions - Flowers,10,10,13,5.0,14,Flowers,30.0,24,1,-4,0,1,up,1976-08-14
4699,The Emotions,1977-02-05,The Emotions - Flowers,14,10,19,5.0,13,Flowers,30.0,25,-6,1,-4,1,down,1976-08-14
4700,The Emotions,1977-02-12,The Emotions - Flowers,13,14,24,5.0,19,Flowers,30.0,26,-5,-6,1,1,down,1976-08-14
4701,The Emotions,1977-02-19,The Emotions - Flowers,19,13,27,5.0,24,Flowers,30.0,27,-3,-5,-6,1,down,1976-08-14
4702,The Emotions,1977-02-26,The Emotions - Flowers,24,19,42,5.0,27,Flowers,30.0,28,-15,-3,-5,1,down,1976-08-14
4703,The Emotions,1977-03-05,The Emotions - Flowers,27,24,44,5.0,42,Flowers,30.0,29,-2,-15,-3,1,down,1976-08-14
4704,The Emotions,1977-03-12,The Emotions - Flowers,42,27,51,5.0,44,Flowers,30.0,30,-7,-2,-15,1,down,1976-08-14
4705,Dexter Wansel,1976-08-14,Dexter Wansel - Life On Mars,51,51,44,44.0,49,Life On Mars,2.0,0,5,2,0,1,up,1976-08-14
4706,Dexter Wansel,1976-08-21,Dexter Wansel - Life On Mars,49,51,44,44.0,44,Life On Mars,2.0,1,0,5,2,0,stay,1976-08-14
4707,Dexter Wansel,1976-08-28,Dexter Wansel - Life On Mars,44,49,51,44.0,44,Life On Mars,2.0,2,-7,0,5,1,down,1976-08-14
4708,James Brown,1976-08-14,James Brown - Get Up Offa That Thing,51,51,25,14.0,50,Get Up Offa That Thing,8.0,0,25,1,0,1,up,1976-08-14
4709,James Brown,1976-08-21,James Brown - Get Up Offa That Thing,50,51,19,14.0,25,Get Up Offa That Thing,8.0,1,6,25,1,1,up,1976-08-14
4710,James Brown,1976-08-28,James Brown - Get Up Offa That Thing,25,50,17,14.0,19,Get Up Offa That Thing,8.0,2,2,6,25,1,up,1976-08-14
4711,James Brown,1976-09-04,James Brown - Get Up Offa That Thing,19,25,14,14.0,17,Get Up Offa That Thing,8.0,3,3,2,6,1,up,1976-08-14
4712,James Brown,1976-09-11,James Brown - Get Up Offa That Thing,17,19,14,14.0,14,Get Up Offa That Thing,8.0,4,0,3,2,0,stay,1976-08-14
4713,James Brown,1976-09-18,James Brown - Get Up Offa That Thing,14,17,19,14.0,14,Get Up Offa That Thing,8.0,5,-5,0,3,1,down,1976-08-14
4714,James Brown,1976-09-25,James Brown - Get Up Offa That Thing,14,14,24,14.0,19,Get Up Offa That Thing,8.0,6,-5,-5,0,1,down,1976-08-14
4715,James Brown,1976-10-02,James Brown - Get Up Offa That Thing,19,14,32,14.0,24,Get Up Offa That Thing,8.0,7,-8,-5,-5,1,down,1976-08-14
4716,James Brown,1976-10-09,James Brown - Get Up Offa That Thing,24,19,51,14.0,32,Get Up Offa That Thing,8.0,8,-19,-8,-5,1,down,1976-08-14
4717,Boz Scaggs,1976-08-21,Boz Scaggs - Silk Degrees,51,51,30,6.0,45,Silk Degrees,17.0,0,15,6,0,1,up,1976-08-21
4718,Boz Scaggs,1976-08-28,Boz Scaggs - Silk Degrees,45,51,22,6.0,30,Silk Degrees,17.0,1,8,15,6,1,up,1976-08-21
4719,Boz Scaggs,1976-09-04,Boz Scaggs - Silk Degrees,30,45,17,6.0,22,Silk Degrees,17.0,2,5,8,15,1,up,1976-08-21
4720,Boz Scaggs,1976-09-11,Boz Scaggs - Silk Degrees,22,30,10,6.0,17,Silk Degrees,17.0,3,7,5,8,1,up,1976-08-21
4721,Boz Scaggs,1976-09-18,Boz Scaggs - Silk Degrees,17,22,9,6.0,10,Silk Degrees,17.0,4,1,7,5,1,up,1976-08-21
4722,Boz Scaggs,1976-09-25,Boz Scaggs - Silk Degrees,10,17,7,6.0,9,Silk Degrees,17.0,5,2,1,7,1,up,1976-08-21
4723,Boz Scaggs,1976-10-02,Boz Scaggs - Silk Degrees,9,10,6,6.0,7,Silk Degrees,17.0,6,1,2,1,1,up,1976-08-21
4724,Boz Scaggs,1976-10-09,Boz Scaggs - Silk Degrees,7,9,15,6.0,6,Silk Degrees,17.0,7,-9,1,2,1,down,1976-08-21
4725,Boz Scaggs,1976-10-16,Boz Scaggs - Silk Degrees,6,7,15,6.0,15,Silk Degrees,17.0,8,0,-9,1,0,stay,1976-08-21
4726,Boz Scaggs,1976-10-23,Boz Scaggs - Silk Degrees,15,6,27,6.0,15,Silk Degrees,17.0,9,-12,0,-9,1,down,1976-08-21
4727,Boz Scaggs,1976-10-30,Boz Scaggs - Silk Degrees,15,15,22,6.0,27,Silk Degrees,17.0,10,5,-12,0,1,up,1976-08-21
4728,Boz Scaggs,1976-11-06,Boz Scaggs - Silk Degrees,27,15,28,6.0,22,Silk Degrees,17.0,11,-6,5,-12,1,down,1976-08-21
4729,Boz Scaggs,1976-11-13,Boz Scaggs - Silk Degrees,22,27,28,6.0,28,Silk Degrees,17.0,12,0,-6,5,0,stay,1976-08-21
4730,Boz Scaggs,1976-11-20,Boz Scaggs - Silk Degrees,28,22,30,6.0,28,Silk Degrees,17.0,13,-2,0,-6,1,down,1976-08-21
4731,Boz Scaggs,1976-11-27,Boz Scaggs - Silk Degrees,28,28,31,6.0,30,Silk Degrees,17.0,14,-1,-2,0,1,down,1976-08-21
4732,Boz Scaggs,1976-12-04,Boz Scaggs - Silk Degrees,30,28,29,6.0,31,Silk Degrees,17.0,15,2,-1,-2,1,up,1976-08-21
4733,Boz Scaggs,1976-12-11,Boz Scaggs - Silk Degrees,31,30,31,6.0,29,Silk Degrees,17.0,16,-2,2,-1,1,down,1976-08-21
4734,Boz Scaggs,1976-12-18,Boz Scaggs - Silk Degrees,29,31,51,6.0,31,Silk Degrees,17.0,17,-20,-2,2,1,down,1976-08-21
4735,The Fatback Band,1976-08-21,The Fatback Band - Night Fever,51,51,43,31.0,49,Night Fever,6.0,0,6,2,0,1,up,1976-08-21
4736,The Fatback Band,1976-08-28,The Fatback Band - Night Fever,49,51,39,31.0,43,Night Fever,6.0,1,4,6,2,1,up,1976-08-21
4737,The Fatback Band,1976-09-04,The Fatback Band - Night Fever,43,49,38,31.0,39,Night Fever,6.0,2,1,4,6,1,up,1976-08-21
4738,The Fatback Band,1976-09-11,The Fatback Band - Night Fever,39,43,35,31.0,38,Night Fever,6.0,3,3,1,4,1,up,1976-08-21
4739,The Fatback Band,1976-09-18,The Fatback Band - Night Fever,38,39,34,31.0,35,Night Fever,6.0,4,1,3,1,1,up,1976-08-21
4740,The Fatback Band,1976-09-25,The Fatback Band - Night Fever,35,38,31,31.0,34,Night Fever,6.0,5,3,1,3,1,up,1976-08-21
4741,The Fatback Band,1976-10-02,The Fatback Band - Night Fever,34,35,51,31.0,31,Night Fever,6.0,6,-20,3,1,1,down,1976-08-21
4742,Jarreau,1976-08-21,Jarreau - Glow,51,51,45,30.0,50,Glow,6.0,0,5,1,0,1,up,1976-08-21
4743,Jarreau,1976-08-28,Jarreau - Glow,50,51,42,30.0,45,Glow,6.0,1,3,5,1,1,up,1976-08-21
4744,Jarreau,1976-09-04,Jarreau - Glow,45,50,37,30.0,42,Glow,6.0,2,5,3,5,1,up,1976-08-21
4745,Jarreau,1976-09-11,Jarreau - Glow,42,45,33,30.0,37,Glow,6.0,3,4,5,3,1,up,1976-08-21
4746,Jarreau,1976-09-18,Jarreau - Glow,37,42,30,30.0,33,Glow,6.0,4,3,4,5,1,up,1976-08-21
4747,Jarreau,1976-09-25,Jarreau - Glow,33,37,30,30.0,30,Glow,6.0,5,0,3,4,0,stay,1976-08-21
4748,Jarreau,1976-10-02,Jarreau - Glow,30,33,51,30.0,30,Glow,6.0,6,-21,0,3,1,down,1976-08-21
4749,Gloria Gaynor,1976-08-28,Gloria Gaynor - I've Got You,51,51,40,40.0,46,I've Got You,2.0,0,6,5,0,1,up,1976-08-28
4750,Gloria Gaynor,1976-09-04,Gloria Gaynor - I've Got You,46,51,40,40.0,40,I've Got You,2.0,1,0,6,5,0,stay,1976-08-28
4751,Gloria Gaynor,1976-09-11,Gloria Gaynor - I've Got You,40,46,51,40.0,40,I've Got You,2.0,2,-11,0,6,1,down,1976-08-28
4752,Double Exposure,1976-08-28,Double Exposure - Ten Percent,51,51,44,40.0,49,Ten Percent,6.0,0,5,2,0,1,up,1976-08-28
4753,Double Exposure,1976-09-04,Double Exposure - Ten Percent,49,51,44,40.0,44,Ten Percent,6.0,1,0,5,2,0,stay,1976-08-28
4754,Double Exposure,1976-09-11,Double Exposure - Ten Percent,44,49,41,40.0,44,Ten Percent,6.0,2,3,0,5,1,up,1976-08-28
4755,Double Exposure,1976-09-18,Double Exposure - Ten Percent,44,44,41,40.0,41,Ten Percent,6.0,3,0,3,0,0,stay,1976-08-28
4756,Double Exposure,1976-09-25,Double Exposure - Ten Percent,41,44,40,40.0,41,Ten Percent,6.0,4,1,0,3,1,up,1976-08-28
4757,Double Exposure,1976-10-02,Double Exposure - Ten Percent,41,41,40,40.0,40,Ten Percent,6.0,5,0,1,0,0,stay,1976-08-28
4758,Double Exposure,1976-10-09,Double Exposure - Ten Percent,40,41,51,40.0,40,Ten Percent,6.0,6,-11,0,1,1,down,1976-08-28
4759,L.T.D.,1976-08-28,L.T.D. - Love To The World,51,51,33,7.0,50,Love To The World,25.0,0,17,1,0,1,up,1976-08-28
4760,L.T.D.,1976-09-04,L.T.D. - Love To The World,50,51,29,7.0,33,Love To The World,25.0,1,4,17,1,1,up,1976-08-28
4761,L.T.D.,1976-09-11,L.T.D. - Love To The World,33,50,22,7.0,29,Love To The World,25.0,2,7,4,17,1,up,1976-08-28
4762,L.T.D.,1976-09-18,L.T.D. - Love To The World,29,33,15,7.0,22,Love To The World,25.0,3,7,7,4,1,up,1976-08-28
4763,L.T.D.,1976-09-25,L.T.D. - Love To The World,22,29,12,7.0,15,Love To The World,25.0,4,3,7,7,1,up,1976-08-28
4764,L.T.D.,1976-10-02,L.T.D. - Love To The World,15,22,12,7.0,12,Love To The World,25.0,5,0,3,7,0,stay,1976-08-28
4765,L.T.D.,1976-10-09,L.T.D. - Love To The World,12,15,11,7.0,12,Love To The World,25.0,6,1,0,3,1,up,1976-08-28
4766,L.T.D.,1976-10-16,L.T.D. - Love To The World,12,12,9,7.0,11,Love To The World,25.0,7,2,1,0,1,up,1976-08-28
4767,L.T.D.,1976-10-23,L.T.D. - Love To The World,11,12,9,7.0,9,Love To The World,25.0,8,0,2,1,0,stay,1976-08-28
4768,L.T.D.,1976-10-30,L.T.D. - Love To The World,9,11,8,7.0,9,Love To The World,25.0,9,1,0,2,1,up,1976-08-28
4769,L.T.D.,1976-11-06,L.T.D. - Love To The World,9,9,8,7.0,8,Love To The World,25.0,10,0,1,0,0,stay,1976-08-28
4770,L.T.D.,1976-11-13,L.T.D. - Love To The World,8,9,7,7.0,8,Love To The World,25.0,11,1,0,1,1,up,1976-08-28
4771,L.T.D.,1976-11-20,L.T.D. - Love To The World,8,8,7,7.0,7,Love To The World,25.0,12,0,1,0,0,stay,1976-08-28
4772,L.T.D.,1976-11-27,L.T.D. - Love To The World,7,8,14,7.0,7,Love To The World,25.0,13,-7,0,1,1,down,1976-08-28
4773,L.T.D.,1976-12-04,L.T.D. - Love To The World,7,7,11,7.0,14,Love To The World,25.0,14,3,-7,0,1,up,1976-08-28
4774,L.T.D.,1976-12-11,L.T.D. - Love To The World,14,7,11,7.0,11,Love To The World,25.0,15,0,3,-7,0,stay,1976-08-28
4775,L.T.D.,1976-12-18,L.T.D. - Love To The World,11,14,15,7.0,11,Love To The World,25.0,16,-4,0,3,1,down,1976-08-28
4776,L.T.D.,1976-12-25,L.T.D. - Love To The World,11,11,15,7.0,15,Love To The World,25.0,17,0,-4,0,0,stay,1976-08-28
4777,L.T.D.,1977-01-01,L.T.D. - Love To The World,15,11,15,7.0,15,Love To The World,25.0,18,0,0,-4,0,stay,1976-08-28
4778,L.T.D.,1977-01-08,L.T.D. - Love To The World,15,15,21,7.0,15,Love To The World,25.0,19,-6,0,0,1,down,1976-08-28
4779,L.T.D.,1977-01-15,L.T.D. - Love To The World,15,15,26,7.0,21,Love To The World,25.0,20,-5,-6,0,1,down,1976-08-28
4780,L.T.D.,1977-01-22,L.T.D. - Love To The World,21,15,31,7.0,26,Love To The World,25.0,21,-5,-5,-6,1,down,1976-08-28
4781,L.T.D.,1977-01-29,L.T.D. - Love To The World,26,21,31,7.0,31,Love To The World,25.0,22,0,-5,-5,0,stay,1976-08-28
4782,L.T.D.,1977-02-05,L.T.D. - Love To The World,31,26,38,7.0,31,Love To The World,25.0,23,-7,0,-5,1,down,1976-08-28
4783,L.T.D.,1977-02-12,L.T.D. - Love To The World,31,31,43,7.0,38,Love To The World,25.0,24,-5,-7,0,1,down,1976-08-28
4784,L.T.D.,1977-02-19,L.T.D. - Love To The World,38,31,51,7.0,43,Love To The World,25.0,25,-8,-5,-7,1,down,1976-08-28
4785,Rimshots,1976-09-04,Rimshots - Down To Earth,51,51,41,41.0,45,Down To Earth,1.0,0,4,6,0,1,up,1976-09-04
4786,Rimshots,1976-09-11,Rimshots - Down To Earth,45,51,51,41.0,41,Down To Earth,1.0,1,-10,4,6,1,down,1976-09-04
4787,Freddie Hubbard,1976-09-04,Freddie Hubbard - Windjammer,51,51,36,17.0,48,Windjammer,6.0,0,12,3,0,1,up,1976-09-04
4788,Freddie Hubbard,1976-09-11,Freddie Hubbard - Windjammer,48,51,24,17.0,36,Windjammer,6.0,1,12,12,3,1,up,1976-09-04
4789,Freddie Hubbard,1976-09-18,Freddie Hubbard - Windjammer,36,48,20,17.0,24,Windjammer,6.0,2,4,12,12,1,up,1976-09-04
4790,Freddie Hubbard,1976-09-25,Freddie Hubbard - Windjammer,24,36,17,17.0,20,Windjammer,6.0,3,3,4,12,1,up,1976-09-04
4791,Freddie Hubbard,1976-10-02,Freddie Hubbard - Windjammer,20,24,17,17.0,17,Windjammer,6.0,4,0,3,4,0,stay,1976-09-04
4792,Freddie Hubbard,1976-10-09,Freddie Hubbard - Windjammer,17,20,38,17.0,17,Windjammer,6.0,5,-21,0,3,1,down,1976-09-04
4793,Freddie Hubbard,1976-10-16,Freddie Hubbard - Windjammer,17,17,51,17.0,38,Windjammer,6.0,6,-13,-21,0,1,down,1976-09-04
4794,Herbie Hancock,1976-09-11,Herbie Hancock - Secrets,51,51,12,8.0,28,Secrets,8.0,0,16,23,0,1,up,1976-09-11
4795,Herbie Hancock,1976-09-18,Herbie Hancock - Secrets,28,51,10,8.0,12,Secrets,8.0,1,2,16,23,1,up,1976-09-11
4796,Herbie Hancock,1976-09-25,Herbie Hancock - Secrets,12,28,9,8.0,10,Secrets,8.0,2,1,2,16,1,up,1976-09-11
4797,Herbie Hancock,1976-10-02,Herbie Hancock - Secrets,10,12,8,8.0,9,Secrets,8.0,3,1,1,2,1,up,1976-09-11
4798,Herbie Hancock,1976-10-09,Herbie Hancock - Secrets,9,10,22,8.0,8,Secrets,8.0,4,-14,1,1,1,down,1976-09-11
4799,Herbie Hancock,1976-10-16,Herbie Hancock - Secrets,8,9,34,8.0,22,Secrets,8.0,5,-12,-14,1,1,down,1976-09-11
4800,Herbie Hancock,1976-10-23,Herbie Hancock - Secrets,22,8,43,8.0,34,Secrets,8.0,6,-9,-12,-14,1,down,1976-09-11
4801,Herbie Hancock,1976-10-30,Herbie Hancock - Secrets,34,22,43,8.0,43,Secrets,8.0,7,0,-9,-12,0,stay,1976-09-11
4802,Herbie Hancock,1976-11-06,Herbie Hancock - Secrets,43,34,51,8.0,43,Secrets,8.0,8,-8,0,-9,1,down,1976-09-11
4803,The Temptations,1976-09-11,The Temptations - The Temptations Do The Temptations,51,51,17,10.0,30,The Temptations Do The Temptations,11.0,0,13,21,0,1,up,1976-09-11
4804,The Temptations,1976-09-18,The Temptations - The Temptations Do The Temptations,30,51,13,10.0,17,The Temptations Do The Temptations,11.0,1,4,13,21,1,up,1976-09-11
4805,The Temptations,1976-09-25,The Temptations - The Temptations Do The Temptations,17,30,11,10.0,13,The Temptations Do The Temptations,11.0,2,2,4,13,1,up,1976-09-11
4806,The Temptations,1976-10-02,The Temptations - The Temptations Do The Temptations,13,17,10,10.0,11,The Temptations Do The Temptations,11.0,3,1,2,4,1,up,1976-09-11
4807,The Temptations,1976-10-09,The Temptations - The Temptations Do The Temptations,11,13,13,10.0,10,The Temptations Do The Temptations,11.0,4,-3,1,2,1,down,1976-09-11
4808,The Temptations,1976-10-16,The Temptations - The Temptations Do The Temptations,10,11,12,10.0,13,The Temptations Do The Temptations,11.0,5,1,-3,1,1,up,1976-09-11
4809,The Temptations,1976-10-23,The Temptations - The Temptations Do The Temptations,13,10,14,10.0,12,The Temptations Do The Temptations,11.0,6,-2,1,-3,1,down,1976-09-11
4810,The Temptations,1976-10-30,The Temptations - The Temptations Do The Temptations,12,13,15,10.0,14,The Temptations Do The Temptations,11.0,7,-1,-2,1,1,down,1976-09-11
4811,The Temptations,1976-11-06,The Temptations - The Temptations Do The Temptations,14,12,17,10.0,15,The Temptations Do The Temptations,11.0,8,-2,-1,-2,1,down,1976-09-11
4812,The Temptations,1976-11-13,The Temptations - The Temptations Do The Temptations,15,14,27,10.0,17,The Temptations Do The Temptations,11.0,9,-10,-2,-1,1,down,1976-09-11
4813,The Temptations,1976-11-20,The Temptations - The Temptations Do The Temptations,17,15,38,10.0,27,The Temptations Do The Temptations,11.0,10,-11,-10,-2,1,down,1976-09-11
4814,The Temptations,1976-11-27,The Temptations - The Temptations Do The Temptations,27,17,51,10.0,38,The Temptations Do The Temptations,11.0,11,-13,-11,-10,1,down,1976-09-11
4815,Jerry Butler,1976-09-11,Jerry Butler - Love's On The Menu,51,51,51,49.0,49,Love's On The Menu,0.0,0,-2,2,0,1,down,1976-09-11
4816,The Staple Singers,1976-09-18,The Staple Singers - Pass It On,51,51,27,20.0,38,Pass It On,6.0,0,11,13,0,1,up,1976-09-18
4817,The Staple Singers,1976-09-25,The Staple Singers - Pass It On,38,51,21,20.0,27,Pass It On,6.0,1,6,11,13,1,up,1976-09-18
4818,The Staple Singers,1976-10-02,The Staple Singers - Pass It On,27,38,20,20.0,21,Pass It On,6.0,2,1,6,11,1,up,1976-09-18
4819,The Staple Singers,1976-10-09,The Staple Singers - Pass It On,21,27,31,20.0,20,Pass It On,6.0,3,-11,1,6,1,down,1976-09-18
4820,The Staple Singers,1976-10-16,The Staple Singers - Pass It On,20,21,30,20.0,31,Pass It On,6.0,4,1,-11,1,1,up,1976-09-18
4821,The Staple Singers,1976-10-23,The Staple Singers - Pass It On,31,20,42,20.0,30,Pass It On,6.0,5,-12,1,-11,1,down,1976-09-18
4822,The Staple Singers,1976-10-30,The Staple Singers - Pass It On,30,31,51,20.0,42,Pass It On,6.0,6,-9,-12,1,1,down,1976-09-18
4823,Gino Vannelli,1976-09-18,Gino Vannelli - The Gist Of The Gemini,51,51,39,35.0,39,The Gist Of The Gemini,4.0,0,0,12,0,0,stay,1976-09-18
4824,Gino Vannelli,1976-09-25,Gino Vannelli - The Gist Of The Gemini,39,51,36,35.0,39,The Gist Of The Gemini,4.0,1,3,0,12,1,up,1976-09-18
4825,Gino Vannelli,1976-10-02,Gino Vannelli - The Gist Of The Gemini,39,39,35,35.0,36,The Gist Of The Gemini,4.0,2,1,3,0,1,up,1976-09-18
4826,Gino Vannelli,1976-10-09,Gino Vannelli - The Gist Of The Gemini,36,39,41,35.0,35,The Gist Of The Gemini,4.0,3,-6,1,3,1,down,1976-09-18
4827,Gino Vannelli,1976-10-16,Gino Vannelli - The Gist Of The Gemini,35,36,51,35.0,41,The Gist Of The Gemini,4.0,4,-10,-6,1,1,down,1976-09-18
4828,Labelle,1976-09-18,Labelle - Chameleon,51,51,33,21.0,43,Chameleon,21.0,0,10,8,0,1,up,1976-09-18
4829,Labelle,1976-09-25,Labelle - Chameleon,43,51,27,21.0,33,Chameleon,21.0,1,6,10,8,1,up,1976-09-18
4830,Labelle,1976-10-02,Labelle - Chameleon,33,43,24,21.0,27,Chameleon,21.0,2,3,6,10,1,up,1976-09-18
4831,Labelle,1976-10-09,Labelle - Chameleon,27,33,23,21.0,24,Chameleon,21.0,3,1,3,6,1,up,1976-09-18
4832,Labelle,1976-10-16,Labelle - Chameleon,24,27,21,21.0,23,Chameleon,21.0,4,2,1,3,1,up,1976-09-18
4833,Labelle,1976-10-23,Labelle - Chameleon,23,24,21,21.0,21,Chameleon,21.0,5,0,2,1,0,stay,1976-09-18
4834,Labelle,1976-10-30,Labelle - Chameleon,21,23,32,21.0,21,Chameleon,21.0,6,-11,0,2,1,down,1976-09-18
4835,Labelle,1976-11-06,Labelle - Chameleon,21,21,33,21.0,32,Chameleon,21.0,7,-1,-11,0,1,down,1976-09-18
4836,Labelle,1976-11-13,Labelle - Chameleon,32,21,36,21.0,33,Chameleon,21.0,8,-3,-1,-11,1,down,1976-09-18
4837,Labelle,1976-11-20,Labelle - Chameleon,33,32,35,21.0,36,Chameleon,21.0,9,1,-3,-1,1,up,1976-09-18
4838,Labelle,1976-11-27,Labelle - Chameleon,36,33,42,21.0,35,Chameleon,21.0,10,-7,1,-3,1,down,1976-09-18
4839,Labelle,1976-12-04,Labelle - Chameleon,35,36,46,21.0,42,Chameleon,21.0,11,-4,-7,1,1,down,1976-09-18
4840,Labelle,1976-12-11,Labelle - Chameleon,42,35,40,21.0,46,Chameleon,21.0,12,6,-4,-7,1,up,1976-09-18
4841,Labelle,1976-12-18,Labelle - Chameleon,46,42,40,21.0,40,Chameleon,21.0,13,0,6,-4,0,stay,1976-09-18
4842,Labelle,1976-12-25,Labelle - Chameleon,40,46,40,21.0,40,Chameleon,21.0,14,0,0,6,0,stay,1976-09-18
4843,Labelle,1977-01-01,Labelle - Chameleon,40,40,40,21.0,40,Chameleon,21.0,15,0,0,0,0,stay,1976-09-18
4844,Labelle,1977-01-08,Labelle - Chameleon,40,40,44,21.0,40,Chameleon,21.0,16,-4,0,0,1,down,1976-09-18
4845,Labelle,1977-01-15,Labelle - Chameleon,40,40,44,21.0,44,Chameleon,21.0,17,0,-4,0,0,stay,1976-09-18
4846,Labelle,1977-01-22,Labelle - Chameleon,44,40,41,21.0,44,Chameleon,21.0,18,3,0,-4,1,up,1976-09-18
4847,Labelle,1977-01-29,Labelle - Chameleon,44,44,38,21.0,41,Chameleon,21.0,19,3,3,0,1,up,1976-09-18
4848,Labelle,1977-02-05,Labelle - Chameleon,41,44,46,21.0,38,Chameleon,21.0,20,-8,3,3,1,down,1976-09-18
4849,Labelle,1977-02-19,Labelle - Chameleon,38,41,51,21.0,46,Chameleon,21.0,21,-5,-8,3,1,down,1976-09-18
4850,Tower Of Power,1976-09-18,Tower Of Power - Ain't Nothin' Stoppin' Us Now,51,51,37,25.0,45,Ain't Nothin' Stoppin' Us Now,5.0,0,8,6,0,1,up,1976-09-18
4851,Tower Of Power,1976-09-25,Tower Of Power - Ain't Nothin' Stoppin' Us Now,45,51,29,25.0,37,Ain't Nothin' Stoppin' Us Now,5.0,1,8,8,6,1,up,1976-09-18
4852,Tower Of Power,1976-10-02,Tower Of Power - Ain't Nothin' Stoppin' Us Now,37,45,25,25.0,29,Ain't Nothin' Stoppin' Us Now,5.0,2,4,8,8,1,up,1976-09-18
4853,Tower Of Power,1976-10-09,Tower Of Power - Ain't Nothin' Stoppin' Us Now,29,37,33,25.0,25,Ain't Nothin' Stoppin' Us Now,5.0,3,-8,4,8,1,down,1976-09-18
4854,Tower Of Power,1976-10-16,Tower Of Power - Ain't Nothin' Stoppin' Us Now,25,29,48,25.0,33,Ain't Nothin' Stoppin' Us Now,5.0,4,-15,-8,4,1,down,1976-09-18
4855,Tower Of Power,1976-10-23,Tower Of Power - Ain't Nothin' Stoppin' Us Now,33,25,51,25.0,48,Ain't Nothin' Stoppin' Us Now,5.0,5,-3,-15,-8,1,down,1976-09-18
4856,Jimmy Caston Bunch,1976-09-18,Jimmy Caston Bunch - E-man Groovin',51,51,35,29.0,46,E-man Groovin',5.0,0,11,5,0,1,up,1976-09-18
4857,Jimmy Caston Bunch,1976-09-25,Jimmy Caston Bunch - E-man Groovin',46,51,32,29.0,35,E-man Groovin',5.0,1,3,11,5,1,up,1976-09-18
4858,Jimmy Caston Bunch,1976-10-02,Jimmy Caston Bunch - E-man Groovin',35,46,29,29.0,32,E-man Groovin',5.0,2,3,3,11,1,up,1976-09-18
4859,Jimmy Caston Bunch,1976-10-09,Jimmy Caston Bunch - E-man Groovin',32,35,29,29.0,29,E-man Groovin',5.0,3,0,3,3,0,stay,1976-09-18
4860,Jimmy Caston Bunch,1976-10-16,Jimmy Caston Bunch - E-man Groovin',29,32,40,29.0,29,E-man Groovin',5.0,4,-11,0,3,1,down,1976-09-18
4861,Jimmy Caston Bunch,1976-10-23,Jimmy Caston Bunch - E-man Groovin',29,29,51,29.0,40,E-man Groovin',5.0,5,-11,-11,0,1,down,1976-09-18
4862,"Marilyn McCoo & Billy Davis, Jr.",1976-09-18,"Marilyn McCoo & Billy Davis, Jr. - I Hope We Get To Love In Time",51,51,46,7.0,48,I Hope We Get To Love In Time,19.0,0,2,3,0,1,up,1976-09-18
4863,"Marilyn McCoo & Billy Davis, Jr.",1976-09-25,"Marilyn McCoo & Billy Davis, Jr. - I Hope We Get To Love In Time",48,51,43,7.0,46,I Hope We Get To Love In Time,19.0,1,3,2,3,1,up,1976-09-18
4864,"Marilyn McCoo & Billy Davis, Jr.",1976-10-02,"Marilyn McCoo & Billy Davis, Jr. - I Hope We Get To Love In Time",46,48,43,7.0,43,I Hope We Get To Love In Time,19.0,2,0,3,2,0,stay,1976-09-18
4865,"Marilyn McCoo & Billy Davis, Jr.",1976-10-09,"Marilyn McCoo & Billy Davis, Jr. - I Hope We Get To Love In Time",43,46,41,7.0,43,I Hope We Get To Love In Time,19.0,3,2,0,3,1,up,1976-09-18
4866,"Marilyn McCoo & Billy Davis, Jr.",1976-11-20,"Marilyn McCoo & Billy Davis, Jr. - I Hope We Get To Love In Time",43,43,31,7.0,41,I Hope We Get To Love In Time,19.0,4,10,2,0,1,up,1976-09-18
4867,"Marilyn McCoo & Billy Davis, Jr.",1976-11-27,"Marilyn McCoo & Billy Davis, Jr. - I Hope We Get To Love In Time",41,43,22,7.0,31,I Hope We Get To Love In Time,19.0,5,9,10,2,1,up,1976-09-18
4868,"Marilyn McCoo & Billy Davis, Jr.",1976-12-04,"Marilyn McCoo & Billy Davis, Jr. - I Hope We Get To Love In Time",31,41,20,7.0,22,I Hope We Get To Love In Time,19.0,6,2,9,10,1,up,1976-09-18
4869,"Marilyn McCoo & Billy Davis, Jr.",1976-12-11,"Marilyn McCoo & Billy Davis, Jr. - I Hope We Get To Love In Time",22,31,15,7.0,20,I Hope We Get To Love In Time,19.0,7,5,2,9,1,up,1976-09-18
4870,"Marilyn McCoo & Billy Davis, Jr.",1976-12-18,"Marilyn McCoo & Billy Davis, Jr. - I Hope We Get To Love In Time",20,22,10,7.0,15,I Hope We Get To Love In Time,19.0,8,5,5,2,1,up,1976-09-18
4871,"Marilyn McCoo & Billy Davis, Jr.",1976-12-25,"Marilyn McCoo & Billy Davis, Jr. - I Hope We Get To Love In Time",15,20,10,7.0,10,I Hope We Get To Love In Time,19.0,9,0,5,5,0,stay,1976-09-18
4872,"Marilyn McCoo & Billy Davis, Jr.",1977-01-01,"Marilyn McCoo & Billy Davis, Jr. - I Hope We Get To Love In Time",10,15,7,7.0,10,I Hope We Get To Love In Time,19.0,10,3,0,5,1,up,1976-09-18
4873,"Marilyn McCoo & Billy Davis, Jr.",1977-01-08,"Marilyn McCoo & Billy Davis, Jr. - I Hope We Get To Love In Time",10,10,7,7.0,7,I Hope We Get To Love In Time,19.0,11,0,3,0,0,stay,1976-09-18
4874,"Marilyn McCoo & Billy Davis, Jr.",1977-01-15,"Marilyn McCoo & Billy Davis, Jr. - I Hope We Get To Love In Time",7,10,7,7.0,7,I Hope We Get To Love In Time,19.0,12,0,0,3,0,stay,1976-09-18
4875,"Marilyn McCoo & Billy Davis, Jr.",1977-01-22,"Marilyn McCoo & Billy Davis, Jr. - I Hope We Get To Love In Time",7,7,9,7.0,7,I Hope We Get To Love In Time,19.0,13,-2,0,0,1,down,1976-09-18
4876,"Marilyn McCoo & Billy Davis, Jr.",1977-01-29,"Marilyn McCoo & Billy Davis, Jr. - I Hope We Get To Love In Time",7,7,17,7.0,9,I Hope We Get To Love In Time,19.0,14,-8,-2,0,1,down,1976-09-18
4877,"Marilyn McCoo & Billy Davis, Jr.",1977-02-05,"Marilyn McCoo & Billy Davis, Jr. - I Hope We Get To Love In Time",9,7,17,7.0,17,I Hope We Get To Love In Time,19.0,15,0,-8,-2,0,stay,1976-09-18
4878,"Marilyn McCoo & Billy Davis, Jr.",1977-02-12,"Marilyn McCoo & Billy Davis, Jr. - I Hope We Get To Love In Time",17,9,28,7.0,17,I Hope We Get To Love In Time,19.0,16,-11,0,-8,1,down,1976-09-18
4879,"Marilyn McCoo & Billy Davis, Jr.",1977-02-19,"Marilyn McCoo & Billy Davis, Jr. - I Hope We Get To Love In Time",17,17,38,7.0,28,I Hope We Get To Love In Time,19.0,17,-10,-11,0,1,down,1976-09-18
4880,"Marilyn McCoo & Billy Davis, Jr.",1977-02-26,"Marilyn McCoo & Billy Davis, Jr. - I Hope We Get To Love In Time",28,17,48,7.0,38,I Hope We Get To Love In Time,19.0,18,-10,-10,-11,1,down,1976-09-18
4881,"Marilyn McCoo & Billy Davis, Jr.",1977-03-05,"Marilyn McCoo & Billy Davis, Jr. - I Hope We Get To Love In Time",38,28,51,7.0,48,I Hope We Get To Love In Time,19.0,19,-3,-10,-10,1,down,1976-09-18
4882,Dr. Buzzard's Original Savannah Band,1976-09-18,Dr. Buzzard's Original Savannah Band - Dr. Buzzard's Original Savannah Band,51,51,45,31.0,49,Dr. Buzzard's Original Savannah Band,21.0,0,4,2,0,1,up,1976-09-18
4883,Dr. Buzzard's Original Savannah Band,1976-09-25,Dr. Buzzard's Original Savannah Band - Dr. Buzzard's Original Savannah Band,49,51,45,31.0,45,Dr. Buzzard's Original Savannah Band,21.0,1,0,4,2,0,stay,1976-09-18
4884,Dr. Buzzard's Original Savannah Band,1976-10-02,Dr. Buzzard's Original Savannah Band - Dr. Buzzard's Original Savannah Band,45,49,41,31.0,45,Dr. Buzzard's Original Savannah Band,21.0,2,4,0,4,1,up,1976-09-18
4885,Dr. Buzzard's Original Savannah Band,1976-10-09,Dr. Buzzard's Original Savannah Band - Dr. Buzzard's Original Savannah Band,45,45,46,31.0,41,Dr. Buzzard's Original Savannah Band,21.0,3,-5,4,0,1,down,1976-09-18
4886,Dr. Buzzard's Original Savannah Band,1976-10-16,Dr. Buzzard's Original Savannah Band - Dr. Buzzard's Original Savannah Band,41,45,49,31.0,46,Dr. Buzzard's Original Savannah Band,21.0,4,-3,-5,4,1,down,1976-09-18
4887,Dr. Buzzard's Original Savannah Band,1976-10-23,Dr. Buzzard's Original Savannah Band - Dr. Buzzard's Original Savannah Band,46,41,46,31.0,49,Dr. Buzzard's Original Savannah Band,21.0,5,3,-3,-5,1,up,1976-09-18
4888,Dr. Buzzard's Original Savannah Band,1976-10-30,Dr. Buzzard's Original Savannah Band - Dr. Buzzard's Original Savannah Band,49,46,46,31.0,46,Dr. Buzzard's Original Savannah Band,21.0,6,0,3,-3,0,stay,1976-09-18
4889,Dr. Buzzard's Original Savannah Band,1976-11-06,Dr. Buzzard's Original Savannah Band - Dr. Buzzard's Original Savannah Band,46,49,48,31.0,46,Dr. Buzzard's Original Savannah Band,21.0,7,-2,0,3,1,down,1976-09-18
4890,Dr. Buzzard's Original Savannah Band,1976-11-13,Dr. Buzzard's Original Savannah Band - Dr. Buzzard's Original Savannah Band,46,46,49,31.0,48,Dr. Buzzard's Original Savannah Band,21.0,8,-1,-2,0,1,down,1976-09-18
4891,Dr. Buzzard's Original Savannah Band,1976-11-27,Dr. Buzzard's Original Savannah Band - Dr. Buzzard's Original Savannah Band,48,46,46,31.0,49,Dr. Buzzard's Original Savannah Band,21.0,9,3,-1,-2,1,up,1976-09-18
4892,Dr. Buzzard's Original Savannah Band,1976-12-04,Dr. Buzzard's Original Savannah Band - Dr. Buzzard's Original Savannah Band,49,48,38,31.0,46,Dr. Buzzard's Original Savannah Band,21.0,10,8,3,-1,1,up,1976-09-18
4893,Dr. Buzzard's Original Savannah Band,1976-12-11,Dr. Buzzard's Original Savannah Band - Dr. Buzzard's Original Savannah Band,46,49,34,31.0,38,Dr. Buzzard's Original Savannah Band,21.0,11,4,8,3,1,up,1976-09-18
4894,Dr. Buzzard's Original Savannah Band,1976-12-18,Dr. Buzzard's Original Savannah Band - Dr. Buzzard's Original Savannah Band,38,46,34,31.0,34,Dr. Buzzard's Original Savannah Band,21.0,12,0,4,8,0,stay,1976-09-18
4895,Dr. Buzzard's Original Savannah Band,1976-12-25,Dr. Buzzard's Original Savannah Band - Dr. Buzzard's Original Savannah Band,34,38,34,31.0,34,Dr. Buzzard's Original Savannah Band,21.0,13,0,0,4,0,stay,1976-09-18
4896,Dr. Buzzard's Original Savannah Band,1977-01-01,Dr. Buzzard's Original Savannah Band - Dr. Buzzard's Original Savannah Band,34,34,34,31.0,34,Dr. Buzzard's Original Savannah Band,21.0,14,0,0,0,0,stay,1976-09-18
4897,Dr. Buzzard's Original Savannah Band,1977-01-08,Dr. Buzzard's Original Savannah Band - Dr. Buzzard's Original Savannah Band,34,34,31,31.0,34,Dr. Buzzard's Original Savannah Band,21.0,15,3,0,0,1,up,1976-09-18
4898,Dr. Buzzard's Original Savannah Band,1977-01-15,Dr. Buzzard's Original Savannah Band - Dr. Buzzard's Original Savannah Band,34,34,38,31.0,31,Dr. Buzzard's Original Savannah Band,21.0,16,-7,3,0,1,down,1976-09-18
4899,Dr. Buzzard's Original Savannah Band,1977-01-22,Dr. Buzzard's Original Savannah Band - Dr. Buzzard's Original Savannah Band,31,34,35,31.0,38,Dr. Buzzard's Original Savannah Band,21.0,17,3,-7,3,1,up,1976-09-18
4900,Dr. Buzzard's Original Savannah Band,1977-01-29,Dr. Buzzard's Original Savannah Band - Dr. Buzzard's Original Savannah Band,38,31,33,31.0,35,Dr. Buzzard's Original Savannah Band,21.0,18,2,3,-7,1,up,1976-09-18
4901,Dr. Buzzard's Original Savannah Band,1977-02-05,Dr. Buzzard's Original Savannah Band - Dr. Buzzard's Original Savannah Band,35,38,47,31.0,33,Dr. Buzzard's Original Savannah Band,21.0,19,-14,2,3,1,down,1976-09-18
4902,Dr. Buzzard's Original Savannah Band,1977-02-12,Dr. Buzzard's Original Savannah Band - Dr. Buzzard's Original Savannah Band,33,35,49,31.0,47,Dr. Buzzard's Original Savannah Band,21.0,20,-2,-14,2,1,down,1976-09-18
4903,Dr. Buzzard's Original Savannah Band,1977-03-12,Dr. Buzzard's Original Savannah Band - Dr. Buzzard's Original Savannah Band,47,33,51,31.0,49,Dr. Buzzard's Original Savannah Band,21.0,21,-2,-2,-14,1,down,1976-09-18
4904,War,1976-09-25,War - Greatest Hits,51,51,16,12.0,29,Greatest Hits,7.0,0,13,22,0,1,up,1976-09-25
4905,War,1976-10-02,War - Greatest Hits,29,51,13,12.0,16,Greatest Hits,7.0,1,3,13,22,1,up,1976-09-25
4906,War,1976-10-09,War - Greatest Hits,16,29,12,12.0,13,Greatest Hits,7.0,2,1,3,13,1,up,1976-09-25
4907,War,1976-10-16,War - Greatest Hits,13,16,24,12.0,12,Greatest Hits,7.0,3,-12,1,3,1,down,1976-09-25
4908,War,1976-10-23,War - Greatest Hits,12,13,28,12.0,24,Greatest Hits,7.0,4,-4,-12,1,1,down,1976-09-25
4909,War,1976-10-30,War - Greatest Hits,24,12,28,12.0,28,Greatest Hits,7.0,5,0,-4,-12,0,stay,1976-09-25
4910,War,1976-11-06,War - Greatest Hits,28,24,40,12.0,28,Greatest Hits,7.0,6,-12,0,-4,1,down,1976-09-25
4911,War,1976-11-13,War - Greatest Hits,28,28,51,12.0,40,Greatest Hits,7.0,7,-11,-12,0,1,down,1976-09-25
4912,Jermaine Jackson,1976-09-25,Jermaine Jackson - My Name Is Jermaine,51,51,39,29.0,47,My Name Is Jermaine,6.0,0,8,4,0,1,up,1976-09-25
4913,Jermaine Jackson,1976-10-02,Jermaine Jackson - My Name Is Jermaine,47,51,33,29.0,39,My Name Is Jermaine,6.0,1,6,8,4,1,up,1976-09-25
4914,Jermaine Jackson,1976-10-09,Jermaine Jackson - My Name Is Jermaine,39,47,30,29.0,33,My Name Is Jermaine,6.0,2,3,6,8,1,up,1976-09-25
4915,Jermaine Jackson,1976-10-16,Jermaine Jackson - My Name Is Jermaine,33,39,29,29.0,30,My Name Is Jermaine,6.0,3,1,3,6,1,up,1976-09-25
4916,Jermaine Jackson,1976-10-23,Jermaine Jackson - My Name Is Jermaine,30,33,40,29.0,29,My Name Is Jermaine,6.0,4,-11,1,3,1,down,1976-09-25
4917,Jermaine Jackson,1976-10-30,Jermaine Jackson - My Name Is Jermaine,29,30,40,29.0,40,My Name Is Jermaine,6.0,5,0,-11,1,0,stay,1976-09-25
4918,Jermaine Jackson,1976-11-06,Jermaine Jackson - My Name Is Jermaine,40,29,51,29.0,40,My Name Is Jermaine,6.0,6,-11,0,-11,1,down,1976-09-25
4919,Blue Magic,1976-09-25,Blue Magic - Mystic Dragons,51,51,44,44.0,49,Mystic Dragons,2.0,0,5,2,0,1,up,1976-09-25
4920,Blue Magic,1976-10-02,Blue Magic - Mystic Dragons,49,51,44,44.0,44,Mystic Dragons,2.0,1,0,5,2,0,stay,1976-09-25
4921,Blue Magic,1976-10-09,Blue Magic - Mystic Dragons,44,49,51,44.0,44,Mystic Dragons,2.0,2,-7,0,5,1,down,1976-09-25
4922,The O'Jays,1976-10-02,The O'Jays - Message In The Music,51,51,18,3.0,33,Message In The Music,25.0,0,15,18,0,1,up,1976-10-02
4923,The O'Jays,1976-10-09,The O'Jays - Message In The Music,33,51,5,3.0,18,Message In The Music,25.0,1,13,15,18,1,up,1976-10-02
4924,The O'Jays,1976-10-16,The O'Jays - Message In The Music,18,33,4,3.0,5,Message In The Music,25.0,2,1,13,15,1,up,1976-10-02
4925,The O'Jays,1976-10-23,The O'Jays - Message In The Music,5,18,3,3.0,4,Message In The Music,25.0,3,1,1,13,1,up,1976-10-02
4926,The O'Jays,1976-10-30,The O'Jays - Message In The Music,4,5,3,3.0,3,Message In The Music,25.0,4,0,1,1,0,stay,1976-10-02
4927,The O'Jays,1976-11-06,The O'Jays - Message In The Music,3,4,3,3.0,3,Message In The Music,25.0,5,0,0,1,0,stay,1976-10-02
4928,The O'Jays,1976-11-13,The O'Jays - Message In The Music,3,3,4,3.0,3,Message In The Music,25.0,6,-1,0,0,1,down,1976-10-02
4929,The O'Jays,1976-11-20,The O'Jays - Message In The Music,3,3,4,3.0,4,Message In The Music,25.0,7,0,-1,0,0,stay,1976-10-02
4930,The O'Jays,1976-11-27,The O'Jays - Message In The Music,4,3,4,3.0,4,Message In The Music,25.0,8,0,0,-1,0,stay,1976-10-02
4931,The O'Jays,1976-12-04,The O'Jays - Message In The Music,4,4,7,3.0,4,Message In The Music,25.0,9,-3,0,0,1,down,1976-10-02
4932,The O'Jays,1976-12-11,The O'Jays - Message In The Music,4,4,7,3.0,7,Message In The Music,25.0,10,0,-3,0,0,stay,1976-10-02
4933,The O'Jays,1976-12-18,The O'Jays - Message In The Music,7,4,8,3.0,7,Message In The Music,25.0,11,-1,0,-3,1,down,1976-10-02
4934,The O'Jays,1976-12-25,The O'Jays - Message In The Music,7,7,8,3.0,8,Message In The Music,25.0,12,0,-1,0,0,stay,1976-10-02
4935,The O'Jays,1977-01-01,The O'Jays - Message In The Music,8,7,14,3.0,8,Message In The Music,25.0,13,-6,0,-1,1,down,1976-10-02
4936,The O'Jays,1977-01-08,The O'Jays - Message In The Music,8,8,14,3.0,14,Message In The Music,25.0,14,0,-6,0,0,stay,1976-10-02
4937,The O'Jays,1977-01-15,The O'Jays - Message In The Music,14,8,11,3.0,14,Message In The Music,25.0,15,3,0,-6,1,up,1976-10-02
4938,The O'Jays,1977-01-22,The O'Jays - Message In The Music,14,14,10,3.0,11,Message In The Music,25.0,16,1,3,0,1,up,1976-10-02
4939,The O'Jays,1977-01-29,The O'Jays - Message In The Music,11,14,10,3.0,10,Message In The Music,25.0,17,0,1,3,0,stay,1976-10-02
4940,The O'Jays,1977-02-05,The O'Jays - Message In The Music,10,11,16,3.0,10,Message In The Music,25.0,18,-6,0,1,1,down,1976-10-02
4941,The O'Jays,1977-02-12,The O'Jays - Message In The Music,10,10,25,3.0,16,Message In The Music,25.0,19,-9,-6,0,1,down,1976-10-02
4942,The O'Jays,1977-02-19,The O'Jays - Message In The Music,16,10,32,3.0,25,Message In The Music,25.0,20,-7,-9,-6,1,down,1976-10-02
4943,The O'Jays,1977-02-26,The O'Jays - Message In The Music,25,16,36,3.0,32,Message In The Music,25.0,21,-4,-7,-9,1,down,1976-10-02
4944,The O'Jays,1977-03-05,The O'Jays - Message In The Music,32,25,36,3.0,36,Message In The Music,25.0,22,0,-4,-7,0,stay,1976-10-02
4945,The O'Jays,1977-03-12,The O'Jays - Message In The Music,36,32,37,3.0,36,Message In The Music,25.0,23,-1,0,-4,1,down,1976-10-02
4946,The O'Jays,1977-03-19,The O'Jays - Message In The Music,36,36,50,3.0,37,Message In The Music,25.0,24,-13,-1,0,1,down,1976-10-02
4947,The O'Jays,1977-03-26,The O'Jays - Message In The Music,37,36,51,3.0,50,Message In The Music,25.0,25,-1,-13,-1,1,down,1976-10-02
4948,Bee Gees,1976-10-02,Bee Gees - Children Of The World,51,51,31,23.0,41,Children Of The World,27.0,0,10,10,0,1,up,1976-10-02
4949,Bee Gees,1976-10-09,Bee Gees - Children Of The World,41,51,25,23.0,31,Children Of The World,27.0,1,6,10,10,1,up,1976-10-02
4950,Bee Gees,1976-10-16,Bee Gees - Children Of The World,31,41,23,23.0,25,Children Of The World,27.0,2,2,6,10,1,up,1976-10-02
4951,Bee Gees,1976-10-23,Bee Gees - Children Of The World,25,31,23,23.0,23,Children Of The World,27.0,3,0,2,6,0,stay,1976-10-02
4952,Bee Gees,1976-10-30,Bee Gees - Children Of The World,23,25,36,23.0,23,Children Of The World,27.0,4,-13,0,2,1,down,1976-10-02
4953,Bee Gees,1976-11-06,Bee Gees - Children Of The World,23,23,31,23.0,36,Children Of The World,27.0,5,5,-13,0,1,up,1976-10-02
4954,Bee Gees,1976-11-13,Bee Gees - Children Of The World,36,23,31,23.0,31,Children Of The World,27.0,6,0,5,-13,0,stay,1976-10-02
4955,Bee Gees,1976-11-20,Bee Gees - Children Of The World,31,36,33,23.0,31,Children Of The World,27.0,7,-2,0,5,1,down,1976-10-02
4956,Bee Gees,1976-11-27,Bee Gees - Children Of The World,31,31,41,23.0,33,Children Of The World,27.0,8,-8,-2,0,1,down,1976-10-02
4957,Bee Gees,1976-12-04,Bee Gees - Children Of The World,33,31,41,23.0,41,Children Of The World,27.0,9,0,-8,-2,0,stay,1976-10-02
4958,Bee Gees,1976-12-11,Bee Gees - Children Of The World,41,33,41,23.0,41,Children Of The World,27.0,10,0,0,-8,0,stay,1976-10-02
4959,Bee Gees,1976-12-18,Bee Gees - Children Of The World,41,41,37,23.0,41,Children Of The World,27.0,11,4,0,0,1,up,1976-10-02
4960,Bee Gees,1976-12-25,Bee Gees - Children Of The World,41,41,37,23.0,37,Children Of The World,27.0,12,0,4,0,0,stay,1976-10-02
4961,Bee Gees,1977-01-01,Bee Gees - Children Of The World,37,41,31,23.0,37,Children Of The World,27.0,13,6,0,4,1,up,1976-10-02
4962,Bee Gees,1977-01-08,Bee Gees - Children Of The World,37,37,25,23.0,31,Children Of The World,27.0,14,6,6,0,1,up,1976-10-02
4963,Bee Gees,1977-01-15,Bee Gees - Children Of The World,31,37,25,23.0,25,Children Of The World,27.0,15,0,6,6,0,stay,1976-10-02
4964,Bee Gees,1977-01-22,Bee Gees - Children Of The World,25,31,24,23.0,25,Children Of The World,27.0,16,1,0,6,1,up,1976-10-02
4965,Bee Gees,1977-01-29,Bee Gees - Children Of The World,25,25,24,23.0,24,Children Of The World,27.0,17,0,1,0,0,stay,1976-10-02
4966,Bee Gees,1977-02-05,Bee Gees - Children Of The World,24,25,28,23.0,24,Children Of The World,27.0,18,-4,0,1,1,down,1976-10-02
4967,Bee Gees,1977-02-12,Bee Gees - Children Of The World,24,24,34,23.0,28,Children Of The World,27.0,19,-6,-4,0,1,down,1976-10-02
4968,Bee Gees,1977-02-19,Bee Gees - Children Of The World,28,24,34,23.0,34,Children Of The World,27.0,20,0,-6,-4,0,stay,1976-10-02
4969,Bee Gees,1977-02-26,Bee Gees - Children Of The World,34,28,32,23.0,34,Children Of The World,27.0,21,2,0,-6,1,up,1976-10-02
4970,Bee Gees,1977-03-05,Bee Gees - Children Of The World,34,34,32,23.0,32,Children Of The World,27.0,22,0,2,0,0,stay,1976-10-02
4971,Bee Gees,1977-03-12,Bee Gees - Children Of The World,32,34,32,23.0,32,Children Of The World,27.0,23,0,0,2,0,stay,1976-10-02
4972,Bee Gees,1977-03-19,Bee Gees - Children Of The World,32,32,32,23.0,32,Children Of The World,27.0,24,0,0,0,0,stay,1976-10-02
4973,Bee Gees,1977-03-26,Bee Gees - Children Of The World,32,32,35,23.0,32,Children Of The World,27.0,25,-3,0,0,1,down,1976-10-02
4974,Bee Gees,1977-04-02,Bee Gees - Children Of The World,32,32,36,23.0,35,Children Of The World,27.0,26,-1,-3,0,1,down,1976-10-02
4975,Bee Gees,1977-04-09,Bee Gees - Children Of The World,35,32,51,23.0,36,Children Of The World,27.0,27,-15,-1,-3,1,down,1976-10-02
4976,Tyrone Davis,1976-10-02,Tyrone Davis - Love And Touch,51,51,22,12.0,42,Love And Touch,14.0,0,20,9,0,1,up,1976-10-02
4977,Tyrone Davis,1976-10-09,Tyrone Davis - Love And Touch,42,51,16,12.0,22,Love And Touch,14.0,1,6,20,9,1,up,1976-10-02
4978,Tyrone Davis,1976-10-16,Tyrone Davis - Love And Touch,22,42,13,12.0,16,Love And Touch,14.0,2,3,6,20,1,up,1976-10-02
4979,Tyrone Davis,1976-10-23,Tyrone Davis - Love And Touch,16,22,12,12.0,13,Love And Touch,14.0,3,1,3,6,1,up,1976-10-02
4980,Tyrone Davis,1976-10-30,Tyrone Davis - Love And Touch,13,16,12,12.0,12,Love And Touch,14.0,4,0,1,3,0,stay,1976-10-02
4981,Tyrone Davis,1976-11-06,Tyrone Davis - Love And Touch,12,13,12,12.0,12,Love And Touch,14.0,5,0,0,1,0,stay,1976-10-02
4982,Tyrone Davis,1976-11-13,Tyrone Davis - Love And Touch,12,12,13,12.0,12,Love And Touch,14.0,6,-1,0,0,1,down,1976-10-02
4983,Tyrone Davis,1976-11-20,Tyrone Davis - Love And Touch,12,12,17,12.0,13,Love And Touch,14.0,7,-4,-1,0,1,down,1976-10-02
4984,Tyrone Davis,1976-11-27,Tyrone Davis - Love And Touch,13,12,24,12.0,17,Love And Touch,14.0,8,-7,-4,-1,1,down,1976-10-02
4985,Tyrone Davis,1976-12-04,Tyrone Davis - Love And Touch,17,13,24,12.0,24,Love And Touch,14.0,9,0,-7,-4,0,stay,1976-10-02
4986,Tyrone Davis,1976-12-11,Tyrone Davis - Love And Touch,24,17,28,12.0,24,Love And Touch,14.0,10,-4,0,-7,1,down,1976-10-02
4987,Tyrone Davis,1976-12-18,Tyrone Davis - Love And Touch,24,24,29,12.0,28,Love And Touch,14.0,11,-1,-4,0,1,down,1976-10-02
4988,Tyrone Davis,1976-12-25,Tyrone Davis - Love And Touch,28,24,29,12.0,29,Love And Touch,14.0,12,0,-1,-4,0,stay,1976-10-02
4989,Tyrone Davis,1977-01-01,Tyrone Davis - Love And Touch,29,28,49,12.0,29,Love And Touch,14.0,13,-20,0,-1,1,down,1976-10-02
4990,Tyrone Davis,1977-01-08,Tyrone Davis - Love And Touch,29,29,51,12.0,49,Love And Touch,14.0,14,-2,-20,0,1,down,1976-10-02
4991,Quincy Jones,1976-10-02,Quincy Jones - I Heard That !!,51,51,26,16.0,46,I Heard That !!,15.0,0,20,5,0,1,up,1976-10-02
4992,Quincy Jones,1976-10-09,Quincy Jones - I Heard That !!,46,51,20,16.0,26,I Heard That !!,15.0,1,6,20,5,1,up,1976-10-02
4993,Quincy Jones,1976-10-16,Quincy Jones - I Heard That !!,26,46,16,16.0,20,I Heard That !!,15.0,2,4,6,20,1,up,1976-10-02
4994,Quincy Jones,1976-10-23,Quincy Jones - I Heard That !!,20,26,16,16.0,16,I Heard That !!,15.0,3,0,4,6,0,stay,1976-10-02
4995,Quincy Jones,1976-10-30,Quincy Jones - I Heard That !!,16,20,16,16.0,16,I Heard That !!,15.0,4,0,0,4,0,stay,1976-10-02
4996,Quincy Jones,1976-11-06,Quincy Jones - I Heard That !!,16,16,16,16.0,16,I Heard That !!,15.0,5,0,0,0,0,stay,1976-10-02
4997,Quincy Jones,1976-11-13,Quincy Jones - I Heard That !!,16,16,22,16.0,16,I Heard That !!,15.0,6,-6,0,0,1,down,1976-10-02
4998,Quincy Jones,1976-11-20,Quincy Jones - I Heard That !!,16,16,32,16.0,22,I Heard That !!,15.0,7,-10,-6,0,1,down,1976-10-02
4999,Quincy Jones,1976-11-27,Quincy Jones - I Heard That !!,22,16,34,16.0,32,I Heard That !!,15.0,8,-2,-10,-6,1,down,1976-10-02
5000,Quincy Jones,1976-12-04,Quincy Jones - I Heard That !!,32,22,31,16.0,34,I Heard That !!,15.0,9,3,-2,-10,1,up,1976-10-02
5001,Quincy Jones,1976-12-11,Quincy Jones - I Heard That !!,34,32,29,16.0,31,I Heard That !!,15.0,10,2,3,-2,1,up,1976-10-02
5002,Quincy Jones,1976-12-18,Quincy Jones - I Heard That !!,31,34,27,16.0,29,I Heard That !!,15.0,11,2,2,3,1,up,1976-10-02
5003,Quincy Jones,1976-12-25,Quincy Jones - I Heard That !!,29,31,27,16.0,27,I Heard That !!,15.0,12,0,2,2,0,stay,1976-10-02
5004,Quincy Jones,1977-01-01,Quincy Jones - I Heard That !!,27,29,43,16.0,27,I Heard That !!,15.0,13,-16,0,2,1,down,1976-10-02
5005,Quincy Jones,1977-01-08,Quincy Jones - I Heard That !!,27,27,43,16.0,43,I Heard That !!,15.0,14,0,-16,0,0,stay,1976-10-02
5006,Quincy Jones,1977-01-15,Quincy Jones - I Heard That !!,43,27,51,16.0,43,I Heard That !!,15.0,15,-8,0,-16,1,down,1976-10-02
5007,Richard Pryor,1976-10-09,Richard Pryor - Bicentennial Nigger,51,51,8,4.0,15,Bicentennial Nigger,16.0,0,7,36,0,1,up,1976-10-09
5008,Richard Pryor,1976-10-16,Richard Pryor - Bicentennial Nigger,15,51,5,4.0,8,Bicentennial Nigger,16.0,1,3,7,36,1,up,1976-10-09
5009,Richard Pryor,1976-10-23,Richard Pryor - Bicentennial Nigger,8,15,4,4.0,5,Bicentennial Nigger,16.0,2,1,3,7,1,up,1976-10-09
5010,Richard Pryor,1976-10-30,Richard Pryor - Bicentennial Nigger,5,8,4,4.0,4,Bicentennial Nigger,16.0,3,0,1,3,0,stay,1976-10-09
5011,Richard Pryor,1976-11-06,Richard Pryor - Bicentennial Nigger,4,5,7,4.0,4,Bicentennial Nigger,16.0,4,-3,0,1,1,down,1976-10-09
5012,Richard Pryor,1976-11-13,Richard Pryor - Bicentennial Nigger,4,4,8,4.0,7,Bicentennial Nigger,16.0,5,-1,-3,0,1,down,1976-10-09
5013,Richard Pryor,1976-11-20,Richard Pryor - Bicentennial Nigger,7,4,10,4.0,8,Bicentennial Nigger,16.0,6,-2,-1,-3,1,down,1976-10-09
5014,Richard Pryor,1976-11-27,Richard Pryor - Bicentennial Nigger,8,7,12,4.0,10,Bicentennial Nigger,16.0,7,-2,-2,-1,1,down,1976-10-09
5015,Richard Pryor,1976-12-04,Richard Pryor - Bicentennial Nigger,10,8,17,4.0,12,Bicentennial Nigger,16.0,8,-5,-2,-2,1,down,1976-10-09
5016,Richard Pryor,1976-12-11,Richard Pryor - Bicentennial Nigger,12,10,20,4.0,17,Bicentennial Nigger,16.0,9,-3,-5,-2,1,down,1976-10-09
5017,Richard Pryor,1976-12-18,Richard Pryor - Bicentennial Nigger,17,12,23,4.0,20,Bicentennial Nigger,16.0,10,-3,-3,-5,1,down,1976-10-09
5018,Richard Pryor,1976-12-25,Richard Pryor - Bicentennial Nigger,20,17,23,4.0,23,Bicentennial Nigger,16.0,11,0,-3,-3,0,stay,1976-10-09
5019,Richard Pryor,1977-01-01,Richard Pryor - Bicentennial Nigger,23,20,23,4.0,23,Bicentennial Nigger,16.0,12,0,0,-3,0,stay,1976-10-09
5020,Richard Pryor,1977-01-08,Richard Pryor - Bicentennial Nigger,23,23,28,4.0,23,Bicentennial Nigger,16.0,13,-5,0,0,1,down,1976-10-09
5021,Richard Pryor,1977-01-15,Richard Pryor - Bicentennial Nigger,23,23,29,4.0,28,Bicentennial Nigger,16.0,14,-1,-5,0,1,down,1976-10-09
5022,Richard Pryor,1977-01-22,Richard Pryor - Bicentennial Nigger,28,23,37,4.0,29,Bicentennial Nigger,16.0,15,-8,-1,-5,1,down,1976-10-09
5023,Richard Pryor,1977-01-29,Richard Pryor - Bicentennial Nigger,29,28,51,4.0,37,Bicentennial Nigger,16.0,16,-14,-8,-1,1,down,1976-10-09
5024,Marvin Gaye,1976-10-09,Marvin Gaye - Marvin Gaye's Greatest Hits,51,51,24,17.0,30,Marvin Gaye's Greatest Hits,5.0,0,6,21,0,1,up,1976-10-09
5025,Marvin Gaye,1976-10-16,Marvin Gaye - Marvin Gaye's Greatest Hits,30,51,18,17.0,24,Marvin Gaye's Greatest Hits,5.0,1,6,6,21,1,up,1976-10-09
5026,Marvin Gaye,1976-10-23,Marvin Gaye - Marvin Gaye's Greatest Hits,24,30,17,17.0,18,Marvin Gaye's Greatest Hits,5.0,2,1,6,6,1,up,1976-10-09
5027,Marvin Gaye,1976-10-30,Marvin Gaye - Marvin Gaye's Greatest Hits,18,24,17,17.0,17,Marvin Gaye's Greatest Hits,5.0,3,0,1,6,0,stay,1976-10-09
5028,Marvin Gaye,1976-11-06,Marvin Gaye - Marvin Gaye's Greatest Hits,17,18,44,17.0,17,Marvin Gaye's Greatest Hits,5.0,4,-27,0,1,1,down,1976-10-09
5029,Marvin Gaye,1976-11-13,Marvin Gaye - Marvin Gaye's Greatest Hits,17,17,51,17.0,44,Marvin Gaye's Greatest Hits,5.0,5,-7,-27,0,1,down,1976-10-09
5030,Funkadelic,1976-10-09,Funkadelic - Tales Of Kidd Funkadelic,51,51,28,14.0,39,Tales Of Kidd Funkadelic,10.0,0,11,12,0,1,up,1976-10-09
5031,Funkadelic,1976-10-16,Funkadelic - Tales Of Kidd Funkadelic,39,51,22,14.0,28,Tales Of Kidd Funkadelic,10.0,1,6,11,12,1,up,1976-10-09
5032,Funkadelic,1976-10-23,Funkadelic - Tales Of Kidd Funkadelic,28,39,15,14.0,22,Tales Of Kidd Funkadelic,10.0,2,7,6,11,1,up,1976-10-09
5033,Funkadelic,1976-10-30,Funkadelic - Tales Of Kidd Funkadelic,22,28,14,14.0,15,Tales Of Kidd Funkadelic,10.0,3,1,7,6,1,up,1976-10-09
5034,Funkadelic,1976-11-06,Funkadelic - Tales Of Kidd Funkadelic,15,22,15,14.0,14,Tales Of Kidd Funkadelic,10.0,4,-1,1,7,1,down,1976-10-09
5035,Funkadelic,1976-11-13,Funkadelic - Tales Of Kidd Funkadelic,14,15,15,14.0,15,Tales Of Kidd Funkadelic,10.0,5,0,-1,1,0,stay,1976-10-09
5036,Funkadelic,1976-11-20,Funkadelic - Tales Of Kidd Funkadelic,15,14,22,14.0,15,Tales Of Kidd Funkadelic,10.0,6,-7,0,-1,1,down,1976-10-09
5037,Funkadelic,1976-11-27,Funkadelic - Tales Of Kidd Funkadelic,15,15,40,14.0,22,Tales Of Kidd Funkadelic,10.0,7,-18,-7,0,1,down,1976-10-09
5038,Funkadelic,1976-12-04,Funkadelic - Tales Of Kidd Funkadelic,22,15,45,14.0,40,Tales Of Kidd Funkadelic,10.0,8,-5,-18,-7,1,down,1976-10-09
5039,Funkadelic,1976-12-11,Funkadelic - Tales Of Kidd Funkadelic,40,22,49,14.0,45,Tales Of Kidd Funkadelic,10.0,9,-4,-5,-18,1,down,1976-10-09
5040,Funkadelic,1976-12-18,Funkadelic - Tales Of Kidd Funkadelic,45,40,51,14.0,49,Tales Of Kidd Funkadelic,10.0,10,-2,-4,-5,1,down,1976-10-09
5041,Eddie Kendricks,1976-10-09,Eddie Kendricks - Goin' Up In Smoke,51,51,32,22.0,42,Goin' Up In Smoke,6.0,0,10,9,0,1,up,1976-10-09
5042,Eddie Kendricks,1976-10-16,Eddie Kendricks - Goin' Up In Smoke,42,51,25,22.0,32,Goin' Up In Smoke,6.0,1,7,10,9,1,up,1976-10-09
5043,Eddie Kendricks,1976-10-23,Eddie Kendricks - Goin' Up In Smoke,32,42,22,22.0,25,Goin' Up In Smoke,6.0,2,3,7,10,1,up,1976-10-09
5044,Eddie Kendricks,1976-10-30,Eddie Kendricks - Goin' Up In Smoke,25,32,34,22.0,22,Goin' Up In Smoke,6.0,3,-12,3,7,1,down,1976-10-09
5045,Eddie Kendricks,1976-11-06,Eddie Kendricks - Goin' Up In Smoke,22,25,36,22.0,34,Goin' Up In Smoke,6.0,4,-2,-12,3,1,down,1976-10-09
5046,Eddie Kendricks,1976-11-13,Eddie Kendricks - Goin' Up In Smoke,34,22,44,22.0,36,Goin' Up In Smoke,6.0,5,-8,-2,-12,1,down,1976-10-09
5047,Eddie Kendricks,1976-11-20,Eddie Kendricks - Goin' Up In Smoke,36,34,51,22.0,44,Goin' Up In Smoke,6.0,6,-7,-8,-2,1,down,1976-10-09
5048,Walter Jackson,1976-10-09,Walter Jackson - Feeling Good,51,51,37,14.0,47,Feeling Good,20.0,0,10,4,0,1,up,1976-10-09
5049,Walter Jackson,1976-10-16,Walter Jackson - Feeling Good,47,51,27,14.0,37,Feeling Good,20.0,1,10,10,4,1,up,1976-10-09
5050,Walter Jackson,1976-10-23,Walter Jackson - Feeling Good,37,47,24,14.0,27,Feeling Good,20.0,2,3,10,10,1,up,1976-10-09
5051,Walter Jackson,1976-10-30,Walter Jackson - Feeling Good,27,37,18,14.0,24,Feeling Good,20.0,3,6,3,10,1,up,1976-10-09
5052,Walter Jackson,1976-11-06,Walter Jackson - Feeling Good,24,27,14,14.0,18,Feeling Good,20.0,4,4,6,3,1,up,1976-10-09
5053,Walter Jackson,1976-11-13,Walter Jackson - Feeling Good,18,24,14,14.0,14,Feeling Good,20.0,5,0,4,6,0,stay,1976-10-09
5054,Walter Jackson,1976-11-20,Walter Jackson - Feeling Good,14,18,21,14.0,14,Feeling Good,20.0,6,-7,0,4,1,down,1976-10-09
5055,Walter Jackson,1976-11-27,Walter Jackson - Feeling Good,14,14,21,14.0,21,Feeling Good,20.0,7,0,-7,0,0,stay,1976-10-09
5056,Walter Jackson,1976-12-04,Walter Jackson - Feeling Good,21,14,27,14.0,21,Feeling Good,20.0,8,-6,0,-7,1,down,1976-10-09
5057,Walter Jackson,1976-12-11,Walter Jackson - Feeling Good,21,21,27,14.0,27,Feeling Good,20.0,9,0,-6,0,0,stay,1976-10-09
5058,Walter Jackson,1976-12-18,Walter Jackson - Feeling Good,27,21,26,14.0,27,Feeling Good,20.0,10,1,0,-6,1,up,1976-10-09
5059,Walter Jackson,1976-12-25,Walter Jackson - Feeling Good,27,27,26,14.0,26,Feeling Good,20.0,11,0,1,0,0,stay,1976-10-09
5060,Walter Jackson,1977-01-01,Walter Jackson - Feeling Good,26,27,19,14.0,26,Feeling Good,20.0,12,7,0,1,1,up,1976-10-09
5061,Walter Jackson,1977-01-08,Walter Jackson - Feeling Good,26,26,19,14.0,19,Feeling Good,20.0,13,0,7,0,0,stay,1976-10-09
5062,Walter Jackson,1977-01-15,Walter Jackson - Feeling Good,19,26,19,14.0,19,Feeling Good,20.0,14,0,0,7,0,stay,1976-10-09
5063,Walter Jackson,1977-01-22,Walter Jackson - Feeling Good,19,19,17,14.0,19,Feeling Good,20.0,15,2,0,0,1,up,1976-10-09
5064,Walter Jackson,1977-01-29,Walter Jackson - Feeling Good,19,19,21,14.0,17,Feeling Good,20.0,16,-4,2,0,1,down,1976-10-09
5065,Walter Jackson,1977-02-05,Walter Jackson - Feeling Good,17,19,27,14.0,21,Feeling Good,20.0,17,-6,-4,2,1,down,1976-10-09
5066,Walter Jackson,1977-02-12,Walter Jackson - Feeling Good,21,17,27,14.0,27,Feeling Good,20.0,18,0,-6,-4,0,stay,1976-10-09
5067,Walter Jackson,1977-02-19,Walter Jackson - Feeling Good,27,21,35,14.0,27,Feeling Good,20.0,19,-8,0,-6,1,down,1976-10-09
5068,Walter Jackson,1977-02-26,Walter Jackson - Feeling Good,27,27,51,14.0,35,Feeling Good,20.0,20,-16,-8,0,1,down,1976-10-09
5069,Ralph MacDonald,1976-10-09,Ralph MacDonald - Sound Of The Drum,51,51,43,43.0,48,Sound Of The Drum,2.0,0,5,3,0,1,up,1976-10-09
5070,Ralph MacDonald,1976-10-16,Ralph MacDonald - Sound Of The Drum,48,51,43,43.0,43,Sound Of The Drum,2.0,1,0,5,3,0,stay,1976-10-09
5071,Ralph MacDonald,1976-10-23,Ralph MacDonald - Sound Of The Drum,43,48,51,43.0,43,Sound Of The Drum,2.0,2,-8,0,5,1,down,1976-10-09
5072,D.J. Rogers,1976-10-09,D.J. Rogers - On The Road Again,51,51,51,49.0,49,On The Road Again,0.0,0,-2,2,0,1,down,1976-10-09
5073,The Salsoul Orchestra,1976-10-09,The Salsoul Orchestra - Nice 'n' Naasty,51,51,39,23.0,50,Nice 'n' Naasty,9.0,0,11,1,0,1,up,1976-10-09
5074,The Salsoul Orchestra,1976-10-16,The Salsoul Orchestra - Nice 'n' Naasty,50,51,31,23.0,39,Nice 'n' Naasty,9.0,1,8,11,1,1,up,1976-10-09
5075,The Salsoul Orchestra,1976-10-23,The Salsoul Orchestra - Nice 'n' Naasty,39,50,25,23.0,31,Nice 'n' Naasty,9.0,2,6,8,11,1,up,1976-10-09
5076,The Salsoul Orchestra,1976-10-30,The Salsoul Orchestra - Nice 'n' Naasty,31,39,24,23.0,25,Nice 'n' Naasty,9.0,3,1,6,8,1,up,1976-10-09
5077,The Salsoul Orchestra,1976-11-06,The Salsoul Orchestra - Nice 'n' Naasty,25,31,23,23.0,24,Nice 'n' Naasty,9.0,4,1,1,6,1,up,1976-10-09
5078,The Salsoul Orchestra,1976-11-13,The Salsoul Orchestra - Nice 'n' Naasty,24,25,23,23.0,23,Nice 'n' Naasty,9.0,5,0,1,1,0,stay,1976-10-09
5079,The Salsoul Orchestra,1976-11-20,The Salsoul Orchestra - Nice 'n' Naasty,23,24,37,23.0,23,Nice 'n' Naasty,9.0,6,-14,0,1,1,down,1976-10-09
5080,The Salsoul Orchestra,1976-11-27,The Salsoul Orchestra - Nice 'n' Naasty,23,23,37,23.0,37,Nice 'n' Naasty,9.0,7,0,-14,0,0,stay,1976-10-09
5081,The Salsoul Orchestra,1976-12-04,The Salsoul Orchestra - Nice 'n' Naasty,37,23,43,23.0,37,Nice 'n' Naasty,9.0,8,-6,0,-14,1,down,1976-10-09
5082,The Salsoul Orchestra,1976-12-11,The Salsoul Orchestra - Nice 'n' Naasty,37,37,51,23.0,43,Nice 'n' Naasty,9.0,9,-8,-6,0,1,down,1976-10-09
5083,Stevie Wonder,1976-10-16,Stevie Wonder - Songs In The Key Of Life,51,51,1,1.0,1,Songs In The Key Of Life,44.0,0,0,50,0,0,stay,1976-10-16
5084,Stevie Wonder,1976-10-23,Stevie Wonder - Songs In The Key Of Life,1,51,1,1.0,1,Songs In The Key Of Life,44.0,1,0,0,50,0,stay,1976-10-16
5085,Stevie Wonder,1976-10-30,Stevie Wonder - Songs In The Key Of Life,1,1,1,1.0,1,Songs In The Key Of Life,44.0,2,0,0,0,0,stay,1976-10-16
5086,Stevie Wonder,1976-11-06,Stevie Wonder - Songs In The Key Of Life,1,1,1,1.0,1,Songs In The Key Of Life,44.0,3,0,0,0,0,stay,1976-10-16
5087,Stevie Wonder,1976-11-13,Stevie Wonder - Songs In The Key Of Life,1,1,1,1.0,1,Songs In The Key Of Life,44.0,4,0,0,0,0,stay,1976-10-16
5088,Stevie Wonder,1976-11-20,Stevie Wonder - Songs In The Key Of Life,1,1,1,1.0,1,Songs In The Key Of Life,44.0,5,0,0,0,0,stay,1976-10-16
5089,Stevie Wonder,1976-11-27,Stevie Wonder - Songs In The Key Of Life,1,1,1,1.0,1,Songs In The Key Of Life,44.0,6,0,0,0,0,stay,1976-10-16
5090,Stevie Wonder,1976-12-04,Stevie Wonder - Songs In The Key Of Life,1,1,1,1.0,1,Songs In The Key Of Life,44.0,7,0,0,0,0,stay,1976-10-16
5091,Stevie Wonder,1976-12-11,Stevie Wonder - Songs In The Key Of Life,1,1,1,1.0,1,Songs In The Key Of Life,44.0,8,0,0,0,0,stay,1976-10-16
5092,Stevie Wonder,1976-12-18,Stevie Wonder - Songs In The Key Of Life,1,1,1,1.0,1,Songs In The Key Of Life,44.0,9,0,0,0,0,stay,1976-10-16
5093,Stevie Wonder,1976-12-25,Stevie Wonder - Songs In The Key Of Life,1,1,1,1.0,1,Songs In The Key Of Life,44.0,10,0,0,0,0,stay,1976-10-16
5094,Stevie Wonder,1977-01-01,Stevie Wonder - Songs In The Key Of Life,1,1,2,1.0,1,Songs In The Key Of Life,44.0,11,-1,0,0,1,down,1976-10-16
5095,Stevie Wonder,1977-01-08,Stevie Wonder - Songs In The Key Of Life,1,1,1,1.0,2,Songs In The Key Of Life,44.0,12,1,-1,0,1,up,1976-10-16
5096,Stevie Wonder,1977-01-15,Stevie Wonder - Songs In The Key Of Life,2,1,1,1.0,1,Songs In The Key Of Life,44.0,13,0,1,-1,0,stay,1976-10-16
5097,Stevie Wonder,1977-01-22,Stevie Wonder - Songs In The Key Of Life,1,2,1,1.0,1,Songs In The Key Of Life,44.0,14,0,0,1,0,stay,1976-10-16
5098,Stevie Wonder,1977-01-29,Stevie Wonder - Songs In The Key Of Life,1,1,1,1.0,1,Songs In The Key Of Life,44.0,15,0,0,0,0,stay,1976-10-16
5099,Stevie Wonder,1977-02-05,Stevie Wonder - Songs In The Key Of Life,1,1,1,1.0,1,Songs In The Key Of Life,44.0,16,0,0,0,0,stay,1976-10-16
5100,Stevie Wonder,1977-02-12,Stevie Wonder - Songs In The Key Of Life,1,1,1,1.0,1,Songs In The Key Of Life,44.0,17,0,0,0,0,stay,1976-10-16
5101,Stevie Wonder,1977-02-19,Stevie Wonder - Songs In The Key Of Life,1,1,1,1.0,1,Songs In The Key Of Life,44.0,18,0,0,0,0,stay,1976-10-16
5102,Stevie Wonder,1977-02-26,Stevie Wonder - Songs In The Key Of Life,1,1,1,1.0,1,Songs In The Key Of Life,44.0,19,0,0,0,0,stay,1976-10-16
5103,Stevie Wonder,1977-03-05,Stevie Wonder - Songs In The Key Of Life,1,1,4,1.0,1,Songs In The Key Of Life,44.0,20,-3,0,0,1,down,1976-10-16
5104,Stevie Wonder,1977-03-12,Stevie Wonder - Songs In The Key Of Life,1,1,4,1.0,4,Songs In The Key Of Life,44.0,21,0,-3,0,0,stay,1976-10-16
5105,Stevie Wonder,1977-03-19,Stevie Wonder - Songs In The Key Of Life,4,1,5,1.0,4,Songs In The Key Of Life,44.0,22,-1,0,-3,1,down,1976-10-16
5106,Stevie Wonder,1977-03-26,Stevie Wonder - Songs In The Key Of Life,4,4,5,1.0,5,Songs In The Key Of Life,44.0,23,0,-1,0,0,stay,1976-10-16
5107,Stevie Wonder,1977-04-02,Stevie Wonder - Songs In The Key Of Life,5,4,5,1.0,5,Songs In The Key Of Life,44.0,24,0,0,-1,0,stay,1976-10-16
5108,Stevie Wonder,1977-04-09,Stevie Wonder - Songs In The Key Of Life,5,5,4,1.0,5,Songs In The Key Of Life,44.0,25,1,0,0,1,up,1976-10-16
5109,Stevie Wonder,1977-04-16,Stevie Wonder - Songs In The Key Of Life,5,5,6,1.0,4,Songs In The Key Of Life,44.0,26,-2,1,0,1,down,1976-10-16
5110,Stevie Wonder,1977-04-23,Stevie Wonder - Songs In The Key Of Life,4,5,7,1.0,6,Songs In The Key Of Life,44.0,27,-1,-2,1,1,down,1976-10-16
5111,Stevie Wonder,1977-04-30,Stevie Wonder - Songs In The Key Of Life,6,4,7,1.0,7,Songs In The Key Of Life,44.0,28,0,-1,-2,0,stay,1976-10-16
5112,Stevie Wonder,1977-05-07,Stevie Wonder - Songs In The Key Of Life,7,6,10,1.0,7,Songs In The Key Of Life,44.0,29,-3,0,-1,1,down,1976-10-16
5113,Stevie Wonder,1977-05-14,Stevie Wonder - Songs In The Key Of Life,7,7,10,1.0,10,Songs In The Key Of Life,44.0,30,0,-3,0,0,stay,1976-10-16
5114,Stevie Wonder,1977-05-21,Stevie Wonder - Songs In The Key Of Life,10,7,14,1.0,10,Songs In The Key Of Life,44.0,31,-4,0,-3,1,down,1976-10-16
5115,Stevie Wonder,1977-05-28,Stevie Wonder - Songs In The Key Of Life,10,10,11,1.0,14,Songs In The Key Of Life,44.0,32,3,-4,0,1,up,1976-10-16
5116,Stevie Wonder,1977-06-04,Stevie Wonder - Songs In The Key Of Life,14,10,14,1.0,11,Songs In The Key Of Life,44.0,33,-3,3,-4,1,down,1976-10-16
5117,Stevie Wonder,1977-06-11,Stevie Wonder - Songs In The Key Of Life,11,14,14,1.0,14,Songs In The Key Of Life,44.0,34,0,-3,3,0,stay,1976-10-16
5118,Stevie Wonder,1977-06-18,Stevie Wonder - Songs In The Key Of Life,14,11,15,1.0,14,Songs In The Key Of Life,44.0,35,-1,0,-3,1,down,1976-10-16
5119,Stevie Wonder,1977-06-25,Stevie Wonder - Songs In The Key Of Life,14,14,15,1.0,15,Songs In The Key Of Life,44.0,36,0,-1,0,0,stay,1976-10-16
5120,Stevie Wonder,1977-07-02,Stevie Wonder - Songs In The Key Of Life,15,14,15,1.0,15,Songs In The Key Of Life,44.0,37,0,0,-1,0,stay,1976-10-16
5121,Stevie Wonder,1977-07-09,Stevie Wonder - Songs In The Key Of Life,15,15,16,1.0,15,Songs In The Key Of Life,44.0,38,-1,0,0,1,down,1976-10-16
5122,Stevie Wonder,1977-07-16,Stevie Wonder - Songs In The Key Of Life,15,15,17,1.0,16,Songs In The Key Of Life,44.0,39,-1,-1,0,1,down,1976-10-16
5123,Stevie Wonder,1977-07-23,Stevie Wonder - Songs In The Key Of Life,16,15,25,1.0,17,Songs In The Key Of Life,44.0,40,-8,-1,-1,1,down,1976-10-16
5124,Stevie Wonder,1977-07-30,Stevie Wonder - Songs In The Key Of Life,17,16,27,1.0,25,Songs In The Key Of Life,44.0,41,-2,-8,-1,1,down,1976-10-16
5125,Stevie Wonder,1977-08-06,Stevie Wonder - Songs In The Key Of Life,25,17,35,1.0,27,Songs In The Key Of Life,44.0,42,-8,-2,-8,1,down,1976-10-16
5126,Stevie Wonder,1977-08-13,Stevie Wonder - Songs In The Key Of Life,27,25,44,1.0,35,Songs In The Key Of Life,44.0,43,-9,-8,-2,1,down,1976-10-16
5127,Stevie Wonder,1977-08-20,Stevie Wonder - Songs In The Key Of Life,35,27,51,1.0,44,Songs In The Key Of Life,44.0,44,-7,-9,-8,1,down,1976-10-16
5128,"Earth, Wind & Fire",1976-10-16,"Earth, Wind & Fire - Spirit",51,51,3,2.0,10,Spirit,26.0,0,7,41,0,1,up,1976-10-16
5129,"Earth, Wind & Fire",1976-10-23,"Earth, Wind & Fire - Spirit",10,51,2,2.0,3,Spirit,26.0,1,1,7,41,1,up,1976-10-16
5130,"Earth, Wind & Fire",1976-10-30,"Earth, Wind & Fire - Spirit",3,10,2,2.0,2,Spirit,26.0,2,0,1,7,0,stay,1976-10-16
5131,"Earth, Wind & Fire",1976-11-06,"Earth, Wind & Fire - Spirit",2,3,2,2.0,2,Spirit,26.0,3,0,0,1,0,stay,1976-10-16
5132,"Earth, Wind & Fire",1976-11-13,"Earth, Wind & Fire - Spirit",2,2,2,2.0,2,Spirit,26.0,4,0,0,0,0,stay,1976-10-16
5133,"Earth, Wind & Fire",1976-11-20,"Earth, Wind & Fire - Spirit",2,2,2,2.0,2,Spirit,26.0,5,0,0,0,0,stay,1976-10-16
5134,"Earth, Wind & Fire",1976-11-27,"Earth, Wind & Fire - Spirit",2,2,2,2.0,2,Spirit,26.0,6,0,0,0,0,stay,1976-10-16
5135,"Earth, Wind & Fire",1976-12-04,"Earth, Wind & Fire - Spirit",2,2,2,2.0,2,Spirit,26.0,7,0,0,0,0,stay,1976-10-16
5136,"Earth, Wind & Fire",1976-12-11,"Earth, Wind & Fire - Spirit",2,2,2,2.0,2,Spirit,26.0,8,0,0,0,0,stay,1976-10-16
5137,"Earth, Wind & Fire",1976-12-18,"Earth, Wind & Fire - Spirit",2,2,5,2.0,2,Spirit,26.0,9,-3,0,0,1,down,1976-10-16
5138,"Earth, Wind & Fire",1976-12-25,"Earth, Wind & Fire - Spirit",2,2,5,2.0,5,Spirit,26.0,10,0,-3,0,0,stay,1976-10-16
5139,"Earth, Wind & Fire",1977-01-01,"Earth, Wind & Fire - Spirit",5,2,5,2.0,5,Spirit,26.0,11,0,0,-3,0,stay,1976-10-16
5140,"Earth, Wind & Fire",1977-01-08,"Earth, Wind & Fire - Spirit",5,5,4,2.0,5,Spirit,26.0,12,1,0,0,1,up,1976-10-16
5141,"Earth, Wind & Fire",1977-01-15,"Earth, Wind & Fire - Spirit",5,5,4,2.0,4,Spirit,26.0,13,0,1,0,0,stay,1976-10-16
5142,"Earth, Wind & Fire",1977-01-22,"Earth, Wind & Fire - Spirit",4,5,4,2.0,4,Spirit,26.0,14,0,0,1,0,stay,1976-10-16
5143,"Earth, Wind & Fire",1977-01-29,"Earth, Wind & Fire - Spirit",4,4,4,2.0,4,Spirit,26.0,15,0,0,0,0,stay,1976-10-16
5144,"Earth, Wind & Fire",1977-02-05,"Earth, Wind & Fire - Spirit",4,4,5,2.0,4,Spirit,26.0,16,-1,0,0,1,down,1976-10-16
5145,"Earth, Wind & Fire",1977-02-12,"Earth, Wind & Fire - Spirit",4,4,5,2.0,5,Spirit,26.0,17,0,-1,0,0,stay,1976-10-16
5146,"Earth, Wind & Fire",1977-02-19,"Earth, Wind & Fire - Spirit",5,4,8,2.0,5,Spirit,26.0,18,-3,0,-1,1,down,1976-10-16
5147,"Earth, Wind & Fire",1977-02-26,"Earth, Wind & Fire - Spirit",5,5,9,2.0,8,Spirit,26.0,19,-1,-3,0,1,down,1976-10-16
5148,"Earth, Wind & Fire",1977-03-05,"Earth, Wind & Fire - Spirit",8,5,15,2.0,9,Spirit,26.0,20,-6,-1,-3,1,down,1976-10-16
5149,"Earth, Wind & Fire",1977-03-12,"Earth, Wind & Fire - Spirit",9,8,17,2.0,15,Spirit,26.0,21,-2,-6,-1,1,down,1976-10-16
5150,"Earth, Wind & Fire",1977-03-19,"Earth, Wind & Fire - Spirit",15,9,16,2.0,17,Spirit,26.0,22,1,-2,-6,1,up,1976-10-16
5151,"Earth, Wind & Fire",1977-03-26,"Earth, Wind & Fire - Spirit",17,15,34,2.0,16,Spirit,26.0,23,-18,1,-2,1,down,1976-10-16
5152,"Earth, Wind & Fire",1977-04-02,"Earth, Wind & Fire - Spirit",16,17,34,2.0,34,Spirit,26.0,24,0,-18,1,0,stay,1976-10-16
5153,"Earth, Wind & Fire",1977-04-09,"Earth, Wind & Fire - Spirit",34,16,37,2.0,34,Spirit,26.0,25,-3,0,-18,1,down,1976-10-16
5154,"Earth, Wind & Fire",1977-04-16,"Earth, Wind & Fire - Spirit",34,34,51,2.0,37,Spirit,26.0,26,-14,-3,0,1,down,1976-10-16
5155,The Miracles,1976-10-16,The Miracles - The Power Of Music,51,51,35,35.0,40,The Power Of Music,2.0,0,5,11,0,1,up,1976-10-16
5156,The Miracles,1976-10-23,The Miracles - The Power Of Music,40,51,35,35.0,35,The Power Of Music,2.0,1,0,5,11,0,stay,1976-10-16
5157,The Miracles,1976-10-30,The Miracles - The Power Of Music,35,40,51,35.0,35,The Power Of Music,2.0,2,-16,0,5,1,down,1976-10-16
5158,Ronnie Dyson,1976-10-16,Ronnie Dyson - The More You Do It,51,51,32,30.0,42,The More You Do It,3.0,0,10,9,0,1,up,1976-10-16
5159,Ronnie Dyson,1976-10-23,Ronnie Dyson - The More You Do It,42,51,30,30.0,32,The More You Do It,3.0,1,2,10,9,1,up,1976-10-16
5160,Ronnie Dyson,1976-10-30,Ronnie Dyson - The More You Do It,32,42,30,30.0,30,The More You Do It,3.0,2,0,2,10,0,stay,1976-10-16
5161,Ronnie Dyson,1976-11-06,Ronnie Dyson - The More You Do It,30,32,51,30.0,30,The More You Do It,3.0,3,-21,0,2,1,down,1976-10-16
5162,Rose Royce,1976-10-16,Rose Royce - Car Wash,51,51,37,2.0,47,Car Wash,33.0,0,10,4,0,1,up,1976-10-16
5163,Rose Royce,1976-10-23,Rose Royce - Car Wash,47,51,31,2.0,37,Car Wash,33.0,1,6,10,4,1,up,1976-10-16
5164,Rose Royce,1976-10-30,Rose Royce - Car Wash,37,47,23,2.0,31,Car Wash,33.0,2,8,6,10,1,up,1976-10-16
5165,Rose Royce,1976-11-06,Rose Royce - Car Wash,31,37,18,2.0,23,Car Wash,33.0,3,5,8,6,1,up,1976-10-16
5166,Rose Royce,1976-11-13,Rose Royce - Car Wash,23,31,10,2.0,18,Car Wash,33.0,4,8,5,8,1,up,1976-10-16
5167,Rose Royce,1976-11-20,Rose Royce - Car Wash,18,23,6,2.0,10,Car Wash,33.0,5,4,8,5,1,up,1976-10-16
5168,Rose Royce,1976-11-27,Rose Royce - Car Wash,10,18,6,2.0,6,Car Wash,33.0,6,0,4,8,0,stay,1976-10-16
5169,Rose Royce,1976-12-04,Rose Royce - Car Wash,6,10,3,2.0,6,Car Wash,33.0,7,3,0,4,1,up,1976-10-16
5170,Rose Royce,1976-12-11,Rose Royce - Car Wash,6,6,3,2.0,3,Car Wash,33.0,8,0,3,0,0,stay,1976-10-16
5171,Rose Royce,1976-12-18,Rose Royce - Car Wash,3,6,3,2.0,3,Car Wash,33.0,9,0,0,3,0,stay,1976-10-16
5172,Rose Royce,1976-12-25,Rose Royce - Car Wash,3,3,3,2.0,3,Car Wash,33.0,10,0,0,0,0,stay,1976-10-16
5173,Rose Royce,1977-01-01,Rose Royce - Car Wash,3,3,3,2.0,3,Car Wash,33.0,11,0,0,0,0,stay,1976-10-16
5174,Rose Royce,1977-01-08,Rose Royce - Car Wash,3,3,2,2.0,3,Car Wash,33.0,12,1,0,0,1,up,1976-10-16
5175,Rose Royce,1977-01-15,Rose Royce - Car Wash,3,3,2,2.0,2,Car Wash,33.0,13,0,1,0,0,stay,1976-10-16
5176,Rose Royce,1977-01-22,Rose Royce - Car Wash,2,3,2,2.0,2,Car Wash,33.0,14,0,0,1,0,stay,1976-10-16
5177,Rose Royce,1977-01-29,Rose Royce - Car Wash,2,2,2,2.0,2,Car Wash,33.0,15,0,0,0,0,stay,1976-10-16
5178,Rose Royce,1977-02-05,Rose Royce - Car Wash,2,2,3,2.0,2,Car Wash,33.0,16,-1,0,0,1,down,1976-10-16
5179,Rose Royce,1977-02-12,Rose Royce - Car Wash,2,2,4,2.0,3,Car Wash,33.0,17,-1,-1,0,1,down,1976-10-16
5180,Rose Royce,1977-02-19,Rose Royce - Car Wash,3,2,7,2.0,4,Car Wash,33.0,18,-3,-1,-1,1,down,1976-10-16
5181,Rose Royce,1977-02-26,Rose Royce - Car Wash,4,3,7,2.0,7,Car Wash,33.0,19,0,-3,-1,0,stay,1976-10-16
5182,Rose Royce,1977-03-05,Rose Royce - Car Wash,7,4,7,2.0,7,Car Wash,33.0,20,0,0,-3,0,stay,1976-10-16
5183,Rose Royce,1977-03-12,Rose Royce - Car Wash,7,7,8,2.0,7,Car Wash,33.0,21,-1,0,0,1,down,1976-10-16
5184,Rose Royce,1977-03-19,Rose Royce - Car Wash,7,7,10,2.0,8,Car Wash,33.0,22,-2,-1,0,1,down,1976-10-16
5185,Rose Royce,1977-03-26,Rose Royce - Car Wash,8,7,13,2.0,10,Car Wash,33.0,23,-3,-2,-1,1,down,1976-10-16
5186,Rose Royce,1977-04-02,Rose Royce - Car Wash,10,8,24,2.0,13,Car Wash,33.0,24,-11,-3,-2,1,down,1976-10-16
5187,Rose Royce,1977-04-09,Rose Royce - Car Wash,13,10,24,2.0,24,Car Wash,33.0,25,0,-11,-3,0,stay,1976-10-16
5188,Rose Royce,1977-04-16,Rose Royce - Car Wash,24,13,35,2.0,24,Car Wash,33.0,26,-11,0,-11,1,down,1976-10-16
5189,Rose Royce,1977-04-23,Rose Royce - Car Wash,24,24,34,2.0,35,Car Wash,33.0,27,1,-11,0,1,up,1976-10-16
5190,Rose Royce,1977-04-30,Rose Royce - Car Wash,35,24,37,2.0,34,Car Wash,33.0,28,-3,1,-11,1,down,1976-10-16
5191,Rose Royce,1977-05-07,Rose Royce - Car Wash,34,35,35,2.0,37,Car Wash,33.0,29,2,-3,1,1,up,1976-10-16
5192,Rose Royce,1977-05-14,Rose Royce - Car Wash,37,34,34,2.0,35,Car Wash,33.0,30,1,2,-3,1,up,1976-10-16
5193,Rose Royce,1977-05-21,Rose Royce - Car Wash,35,37,37,2.0,34,Car Wash,33.0,31,-3,1,2,1,down,1976-10-16
5194,Rose Royce,1977-05-28,Rose Royce - Car Wash,34,35,34,2.0,37,Car Wash,33.0,32,3,-3,1,1,up,1976-10-16
5195,Rose Royce,1977-06-04,Rose Royce - Car Wash,37,34,51,2.0,34,Car Wash,33.0,33,-17,3,-3,1,down,1976-10-16
5196,Vicki Sue Robinson,1976-10-16,Vicki Sue Robinson - Vicki Sue Robinson,51,51,39,39.0,49,Vicki Sue Robinson,2.0,0,10,2,0,1,up,1976-10-16
5197,Vicki Sue Robinson,1976-10-23,Vicki Sue Robinson - Vicki Sue Robinson,49,51,39,39.0,39,Vicki Sue Robinson,2.0,1,0,10,2,0,stay,1976-10-16
5198,Vicki Sue Robinson,1976-10-30,Vicki Sue Robinson - Vicki Sue Robinson,39,49,51,39.0,39,Vicki Sue Robinson,2.0,2,-12,0,10,1,down,1976-10-16
5199,Van Mccoy,1976-10-16,Van Mccoy - Rhythms Of The World,51,51,44,44.0,50,Rhythms Of The World,2.0,0,6,1,0,1,up,1976-10-16
5200,Van Mccoy,1976-10-23,Van Mccoy - Rhythms Of The World,50,51,44,44.0,44,Rhythms Of The World,2.0,1,0,6,1,0,stay,1976-10-16
5201,Van Mccoy,1976-10-30,Van Mccoy - Rhythms Of The World,44,50,51,44.0,44,Rhythms Of The World,2.0,2,-7,0,6,1,down,1976-10-16
5202,Parliament,1976-10-23,Parliament - Clones Of Dr. Funkenstein,51,51,7,3.0,20,Clones Of Dr. Funkenstein,23.0,0,13,31,0,1,up,1976-10-23
5203,Parliament,1976-10-30,Parliament - Clones Of Dr. Funkenstein,20,51,6,3.0,7,Clones Of Dr. Funkenstein,23.0,1,1,13,31,1,up,1976-10-23
5204,Parliament,1976-11-06,Parliament - Clones Of Dr. Funkenstein,7,20,4,3.0,6,Clones Of Dr. Funkenstein,23.0,2,2,1,13,1,up,1976-10-23
5205,Parliament,1976-11-13,Parliament - Clones Of Dr. Funkenstein,6,7,3,3.0,4,Clones Of Dr. Funkenstein,23.0,3,1,2,1,1,up,1976-10-23
5206,Parliament,1976-11-20,Parliament - Clones Of Dr. Funkenstein,4,6,3,3.0,3,Clones Of Dr. Funkenstein,23.0,4,0,1,2,0,stay,1976-10-23
5207,Parliament,1976-11-27,Parliament - Clones Of Dr. Funkenstein,3,4,3,3.0,3,Clones Of Dr. Funkenstein,23.0,5,0,0,1,0,stay,1976-10-23
5208,Parliament,1976-12-04,Parliament - Clones Of Dr. Funkenstein,3,3,5,3.0,3,Clones Of Dr. Funkenstein,23.0,6,-2,0,0,1,down,1976-10-23
5209,Parliament,1976-12-11,Parliament - Clones Of Dr. Funkenstein,3,3,6,3.0,5,Clones Of Dr. Funkenstein,23.0,7,-1,-2,0,1,down,1976-10-23
5210,Parliament,1976-12-18,Parliament - Clones Of Dr. Funkenstein,5,3,7,3.0,6,Clones Of Dr. Funkenstein,23.0,8,-1,-1,-2,1,down,1976-10-23
5211,Parliament,1976-12-25,Parliament - Clones Of Dr. Funkenstein,6,5,7,3.0,7,Clones Of Dr. Funkenstein,23.0,9,0,-1,-1,0,stay,1976-10-23
5212,Parliament,1977-01-01,Parliament - Clones Of Dr. Funkenstein,7,6,10,3.0,7,Clones Of Dr. Funkenstein,23.0,10,-3,0,-1,1,down,1976-10-23
5213,Parliament,1977-01-08,Parliament - Clones Of Dr. Funkenstein,7,7,11,3.0,10,Clones Of Dr. Funkenstein,23.0,11,-1,-3,0,1,down,1976-10-23
5214,Parliament,1977-01-15,Parliament - Clones Of Dr. Funkenstein,10,7,13,3.0,11,Clones Of Dr. Funkenstein,23.0,12,-2,-1,-3,1,down,1976-10-23
5215,Parliament,1977-01-22,Parliament - Clones Of Dr. Funkenstein,11,10,15,3.0,13,Clones Of Dr. Funkenstein,23.0,13,-2,-2,-1,1,down,1976-10-23
5216,Parliament,1977-01-29,Parliament - Clones Of Dr. Funkenstein,13,11,19,3.0,15,Clones Of Dr. Funkenstein,23.0,14,-4,-2,-2,1,down,1976-10-23
5217,Parliament,1977-02-05,Parliament - Clones Of Dr. Funkenstein,15,13,29,3.0,19,Clones Of Dr. Funkenstein,23.0,15,-10,-4,-2,1,down,1976-10-23
5218,Parliament,1977-02-12,Parliament - Clones Of Dr. Funkenstein,19,15,29,3.0,29,Clones Of Dr. Funkenstein,23.0,16,0,-10,-4,0,stay,1976-10-23
5219,Parliament,1977-02-19,Parliament - Clones Of Dr. Funkenstein,29,19,28,3.0,29,Clones Of Dr. Funkenstein,23.0,17,1,0,-10,1,up,1976-10-23
5220,Parliament,1977-02-26,Parliament - Clones Of Dr. Funkenstein,29,29,38,3.0,28,Clones Of Dr. Funkenstein,23.0,18,-10,1,0,1,down,1976-10-23
5221,Parliament,1977-03-05,Parliament - Clones Of Dr. Funkenstein,28,29,38,3.0,38,Clones Of Dr. Funkenstein,23.0,19,0,-10,1,0,stay,1976-10-23
5222,Parliament,1977-03-12,Parliament - Clones Of Dr. Funkenstein,38,28,38,3.0,38,Clones Of Dr. Funkenstein,23.0,20,0,0,-10,0,stay,1976-10-23
5223,Parliament,1977-03-19,Parliament - Clones Of Dr. Funkenstein,38,38,43,3.0,38,Clones Of Dr. Funkenstein,23.0,21,-5,0,0,1,down,1976-10-23
5224,Parliament,1977-03-26,Parliament - Clones Of Dr. Funkenstein,38,38,43,3.0,43,Clones Of Dr. Funkenstein,23.0,22,0,-5,0,0,stay,1976-10-23
5225,Parliament,1977-04-02,Parliament - Clones Of Dr. Funkenstein,43,38,51,3.0,43,Clones Of Dr. Funkenstein,23.0,23,-8,0,-5,1,down,1976-10-23
5226,The Dramatics,1976-10-23,The Dramatics - Joy Ride,51,51,34,11.0,42,Joy Ride,28.0,0,8,9,0,1,up,1976-10-23
5227,The Dramatics,1976-10-30,The Dramatics - Joy Ride,42,51,27,11.0,34,Joy Ride,28.0,1,7,8,9,1,up,1976-10-23
5228,The Dramatics,1976-11-06,The Dramatics - Joy Ride,34,42,21,11.0,27,Joy Ride,28.0,2,6,7,8,1,up,1976-10-23
5229,The Dramatics,1976-11-13,The Dramatics - Joy Ride,27,34,16,11.0,21,Joy Ride,28.0,3,5,6,7,1,up,1976-10-23
5230,The Dramatics,1976-11-20,The Dramatics - Joy Ride,21,27,16,11.0,16,Joy Ride,28.0,4,0,5,6,0,stay,1976-10-23
5231,The Dramatics,1976-11-27,The Dramatics - Joy Ride,16,21,27,11.0,16,Joy Ride,28.0,5,-11,0,5,1,down,1976-10-23
5232,The Dramatics,1976-12-04,The Dramatics - Joy Ride,16,16,30,11.0,27,Joy Ride,28.0,6,-3,-11,0,1,down,1976-10-23
5233,The Dramatics,1976-12-11,The Dramatics - Joy Ride,27,16,32,11.0,30,Joy Ride,28.0,7,-2,-3,-11,1,down,1976-10-23
5234,The Dramatics,1976-12-18,The Dramatics - Joy Ride,30,27,31,11.0,32,Joy Ride,28.0,8,1,-2,-3,1,up,1976-10-23
5235,The Dramatics,1976-12-25,The Dramatics - Joy Ride,32,30,31,11.0,31,Joy Ride,28.0,9,0,1,-2,0,stay,1976-10-23
5236,The Dramatics,1977-01-01,The Dramatics - Joy Ride,31,32,32,11.0,31,Joy Ride,28.0,10,-1,0,1,1,down,1976-10-23
5237,The Dramatics,1977-01-08,The Dramatics - Joy Ride,31,31,32,11.0,32,Joy Ride,28.0,11,0,-1,0,0,stay,1976-10-23
5238,The Dramatics,1977-01-15,The Dramatics - Joy Ride,32,31,28,11.0,32,Joy Ride,28.0,12,4,0,-1,1,up,1976-10-23
5239,The Dramatics,1977-01-22,The Dramatics - Joy Ride,32,32,26,11.0,28,Joy Ride,28.0,13,2,4,0,1,up,1976-10-23
5240,The Dramatics,1977-01-29,The Dramatics - Joy Ride,28,32,22,11.0,26,Joy Ride,28.0,14,4,2,4,1,up,1976-10-23
5241,The Dramatics,1977-02-05,The Dramatics - Joy Ride,26,28,24,11.0,22,Joy Ride,28.0,15,-2,4,2,1,down,1976-10-23
5242,The Dramatics,1977-02-12,The Dramatics - Joy Ride,22,26,21,11.0,24,Joy Ride,28.0,16,3,-2,4,1,up,1976-10-23
5243,The Dramatics,1977-02-19,The Dramatics - Joy Ride,24,22,24,11.0,21,Joy Ride,28.0,17,-3,3,-2,1,down,1976-10-23
5244,The Dramatics,1977-02-26,The Dramatics - Joy Ride,21,24,18,11.0,24,Joy Ride,28.0,18,6,-3,3,1,up,1976-10-23
5245,The Dramatics,1977-03-05,The Dramatics - Joy Ride,24,21,18,11.0,18,Joy Ride,28.0,19,0,6,-3,0,stay,1976-10-23
5246,The Dramatics,1977-03-12,The Dramatics - Joy Ride,18,24,13,11.0,18,Joy Ride,28.0,20,5,0,6,1,up,1976-10-23
5247,The Dramatics,1977-03-19,The Dramatics - Joy Ride,18,18,13,11.0,13,Joy Ride,28.0,21,0,5,0,0,stay,1976-10-23
5248,The Dramatics,1977-03-26,The Dramatics - Joy Ride,13,18,11,11.0,13,Joy Ride,28.0,22,2,0,5,1,up,1976-10-23
5249,The Dramatics,1977-04-02,The Dramatics - Joy Ride,13,13,12,11.0,11,Joy Ride,28.0,23,-1,2,0,1,down,1976-10-23
5250,The Dramatics,1977-04-09,The Dramatics - Joy Ride,11,13,18,11.0,12,Joy Ride,28.0,24,-6,-1,2,1,down,1976-10-23
5251,The Dramatics,1977-04-16,The Dramatics - Joy Ride,12,11,21,11.0,18,Joy Ride,28.0,25,-3,-6,-1,1,down,1976-10-23
5252,The Dramatics,1977-04-23,The Dramatics - Joy Ride,18,12,40,11.0,21,Joy Ride,28.0,26,-19,-3,-6,1,down,1976-10-23
5253,The Dramatics,1977-04-30,The Dramatics - Joy Ride,21,18,40,11.0,40,Joy Ride,28.0,27,0,-19,-3,0,stay,1976-10-23
5254,The Dramatics,1977-05-07,The Dramatics - Joy Ride,40,21,51,11.0,40,Joy Ride,28.0,28,-11,0,-19,1,down,1976-10-23
5255,Deniece Williams,1976-10-23,Deniece Williams - This Is Niecy,51,51,45,3.0,45,This Is Niecy,29.0,0,0,6,0,0,stay,1976-10-23
5256,Deniece Williams,1976-10-30,Deniece Williams - This Is Niecy,45,51,39,3.0,45,This Is Niecy,29.0,1,6,0,6,1,up,1976-10-23
5257,Deniece Williams,1976-11-06,Deniece Williams - This Is Niecy,45,45,34,3.0,39,This Is Niecy,29.0,2,5,6,0,1,up,1976-10-23
5258,Deniece Williams,1976-11-13,Deniece Williams - This Is Niecy,39,45,21,3.0,34,This Is Niecy,29.0,3,13,5,6,1,up,1976-10-23
5259,Deniece Williams,1976-11-20,Deniece Williams - This Is Niecy,34,39,19,3.0,21,This Is Niecy,29.0,4,2,13,5,1,up,1976-10-23
5260,Deniece Williams,1976-11-27,Deniece Williams - This Is Niecy,21,34,16,3.0,19,This Is Niecy,29.0,5,3,2,13,1,up,1976-10-23
5261,Deniece Williams,1976-12-04,Deniece Williams - This Is Niecy,19,21,12,3.0,16,This Is Niecy,29.0,6,4,3,2,1,up,1976-10-23
5262,Deniece Williams,1976-12-11,Deniece Williams - This Is Niecy,16,19,10,3.0,12,This Is Niecy,29.0,7,2,4,3,1,up,1976-10-23
5263,Deniece Williams,1976-12-18,Deniece Williams - This Is Niecy,12,16,6,3.0,10,This Is Niecy,29.0,8,4,2,4,1,up,1976-10-23
5264,Deniece Williams,1976-12-25,Deniece Williams - This Is Niecy,10,12,6,3.0,6,This Is Niecy,29.0,9,0,4,2,0,stay,1976-10-23
5265,Deniece Williams,1977-01-01,Deniece Williams - This Is Niecy,6,10,6,3.0,6,This Is Niecy,29.0,10,0,0,4,0,stay,1976-10-23
5266,Deniece Williams,1977-01-08,Deniece Williams - This Is Niecy,6,6,6,3.0,6,This Is Niecy,29.0,11,0,0,0,0,stay,1976-10-23
5267,Deniece Williams,1977-01-15,Deniece Williams - This Is Niecy,6,6,5,3.0,6,This Is Niecy,29.0,12,1,0,0,1,up,1976-10-23
5268,Deniece Williams,1977-01-22,Deniece Williams - This Is Niecy,6,6,5,3.0,5,This Is Niecy,29.0,13,0,1,0,0,stay,1976-10-23
5269,Deniece Williams,1977-01-29,Deniece Williams - This Is Niecy,5,6,5,3.0,5,This Is Niecy,29.0,14,0,0,1,0,stay,1976-10-23
5270,Deniece Williams,1977-02-05,Deniece Williams - This Is Niecy,5,5,4,3.0,5,This Is Niecy,29.0,15,1,0,0,1,up,1976-10-23
5271,Deniece Williams,1977-02-12,Deniece Williams - This Is Niecy,5,5,3,3.0,4,This Is Niecy,29.0,16,1,1,0,1,up,1976-10-23
5272,Deniece Williams,1977-02-19,Deniece Williams - This Is Niecy,4,5,4,3.0,3,This Is Niecy,29.0,17,-1,1,1,1,down,1976-10-23
5273,Deniece Williams,1977-02-26,Deniece Williams - This Is Niecy,3,4,6,3.0,4,This Is Niecy,29.0,18,-2,-1,1,1,down,1976-10-23
5274,Deniece Williams,1977-03-05,Deniece Williams - This Is Niecy,4,3,6,3.0,6,This Is Niecy,29.0,19,0,-2,-1,0,stay,1976-10-23
5275,Deniece Williams,1977-03-12,Deniece Williams - This Is Niecy,6,4,9,3.0,6,This Is Niecy,29.0,20,-3,0,-2,1,down,1976-10-23
5276,Deniece Williams,1977-03-19,Deniece Williams - This Is Niecy,6,6,8,3.0,9,This Is Niecy,29.0,21,1,-3,0,1,up,1976-10-23
5277,Deniece Williams,1977-03-26,Deniece Williams - This Is Niecy,9,6,16,3.0,8,This Is Niecy,29.0,22,-8,1,-3,1,down,1976-10-23
5278,Deniece Williams,1977-04-02,Deniece Williams - This Is Niecy,8,9,15,3.0,16,This Is Niecy,29.0,23,1,-8,1,1,up,1976-10-23
5279,Deniece Williams,1977-04-09,Deniece Williams - This Is Niecy,16,8,22,3.0,15,This Is Niecy,29.0,24,-7,1,-8,1,down,1976-10-23
5280,Deniece Williams,1977-04-16,Deniece Williams - This Is Niecy,15,16,27,3.0,22,This Is Niecy,29.0,25,-5,-7,1,1,down,1976-10-23
5281,Deniece Williams,1977-04-23,Deniece Williams - This Is Niecy,22,15,38,3.0,27,This Is Niecy,29.0,26,-11,-5,-7,1,down,1976-10-23
5282,Deniece Williams,1977-04-30,Deniece Williams - This Is Niecy,27,22,41,3.0,38,This Is Niecy,29.0,27,-3,-11,-5,1,down,1976-10-23
5283,Deniece Williams,1977-05-07,Deniece Williams - This Is Niecy,38,27,39,3.0,41,This Is Niecy,29.0,28,2,-3,-11,1,up,1976-10-23
5284,Deniece Williams,1977-05-14,Deniece Williams - This Is Niecy,41,38,51,3.0,39,This Is Niecy,29.0,29,-12,2,-3,1,down,1976-10-23
5285,Four Tops,1976-10-23,Four Tops - Catfish,51,51,38,26.0,46,Catfish,12.0,0,8,5,0,1,up,1976-10-23
5286,Four Tops,1976-10-30,Four Tops - Catfish,46,51,31,26.0,38,Catfish,12.0,1,7,8,5,1,up,1976-10-23
5287,Four Tops,1976-11-06,Four Tops - Catfish,38,46,27,26.0,31,Catfish,12.0,2,4,7,8,1,up,1976-10-23
5288,Four Tops,1976-11-13,Four Tops - Catfish,31,38,26,26.0,27,Catfish,12.0,3,1,4,7,1,up,1976-10-23
5289,Four Tops,1976-11-20,Four Tops - Catfish,27,31,39,26.0,26,Catfish,12.0,4,-13,1,4,1,down,1976-10-23
5290,Four Tops,1976-11-27,Four Tops - Catfish,26,27,38,26.0,39,Catfish,12.0,5,1,-13,1,1,up,1976-10-23
5291,Four Tops,1976-12-04,Four Tops - Catfish,39,26,35,26.0,38,Catfish,12.0,6,3,1,-13,1,up,1976-10-23
5292,Four Tops,1976-12-11,Four Tops - Catfish,38,39,30,26.0,35,Catfish,12.0,7,5,3,1,1,up,1976-10-23
5293,Four Tops,1976-12-18,Four Tops - Catfish,35,38,30,26.0,30,Catfish,12.0,8,0,5,3,0,stay,1976-10-23
5294,Four Tops,1976-12-25,Four Tops - Catfish,30,35,30,26.0,30,Catfish,12.0,9,0,0,5,0,stay,1976-10-23
5295,Four Tops,1977-01-01,Four Tops - Catfish,30,30,30,26.0,30,Catfish,12.0,10,0,0,0,0,stay,1976-10-23
5296,Four Tops,1977-01-08,Four Tops - Catfish,30,30,42,26.0,30,Catfish,12.0,11,-12,0,0,1,down,1976-10-23
5297,Four Tops,1977-01-22,Four Tops - Catfish,30,30,51,26.0,42,Catfish,12.0,12,-9,-12,0,1,down,1976-10-23
5298,Peabo Bryson,1976-10-23,Peabo Bryson - Peabo,51,51,48,48.0,50,Peabo,3.0,0,2,1,0,1,up,1976-10-23
5299,Peabo Bryson,1976-10-30,Peabo Bryson - Peabo,50,51,50,48.0,48,Peabo,3.0,1,-2,2,1,1,down,1976-10-23
5300,Peabo Bryson,1976-11-06,Peabo Bryson - Peabo,48,50,50,48.0,50,Peabo,3.0,2,0,-2,2,0,stay,1976-10-23
5301,Peabo Bryson,1976-11-13,Peabo Bryson - Peabo,50,48,51,48.0,50,Peabo,3.0,3,-1,0,-2,1,down,1976-10-23
5302,KC And The Sunshine Band,1976-10-30,KC And The Sunshine Band - Part 3,51,51,7,5.0,10,Part 3,44.0,0,3,41,0,1,up,1976-10-30
5303,KC And The Sunshine Band,1976-11-06,KC And The Sunshine Band - Part 3,10,51,5,5.0,7,Part 3,44.0,1,2,3,41,1,up,1976-10-30
5304,KC And The Sunshine Band,1976-11-13,KC And The Sunshine Band - Part 3,7,10,5,5.0,5,Part 3,44.0,2,0,2,3,0,stay,1976-10-30
5305,KC And The Sunshine Band,1976-11-20,KC And The Sunshine Band - Part 3,5,7,9,5.0,5,Part 3,44.0,3,-4,0,2,1,down,1976-10-30
5306,KC And The Sunshine Band,1976-11-27,KC And The Sunshine Band - Part 3,5,5,15,5.0,9,Part 3,44.0,4,-6,-4,0,1,down,1976-10-30
5307,KC And The Sunshine Band,1976-12-04,KC And The Sunshine Band - Part 3,9,5,16,5.0,15,Part 3,44.0,5,-1,-6,-4,1,down,1976-10-30
5308,KC And The Sunshine Band,1976-12-11,KC And The Sunshine Band - Part 3,15,9,22,5.0,16,Part 3,44.0,6,-6,-1,-6,1,down,1976-10-30
5309,KC And The Sunshine Band,1976-12-18,KC And The Sunshine Band - Part 3,16,15,24,5.0,22,Part 3,44.0,7,-2,-6,-1,1,down,1976-10-30
5310,KC And The Sunshine Band,1976-12-25,KC And The Sunshine Band - Part 3,22,16,24,5.0,24,Part 3,44.0,8,0,-2,-6,0,stay,1976-10-30
5311,KC And The Sunshine Band,1977-01-01,KC And The Sunshine Band - Part 3,24,22,24,5.0,24,Part 3,44.0,9,0,0,-2,0,stay,1976-10-30
5312,KC And The Sunshine Band,1977-01-08,KC And The Sunshine Band - Part 3,24,24,23,5.0,24,Part 3,44.0,10,1,0,0,1,up,1976-10-30
5313,KC And The Sunshine Band,1977-01-15,KC And The Sunshine Band - Part 3,24,24,20,5.0,23,Part 3,44.0,11,3,1,0,1,up,1976-10-30
5314,KC And The Sunshine Band,1977-01-22,KC And The Sunshine Band - Part 3,23,24,20,5.0,20,Part 3,44.0,12,0,3,1,0,stay,1976-10-30
5315,KC And The Sunshine Band,1977-01-29,KC And The Sunshine Band - Part 3,20,23,18,5.0,20,Part 3,44.0,13,2,0,3,1,up,1976-10-30
5316,KC And The Sunshine Band,1977-02-05,KC And The Sunshine Band - Part 3,20,20,18,5.0,18,Part 3,44.0,14,0,2,0,0,stay,1976-10-30
5317,KC And The Sunshine Band,1977-02-12,KC And The Sunshine Band - Part 3,18,20,18,5.0,18,Part 3,44.0,15,0,0,2,0,stay,1976-10-30
5318,KC And The Sunshine Band,1977-02-19,KC And The Sunshine Band - Part 3,18,18,17,5.0,18,Part 3,44.0,16,1,0,0,1,up,1976-10-30
5319,KC And The Sunshine Band,1977-02-26,KC And The Sunshine Band - Part 3,18,18,24,5.0,17,Part 3,44.0,17,-7,1,0,1,down,1976-10-30
5320,KC And The Sunshine Band,1977-03-05,KC And The Sunshine Band - Part 3,17,18,31,5.0,24,Part 3,44.0,18,-7,-7,1,1,down,1976-10-30
5321,KC And The Sunshine Band,1977-03-12,KC And The Sunshine Band - Part 3,24,17,31,5.0,31,Part 3,44.0,19,0,-7,-7,0,stay,1976-10-30
5322,KC And The Sunshine Band,1977-03-19,KC And The Sunshine Band - Part 3,31,24,29,5.0,31,Part 3,44.0,20,2,0,-7,1,up,1976-10-30
5323,KC And The Sunshine Band,1977-03-26,KC And The Sunshine Band - Part 3,31,31,29,5.0,29,Part 3,44.0,21,0,2,0,0,stay,1976-10-30
5324,KC And The Sunshine Band,1977-04-02,KC And The Sunshine Band - Part 3,29,31,26,5.0,29,Part 3,44.0,22,3,0,2,1,up,1976-10-30
5325,KC And The Sunshine Band,1977-04-09,KC And The Sunshine Band - Part 3,29,29,23,5.0,26,Part 3,44.0,23,3,3,0,1,up,1976-10-30
5326,KC And The Sunshine Band,1977-04-16,KC And The Sunshine Band - Part 3,26,29,28,5.0,23,Part 3,44.0,24,-5,3,3,1,down,1976-10-30
5327,KC And The Sunshine Band,1977-04-23,KC And The Sunshine Band - Part 3,23,26,28,5.0,28,Part 3,44.0,25,0,-5,3,0,stay,1976-10-30
5328,KC And The Sunshine Band,1977-04-30,KC And The Sunshine Band - Part 3,28,23,28,5.0,28,Part 3,44.0,26,0,0,-5,0,stay,1976-10-30
5329,KC And The Sunshine Band,1977-05-07,KC And The Sunshine Band - Part 3,28,28,27,5.0,28,Part 3,44.0,27,1,0,0,1,up,1976-10-30
5330,KC And The Sunshine Band,1977-05-14,KC And The Sunshine Band - Part 3,28,28,27,5.0,27,Part 3,44.0,28,0,1,0,0,stay,1976-10-30
5331,KC And The Sunshine Band,1977-05-21,KC And The Sunshine Band - Part 3,27,28,27,5.0,27,Part 3,44.0,29,0,0,1,0,stay,1976-10-30
5332,KC And The Sunshine Band,1977-05-28,KC And The Sunshine Band - Part 3,27,27,26,5.0,27,Part 3,44.0,30,1,0,0,1,up,1976-10-30
5333,KC And The Sunshine Band,1977-06-04,KC And The Sunshine Band - Part 3,27,27,26,5.0,26,Part 3,44.0,31,0,1,0,0,stay,1976-10-30
5334,KC And The Sunshine Band,1977-06-11,KC And The Sunshine Band - Part 3,26,27,23,5.0,26,Part 3,44.0,32,3,0,1,1,up,1976-10-30
5335,KC And The Sunshine Band,1977-06-18,KC And The Sunshine Band - Part 3,26,26,24,5.0,23,Part 3,44.0,33,-1,3,0,1,down,1976-10-30
5336,KC And The Sunshine Band,1977-06-25,KC And The Sunshine Band - Part 3,23,26,34,5.0,24,Part 3,44.0,34,-10,-1,3,1,down,1976-10-30
5337,KC And The Sunshine Band,1977-07-02,KC And The Sunshine Band - Part 3,24,23,34,5.0,34,Part 3,44.0,35,0,-10,-1,0,stay,1976-10-30
5338,KC And The Sunshine Band,1977-07-09,KC And The Sunshine Band - Part 3,34,24,34,5.0,34,Part 3,44.0,36,0,0,-10,0,stay,1976-10-30
5339,KC And The Sunshine Band,1977-07-16,KC And The Sunshine Band - Part 3,34,34,34,5.0,34,Part 3,44.0,37,0,0,0,0,stay,1976-10-30
5340,KC And The Sunshine Band,1977-07-23,KC And The Sunshine Band - Part 3,34,34,34,5.0,34,Part 3,44.0,38,0,0,0,0,stay,1976-10-30
5341,KC And The Sunshine Band,1977-07-30,KC And The Sunshine Band - Part 3,34,34,34,5.0,34,Part 3,44.0,39,0,0,0,0,stay,1976-10-30
5342,KC And The Sunshine Band,1977-08-06,KC And The Sunshine Band - Part 3,34,34,37,5.0,34,Part 3,44.0,40,-3,0,0,1,down,1976-10-30
5343,KC And The Sunshine Band,1977-08-13,KC And The Sunshine Band - Part 3,34,34,35,5.0,37,Part 3,44.0,41,2,-3,0,1,up,1976-10-30
5344,KC And The Sunshine Band,1977-08-20,KC And The Sunshine Band - Part 3,37,34,47,5.0,35,Part 3,44.0,42,-12,2,-3,1,down,1976-10-30
5345,KC And The Sunshine Band,1977-08-27,KC And The Sunshine Band - Part 3,35,37,50,5.0,47,Part 3,44.0,43,-3,-12,2,1,down,1976-10-30
5346,KC And The Sunshine Band,1977-09-03,KC And The Sunshine Band - Part 3,47,35,51,5.0,50,Part 3,44.0,44,-1,-3,-12,1,down,1976-10-30
5347,Love Unlimited Orchestra,1976-10-30,Love Unlimited Orchestra - My Sweet Summer Suite,51,51,38,35.0,47,My Sweet Summer Suite,4.0,0,9,4,0,1,up,1976-10-30
5348,Love Unlimited Orchestra,1976-11-06,Love Unlimited Orchestra - My Sweet Summer Suite,47,51,35,35.0,38,My Sweet Summer Suite,4.0,1,3,9,4,1,up,1976-10-30
5349,Love Unlimited Orchestra,1976-11-13,Love Unlimited Orchestra - My Sweet Summer Suite,38,47,43,35.0,35,My Sweet Summer Suite,4.0,2,-8,3,9,1,down,1976-10-30
5350,Love Unlimited Orchestra,1976-11-20,Love Unlimited Orchestra - My Sweet Summer Suite,35,38,43,35.0,43,My Sweet Summer Suite,4.0,3,0,-8,3,0,stay,1976-10-30
5351,Love Unlimited Orchestra,1976-11-27,Love Unlimited Orchestra - My Sweet Summer Suite,43,35,51,35.0,43,My Sweet Summer Suite,4.0,4,-8,0,-8,1,down,1976-10-30
5352,Bill Withers,1976-10-30,Bill Withers - Naked & Warm,51,51,41,41.0,49,Naked & Warm,2.0,0,8,2,0,1,up,1976-10-30
5353,Bill Withers,1976-11-06,Bill Withers - Naked & Warm,49,51,41,41.0,41,Naked & Warm,2.0,1,0,8,2,0,stay,1976-10-30
5354,Bill Withers,1976-11-13,Bill Withers - Naked & Warm,41,49,51,41.0,41,Naked & Warm,2.0,2,-10,0,8,1,down,1976-10-30
5355,Little Milton,1976-10-30,Little Milton - Friend Of Mine,51,51,51,50.0,50,Friend Of Mine,0.0,0,-1,1,0,1,down,1976-10-30
5356,Brick,1976-11-06,Brick - Good High,51,51,30,1.0,42,Good High,22.0,0,12,9,0,1,up,1976-11-06
5357,Brick,1976-11-13,Brick - Good High,42,51,24,1.0,30,Good High,22.0,1,6,12,9,1,up,1976-11-06
5358,Brick,1976-11-20,Brick - Good High,30,42,18,1.0,24,Good High,22.0,2,6,6,12,1,up,1976-11-06
5359,Brick,1976-11-27,Brick - Good High,24,30,7,1.0,18,Good High,22.0,3,11,6,6,1,up,1976-11-06
5360,Brick,1976-12-04,Brick - Good High,18,24,4,1.0,7,Good High,22.0,4,3,11,6,1,up,1976-11-06
5361,Brick,1976-12-11,Brick - Good High,7,18,4,1.0,4,Good High,22.0,5,0,3,11,0,stay,1976-11-06
5362,Brick,1976-12-18,Brick - Good High,4,7,2,1.0,4,Good High,22.0,6,2,0,3,1,up,1976-11-06
5363,Brick,1976-12-25,Brick - Good High,4,4,2,1.0,2,Good High,22.0,7,0,2,0,0,stay,1976-11-06
5364,Brick,1977-01-01,Brick - Good High,2,4,1,1.0,2,Good High,22.0,8,1,0,2,1,up,1976-11-06
5365,Brick,1977-01-08,Brick - Good High,2,2,5,1.0,1,Good High,22.0,9,-4,1,0,1,down,1976-11-06
5366,Brick,1977-01-15,Brick - Good High,1,2,6,1.0,5,Good High,22.0,10,-1,-4,1,1,down,1976-11-06
5367,Brick,1977-01-22,Brick - Good High,5,1,3,1.0,6,Good High,22.0,11,3,-1,-4,1,up,1976-11-06
5368,Brick,1977-01-29,Brick - Good High,6,5,3,1.0,3,Good High,22.0,12,0,3,-1,0,stay,1976-11-06
5369,Brick,1977-02-05,Brick - Good High,3,6,2,1.0,3,Good High,22.0,13,1,0,3,1,up,1976-11-06
5370,Brick,1977-02-12,Brick - Good High,3,3,2,1.0,2,Good High,22.0,14,0,1,0,0,stay,1976-11-06
5371,Brick,1977-02-19,Brick - Good High,2,3,3,1.0,2,Good High,22.0,15,-1,0,1,1,down,1976-11-06
5372,Brick,1977-02-26,Brick - Good High,2,2,5,1.0,3,Good High,22.0,16,-2,-1,0,1,down,1976-11-06
5373,Brick,1977-03-05,Brick - Good High,3,2,16,1.0,5,Good High,22.0,17,-11,-2,-1,1,down,1976-11-06
5374,Brick,1977-03-12,Brick - Good High,5,3,18,1.0,16,Good High,22.0,18,-2,-11,-2,1,down,1976-11-06
5375,Brick,1977-03-19,Brick - Good High,16,5,26,1.0,18,Good High,22.0,19,-8,-2,-11,1,down,1976-11-06
5376,Brick,1977-03-26,Brick - Good High,18,16,37,1.0,26,Good High,22.0,20,-11,-8,-2,1,down,1976-11-06
5377,Brick,1977-04-02,Brick - Good High,26,18,49,1.0,37,Good High,22.0,21,-12,-11,-8,1,down,1976-11-06
5378,Brick,1977-04-09,Brick - Good High,37,26,51,1.0,49,Good High,22.0,22,-2,-12,-11,1,down,1976-11-06
5379,George Benson & Joe Farrell,1976-11-06,George Benson & Joe Farrell - Benson & Farrell,51,51,37,27.0,45,Benson & Farrell,6.0,0,8,6,0,1,up,1976-11-06
5380,George Benson & Joe Farrell,1976-11-13,George Benson & Joe Farrell - Benson & Farrell,45,51,29,27.0,37,Benson & Farrell,6.0,1,8,8,6,1,up,1976-11-06
5381,George Benson & Joe Farrell,1976-11-20,George Benson & Joe Farrell - Benson & Farrell,37,45,27,27.0,29,Benson & Farrell,6.0,2,2,8,8,1,up,1976-11-06
5382,George Benson & Joe Farrell,1976-11-27,George Benson & Joe Farrell - Benson & Farrell,29,37,36,27.0,27,Benson & Farrell,6.0,3,-9,2,8,1,down,1976-11-06
5383,George Benson & Joe Farrell,1976-12-04,George Benson & Joe Farrell - Benson & Farrell,27,29,36,27.0,36,Benson & Farrell,6.0,4,0,-9,2,0,stay,1976-11-06
5384,George Benson & Joe Farrell,1976-12-11,George Benson & Joe Farrell - Benson & Farrell,36,27,46,27.0,36,Benson & Farrell,6.0,5,-10,0,-9,1,down,1976-11-06
5385,George Benson & Joe Farrell,1976-12-18,George Benson & Joe Farrell - Benson & Farrell,36,36,51,27.0,46,Benson & Farrell,6.0,6,-5,-10,0,1,down,1976-11-06
5386,Michael Henderson,1976-11-06,Michael Henderson - Solid,51,51,42,10.0,47,Solid,22.0,0,5,4,0,1,up,1976-11-06
5387,Michael Henderson,1976-11-13,Michael Henderson - Solid,47,51,49,10.0,42,Solid,22.0,1,-7,5,4,1,down,1976-11-06
5388,Michael Henderson,1976-12-11,Michael Henderson - Solid,42,47,39,10.0,49,Solid,22.0,2,10,-7,5,1,up,1976-11-06
5389,Michael Henderson,1976-12-18,Michael Henderson - Solid,49,42,36,10.0,39,Solid,22.0,3,3,10,-7,1,up,1976-11-06
5390,Michael Henderson,1976-12-25,Michael Henderson - Solid,39,49,36,10.0,36,Solid,22.0,4,0,3,10,0,stay,1976-11-06
5391,Michael Henderson,1977-01-01,Michael Henderson - Solid,36,39,26,10.0,36,Solid,22.0,5,10,0,3,1,up,1976-11-06
5392,Michael Henderson,1977-01-08,Michael Henderson - Solid,36,36,20,10.0,26,Solid,22.0,6,6,10,0,1,up,1976-11-06
5393,Michael Henderson,1977-01-15,Michael Henderson - Solid,26,36,18,10.0,20,Solid,22.0,7,2,6,10,1,up,1976-11-06
5394,Michael Henderson,1977-01-22,Michael Henderson - Solid,20,26,16,10.0,18,Solid,22.0,8,2,2,6,1,up,1976-11-06
5395,Michael Henderson,1977-01-29,Michael Henderson - Solid,18,20,11,10.0,16,Solid,22.0,9,5,2,2,1,up,1976-11-06
5396,Michael Henderson,1977-02-05,Michael Henderson - Solid,16,18,10,10.0,11,Solid,22.0,10,1,5,2,1,up,1976-11-06
5397,Michael Henderson,1977-02-12,Michael Henderson - Solid,11,16,16,10.0,10,Solid,22.0,11,-6,1,5,1,down,1976-11-06
5398,Michael Henderson,1977-02-19,Michael Henderson - Solid,10,11,23,10.0,16,Solid,22.0,12,-7,-6,1,1,down,1976-11-06
5399,Michael Henderson,1977-02-26,Michael Henderson - Solid,16,10,21,10.0,23,Solid,22.0,13,2,-7,-6,1,up,1976-11-06
5400,Michael Henderson,1977-03-05,Michael Henderson - Solid,23,16,23,10.0,21,Solid,22.0,14,-2,2,-7,1,down,1976-11-06
5401,Michael Henderson,1977-03-12,Michael Henderson - Solid,21,23,27,10.0,23,Solid,22.0,15,-4,-2,2,1,down,1976-11-06
5402,Michael Henderson,1977-03-19,Michael Henderson - Solid,23,21,27,10.0,27,Solid,22.0,16,0,-4,-2,0,stay,1976-11-06
5403,Michael Henderson,1977-03-26,Michael Henderson - Solid,27,23,27,10.0,27,Solid,22.0,17,0,0,-4,0,stay,1976-11-06
5404,Michael Henderson,1977-04-02,Michael Henderson - Solid,27,27,43,10.0,27,Solid,22.0,18,-16,0,0,1,down,1976-11-06
5405,Michael Henderson,1977-04-09,Michael Henderson - Solid,27,27,42,10.0,43,Solid,22.0,19,1,-16,0,1,up,1976-11-06
5406,Michael Henderson,1977-04-16,Michael Henderson - Solid,43,27,38,10.0,42,Solid,22.0,20,4,1,-16,1,up,1976-11-06
5407,Michael Henderson,1977-04-23,Michael Henderson - Solid,42,43,48,10.0,38,Solid,22.0,21,-10,4,1,1,down,1976-11-06
5408,Michael Henderson,1977-04-30,Michael Henderson - Solid,38,42,51,10.0,48,Solid,22.0,22,-3,-10,4,1,down,1976-11-06
5409,Gil Scott-Heron & Brian Jackson,1976-11-06,Gil Scott-Heron & Brian Jackson - It's Your World,51,51,38,34.0,48,It's Your World,4.0,0,10,3,0,1,up,1976-11-06
5410,Gil Scott-Heron & Brian Jackson,1976-11-13,Gil Scott-Heron & Brian Jackson - It's Your World,48,51,34,34.0,38,It's Your World,4.0,1,4,10,3,1,up,1976-11-06
5411,Gil Scott-Heron & Brian Jackson,1976-11-20,Gil Scott-Heron & Brian Jackson - It's Your World,38,48,44,34.0,34,It's Your World,4.0,2,-10,4,10,1,down,1976-11-06
5412,Gil Scott-Heron & Brian Jackson,1976-11-27,Gil Scott-Heron & Brian Jackson - It's Your World,34,38,44,34.0,44,It's Your World,4.0,3,0,-10,4,0,stay,1976-11-06
5413,Gil Scott-Heron & Brian Jackson,1976-12-04,Gil Scott-Heron & Brian Jackson - It's Your World,44,34,51,34.0,44,It's Your World,4.0,4,-7,0,-10,1,down,1976-11-06
5414,Bobby Humphrey,1976-11-06,Bobby Humphrey - Bobbi Humphrey's Best,51,51,43,43.0,49,Bobbi Humphrey's Best,2.0,0,6,2,0,1,up,1976-11-06
5415,Bobby Humphrey,1976-11-13,Bobby Humphrey - Bobbi Humphrey's Best,49,51,50,43.0,43,Bobbi Humphrey's Best,2.0,1,-7,6,2,1,down,1976-11-06
5416,Bobby Humphrey,1976-11-20,Bobby Humphrey - Bobbi Humphrey's Best,43,49,51,43.0,50,Bobbi Humphrey's Best,2.0,2,-1,-7,6,1,down,1976-11-06
5417,Donna Summer,1976-11-13,Donna Summer - Four Seasons Of Love,51,51,18,13.0,20,Four Seasons Of Love,19.0,0,2,31,0,1,up,1976-11-13
5418,Donna Summer,1976-11-20,Donna Summer - Four Seasons Of Love,20,51,14,13.0,18,Four Seasons Of Love,19.0,1,4,2,31,1,up,1976-11-13
5419,Donna Summer,1976-11-27,Donna Summer - Four Seasons Of Love,18,20,13,13.0,14,Four Seasons Of Love,19.0,2,1,4,2,1,up,1976-11-13
5420,Donna Summer,1976-12-04,Donna Summer - Four Seasons Of Love,14,18,25,13.0,13,Four Seasons Of Love,19.0,3,-12,1,4,1,down,1976-11-13
5421,Donna Summer,1976-12-11,Donna Summer - Four Seasons Of Love,13,14,26,13.0,25,Four Seasons Of Love,19.0,4,-1,-12,1,1,down,1976-11-13
5422,Donna Summer,1976-12-18,Donna Summer - Four Seasons Of Love,25,13,28,13.0,26,Four Seasons Of Love,19.0,5,-2,-1,-12,1,down,1976-11-13
5423,Donna Summer,1976-12-25,Donna Summer - Four Seasons Of Love,26,25,28,13.0,28,Four Seasons Of Love,19.0,6,0,-2,-1,0,stay,1976-11-13
5424,Donna Summer,1977-01-01,Donna Summer - Four Seasons Of Love,28,26,28,13.0,28,Four Seasons Of Love,19.0,7,0,0,-2,0,stay,1976-11-13
5425,Donna Summer,1977-01-08,Donna Summer - Four Seasons Of Love,28,28,27,13.0,28,Four Seasons Of Love,19.0,8,1,0,0,1,up,1976-11-13
5426,Donna Summer,1977-01-15,Donna Summer - Four Seasons Of Love,28,28,23,13.0,27,Four Seasons Of Love,19.0,9,4,1,0,1,up,1976-11-13
5427,Donna Summer,1977-01-22,Donna Summer - Four Seasons Of Love,27,28,23,13.0,23,Four Seasons Of Love,19.0,10,0,4,1,0,stay,1976-11-13
5428,Donna Summer,1977-01-29,Donna Summer - Four Seasons Of Love,23,27,25,13.0,23,Four Seasons Of Love,19.0,11,-2,0,4,1,down,1976-11-13
5429,Donna Summer,1977-02-05,Donna Summer - Four Seasons Of Love,23,23,22,13.0,25,Four Seasons Of Love,19.0,12,3,-2,0,1,up,1976-11-13
5430,Donna Summer,1977-02-12,Donna Summer - Four Seasons Of Love,25,23,22,13.0,22,Four Seasons Of Love,19.0,13,0,3,-2,0,stay,1976-11-13
5431,Donna Summer,1977-02-19,Donna Summer - Four Seasons Of Love,22,25,26,13.0,22,Four Seasons Of Love,19.0,14,-4,0,3,1,down,1976-11-13
5432,Donna Summer,1977-02-26,Donna Summer - Four Seasons Of Love,22,22,37,13.0,26,Four Seasons Of Love,19.0,15,-11,-4,0,1,down,1976-11-13
5433,Donna Summer,1977-03-05,Donna Summer - Four Seasons Of Love,26,22,35,13.0,37,Four Seasons Of Love,19.0,16,2,-11,-4,1,up,1976-11-13
5434,Donna Summer,1977-03-12,Donna Summer - Four Seasons Of Love,37,26,34,13.0,35,Four Seasons Of Love,19.0,17,1,2,-11,1,up,1976-11-13
5435,Donna Summer,1977-03-19,Donna Summer - Four Seasons Of Love,35,37,35,13.0,34,Four Seasons Of Love,19.0,18,-1,1,2,1,down,1976-11-13
5436,Donna Summer,1977-03-26,Donna Summer - Four Seasons Of Love,34,35,51,13.0,35,Four Seasons Of Love,19.0,19,-16,-1,1,1,down,1976-11-13
5437,Ohio Players,1976-11-13,Ohio Players - Ohio Players Gold,51,51,19,10.0,25,Ohio Players Gold,11.0,0,6,26,0,1,up,1976-11-13
5438,Ohio Players,1976-11-20,Ohio Players - Ohio Players Gold,25,51,15,10.0,19,Ohio Players Gold,11.0,1,4,6,26,1,up,1976-11-13
5439,Ohio Players,1976-11-27,Ohio Players - Ohio Players Gold,19,25,11,10.0,15,Ohio Players Gold,11.0,2,4,4,6,1,up,1976-11-13
5440,Ohio Players,1976-12-04,Ohio Players - Ohio Players Gold,15,19,10,10.0,11,Ohio Players Gold,11.0,3,1,4,4,1,up,1976-11-13
5441,Ohio Players,1976-12-11,Ohio Players - Ohio Players Gold,11,15,24,10.0,10,Ohio Players Gold,11.0,4,-14,1,4,1,down,1976-11-13
5442,Ohio Players,1976-12-18,Ohio Players - Ohio Players Gold,10,11,25,10.0,24,Ohio Players Gold,11.0,5,-1,-14,1,1,down,1976-11-13
5443,Ohio Players,1976-12-25,Ohio Players - Ohio Players Gold,24,10,25,10.0,25,Ohio Players Gold,11.0,6,0,-1,-14,0,stay,1976-11-13
5444,Ohio Players,1977-01-01,Ohio Players - Ohio Players Gold,25,24,25,10.0,25,Ohio Players Gold,11.0,7,0,0,-1,0,stay,1976-11-13
5445,Ohio Players,1977-01-08,Ohio Players - Ohio Players Gold,25,25,24,10.0,25,Ohio Players Gold,11.0,8,1,0,0,1,up,1976-11-13
5446,Ohio Players,1977-01-15,Ohio Players - Ohio Players Gold,25,25,34,10.0,24,Ohio Players Gold,11.0,9,-10,1,0,1,down,1976-11-13
5447,Ohio Players,1977-01-22,Ohio Players - Ohio Players Gold,24,25,34,10.0,34,Ohio Players Gold,11.0,10,0,-10,1,0,stay,1976-11-13
5448,Ohio Players,1977-01-29,Ohio Players - Ohio Players Gold,34,24,51,10.0,34,Ohio Players Gold,11.0,11,-17,0,-10,1,down,1976-11-13
5449,Barry White,1976-11-13,Barry White - Is This Whatcha Wont?,51,51,37,25.0,47,Is This Whatcha Wont?,7.0,0,10,4,0,1,up,1976-11-13
5450,Barry White,1976-11-20,Barry White - Is This Whatcha Wont?,47,51,29,25.0,37,Is This Whatcha Wont?,7.0,1,8,10,4,1,up,1976-11-13
5451,Barry White,1976-11-27,Barry White - Is This Whatcha Wont?,37,47,25,25.0,29,Is This Whatcha Wont?,7.0,2,4,8,10,1,up,1976-11-13
5452,Barry White,1976-12-04,Barry White - Is This Whatcha Wont?,29,37,37,25.0,25,Is This Whatcha Wont?,7.0,3,-12,4,8,1,down,1976-11-13
5453,Barry White,1976-12-11,Barry White - Is This Whatcha Wont?,25,29,46,25.0,37,Is This Whatcha Wont?,7.0,4,-9,-12,4,1,down,1976-11-13
5454,Barry White,1976-12-25,Barry White - Is This Whatcha Wont?,37,25,46,25.0,46,Is This Whatcha Wont?,7.0,5,0,-9,-12,0,stay,1976-11-13
5455,Barry White,1977-01-01,Barry White - Is This Whatcha Wont?,46,37,46,25.0,46,Is This Whatcha Wont?,7.0,6,0,0,-9,0,stay,1976-11-13
5456,Barry White,1977-01-08,Barry White - Is This Whatcha Wont?,46,46,51,25.0,46,Is This Whatcha Wont?,7.0,7,-5,0,0,1,down,1976-11-13
5457,Bob Marley And The Wailers,1976-11-13,Bob Marley And The Wailers - Live!,51,51,47,47.0,49,Live!,1.0,0,2,2,0,1,up,1976-11-13
5458,Bob Marley And The Wailers,1976-11-20,Bob Marley And The Wailers - Live!,49,51,51,47.0,47,Live!,1.0,1,-4,2,2,1,down,1976-11-13
5459,Kool & The Gang,1976-11-20,Kool & The Gang - Open Sesame,51,51,13,9.0,17,Open Sesame,18.0,0,4,34,0,1,up,1976-11-20
5460,Kool & The Gang,1976-11-27,Kool & The Gang - Open Sesame,17,51,10,9.0,13,Open Sesame,18.0,1,3,4,34,1,up,1976-11-20
5461,Kool & The Gang,1976-12-04,Kool & The Gang - Open Sesame,13,17,9,9.0,10,Open Sesame,18.0,2,1,3,4,1,up,1976-11-20
5462,Kool & The Gang,1976-12-11,Kool & The Gang - Open Sesame,10,13,9,9.0,9,Open Sesame,18.0,3,0,1,3,0,stay,1976-11-20
5463,Kool & The Gang,1976-12-18,Kool & The Gang - Open Sesame,9,10,21,9.0,9,Open Sesame,18.0,4,-12,0,1,1,down,1976-11-20
5464,Kool & The Gang,1976-12-25,Kool & The Gang - Open Sesame,9,9,21,9.0,21,Open Sesame,18.0,5,0,-12,0,0,stay,1976-11-20
5465,Kool & The Gang,1977-01-01,Kool & The Gang - Open Sesame,21,9,22,9.0,21,Open Sesame,18.0,6,-1,0,-12,1,down,1976-11-20
5466,Kool & The Gang,1977-01-08,Kool & The Gang - Open Sesame,21,21,18,9.0,22,Open Sesame,18.0,7,4,-1,0,1,up,1976-11-20
5467,Kool & The Gang,1977-01-15,Kool & The Gang - Open Sesame,22,21,14,9.0,18,Open Sesame,18.0,8,4,4,-1,1,up,1976-11-20
5468,Kool & The Gang,1977-01-22,Kool & The Gang - Open Sesame,18,22,13,9.0,14,Open Sesame,18.0,9,1,4,4,1,up,1976-11-20
5469,Kool & The Gang,1977-01-29,Kool & The Gang - Open Sesame,14,18,14,9.0,13,Open Sesame,18.0,10,-1,1,4,1,down,1976-11-20
5470,Kool & The Gang,1977-02-05,Kool & The Gang - Open Sesame,13,14,26,9.0,14,Open Sesame,18.0,11,-12,-1,1,1,down,1976-11-20
5471,Kool & The Gang,1977-02-12,Kool & The Gang - Open Sesame,14,13,26,9.0,26,Open Sesame,18.0,12,0,-12,-1,0,stay,1976-11-20
5472,Kool & The Gang,1977-02-19,Kool & The Gang - Open Sesame,26,14,22,9.0,26,Open Sesame,18.0,13,4,0,-12,1,up,1976-11-20
5473,Kool & The Gang,1977-02-26,Kool & The Gang - Open Sesame,26,26,26,9.0,22,Open Sesame,18.0,14,-4,4,0,1,down,1976-11-20
5474,Kool & The Gang,1977-03-05,Kool & The Gang - Open Sesame,22,26,28,9.0,26,Open Sesame,18.0,15,-2,-4,4,1,down,1976-11-20
5475,Kool & The Gang,1977-03-12,Kool & The Gang - Open Sesame,26,22,36,9.0,28,Open Sesame,18.0,16,-8,-2,-4,1,down,1976-11-20
5476,Kool & The Gang,1977-03-19,Kool & The Gang - Open Sesame,28,26,48,9.0,36,Open Sesame,18.0,17,-12,-8,-2,1,down,1976-11-20
5477,Kool & The Gang,1977-03-26,Kool & The Gang - Open Sesame,36,28,51,9.0,48,Open Sesame,18.0,18,-3,-12,-8,1,down,1976-11-20
5478,Brass Construction,1976-11-20,Brass Construction - Brass Construction Ii,51,51,12,3.0,20,Brass Construction Ii,22.0,0,8,31,0,1,up,1976-11-20
5479,Brass Construction,1976-11-27,Brass Construction - Brass Construction Ii,20,51,8,3.0,12,Brass Construction Ii,22.0,1,4,8,31,1,up,1976-11-20
5480,Brass Construction,1976-12-04,Brass Construction - Brass Construction Ii,12,20,6,3.0,8,Brass Construction Ii,22.0,2,2,4,8,1,up,1976-11-20
5481,Brass Construction,1976-12-11,Brass Construction - Brass Construction Ii,8,12,5,3.0,6,Brass Construction Ii,22.0,3,1,2,4,1,up,1976-11-20
5482,Brass Construction,1976-12-18,Brass Construction - Brass Construction Ii,6,8,4,3.0,5,Brass Construction Ii,22.0,4,1,1,2,1,up,1976-11-20
5483,Brass Construction,1976-12-25,Brass Construction - Brass Construction Ii,5,6,4,3.0,4,Brass Construction Ii,22.0,5,0,1,1,0,stay,1976-11-20
5484,Brass Construction,1977-01-01,Brass Construction - Brass Construction Ii,4,5,4,3.0,4,Brass Construction Ii,22.0,6,0,0,1,0,stay,1976-11-20
5485,Brass Construction,1977-01-08,Brass Construction - Brass Construction Ii,4,4,3,3.0,4,Brass Construction Ii,22.0,7,1,0,0,1,up,1976-11-20
5486,Brass Construction,1977-01-15,Brass Construction - Brass Construction Ii,4,4,3,3.0,3,Brass Construction Ii,22.0,8,0,1,0,0,stay,1976-11-20
5487,Brass Construction,1977-01-22,Brass Construction - Brass Construction Ii,3,4,7,3.0,3,Brass Construction Ii,22.0,9,-4,0,1,1,down,1976-11-20
5488,Brass Construction,1977-01-29,Brass Construction - Brass Construction Ii,3,3,8,3.0,7,Brass Construction Ii,22.0,10,-1,-4,0,1,down,1976-11-20
5489,Brass Construction,1977-02-05,Brass Construction - Brass Construction Ii,7,3,8,3.0,8,Brass Construction Ii,22.0,11,0,-1,-4,0,stay,1976-11-20
5490,Brass Construction,1977-02-12,Brass Construction - Brass Construction Ii,8,7,14,3.0,8,Brass Construction Ii,22.0,12,-6,0,-1,1,down,1976-11-20
5491,Brass Construction,1977-02-19,Brass Construction - Brass Construction Ii,8,8,15,3.0,14,Brass Construction Ii,22.0,13,-1,-6,0,1,down,1976-11-20
5492,Brass Construction,1977-02-26,Brass Construction - Brass Construction Ii,14,8,17,3.0,15,Brass Construction Ii,22.0,14,-2,-1,-6,1,down,1976-11-20
5493,Brass Construction,1977-03-05,Brass Construction - Brass Construction Ii,15,14,21,3.0,17,Brass Construction Ii,22.0,15,-4,-2,-1,1,down,1976-11-20
5494,Brass Construction,1977-03-12,Brass Construction - Brass Construction Ii,17,15,28,3.0,21,Brass Construction Ii,22.0,16,-7,-4,-2,1,down,1976-11-20
5495,Brass Construction,1977-03-19,Brass Construction - Brass Construction Ii,21,17,28,3.0,28,Brass Construction Ii,22.0,17,0,-7,-4,0,stay,1976-11-20
5496,Brass Construction,1977-03-26,Brass Construction - Brass Construction Ii,28,21,42,3.0,28,Brass Construction Ii,22.0,18,-14,0,-7,1,down,1976-11-20
5497,Brass Construction,1977-04-02,Brass Construction - Brass Construction Ii,28,28,48,3.0,42,Brass Construction Ii,22.0,19,-6,-14,0,1,down,1976-11-20
5498,Brass Construction,1977-04-09,Brass Construction - Brass Construction Ii,42,28,43,3.0,48,Brass Construction Ii,22.0,20,5,-6,-14,1,up,1976-11-20
5499,Brass Construction,1977-04-16,Brass Construction - Brass Construction Ii,48,42,39,3.0,43,Brass Construction Ii,22.0,21,4,5,-6,1,up,1976-11-20
5500,Brass Construction,1977-04-23,Brass Construction - Brass Construction Ii,43,48,51,3.0,39,Brass Construction Ii,22.0,22,-12,4,5,1,down,1976-11-20
5501,The Sylvers,1976-11-20,The Sylvers - Something Special,51,51,24,13.0,32,Something Special,16.0,0,8,19,0,1,up,1976-11-20
5502,The Sylvers,1976-11-27,The Sylvers - Something Special,32,51,18,13.0,24,Something Special,16.0,1,6,8,19,1,up,1976-11-20
5503,The Sylvers,1976-12-04,The Sylvers - Something Special,24,32,14,13.0,18,Something Special,16.0,2,4,6,8,1,up,1976-11-20
5504,The Sylvers,1976-12-11,The Sylvers - Something Special,18,24,14,13.0,14,Something Special,16.0,3,0,4,6,0,stay,1976-11-20
5505,The Sylvers,1976-12-18,The Sylvers - Something Special,14,18,13,13.0,14,Something Special,16.0,4,1,0,4,1,up,1976-11-20
5506,The Sylvers,1976-12-25,The Sylvers - Something Special,14,14,13,13.0,13,Something Special,16.0,5,0,1,0,0,stay,1976-11-20
5507,The Sylvers,1977-01-01,The Sylvers - Something Special,13,14,13,13.0,13,Something Special,16.0,6,0,0,1,0,stay,1976-11-20
5508,The Sylvers,1977-01-08,The Sylvers - Something Special,13,13,13,13.0,13,Something Special,16.0,7,0,0,0,0,stay,1976-11-20
5509,The Sylvers,1977-01-15,The Sylvers - Something Special,13,13,16,13.0,13,Something Special,16.0,8,-3,0,0,1,down,1976-11-20
5510,The Sylvers,1977-01-22,The Sylvers - Something Special,13,13,18,13.0,16,Something Special,16.0,9,-2,-3,0,1,down,1976-11-20
5511,The Sylvers,1977-01-29,The Sylvers - Something Special,16,13,27,13.0,18,Something Special,16.0,10,-9,-2,-3,1,down,1976-11-20
5512,The Sylvers,1977-02-05,The Sylvers - Something Special,18,16,37,13.0,27,Something Special,16.0,11,-10,-9,-2,1,down,1976-11-20
5513,The Sylvers,1977-02-12,The Sylvers - Something Special,27,18,37,13.0,37,Something Special,16.0,12,0,-10,-9,0,stay,1976-11-20
5514,The Sylvers,1977-02-19,The Sylvers - Something Special,37,27,47,13.0,37,Something Special,16.0,13,-10,0,-10,1,down,1976-11-20
5515,The Sylvers,1977-02-26,The Sylvers - Something Special,37,37,46,13.0,47,Something Special,16.0,14,1,-10,0,1,up,1976-11-20
5516,The Sylvers,1977-03-05,The Sylvers - Something Special,47,37,48,13.0,46,Something Special,16.0,15,-2,1,-10,1,down,1976-11-20
5517,The Sylvers,1977-03-12,The Sylvers - Something Special,46,47,51,13.0,48,Something Special,16.0,16,-3,-2,1,1,down,1976-11-20
5518,Barkays,1976-11-20,Barkays - Too Hot To Stop,51,51,23,8.0,35,Too Hot To Stop,21.0,0,12,16,0,1,up,1976-11-20
5519,Barkays,1976-11-27,Barkays - Too Hot To Stop,35,51,19,8.0,23,Too Hot To Stop,21.0,1,4,12,16,1,up,1976-11-20
5520,Barkays,1976-12-04,Barkays - Too Hot To Stop,23,35,15,8.0,19,Too Hot To Stop,21.0,2,4,4,12,1,up,1976-11-20
5521,Barkays,1976-12-11,Barkays - Too Hot To Stop,19,23,13,8.0,15,Too Hot To Stop,21.0,3,2,4,4,1,up,1976-11-20
5522,Barkays,1976-12-18,Barkays - Too Hot To Stop,15,19,12,8.0,13,Too Hot To Stop,21.0,4,1,2,4,1,up,1976-11-20
5523,Barkays,1976-12-25,Barkays - Too Hot To Stop,13,15,12,8.0,12,Too Hot To Stop,21.0,5,0,1,2,0,stay,1976-11-20
5524,Barkays,1977-01-01,Barkays - Too Hot To Stop,12,13,8,8.0,12,Too Hot To Stop,21.0,6,4,0,1,1,up,1976-11-20
5525,Barkays,1977-01-08,Barkays - Too Hot To Stop,12,12,8,8.0,8,Too Hot To Stop,21.0,7,0,4,0,0,stay,1976-11-20
5526,Barkays,1977-01-15,Barkays - Too Hot To Stop,8,12,12,8.0,8,Too Hot To Stop,21.0,8,-4,0,4,1,down,1976-11-20
5527,Barkays,1977-01-22,Barkays - Too Hot To Stop,8,8,12,8.0,12,Too Hot To Stop,21.0,9,0,-4,0,0,stay,1976-11-20
5528,Barkays,1977-01-29,Barkays - Too Hot To Stop,12,8,12,8.0,12,Too Hot To Stop,21.0,10,0,0,-4,0,stay,1976-11-20
5529,Barkays,1977-02-05,Barkays - Too Hot To Stop,12,12,12,8.0,12,Too Hot To Stop,21.0,11,0,0,0,0,stay,1976-11-20
5530,Barkays,1977-02-12,Barkays - Too Hot To Stop,12,12,17,8.0,12,Too Hot To Stop,21.0,12,-5,0,0,1,down,1976-11-20
5531,Barkays,1977-02-19,Barkays - Too Hot To Stop,12,12,16,8.0,17,Too Hot To Stop,21.0,13,1,-5,0,1,up,1976-11-20
5532,Barkays,1977-02-26,Barkays - Too Hot To Stop,17,12,22,8.0,16,Too Hot To Stop,21.0,14,-6,1,-5,1,down,1976-11-20
5533,Barkays,1977-03-05,Barkays - Too Hot To Stop,16,17,24,8.0,22,Too Hot To Stop,21.0,15,-2,-6,1,1,down,1976-11-20
5534,Barkays,1977-03-12,Barkays - Too Hot To Stop,22,16,30,8.0,24,Too Hot To Stop,21.0,16,-6,-2,-6,1,down,1976-11-20
5535,Barkays,1977-03-19,Barkays - Too Hot To Stop,24,22,30,8.0,30,Too Hot To Stop,21.0,17,0,-6,-2,0,stay,1976-11-20
5536,Barkays,1977-03-26,Barkays - Too Hot To Stop,30,24,38,8.0,30,Too Hot To Stop,21.0,18,-8,0,-6,1,down,1976-11-20
5537,Barkays,1977-04-02,Barkays - Too Hot To Stop,30,30,33,8.0,38,Too Hot To Stop,21.0,19,5,-8,0,1,up,1976-11-20
5538,Barkays,1977-04-09,Barkays - Too Hot To Stop,38,30,36,8.0,33,Too Hot To Stop,21.0,20,-3,5,-8,1,down,1976-11-20
5539,Barkays,1977-04-16,Barkays - Too Hot To Stop,33,38,51,8.0,36,Too Hot To Stop,21.0,21,-15,-3,5,1,down,1976-11-20
5540,Hubert Laws,1976-11-20,Hubert Laws - Romeo & Juliet,51,51,36,33.0,40,Romeo & Juliet,4.0,0,4,11,0,1,up,1976-11-20
5541,Hubert Laws,1976-11-27,Hubert Laws - Romeo & Juliet,40,51,33,33.0,36,Romeo & Juliet,4.0,1,3,4,11,1,up,1976-11-20
5542,Hubert Laws,1976-12-04,Hubert Laws - Romeo & Juliet,36,40,33,33.0,33,Romeo & Juliet,4.0,2,0,3,4,0,stay,1976-11-20
5543,Hubert Laws,1976-12-11,Hubert Laws - Romeo & Juliet,33,36,36,33.0,33,Romeo & Juliet,4.0,3,-3,0,3,1,down,1976-11-20
5544,Hubert Laws,1976-12-18,Hubert Laws - Romeo & Juliet,33,33,51,33.0,36,Romeo & Juliet,4.0,4,-15,-3,0,1,down,1976-11-20
5545,Funkadelic,1976-11-27,Funkadelic - Hardcore Jollies,51,51,17,12.0,25,Hardcore Jollies,12.0,0,8,26,0,1,up,1976-11-27
5546,Funkadelic,1976-12-04,Funkadelic - Hardcore Jollies,25,51,13,12.0,17,Hardcore Jollies,12.0,1,4,8,26,1,up,1976-11-27
5547,Funkadelic,1976-12-11,Funkadelic - Hardcore Jollies,17,25,12,12.0,13,Hardcore Jollies,12.0,2,1,4,8,1,up,1976-11-27
5548,Funkadelic,1976-12-18,Funkadelic - Hardcore Jollies,13,17,18,12.0,12,Hardcore Jollies,12.0,3,-6,1,4,1,down,1976-11-27
5549,Funkadelic,1976-12-25,Funkadelic - Hardcore Jollies,12,13,18,12.0,18,Hardcore Jollies,12.0,4,0,-6,1,0,stay,1976-11-27
5550,Funkadelic,1977-01-01,Funkadelic - Hardcore Jollies,18,12,18,12.0,18,Hardcore Jollies,12.0,5,0,0,-6,0,stay,1976-11-27
5551,Funkadelic,1977-01-08,Funkadelic - Hardcore Jollies,18,18,22,12.0,18,Hardcore Jollies,12.0,6,-4,0,0,1,down,1976-11-27
5552,Funkadelic,1977-01-15,Funkadelic - Hardcore Jollies,18,18,27,12.0,22,Hardcore Jollies,12.0,7,-5,-4,0,1,down,1976-11-27
5553,Funkadelic,1977-01-22,Funkadelic - Hardcore Jollies,22,18,28,12.0,27,Hardcore Jollies,12.0,8,-1,-5,-4,1,down,1976-11-27
5554,Funkadelic,1977-01-29,Funkadelic - Hardcore Jollies,27,22,30,12.0,28,Hardcore Jollies,12.0,9,-2,-1,-5,1,down,1976-11-27
5555,Funkadelic,1977-02-05,Funkadelic - Hardcore Jollies,28,27,30,12.0,30,Hardcore Jollies,12.0,10,0,-2,-1,0,stay,1976-11-27
5556,Funkadelic,1977-02-12,Funkadelic - Hardcore Jollies,30,28,38,12.0,30,Hardcore Jollies,12.0,11,-8,0,-2,1,down,1976-11-27
5557,Funkadelic,1977-02-19,Funkadelic - Hardcore Jollies,30,30,51,12.0,38,Hardcore Jollies,12.0,12,-13,-8,0,1,down,1976-11-27
5558,Gladys Knight And The Pips,1976-11-27,Gladys Knight And The Pips - Pipe Dreams,51,51,32,16.0,40,Pipe Dreams,11.0,0,8,11,0,1,up,1976-11-27
5559,Gladys Knight And The Pips,1976-12-04,Gladys Knight And The Pips - Pipe Dreams,40,51,26,16.0,32,Pipe Dreams,11.0,1,6,8,11,1,up,1976-11-27
5560,Gladys Knight And The Pips,1976-12-11,Gladys Knight And The Pips - Pipe Dreams,32,40,21,16.0,26,Pipe Dreams,11.0,2,5,6,8,1,up,1976-11-27
5561,Gladys Knight And The Pips,1976-12-18,Gladys Knight And The Pips - Pipe Dreams,26,32,17,16.0,21,Pipe Dreams,11.0,3,4,5,6,1,up,1976-11-27
5562,Gladys Knight And The Pips,1976-12-25,Gladys Knight And The Pips - Pipe Dreams,21,26,17,16.0,17,Pipe Dreams,11.0,4,0,4,5,0,stay,1976-11-27
5563,Gladys Knight And The Pips,1977-01-01,Gladys Knight And The Pips - Pipe Dreams,17,21,17,16.0,17,Pipe Dreams,11.0,5,0,0,4,0,stay,1976-11-27
5564,Gladys Knight And The Pips,1977-01-08,Gladys Knight And The Pips - Pipe Dreams,17,17,16,16.0,17,Pipe Dreams,11.0,6,1,0,0,1,up,1976-11-27
5565,Gladys Knight And The Pips,1977-01-15,Gladys Knight And The Pips - Pipe Dreams,17,17,21,16.0,16,Pipe Dreams,11.0,7,-5,1,0,1,down,1976-11-27
5566,Gladys Knight And The Pips,1977-01-22,Gladys Knight And The Pips - Pipe Dreams,16,17,21,16.0,21,Pipe Dreams,11.0,8,0,-5,1,0,stay,1976-11-27
5567,Gladys Knight And The Pips,1977-01-29,Gladys Knight And The Pips - Pipe Dreams,21,16,28,16.0,21,Pipe Dreams,11.0,9,-7,0,-5,1,down,1976-11-27
5568,Gladys Knight And The Pips,1977-02-05,Gladys Knight And The Pips - Pipe Dreams,21,21,44,16.0,28,Pipe Dreams,11.0,10,-16,-7,0,1,down,1976-11-27
5569,Gladys Knight And The Pips,1977-02-12,Gladys Knight And The Pips - Pipe Dreams,28,21,51,16.0,44,Pipe Dreams,11.0,11,-7,-16,-7,1,down,1976-11-27
5570,Al Green,1976-11-27,Al Green - Have A Good Time,51,51,35,12.0,45,Have A Good Time,12.0,0,10,6,0,1,up,1976-11-27
5571,Al Green,1976-12-04,Al Green - Have A Good Time,45,51,21,12.0,35,Have A Good Time,12.0,1,14,10,6,1,up,1976-11-27
5572,Al Green,1976-12-11,Al Green - Have A Good Time,35,45,17,12.0,21,Have A Good Time,12.0,2,4,14,10,1,up,1976-11-27
5573,Al Green,1976-12-18,Al Green - Have A Good Time,21,35,14,12.0,17,Have A Good Time,12.0,3,3,4,14,1,up,1976-11-27
5574,Al Green,1976-12-25,Al Green - Have A Good Time,17,21,14,12.0,14,Have A Good Time,12.0,4,0,3,4,0,stay,1976-11-27
5575,Al Green,1977-01-01,Al Green - Have A Good Time,14,17,12,12.0,14,Have A Good Time,12.0,5,2,0,3,1,up,1976-11-27
5576,Al Green,1977-01-08,Al Green - Have A Good Time,14,14,15,12.0,12,Have A Good Time,12.0,6,-3,2,0,1,down,1976-11-27
5577,Al Green,1977-01-15,Al Green - Have A Good Time,12,14,17,12.0,15,Have A Good Time,12.0,7,-2,-3,2,1,down,1976-11-27
5578,Al Green,1977-01-22,Al Green - Have A Good Time,15,12,22,12.0,17,Have A Good Time,12.0,8,-5,-2,-3,1,down,1976-11-27
5579,Al Green,1977-01-29,Al Green - Have A Good Time,17,15,29,12.0,22,Have A Good Time,12.0,9,-7,-5,-2,1,down,1976-11-27
5580,Al Green,1977-02-05,Al Green - Have A Good Time,22,17,31,12.0,29,Have A Good Time,12.0,10,-2,-7,-5,1,down,1976-11-27
5581,Al Green,1977-02-12,Al Green - Have A Good Time,29,22,41,12.0,31,Have A Good Time,12.0,11,-10,-2,-7,1,down,1976-11-27
5582,Al Green,1977-02-19,Al Green - Have A Good Time,31,29,51,12.0,41,Have A Good Time,12.0,12,-10,-10,-2,1,down,1976-11-27
5583,Stanley Turrentine,1976-11-27,Stanley Turrentine - Man With Sad Face,51,51,39,32.0,50,Man With Sad Face,5.0,0,11,1,0,1,up,1976-11-27
5584,Stanley Turrentine,1976-12-04,Stanley Turrentine - Man With Sad Face,50,51,34,32.0,39,Man With Sad Face,5.0,1,5,11,1,1,up,1976-11-27
5585,Stanley Turrentine,1976-12-11,Stanley Turrentine - Man With Sad Face,39,50,35,32.0,34,Man With Sad Face,5.0,2,-1,5,11,1,down,1976-11-27
5586,Stanley Turrentine,1976-12-18,Stanley Turrentine - Man With Sad Face,34,39,32,32.0,35,Man With Sad Face,5.0,3,3,-1,5,1,up,1976-11-27
5587,Stanley Turrentine,1976-12-25,Stanley Turrentine - Man With Sad Face,35,34,32,32.0,32,Man With Sad Face,5.0,4,0,3,-1,0,stay,1976-11-27
5588,Stanley Turrentine,1977-01-01,Stanley Turrentine - Man With Sad Face,32,35,51,32.0,32,Man With Sad Face,5.0,5,-19,0,3,1,down,1976-11-27
5589,The Blackbyrds,1976-12-04,The Blackbyrds - Unfinished Business,51,51,22,6.0,28,Unfinished Business,28.0,0,6,23,0,1,up,1976-12-04
5590,The Blackbyrds,1976-12-11,The Blackbyrds - Unfinished Business,28,51,18,6.0,22,Unfinished Business,28.0,1,4,6,23,1,up,1976-12-04
5591,The Blackbyrds,1976-12-18,The Blackbyrds - Unfinished Business,22,28,11,6.0,18,Unfinished Business,28.0,2,7,4,6,1,up,1976-12-04
5592,The Blackbyrds,1976-12-25,The Blackbyrds - Unfinished Business,18,22,11,6.0,11,Unfinished Business,28.0,3,0,7,4,0,stay,1976-12-04
5593,The Blackbyrds,1977-01-01,The Blackbyrds - Unfinished Business,11,18,9,6.0,11,Unfinished Business,28.0,4,2,0,7,1,up,1976-12-04
5594,The Blackbyrds,1977-01-08,The Blackbyrds - Unfinished Business,11,11,9,6.0,9,Unfinished Business,28.0,5,0,2,0,0,stay,1976-12-04
5595,The Blackbyrds,1977-01-15,The Blackbyrds - Unfinished Business,9,11,8,6.0,9,Unfinished Business,28.0,6,1,0,2,1,up,1976-12-04
5596,The Blackbyrds,1977-01-22,The Blackbyrds - Unfinished Business,9,9,8,6.0,8,Unfinished Business,28.0,7,0,1,0,0,stay,1976-12-04
5597,The Blackbyrds,1977-01-29,The Blackbyrds - Unfinished Business,8,9,7,6.0,8,Unfinished Business,28.0,8,1,0,1,1,up,1976-12-04
5598,The Blackbyrds,1977-02-05,The Blackbyrds - Unfinished Business,8,8,6,6.0,7,Unfinished Business,28.0,9,1,1,0,1,up,1976-12-04
5599,The Blackbyrds,1977-02-12,The Blackbyrds - Unfinished Business,7,8,6,6.0,6,Unfinished Business,28.0,10,0,1,1,0,stay,1976-12-04
5600,The Blackbyrds,1977-02-19,The Blackbyrds - Unfinished Business,6,7,9,6.0,6,Unfinished Business,28.0,11,-3,0,1,1,down,1976-12-04
5601,The Blackbyrds,1977-02-26,The Blackbyrds - Unfinished Business,6,6,10,6.0,9,Unfinished Business,28.0,12,-1,-3,0,1,down,1976-12-04
5602,The Blackbyrds,1977-03-05,The Blackbyrds - Unfinished Business,9,6,13,6.0,10,Unfinished Business,28.0,13,-3,-1,-3,1,down,1976-12-04
5603,The Blackbyrds,1977-03-12,The Blackbyrds - Unfinished Business,10,9,11,6.0,13,Unfinished Business,28.0,14,2,-3,-1,1,up,1976-12-04
5604,The Blackbyrds,1977-03-19,The Blackbyrds - Unfinished Business,13,10,11,6.0,11,Unfinished Business,28.0,15,0,2,-3,0,stay,1976-12-04
5605,The Blackbyrds,1977-03-26,The Blackbyrds - Unfinished Business,11,13,9,6.0,11,Unfinished Business,28.0,16,2,0,2,1,up,1976-12-04
5606,The Blackbyrds,1977-04-02,The Blackbyrds - Unfinished Business,11,11,11,6.0,9,Unfinished Business,28.0,17,-2,2,0,1,down,1976-12-04
5607,The Blackbyrds,1977-04-09,The Blackbyrds - Unfinished Business,9,11,13,6.0,11,Unfinished Business,28.0,18,-2,-2,2,1,down,1976-12-04
5608,The Blackbyrds,1977-04-16,The Blackbyrds - Unfinished Business,11,9,31,6.0,13,Unfinished Business,28.0,19,-18,-2,-2,1,down,1976-12-04
5609,The Blackbyrds,1977-04-23,The Blackbyrds - Unfinished Business,13,11,30,6.0,31,Unfinished Business,28.0,20,1,-18,-2,1,up,1976-12-04
5610,The Blackbyrds,1977-04-30,The Blackbyrds - Unfinished Business,31,13,38,6.0,30,Unfinished Business,28.0,21,-8,1,-18,1,down,1976-12-04
5611,The Blackbyrds,1977-05-07,The Blackbyrds - Unfinished Business,30,31,44,6.0,38,Unfinished Business,28.0,22,-6,-8,1,1,down,1976-12-04
5612,The Blackbyrds,1977-05-14,The Blackbyrds - Unfinished Business,38,30,45,6.0,44,Unfinished Business,28.0,23,-1,-6,-8,1,down,1976-12-04
5613,The Blackbyrds,1977-06-04,The Blackbyrds - Unfinished Business,44,38,37,6.0,45,Unfinished Business,28.0,24,8,-1,-6,1,up,1976-12-04
5614,The Blackbyrds,1977-06-11,The Blackbyrds - Unfinished Business,45,44,30,6.0,37,Unfinished Business,28.0,25,7,8,-1,1,up,1976-12-04
5615,The Blackbyrds,1977-06-18,The Blackbyrds - Unfinished Business,37,45,26,6.0,30,Unfinished Business,28.0,26,4,7,8,1,up,1976-12-04
5616,The Blackbyrds,1977-06-25,The Blackbyrds - Unfinished Business,30,37,46,6.0,26,Unfinished Business,28.0,27,-20,4,7,1,down,1976-12-04
5617,The Blackbyrds,1977-07-02,The Blackbyrds - Unfinished Business,26,30,51,6.0,46,Unfinished Business,28.0,28,-5,-20,4,1,down,1976-12-04
5618,The Jacksons,1976-12-04,The Jacksons - The Jacksons,51,51,18,6.0,30,The Jacksons,25.0,0,12,21,0,1,up,1976-12-04
5619,The Jacksons,1976-12-11,The Jacksons - The Jacksons,30,51,16,6.0,18,The Jacksons,25.0,1,2,12,21,1,up,1976-12-04
5620,The Jacksons,1976-12-18,The Jacksons - The Jacksons,18,30,16,6.0,16,The Jacksons,25.0,2,0,2,12,0,stay,1976-12-04
5621,The Jacksons,1976-12-25,The Jacksons - The Jacksons,16,18,16,6.0,16,The Jacksons,25.0,3,0,0,2,0,stay,1976-12-04
5622,The Jacksons,1977-01-01,The Jacksons - The Jacksons,16,16,16,6.0,16,The Jacksons,25.0,4,0,0,0,0,stay,1976-12-04
5623,The Jacksons,1977-01-08,The Jacksons - The Jacksons,16,16,12,6.0,16,The Jacksons,25.0,5,4,0,0,1,up,1976-12-04
5624,The Jacksons,1977-01-15,The Jacksons - The Jacksons,16,16,9,6.0,12,The Jacksons,25.0,6,3,4,0,1,up,1976-12-04
5625,The Jacksons,1977-01-22,The Jacksons - The Jacksons,12,16,6,6.0,9,The Jacksons,25.0,7,3,3,4,1,up,1976-12-04
5626,The Jacksons,1977-01-29,The Jacksons - The Jacksons,9,12,6,6.0,6,The Jacksons,25.0,8,0,3,3,0,stay,1976-12-04
5627,The Jacksons,1977-02-05,The Jacksons - The Jacksons,6,9,13,6.0,6,The Jacksons,25.0,9,-7,0,3,1,down,1976-12-04
5628,The Jacksons,1977-02-12,The Jacksons - The Jacksons,6,6,12,6.0,13,The Jacksons,25.0,10,1,-7,0,1,up,1976-12-04
5629,The Jacksons,1977-02-19,The Jacksons - The Jacksons,13,6,13,6.0,12,The Jacksons,25.0,11,-1,1,-7,1,down,1976-12-04
5630,The Jacksons,1977-02-26,The Jacksons - The Jacksons,12,13,13,6.0,13,The Jacksons,25.0,12,0,-1,1,0,stay,1976-12-04
5631,The Jacksons,1977-03-05,The Jacksons - The Jacksons,13,12,11,6.0,13,The Jacksons,25.0,13,2,0,-1,1,up,1976-12-04
5632,The Jacksons,1977-03-12,The Jacksons - The Jacksons,13,13,10,6.0,11,The Jacksons,25.0,14,1,2,0,1,up,1976-12-04
5633,The Jacksons,1977-03-19,The Jacksons - The Jacksons,11,13,9,6.0,10,The Jacksons,25.0,15,1,1,2,1,up,1976-12-04
5634,The Jacksons,1977-03-26,The Jacksons - The Jacksons,10,11,10,6.0,9,The Jacksons,25.0,16,-1,1,1,1,down,1976-12-04
5635,The Jacksons,1977-04-02,The Jacksons - The Jacksons,9,10,10,6.0,10,The Jacksons,25.0,17,0,-1,1,0,stay,1976-12-04
5636,The Jacksons,1977-04-09,The Jacksons - The Jacksons,10,9,27,6.0,10,The Jacksons,25.0,18,-17,0,-1,1,down,1976-12-04
5637,The Jacksons,1977-04-16,The Jacksons - The Jacksons,10,10,22,6.0,27,The Jacksons,25.0,19,5,-17,0,1,up,1976-12-04
5638,The Jacksons,1977-04-23,The Jacksons - The Jacksons,27,10,29,6.0,22,The Jacksons,25.0,20,-7,5,-17,1,down,1976-12-04
5639,The Jacksons,1977-04-30,The Jacksons - The Jacksons,22,27,31,6.0,29,The Jacksons,25.0,21,-2,-7,5,1,down,1976-12-04
5640,The Jacksons,1977-05-07,The Jacksons - The Jacksons,29,22,45,6.0,31,The Jacksons,25.0,22,-14,-2,-7,1,down,1976-12-04
5641,The Jacksons,1977-05-14,The Jacksons - The Jacksons,31,29,46,6.0,45,The Jacksons,25.0,23,-1,-14,-2,1,down,1976-12-04
5642,The Jacksons,1977-05-21,The Jacksons - The Jacksons,45,31,50,6.0,46,The Jacksons,25.0,24,-4,-1,-14,1,down,1976-12-04
5643,The Jacksons,1977-05-28,The Jacksons - The Jacksons,46,45,51,6.0,50,The Jacksons,25.0,25,-1,-4,-1,1,down,1976-12-04
5644,Leroy Hutson,1976-12-04,Leroy Hutson - Hutson II,51,51,42,26.0,48,Hutson II,8.0,0,6,3,0,1,up,1976-12-04
5645,Leroy Hutson,1976-12-11,Leroy Hutson - Hutson II,48,51,38,26.0,42,Hutson II,8.0,1,4,6,3,1,up,1976-12-04
5646,Leroy Hutson,1976-12-18,Leroy Hutson - Hutson II,42,48,38,26.0,38,Hutson II,8.0,2,0,4,6,0,stay,1976-12-04
5647,Leroy Hutson,1976-12-25,Leroy Hutson - Hutson II,38,42,38,26.0,38,Hutson II,8.0,3,0,0,4,0,stay,1976-12-04
5648,Leroy Hutson,1977-01-01,Leroy Hutson - Hutson II,38,38,27,26.0,38,Hutson II,8.0,4,11,0,0,1,up,1976-12-04
5649,Leroy Hutson,1977-01-08,Leroy Hutson - Hutson II,38,38,26,26.0,27,Hutson II,8.0,5,1,11,0,1,up,1976-12-04
5650,Leroy Hutson,1977-01-15,Leroy Hutson - Hutson II,27,38,36,26.0,26,Hutson II,8.0,6,-10,1,11,1,down,1976-12-04
5651,Leroy Hutson,1977-01-22,Leroy Hutson - Hutson II,26,27,48,26.0,36,Hutson II,8.0,7,-12,-10,1,1,down,1976-12-04
5652,Leroy Hutson,1977-01-29,Leroy Hutson - Hutson II,36,26,51,26.0,48,Hutson II,8.0,8,-3,-12,-10,1,down,1976-12-04
5653,Crown Heights Affair,1976-12-04,Crown Heights Affair - Do It Your Way,51,51,44,41.0,49,Do It Your Way,10.0,0,5,2,0,1,up,1976-12-04
5654,Crown Heights Affair,1976-12-11,Crown Heights Affair - Do It Your Way,49,51,41,41.0,44,Do It Your Way,10.0,1,3,5,2,1,up,1976-12-04
5655,Crown Heights Affair,1977-01-08,Crown Heights Affair - Do It Your Way,44,49,41,41.0,41,Do It Your Way,10.0,2,0,3,5,0,stay,1976-12-04
5656,Crown Heights Affair,1977-01-15,Crown Heights Affair - Do It Your Way,41,44,41,41.0,41,Do It Your Way,10.0,3,0,0,3,0,stay,1976-12-04
5657,Crown Heights Affair,1977-01-22,Crown Heights Affair - Do It Your Way,41,41,49,41.0,41,Do It Your Way,10.0,4,-8,0,0,1,down,1976-12-04
5658,Crown Heights Affair,1977-02-05,Crown Heights Affair - Do It Your Way,41,41,46,41.0,49,Do It Your Way,10.0,5,3,-8,0,1,up,1976-12-04
5659,Crown Heights Affair,1977-02-12,Crown Heights Affair - Do It Your Way,49,41,47,41.0,46,Do It Your Way,10.0,6,-1,3,-8,1,down,1976-12-04
5660,Crown Heights Affair,1977-02-19,Crown Heights Affair - Do It Your Way,46,49,50,41.0,47,Do It Your Way,10.0,7,-3,-1,3,1,down,1976-12-04
5661,Crown Heights Affair,1977-02-26,Crown Heights Affair - Do It Your Way,47,46,45,41.0,50,Do It Your Way,10.0,8,5,-3,-1,1,up,1976-12-04
5662,Crown Heights Affair,1977-03-05,Crown Heights Affair - Do It Your Way,50,47,45,41.0,45,Do It Your Way,10.0,9,0,5,-3,0,stay,1976-12-04
5663,Crown Heights Affair,1977-03-12,Crown Heights Affair - Do It Your Way,45,50,51,41.0,45,Do It Your Way,10.0,10,-6,0,5,1,down,1976-12-04
5664,Daryl Hall John Oates,1976-12-04,Daryl Hall John Oates - Bigger Than Both Of Us,51,51,40,33.0,50,Bigger Than Both Of Us,9.0,0,10,1,0,1,up,1976-12-04
5665,Daryl Hall John Oates,1976-12-11,Daryl Hall John Oates - Bigger Than Both Of Us,50,51,37,33.0,40,Bigger Than Both Of Us,9.0,1,3,10,1,1,up,1976-12-04
5666,Daryl Hall John Oates,1976-12-18,Daryl Hall John Oates - Bigger Than Both Of Us,40,50,35,33.0,37,Bigger Than Both Of Us,9.0,2,2,3,10,1,up,1976-12-04
5667,Daryl Hall John Oates,1976-12-25,Daryl Hall John Oates - Bigger Than Both Of Us,37,40,35,33.0,35,Bigger Than Both Of Us,9.0,3,0,2,3,0,stay,1976-12-04
5668,Daryl Hall John Oates,1977-01-01,Daryl Hall John Oates - Bigger Than Both Of Us,35,37,37,33.0,35,Bigger Than Both Of Us,9.0,4,-2,0,2,1,down,1976-12-04
5669,Daryl Hall John Oates,1977-01-08,Daryl Hall John Oates - Bigger Than Both Of Us,35,35,35,33.0,37,Bigger Than Both Of Us,9.0,5,2,-2,0,1,up,1976-12-04
5670,Daryl Hall John Oates,1977-01-15,Daryl Hall John Oates - Bigger Than Both Of Us,37,35,37,33.0,35,Bigger Than Both Of Us,9.0,6,-2,2,-2,1,down,1976-12-04
5671,Daryl Hall John Oates,1977-01-22,Daryl Hall John Oates - Bigger Than Both Of Us,35,37,33,33.0,37,Bigger Than Both Of Us,9.0,7,4,-2,2,1,up,1976-12-04
5672,Daryl Hall John Oates,1977-01-29,Daryl Hall John Oates - Bigger Than Both Of Us,37,35,34,33.0,33,Bigger Than Both Of Us,9.0,8,-1,4,-2,1,down,1976-12-04
5673,Daryl Hall John Oates,1977-02-05,Daryl Hall John Oates - Bigger Than Both Of Us,33,37,51,33.0,34,Bigger Than Both Of Us,9.0,9,-17,-1,4,1,down,1976-12-04
5674,Ray Charles And Cleo Laine,1976-12-11,Ray Charles And Cleo Laine - Porgy & Bess,51,51,45,43.0,50,Porgy & Bess,3.0,0,5,1,0,1,up,1976-12-11
5675,Ray Charles And Cleo Laine,1976-12-18,Ray Charles And Cleo Laine - Porgy & Bess,50,51,43,43.0,45,Porgy & Bess,3.0,1,2,5,1,1,up,1976-12-11
5676,Ray Charles And Cleo Laine,1976-12-25,Ray Charles And Cleo Laine - Porgy & Bess,45,50,43,43.0,43,Porgy & Bess,3.0,2,0,2,5,0,stay,1976-12-11
5677,Ray Charles And Cleo Laine,1977-01-01,Ray Charles And Cleo Laine - Porgy & Bess,43,45,51,43.0,43,Porgy & Bess,3.0,3,-8,0,2,1,down,1976-12-11
5678,Sly & The Family Stone,1976-12-18,"Sly & The Family Stone - Heard Ya Missed Me, Well I'm Back",51,51,33,33.0,42,"Heard Ya Missed Me, Well I'm Back",3.0,0,9,9,0,1,up,1976-12-18
5679,Sly & The Family Stone,1976-12-25,"Sly & The Family Stone - Heard Ya Missed Me, Well I'm Back",42,51,33,33.0,33,"Heard Ya Missed Me, Well I'm Back",3.0,1,0,9,9,0,stay,1976-12-18
5680,Sly & The Family Stone,1977-01-01,"Sly & The Family Stone - Heard Ya Missed Me, Well I'm Back",33,42,33,33.0,33,"Heard Ya Missed Me, Well I'm Back",3.0,2,0,0,9,0,stay,1976-12-18
5681,Sly & The Family Stone,1977-01-08,"Sly & The Family Stone - Heard Ya Missed Me, Well I'm Back",33,33,51,33.0,33,"Heard Ya Missed Me, Well I'm Back",3.0,3,-18,0,0,1,down,1976-12-18
5682,The Crusaders,1976-12-18,The Crusaders - Best Of Crusaders,51,51,41,41.0,47,Best Of Crusaders,2.0,0,6,4,0,1,up,1976-12-18
5683,The Crusaders,1976-12-25,The Crusaders - Best Of Crusaders,47,51,41,41.0,41,Best Of Crusaders,2.0,1,0,6,4,0,stay,1976-12-18
5684,The Crusaders,1977-01-01,The Crusaders - Best Of Crusaders,41,47,51,41.0,41,Best Of Crusaders,2.0,2,-10,0,6,1,down,1976-12-18
5685,Silver Convention,1976-12-18,Silver Convention - Mad House,51,51,50,47.0,50,Mad House,3.0,0,0,1,0,0,stay,1976-12-18
5686,Silver Convention,1976-12-25,Silver Convention - Mad House,50,51,50,47.0,50,Mad House,3.0,1,0,0,1,0,stay,1976-12-18
5687,Silver Convention,1977-01-01,Silver Convention - Mad House,50,50,47,47.0,50,Mad House,3.0,2,3,0,0,1,up,1976-12-18
5688,Silver Convention,1977-01-08,Silver Convention - Mad House,50,50,51,47.0,47,Mad House,3.0,3,-4,3,0,1,down,1976-12-18
5689,Aretha Franklin,1976-12-25,Aretha Franklin - Ten Years Of Gold,51,51,45,29.0,45,Ten Years Of Gold,5.0,0,0,6,0,0,stay,1976-12-25
5690,Aretha Franklin,1977-01-01,Aretha Franklin - Ten Years Of Gold,45,51,29,29.0,45,Ten Years Of Gold,5.0,1,16,0,6,1,up,1976-12-25
5691,Aretha Franklin,1977-01-08,Aretha Franklin - Ten Years Of Gold,45,45,29,29.0,29,Ten Years Of Gold,5.0,2,0,16,0,0,stay,1976-12-25
5692,Aretha Franklin,1977-01-15,Aretha Franklin - Ten Years Of Gold,29,45,31,29.0,29,Ten Years Of Gold,5.0,3,-2,0,16,1,down,1976-12-25
5693,Aretha Franklin,1977-01-22,Aretha Franklin - Ten Years Of Gold,29,29,42,29.0,31,Ten Years Of Gold,5.0,4,-11,-2,0,1,down,1976-12-25
5694,Aretha Franklin,1977-01-29,Aretha Franklin - Ten Years Of Gold,31,29,51,29.0,42,Ten Years Of Gold,5.0,5,-9,-11,-2,1,down,1976-12-25
5695,The Salsoul Orchestra,1976-12-25,The Salsoul Orchestra - Christmas Jollies,51,51,48,38.0,48,Christmas Jollies,3.0,0,0,3,0,0,stay,1976-12-25
5696,The Salsoul Orchestra,1977-01-01,The Salsoul Orchestra - Christmas Jollies,48,51,38,38.0,48,Christmas Jollies,3.0,1,10,0,3,1,up,1976-12-25
5697,The Salsoul Orchestra,1977-01-08,The Salsoul Orchestra - Christmas Jollies,48,48,38,38.0,38,Christmas Jollies,3.0,2,0,10,0,0,stay,1976-12-25
5698,The Salsoul Orchestra,1977-01-15,The Salsoul Orchestra - Christmas Jollies,38,48,51,38.0,38,Christmas Jollies,3.0,3,-13,0,10,1,down,1976-12-25
5699,Melba Moore,1976-12-25,Melba Moore - Melba,51,51,49,30.0,49,Melba,19.0,0,0,2,0,0,stay,1976-12-25
5700,Melba Moore,1977-01-01,Melba Moore - Melba,49,51,39,30.0,49,Melba,19.0,1,10,0,2,1,up,1976-12-25
5701,Melba Moore,1977-01-08,Melba Moore - Melba,49,49,36,30.0,39,Melba,19.0,2,3,10,0,1,up,1976-12-25
5702,Melba Moore,1977-01-15,Melba Moore - Melba,39,49,32,30.0,36,Melba,19.0,3,4,3,10,1,up,1976-12-25
5703,Melba Moore,1977-01-22,Melba Moore - Melba,36,39,30,30.0,32,Melba,19.0,4,2,4,3,1,up,1976-12-25
5704,Melba Moore,1977-01-29,Melba Moore - Melba,32,36,32,30.0,30,Melba,19.0,5,-2,2,4,1,down,1976-12-25
5705,Melba Moore,1977-02-05,Melba Moore - Melba,30,32,49,30.0,32,Melba,19.0,6,-17,-2,2,1,down,1976-12-25
5706,Melba Moore,1977-02-12,Melba Moore - Melba,32,30,48,30.0,49,Melba,19.0,7,1,-17,-2,1,up,1976-12-25
5707,Melba Moore,1978-11-04,Melba Moore - Melba,49,32,48,30.0,48,Melba,19.0,8,0,1,-17,0,stay,1976-12-25
5708,Melba Moore,1978-11-11,Melba Moore - Melba,48,49,45,30.0,48,Melba,19.0,9,3,0,1,1,up,1976-12-25
5709,Melba Moore,1978-11-18,Melba Moore - Melba,48,48,44,30.0,45,Melba,19.0,10,1,3,0,1,up,1976-12-25
5710,Melba Moore,1978-12-09,Melba Moore - Melba,45,48,39,30.0,44,Melba,19.0,11,5,1,3,1,up,1976-12-25
5711,Melba Moore,1978-12-16,Melba Moore - Melba,44,45,40,30.0,39,Melba,19.0,12,-1,5,1,1,down,1976-12-25
5712,Melba Moore,1978-12-23,Melba Moore - Melba,39,44,40,30.0,40,Melba,19.0,13,0,-1,5,0,stay,1976-12-25
5713,Melba Moore,1978-12-30,Melba Moore - Melba,40,39,44,30.0,40,Melba,19.0,14,-4,0,-1,1,down,1976-12-25
5714,Melba Moore,1979-01-13,Melba Moore - Melba,40,40,41,30.0,44,Melba,19.0,15,3,-4,0,1,up,1976-12-25
5715,Melba Moore,1979-01-20,Melba Moore - Melba,44,40,38,30.0,41,Melba,19.0,16,3,3,-4,1,up,1976-12-25
5716,Melba Moore,1979-01-27,Melba Moore - Melba,41,44,35,30.0,38,Melba,19.0,17,3,3,3,1,up,1976-12-25
5717,Melba Moore,1979-02-03,Melba Moore - Melba,38,41,44,30.0,35,Melba,19.0,18,-9,3,3,1,down,1976-12-25
5718,Melba Moore,1979-02-10,Melba Moore - Melba,35,38,51,30.0,44,Melba,19.0,19,-7,-9,3,1,down,1976-12-25
5719,The Pointer Sisters,1977-01-08,The Pointer Sisters - The Best Of The Pointer Sisters,51,51,33,33.0,35,The Best Of The Pointer Sisters,1.0,0,2,16,0,1,up,1977-01-08
5720,The Pointer Sisters,1977-01-15,The Pointer Sisters - The Best Of The Pointer Sisters,35,51,51,33.0,33,The Best Of The Pointer Sisters,1.0,1,-18,2,16,1,down,1977-01-08
5721,Esther Phillips,1977-01-08,Esther Phillips - Capricorn Princess,51,51,40,40.0,42,Capricorn Princess,2.0,0,2,9,0,1,up,1977-01-08
5722,Esther Phillips,1977-01-15,Esther Phillips - Capricorn Princess,42,51,40,40.0,40,Capricorn Princess,2.0,1,0,2,9,0,stay,1977-01-08
5723,Esther Phillips,1977-01-22,Esther Phillips - Capricorn Princess,40,42,51,40.0,40,Capricorn Princess,2.0,2,-11,0,2,1,down,1977-01-08
5724,"Grover Washington, Jr.",1977-01-08,"Grover Washington, Jr. - A Secret Place",51,51,37,7.0,45,A Secret Place,15.0,0,8,6,0,1,up,1977-01-08
5725,"Grover Washington, Jr.",1977-01-15,"Grover Washington, Jr. - A Secret Place",45,51,15,7.0,37,A Secret Place,15.0,1,22,8,6,1,up,1977-01-08
5726,"Grover Washington, Jr.",1977-01-22,"Grover Washington, Jr. - A Secret Place",37,45,11,7.0,15,A Secret Place,15.0,2,4,22,8,1,up,1977-01-08
5727,"Grover Washington, Jr.",1977-01-29,"Grover Washington, Jr. - A Secret Place",15,37,9,7.0,11,A Secret Place,15.0,3,2,4,22,1,up,1977-01-08
5728,"Grover Washington, Jr.",1977-02-05,"Grover Washington, Jr. - A Secret Place",11,15,7,7.0,9,A Secret Place,15.0,4,2,2,4,1,up,1977-01-08
5729,"Grover Washington, Jr.",1977-02-12,"Grover Washington, Jr. - A Secret Place",9,11,7,7.0,7,A Secret Place,15.0,5,0,2,2,0,stay,1977-01-08
5730,"Grover Washington, Jr.",1977-02-19,"Grover Washington, Jr. - A Secret Place",7,9,12,7.0,7,A Secret Place,15.0,6,-5,0,2,1,down,1977-01-08
5731,"Grover Washington, Jr.",1977-02-26,"Grover Washington, Jr. - A Secret Place",7,7,12,7.0,12,A Secret Place,15.0,7,0,-5,0,0,stay,1977-01-08
5732,"Grover Washington, Jr.",1977-03-05,"Grover Washington, Jr. - A Secret Place",12,7,12,7.0,12,A Secret Place,15.0,8,0,0,-5,0,stay,1977-01-08
5733,"Grover Washington, Jr.",1977-03-12,"Grover Washington, Jr. - A Secret Place",12,12,12,7.0,12,A Secret Place,15.0,9,0,0,0,0,stay,1977-01-08
5734,"Grover Washington, Jr.",1977-03-19,"Grover Washington, Jr. - A Secret Place",12,12,15,7.0,12,A Secret Place,15.0,10,-3,0,0,1,down,1977-01-08
5735,"Grover Washington, Jr.",1977-03-26,"Grover Washington, Jr. - A Secret Place",12,12,15,7.0,15,A Secret Place,15.0,11,0,-3,0,0,stay,1977-01-08
5736,"Grover Washington, Jr.",1977-04-02,"Grover Washington, Jr. - A Secret Place",15,12,17,7.0,15,A Secret Place,15.0,12,-2,0,-3,1,down,1977-01-08
5737,"Grover Washington, Jr.",1977-04-09,"Grover Washington, Jr. - A Secret Place",15,15,48,7.0,17,A Secret Place,15.0,13,-31,-2,0,1,down,1977-01-08
5738,"Grover Washington, Jr.",1977-04-16,"Grover Washington, Jr. - A Secret Place",17,15,48,7.0,48,A Secret Place,15.0,14,0,-31,-2,0,stay,1977-01-08
5739,"Grover Washington, Jr.",1977-04-23,"Grover Washington, Jr. - A Secret Place",48,17,51,7.0,48,A Secret Place,15.0,15,-3,0,-31,1,down,1977-01-08
5740,The Stylistics,1977-01-08,The Stylistics - Once Upon A Juke Box,51,51,45,45.0,48,Once Upon A Juke Box,2.0,0,3,3,0,1,up,1977-01-08
5741,The Stylistics,1977-01-15,The Stylistics - Once Upon A Juke Box,48,51,45,45.0,45,Once Upon A Juke Box,2.0,1,0,3,3,0,stay,1977-01-08
5742,The Stylistics,1977-01-22,The Stylistics - Once Upon A Juke Box,45,48,51,45.0,45,Once Upon A Juke Box,2.0,2,-6,0,3,1,down,1977-01-08
5743,Mass Production,1977-01-08,Mass Production - Welcome To Our World,51,51,46,35.0,50,Welcome To Our World,9.0,0,4,1,0,1,up,1977-01-08
5744,Mass Production,1977-01-15,Mass Production - Welcome To Our World,50,51,43,35.0,46,Welcome To Our World,9.0,1,3,4,1,1,up,1977-01-08
5745,Mass Production,1977-01-22,Mass Production - Welcome To Our World,46,50,39,35.0,43,Welcome To Our World,9.0,2,4,3,4,1,up,1977-01-08
5746,Mass Production,1977-01-29,Mass Production - Welcome To Our World,43,46,35,35.0,39,Welcome To Our World,9.0,3,4,4,3,1,up,1977-01-08
5747,Mass Production,1977-02-05,Mass Production - Welcome To Our World,39,43,35,35.0,35,Welcome To Our World,9.0,4,0,4,4,0,stay,1977-01-08
5748,Mass Production,1977-02-12,Mass Production - Welcome To Our World,35,39,47,35.0,35,Welcome To Our World,9.0,5,-12,0,4,1,down,1977-01-08
5749,Mass Production,1977-03-05,Mass Production - Welcome To Our World,35,35,47,35.0,47,Welcome To Our World,9.0,6,0,-12,0,0,stay,1977-01-08
5750,Mass Production,1977-03-12,Mass Production - Welcome To Our World,47,35,46,35.0,47,Welcome To Our World,9.0,7,1,0,-12,1,up,1977-01-08
5751,Mass Production,1977-03-19,Mass Production - Welcome To Our World,47,47,46,35.0,46,Welcome To Our World,9.0,8,0,1,0,0,stay,1977-01-08
5752,Mass Production,1977-03-26,Mass Production - Welcome To Our World,46,47,51,35.0,46,Welcome To Our World,9.0,9,-5,0,1,1,down,1977-01-08
5753,Roy Ayers Ubiquity,1977-01-15,Roy Ayers Ubiquity - Vibrations,51,51,24,11.0,30,Vibrations,12.0,0,6,21,0,1,up,1977-01-15
5754,Roy Ayers Ubiquity,1977-01-22,Roy Ayers Ubiquity - Vibrations,30,51,19,11.0,24,Vibrations,12.0,1,5,6,21,1,up,1977-01-15
5755,Roy Ayers Ubiquity,1977-01-29,Roy Ayers Ubiquity - Vibrations,24,30,15,11.0,19,Vibrations,12.0,2,4,5,6,1,up,1977-01-15
5756,Roy Ayers Ubiquity,1977-02-05,Roy Ayers Ubiquity - Vibrations,19,24,11,11.0,15,Vibrations,12.0,3,4,4,5,1,up,1977-01-15
5757,Roy Ayers Ubiquity,1977-02-12,Roy Ayers Ubiquity - Vibrations,15,19,11,11.0,11,Vibrations,12.0,4,0,4,4,0,stay,1977-01-15
5758,Roy Ayers Ubiquity,1977-02-19,Roy Ayers Ubiquity - Vibrations,11,15,14,11.0,11,Vibrations,12.0,5,-3,0,4,1,down,1977-01-15
5759,Roy Ayers Ubiquity,1977-02-26,Roy Ayers Ubiquity - Vibrations,11,11,23,11.0,14,Vibrations,12.0,6,-9,-3,0,1,down,1977-01-15
5760,Roy Ayers Ubiquity,1977-03-05,Roy Ayers Ubiquity - Vibrations,14,11,20,11.0,23,Vibrations,12.0,7,3,-9,-3,1,up,1977-01-15
5761,Roy Ayers Ubiquity,1977-03-12,Roy Ayers Ubiquity - Vibrations,23,14,20,11.0,20,Vibrations,12.0,8,0,3,-9,0,stay,1977-01-15
5762,Roy Ayers Ubiquity,1977-03-19,Roy Ayers Ubiquity - Vibrations,20,23,31,11.0,20,Vibrations,12.0,9,-11,0,3,1,down,1977-01-15
5763,Roy Ayers Ubiquity,1977-03-26,Roy Ayers Ubiquity - Vibrations,20,20,36,11.0,31,Vibrations,12.0,10,-5,-11,0,1,down,1977-01-15
5764,Roy Ayers Ubiquity,1977-04-02,Roy Ayers Ubiquity - Vibrations,31,20,41,11.0,36,Vibrations,12.0,11,-5,-5,-11,1,down,1977-01-15
5765,Roy Ayers Ubiquity,1977-04-09,Roy Ayers Ubiquity - Vibrations,36,31,51,11.0,41,Vibrations,12.0,12,-10,-5,-5,1,down,1977-01-15
5766,Thelma Houston,1977-01-15,Thelma Houston - Anyway You Like It,51,51,33,5.0,42,Anyway You Like It,22.0,0,9,9,0,1,up,1977-01-15
5767,Thelma Houston,1977-01-22,Thelma Houston - Anyway You Like It,42,51,27,5.0,33,Anyway You Like It,22.0,1,6,9,9,1,up,1977-01-15
5768,Thelma Houston,1977-01-29,Thelma Houston - Anyway You Like It,33,42,20,5.0,27,Anyway You Like It,22.0,2,7,6,9,1,up,1977-01-15
5769,Thelma Houston,1977-02-05,Thelma Houston - Anyway You Like It,27,33,15,5.0,20,Anyway You Like It,22.0,3,5,7,6,1,up,1977-01-15
5770,Thelma Houston,1977-02-12,Thelma Houston - Anyway You Like It,20,27,13,5.0,15,Anyway You Like It,22.0,4,2,5,7,1,up,1977-01-15
5771,Thelma Houston,1977-02-19,Thelma Houston - Anyway You Like It,15,20,10,5.0,13,Anyway You Like It,22.0,5,3,2,5,1,up,1977-01-15
5772,Thelma Houston,1977-02-26,Thelma Houston - Anyway You Like It,13,15,8,5.0,10,Anyway You Like It,22.0,6,2,3,2,1,up,1977-01-15
5773,Thelma Houston,1977-03-05,Thelma Houston - Anyway You Like It,10,13,5,5.0,8,Anyway You Like It,22.0,7,3,2,3,1,up,1977-01-15
5774,Thelma Houston,1977-03-12,Thelma Houston - Anyway You Like It,8,10,5,5.0,5,Anyway You Like It,22.0,8,0,3,2,0,stay,1977-01-15
5775,Thelma Houston,1977-03-19,Thelma Houston - Anyway You Like It,5,8,7,5.0,5,Anyway You Like It,22.0,9,-2,0,3,1,down,1977-01-15
5776,Thelma Houston,1977-03-26,Thelma Houston - Anyway You Like It,5,5,7,5.0,7,Anyway You Like It,22.0,10,0,-2,0,0,stay,1977-01-15
5777,Thelma Houston,1977-04-02,Thelma Houston - Anyway You Like It,7,5,7,5.0,7,Anyway You Like It,22.0,11,0,0,-2,0,stay,1977-01-15
5778,Thelma Houston,1977-04-09,Thelma Houston - Anyway You Like It,7,7,8,5.0,7,Anyway You Like It,22.0,12,-1,0,0,1,down,1977-01-15
5779,Thelma Houston,1977-04-16,Thelma Houston - Anyway You Like It,7,7,12,5.0,8,Anyway You Like It,22.0,13,-4,-1,0,1,down,1977-01-15
5780,Thelma Houston,1977-04-23,Thelma Houston - Anyway You Like It,8,7,12,5.0,12,Anyway You Like It,22.0,14,0,-4,-1,0,stay,1977-01-15
5781,Thelma Houston,1977-04-30,Thelma Houston - Anyway You Like It,12,8,12,5.0,12,Anyway You Like It,22.0,15,0,0,-4,0,stay,1977-01-15
5782,Thelma Houston,1977-05-07,Thelma Houston - Anyway You Like It,12,12,12,5.0,12,Anyway You Like It,22.0,16,0,0,0,0,stay,1977-01-15
5783,Thelma Houston,1977-05-14,Thelma Houston - Anyway You Like It,12,12,21,5.0,12,Anyway You Like It,22.0,17,-9,0,0,1,down,1977-01-15
5784,Thelma Houston,1977-05-21,Thelma Houston - Anyway You Like It,12,12,21,5.0,21,Anyway You Like It,22.0,18,0,-9,0,0,stay,1977-01-15
5785,Thelma Houston,1977-05-28,Thelma Houston - Anyway You Like It,21,12,23,5.0,21,Anyway You Like It,22.0,19,-2,0,-9,1,down,1977-01-15
5786,Thelma Houston,1977-06-04,Thelma Houston - Anyway You Like It,21,21,24,5.0,23,Anyway You Like It,22.0,20,-1,-2,0,1,down,1977-01-15
5787,Thelma Houston,1977-06-11,Thelma Houston - Anyway You Like It,23,21,49,5.0,24,Anyway You Like It,22.0,21,-25,-1,-2,1,down,1977-01-15
5788,Thelma Houston,1977-06-18,Thelma Houston - Anyway You Like It,24,23,51,5.0,49,Anyway You Like It,22.0,22,-2,-25,-1,1,down,1977-01-15
5789,Donald Byrd,1977-01-15,Donald Byrd - Donald Byrd's Best,51,51,46,46.0,47,Donald Byrd's Best,1.0,0,1,4,0,1,up,1977-01-15
5790,Donald Byrd,1977-01-22,Donald Byrd - Donald Byrd's Best,47,51,51,46.0,46,Donald Byrd's Best,1.0,1,-5,1,4,1,down,1977-01-15
5791,Latimore,1977-01-15,Latimore - It Ain't Where You Been,51,51,47,47.0,48,It Ain't Where You Been,1.0,0,1,3,0,1,up,1977-01-15
5792,Latimore,1977-01-22,Latimore - It Ain't Where You Been,48,51,51,47.0,47,It Ain't Where You Been,1.0,1,-4,1,3,1,down,1977-01-15
5793,Lonnie Liston Smith,1977-01-15,Lonnie Liston Smith - Renaissance,51,51,51,49.0,49,Renaissance,0.0,0,-2,2,0,1,down,1977-01-15
5794,James Brown,1977-01-15,James Brown - Bodyheat,51,51,35,20.0,50,Bodyheat,11.0,0,15,1,0,1,up,1977-01-15
5795,James Brown,1977-01-22,James Brown - Bodyheat,50,51,29,20.0,35,Bodyheat,11.0,1,6,15,1,1,up,1977-01-15
5796,James Brown,1977-01-29,James Brown - Bodyheat,35,50,23,20.0,29,Bodyheat,11.0,2,6,6,15,1,up,1977-01-15
5797,James Brown,1977-02-05,James Brown - Bodyheat,29,35,21,20.0,23,Bodyheat,11.0,3,2,6,6,1,up,1977-01-15
5798,James Brown,1977-02-12,James Brown - Bodyheat,23,29,20,20.0,21,Bodyheat,11.0,4,1,2,6,1,up,1977-01-15
5799,James Brown,1977-02-19,James Brown - Bodyheat,21,23,21,20.0,20,Bodyheat,11.0,5,-1,1,2,1,down,1977-01-15
5800,James Brown,1977-02-26,James Brown - Bodyheat,20,21,25,20.0,21,Bodyheat,11.0,6,-4,-1,1,1,down,1977-01-15
5801,James Brown,1977-03-05,James Brown - Bodyheat,21,20,29,20.0,25,Bodyheat,11.0,7,-4,-4,-1,1,down,1977-01-15
5802,James Brown,1977-03-12,James Brown - Bodyheat,25,21,35,20.0,29,Bodyheat,11.0,8,-6,-4,-4,1,down,1977-01-15
5803,James Brown,1977-03-19,James Brown - Bodyheat,29,25,37,20.0,35,Bodyheat,11.0,9,-2,-6,-4,1,down,1977-01-15
5804,James Brown,1977-03-26,James Brown - Bodyheat,35,29,49,20.0,37,Bodyheat,11.0,10,-12,-2,-6,1,down,1977-01-15
5805,James Brown,1977-04-02,James Brown - Bodyheat,37,35,51,20.0,49,Bodyheat,11.0,11,-2,-12,-2,1,down,1977-01-15
5806,Millie Jackson,1977-01-22,Millie Jackson - Lovingly Yours,51,51,44,44.0,48,Lovingly Yours,1.0,0,4,3,0,1,up,1977-01-22
5807,Millie Jackson,1977-01-29,Millie Jackson - Lovingly Yours,48,51,51,44.0,44,Lovingly Yours,1.0,1,-7,4,3,1,down,1977-01-22
5808,Archie Bell & The Drells,1977-01-22,Archie Bell & The Drells - Where Will You Go When The Party's Over,51,51,47,47.0,49,Where Will You Go When The Party's Over,1.0,0,2,2,0,1,up,1977-01-22
5809,Archie Bell & The Drells,1977-01-29,Archie Bell & The Drells - Where Will You Go When The Party's Over,49,51,51,47.0,47,Where Will You Go When The Party's Over,1.0,1,-4,2,2,1,down,1977-01-22
5810,Average White Band,1977-01-22,Average White Band - Person To Person,51,51,25,9.0,50,Person To Person,15.0,0,25,1,0,1,up,1977-01-22
5811,Average White Band,1977-01-29,Average White Band - Person To Person,50,51,16,9.0,25,Person To Person,15.0,1,9,25,1,1,up,1977-01-22
5812,Average White Band,1977-02-05,Average White Band - Person To Person,25,50,9,9.0,16,Person To Person,15.0,2,7,9,25,1,up,1977-01-22
5813,Average White Band,1977-02-12,Average White Band - Person To Person,16,25,9,9.0,9,Person To Person,15.0,3,0,7,9,0,stay,1977-01-22
5814,Average White Band,1977-02-19,Average White Band - Person To Person,9,16,11,9.0,9,Person To Person,15.0,4,-2,0,7,1,down,1977-01-22
5815,Average White Band,1977-02-26,Average White Band - Person To Person,9,9,11,9.0,11,Person To Person,15.0,5,0,-2,0,0,stay,1977-01-22
5816,Average White Band,1977-03-05,Average White Band - Person To Person,11,9,10,9.0,11,Person To Person,15.0,6,1,0,-2,1,up,1977-01-22
5817,Average White Band,1977-03-12,Average White Band - Person To Person,11,11,15,9.0,10,Person To Person,15.0,7,-5,1,0,1,down,1977-01-22
5818,Average White Band,1977-03-19,Average White Band - Person To Person,10,11,19,9.0,15,Person To Person,15.0,8,-4,-5,1,1,down,1977-01-22
5819,Average White Band,1977-03-26,Average White Band - Person To Person,15,10,17,9.0,19,Person To Person,15.0,9,2,-4,-5,1,up,1977-01-22
5820,Average White Band,1977-04-02,Average White Band - Person To Person,19,15,23,9.0,17,Person To Person,15.0,10,-6,2,-4,1,down,1977-01-22
5821,Average White Band,1977-04-09,Average White Band - Person To Person,17,19,21,9.0,23,Person To Person,15.0,11,2,-6,2,1,up,1977-01-22
5822,Average White Band,1977-04-16,Average White Band - Person To Person,23,17,20,9.0,21,Person To Person,15.0,12,1,2,-6,1,up,1977-01-22
5823,Average White Band,1977-04-23,Average White Band - Person To Person,21,23,26,9.0,20,Person To Person,15.0,13,-6,1,2,1,down,1977-01-22
5824,Average White Band,1977-04-30,Average White Band - Person To Person,20,21,35,9.0,26,Person To Person,15.0,14,-9,-6,1,1,down,1977-01-22
5825,Average White Band,1977-05-07,Average White Band - Person To Person,26,20,51,9.0,35,Person To Person,15.0,15,-16,-9,-6,1,down,1977-01-22
5826,Undisputed Truth,1977-01-29,Undisputed Truth - Method To The Madness,51,51,26,19.0,40,Method To The Madness,12.0,0,14,11,0,1,up,1977-01-29
5827,Undisputed Truth,1977-02-05,Undisputed Truth - Method To The Madness,40,51,23,19.0,26,Method To The Madness,12.0,1,3,14,11,1,up,1977-01-29
5828,Undisputed Truth,1977-02-12,Undisputed Truth - Method To The Madness,26,40,23,19.0,23,Method To The Madness,12.0,2,0,3,14,0,stay,1977-01-29
5829,Undisputed Truth,1977-02-19,Undisputed Truth - Method To The Madness,23,26,19,19.0,23,Method To The Madness,12.0,3,4,0,3,1,up,1977-01-29
5830,Undisputed Truth,1977-02-26,Undisputed Truth - Method To The Madness,23,23,19,19.0,19,Method To The Madness,12.0,4,0,4,0,0,stay,1977-01-29
5831,Undisputed Truth,1977-03-05,Undisputed Truth - Method To The Madness,19,23,22,19.0,19,Method To The Madness,12.0,5,-3,0,4,1,down,1977-01-29
5832,Undisputed Truth,1977-03-12,Undisputed Truth - Method To The Madness,19,19,21,19.0,22,Method To The Madness,12.0,6,1,-3,0,1,up,1977-01-29
5833,Undisputed Truth,1977-03-19,Undisputed Truth - Method To The Madness,22,19,24,19.0,21,Method To The Madness,12.0,7,-3,1,-3,1,down,1977-01-29
5834,Undisputed Truth,1977-03-26,Undisputed Truth - Method To The Madness,21,22,25,19.0,24,Method To The Madness,12.0,8,-1,-3,1,1,down,1977-01-29
5835,Undisputed Truth,1977-04-02,Undisputed Truth - Method To The Madness,24,21,25,19.0,25,Method To The Madness,12.0,9,0,-1,-3,0,stay,1977-01-29
5836,Undisputed Truth,1977-04-09,Undisputed Truth - Method To The Madness,25,24,29,19.0,25,Method To The Madness,12.0,10,-4,0,-1,1,down,1977-01-29
5837,Undisputed Truth,1977-04-16,Undisputed Truth - Method To The Madness,25,25,34,19.0,29,Method To The Madness,12.0,11,-5,-4,0,1,down,1977-01-29
5838,Undisputed Truth,1977-04-23,Undisputed Truth - Method To The Madness,29,25,51,19.0,34,Method To The Madness,12.0,12,-17,-5,-4,1,down,1977-01-29
5839,The Moments,1977-01-29,The Moments - Moments With You,51,51,40,40.0,43,Moments With You,2.0,0,3,8,0,1,up,1977-01-29
5840,The Moments,1977-02-05,The Moments - Moments With You,43,51,49,40.0,40,Moments With You,2.0,1,-9,3,8,1,down,1977-01-29
5841,The Moments,1977-02-19,The Moments - Moments With You,40,43,51,40.0,49,Moments With You,2.0,2,-2,-9,3,1,down,1977-01-29
5842,The Trammps,1977-01-29,The Trammps - Disco Inferno,51,51,37,16.0,45,Disco Inferno,18.0,0,8,6,0,1,up,1977-01-29
5843,The Trammps,1977-02-05,The Trammps - Disco Inferno,45,51,32,16.0,37,Disco Inferno,18.0,1,5,8,6,1,up,1977-01-29
5844,The Trammps,1977-02-12,The Trammps - Disco Inferno,37,45,32,16.0,32,Disco Inferno,18.0,2,0,5,8,0,stay,1977-01-29
5845,The Trammps,1977-02-19,The Trammps - Disco Inferno,32,37,33,16.0,32,Disco Inferno,18.0,3,-1,0,5,1,down,1977-01-29
5846,The Trammps,1977-02-26,The Trammps - Disco Inferno,32,32,28,16.0,33,Disco Inferno,18.0,4,5,-1,0,1,up,1977-01-29
5847,The Trammps,1977-03-05,The Trammps - Disco Inferno,33,32,37,16.0,28,Disco Inferno,18.0,5,-9,5,-1,1,down,1977-01-29
5848,The Trammps,1977-03-12,The Trammps - Disco Inferno,28,33,29,16.0,37,Disco Inferno,18.0,6,8,-9,5,1,up,1977-01-29
5849,The Trammps,1977-03-19,The Trammps - Disco Inferno,37,28,25,16.0,29,Disco Inferno,18.0,7,4,8,-9,1,up,1977-01-29
5850,The Trammps,1977-03-26,The Trammps - Disco Inferno,29,37,22,16.0,25,Disco Inferno,18.0,8,3,4,8,1,up,1977-01-29
5851,The Trammps,1977-04-02,The Trammps - Disco Inferno,25,29,19,16.0,22,Disco Inferno,18.0,9,3,3,4,1,up,1977-01-29
5852,The Trammps,1977-04-09,The Trammps - Disco Inferno,22,25,19,16.0,19,Disco Inferno,18.0,10,0,3,3,0,stay,1977-01-29
5853,The Trammps,1977-04-16,The Trammps - Disco Inferno,19,22,17,16.0,19,Disco Inferno,18.0,11,2,0,3,1,up,1977-01-29
5854,The Trammps,1977-04-23,The Trammps - Disco Inferno,19,19,16,16.0,17,Disco Inferno,18.0,12,1,2,0,1,up,1977-01-29
5855,The Trammps,1977-04-30,The Trammps - Disco Inferno,17,19,21,16.0,16,Disco Inferno,18.0,13,-5,1,2,1,down,1977-01-29
5856,The Trammps,1977-05-07,The Trammps - Disco Inferno,16,17,46,16.0,21,Disco Inferno,18.0,14,-25,-5,1,1,down,1977-01-29
5857,The Trammps,1977-05-14,The Trammps - Disco Inferno,21,16,50,16.0,46,Disco Inferno,18.0,15,-4,-25,-5,1,down,1977-01-29
5858,The Trammps,1977-05-21,The Trammps - Disco Inferno,46,21,47,16.0,50,Disco Inferno,18.0,16,3,-4,-25,1,up,1977-01-29
5859,The Trammps,1977-06-04,The Trammps - Disco Inferno,50,46,42,16.0,47,Disco Inferno,18.0,17,5,3,-4,1,up,1977-01-29
5860,The Trammps,1977-06-11,The Trammps - Disco Inferno,47,50,51,16.0,42,Disco Inferno,18.0,18,-9,5,3,1,down,1977-01-29
5861,Billy Paul,1977-01-29,Billy Paul - Let 'em In,51,51,36,27.0,46,Let 'em In,13.0,0,10,5,0,1,up,1977-01-29
5862,Billy Paul,1977-02-05,Billy Paul - Let 'em In,46,51,34,27.0,36,Let 'em In,13.0,1,2,10,5,1,up,1977-01-29
5863,Billy Paul,1977-02-12,Billy Paul - Let 'em In,36,46,31,27.0,34,Let 'em In,13.0,2,3,2,10,1,up,1977-01-29
5864,Billy Paul,1977-02-19,Billy Paul - Let 'em In,34,36,31,27.0,31,Let 'em In,13.0,3,0,3,2,0,stay,1977-01-29
5865,Billy Paul,1977-02-26,Billy Paul - Let 'em In,31,34,27,27.0,31,Let 'em In,13.0,4,4,0,3,1,up,1977-01-29
5866,Billy Paul,1977-03-05,Billy Paul - Let 'em In,31,31,33,27.0,27,Let 'em In,13.0,5,-6,4,0,1,down,1977-01-29
5867,Billy Paul,1977-03-12,Billy Paul - Let 'em In,27,31,33,27.0,33,Let 'em In,13.0,6,0,-6,4,0,stay,1977-01-29
5868,Billy Paul,1977-03-19,Billy Paul - Let 'em In,33,27,44,27.0,33,Let 'em In,13.0,7,-11,0,-6,1,down,1977-01-29
5869,Billy Paul,1977-03-26,Billy Paul - Let 'em In,33,33,39,27.0,44,Let 'em In,13.0,8,5,-11,0,1,up,1977-01-29
5870,Billy Paul,1977-04-02,Billy Paul - Let 'em In,44,33,39,27.0,39,Let 'em In,13.0,9,0,5,-11,0,stay,1977-01-29
5871,Billy Paul,1977-04-09,Billy Paul - Let 'em In,39,44,40,27.0,39,Let 'em In,13.0,10,-1,0,5,1,down,1977-01-29
5872,Billy Paul,1977-04-16,Billy Paul - Let 'em In,39,39,42,27.0,40,Let 'em In,13.0,11,-2,-1,0,1,down,1977-01-29
5873,Billy Paul,1977-04-23,Billy Paul - Let 'em In,40,39,47,27.0,42,Let 'em In,13.0,12,-5,-2,-1,1,down,1977-01-29
5874,Billy Paul,1977-04-30,Billy Paul - Let 'em In,42,40,51,27.0,47,Let 'em In,13.0,13,-4,-5,-2,1,down,1977-01-29
5875,Ashford & Simpson,1977-01-29,Ashford & Simpson - So So Satisfied,51,51,41,30.0,49,So So Satisfied,5.0,0,8,2,0,1,up,1977-01-29
5876,Ashford & Simpson,1977-02-05,Ashford & Simpson - So So Satisfied,49,51,33,30.0,41,So So Satisfied,5.0,1,8,8,2,1,up,1977-01-29
5877,Ashford & Simpson,1977-02-12,Ashford & Simpson - So So Satisfied,41,49,30,30.0,33,So So Satisfied,5.0,2,3,8,8,1,up,1977-01-29
5878,Ashford & Simpson,1977-02-19,Ashford & Simpson - So So Satisfied,33,41,44,30.0,30,So So Satisfied,5.0,3,-14,3,8,1,down,1977-01-29
5879,Ashford & Simpson,1977-02-26,Ashford & Simpson - So So Satisfied,30,33,44,30.0,44,So So Satisfied,5.0,4,0,-14,3,0,stay,1977-01-29
5880,Ashford & Simpson,1977-03-05,Ashford & Simpson - So So Satisfied,44,30,51,30.0,44,So So Satisfied,5.0,5,-7,0,-14,1,down,1977-01-29
5881,Hank Crawford,1977-01-29,Hank Crawford - Hank Crawford's Back,51,51,47,42.0,50,Hank Crawford's Back,2.0,0,3,1,0,1,up,1977-01-29
5882,Hank Crawford,1977-02-05,Hank Crawford - Hank Crawford's Back,50,51,42,42.0,47,Hank Crawford's Back,2.0,1,5,3,1,1,up,1977-01-29
5883,Hank Crawford,1977-02-12,Hank Crawford - Hank Crawford's Back,47,50,51,42.0,42,Hank Crawford's Back,2.0,2,-9,5,3,1,down,1977-01-29
5884,Rufus And Chaka Khan,1977-02-05,Rufus And Chaka Khan - Ask Rufus,51,51,14,1.0,42,Ask Rufus,23.0,0,28,9,0,1,up,1977-02-05
5885,Rufus And Chaka Khan,1977-02-12,Rufus And Chaka Khan - Ask Rufus,42,51,8,1.0,14,Ask Rufus,23.0,1,6,28,9,1,up,1977-02-05
5886,Rufus And Chaka Khan,1977-02-19,Rufus And Chaka Khan - Ask Rufus,14,42,2,1.0,8,Ask Rufus,23.0,2,6,6,28,1,up,1977-02-05
5887,Rufus And Chaka Khan,1977-02-26,Rufus And Chaka Khan - Ask Rufus,8,14,2,1.0,2,Ask Rufus,23.0,3,0,6,6,0,stay,1977-02-05
5888,Rufus And Chaka Khan,1977-03-05,Rufus And Chaka Khan - Ask Rufus,2,8,1,1.0,2,Ask Rufus,23.0,4,1,0,6,1,up,1977-02-05
5889,Rufus And Chaka Khan,1977-03-12,Rufus And Chaka Khan - Ask Rufus,2,2,1,1.0,1,Ask Rufus,23.0,5,0,1,0,0,stay,1977-02-05
5890,Rufus And Chaka Khan,1977-03-19,Rufus And Chaka Khan - Ask Rufus,1,2,1,1.0,1,Ask Rufus,23.0,6,0,0,1,0,stay,1977-02-05
5891,Rufus And Chaka Khan,1977-03-26,Rufus And Chaka Khan - Ask Rufus,1,1,2,1.0,1,Ask Rufus,23.0,7,-1,0,0,1,down,1977-02-05
5892,Rufus And Chaka Khan,1977-04-02,Rufus And Chaka Khan - Ask Rufus,1,1,3,1.0,2,Ask Rufus,23.0,8,-1,-1,0,1,down,1977-02-05
5893,Rufus And Chaka Khan,1977-04-09,Rufus And Chaka Khan - Ask Rufus,2,1,5,1.0,3,Ask Rufus,23.0,9,-2,-1,-1,1,down,1977-02-05
5894,Rufus And Chaka Khan,1977-04-16,Rufus And Chaka Khan - Ask Rufus,3,2,8,1.0,5,Ask Rufus,23.0,10,-3,-2,-1,1,down,1977-02-05
5895,Rufus And Chaka Khan,1977-04-23,Rufus And Chaka Khan - Ask Rufus,5,3,8,1.0,8,Ask Rufus,23.0,11,0,-3,-2,0,stay,1977-02-05
5896,Rufus And Chaka Khan,1977-04-30,Rufus And Chaka Khan - Ask Rufus,8,5,8,1.0,8,Ask Rufus,23.0,12,0,0,-3,0,stay,1977-02-05
5897,Rufus And Chaka Khan,1977-05-07,Rufus And Chaka Khan - Ask Rufus,8,8,8,1.0,8,Ask Rufus,23.0,13,0,0,0,0,stay,1977-02-05
5898,Rufus And Chaka Khan,1977-05-14,Rufus And Chaka Khan - Ask Rufus,8,8,8,1.0,8,Ask Rufus,23.0,14,0,0,0,0,stay,1977-02-05
5899,Rufus And Chaka Khan,1977-05-21,Rufus And Chaka Khan - Ask Rufus,8,8,17,1.0,8,Ask Rufus,23.0,15,-9,0,0,1,down,1977-02-05
5900,Rufus And Chaka Khan,1977-05-28,Rufus And Chaka Khan - Ask Rufus,8,8,18,1.0,17,Ask Rufus,23.0,16,-1,-9,0,1,down,1977-02-05
5901,Rufus And Chaka Khan,1977-06-04,Rufus And Chaka Khan - Ask Rufus,17,8,19,1.0,18,Ask Rufus,23.0,17,-1,-1,-9,1,down,1977-02-05
5902,Rufus And Chaka Khan,1977-06-11,Rufus And Chaka Khan - Ask Rufus,18,17,17,1.0,19,Ask Rufus,23.0,18,2,-1,-1,1,up,1977-02-05
5903,Rufus And Chaka Khan,1977-06-18,Rufus And Chaka Khan - Ask Rufus,19,18,31,1.0,17,Ask Rufus,23.0,19,-14,2,-1,1,down,1977-02-05
5904,Rufus And Chaka Khan,1977-06-25,Rufus And Chaka Khan - Ask Rufus,17,19,42,1.0,31,Ask Rufus,23.0,20,-11,-14,2,1,down,1977-02-05
5905,Rufus And Chaka Khan,1977-07-02,Rufus And Chaka Khan - Ask Rufus,31,17,38,1.0,42,Ask Rufus,23.0,21,4,-11,-14,1,up,1977-02-05
5906,Rufus And Chaka Khan,1977-07-09,Rufus And Chaka Khan - Ask Rufus,42,31,38,1.0,38,Ask Rufus,23.0,22,0,4,-11,0,stay,1977-02-05
5907,Rufus And Chaka Khan,1977-07-16,Rufus And Chaka Khan - Ask Rufus,38,42,51,1.0,38,Ask Rufus,23.0,23,-13,0,4,1,down,1977-02-05
5908,Bootsy's Rubber Band,1977-02-05,"Bootsy's Rubber Band - Ahh, The Name Is Bootsy, Baby",51,51,20,1.0,44,"Ahh, The Name Is Bootsy, Baby",24.0,0,24,7,0,1,up,1977-02-05
5909,Bootsy's Rubber Band,1977-02-12,"Bootsy's Rubber Band - Ahh, The Name Is Bootsy, Baby",44,51,10,1.0,20,"Ahh, The Name Is Bootsy, Baby",24.0,1,10,24,7,1,up,1977-02-05
5910,Bootsy's Rubber Band,1977-02-19,"Bootsy's Rubber Band - Ahh, The Name Is Bootsy, Baby",20,44,6,1.0,10,"Ahh, The Name Is Bootsy, Baby",24.0,2,4,10,24,1,up,1977-02-05
5911,Bootsy's Rubber Band,1977-02-26,"Bootsy's Rubber Band - Ahh, The Name Is Bootsy, Baby",10,20,3,1.0,6,"Ahh, The Name Is Bootsy, Baby",24.0,3,3,4,10,1,up,1977-02-05
5912,Bootsy's Rubber Band,1977-03-05,"Bootsy's Rubber Band - Ahh, The Name Is Bootsy, Baby",6,10,3,1.0,3,"Ahh, The Name Is Bootsy, Baby",24.0,4,0,3,4,0,stay,1977-02-05
5913,Bootsy's Rubber Band,1977-03-12,"Bootsy's Rubber Band - Ahh, The Name Is Bootsy, Baby",3,6,3,1.0,3,"Ahh, The Name Is Bootsy, Baby",24.0,5,0,0,3,0,stay,1977-02-05
5914,Bootsy's Rubber Band,1977-03-19,"Bootsy's Rubber Band - Ahh, The Name Is Bootsy, Baby",3,3,3,1.0,3,"Ahh, The Name Is Bootsy, Baby",24.0,6,0,0,0,0,stay,1977-02-05
5915,Bootsy's Rubber Band,1977-03-26,"Bootsy's Rubber Band - Ahh, The Name Is Bootsy, Baby",3,3,4,1.0,3,"Ahh, The Name Is Bootsy, Baby",24.0,7,-1,0,0,1,down,1977-02-05
5916,Bootsy's Rubber Band,1977-04-02,"Bootsy's Rubber Band - Ahh, The Name Is Bootsy, Baby",3,3,2,1.0,4,"Ahh, The Name Is Bootsy, Baby",24.0,8,2,-1,0,1,up,1977-02-05
5917,Bootsy's Rubber Band,1977-04-09,"Bootsy's Rubber Band - Ahh, The Name Is Bootsy, Baby",4,3,2,1.0,2,"Ahh, The Name Is Bootsy, Baby",24.0,9,0,2,-1,0,stay,1977-02-05
5918,Bootsy's Rubber Band,1977-04-16,"Bootsy's Rubber Band - Ahh, The Name Is Bootsy, Baby",2,4,1,1.0,2,"Ahh, The Name Is Bootsy, Baby",24.0,10,1,0,2,1,up,1977-02-05
5919,Bootsy's Rubber Band,1977-04-23,"Bootsy's Rubber Band - Ahh, The Name Is Bootsy, Baby",2,2,2,1.0,1,"Ahh, The Name Is Bootsy, Baby",24.0,11,-1,1,0,1,down,1977-02-05
5920,Bootsy's Rubber Band,1977-04-30,"Bootsy's Rubber Band - Ahh, The Name Is Bootsy, Baby",1,2,4,1.0,2,"Ahh, The Name Is Bootsy, Baby",24.0,12,-2,-1,1,1,down,1977-02-05
5921,Bootsy's Rubber Band,1977-05-07,"Bootsy's Rubber Band - Ahh, The Name Is Bootsy, Baby",2,1,5,1.0,4,"Ahh, The Name Is Bootsy, Baby",24.0,13,-1,-2,-1,1,down,1977-02-05
5922,Bootsy's Rubber Band,1977-05-14,"Bootsy's Rubber Band - Ahh, The Name Is Bootsy, Baby",4,2,6,1.0,5,"Ahh, The Name Is Bootsy, Baby",24.0,14,-1,-1,-2,1,down,1977-02-05
5923,Bootsy's Rubber Band,1977-05-21,"Bootsy's Rubber Band - Ahh, The Name Is Bootsy, Baby",5,4,6,1.0,6,"Ahh, The Name Is Bootsy, Baby",24.0,15,0,-1,-1,0,stay,1977-02-05
5924,Bootsy's Rubber Band,1977-05-28,"Bootsy's Rubber Band - Ahh, The Name Is Bootsy, Baby",6,5,9,1.0,6,"Ahh, The Name Is Bootsy, Baby",24.0,16,-3,0,-1,1,down,1977-02-05
5925,Bootsy's Rubber Band,1977-06-04,"Bootsy's Rubber Band - Ahh, The Name Is Bootsy, Baby",6,6,18,1.0,9,"Ahh, The Name Is Bootsy, Baby",24.0,17,-9,-3,0,1,down,1977-02-05
5926,Bootsy's Rubber Band,1977-06-11,"Bootsy's Rubber Band - Ahh, The Name Is Bootsy, Baby",9,6,19,1.0,18,"Ahh, The Name Is Bootsy, Baby",24.0,18,-1,-9,-3,1,down,1977-02-05
5927,Bootsy's Rubber Band,1977-06-18,"Bootsy's Rubber Band - Ahh, The Name Is Bootsy, Baby",18,9,19,1.0,19,"Ahh, The Name Is Bootsy, Baby",24.0,19,0,-1,-9,0,stay,1977-02-05
5928,Bootsy's Rubber Band,1977-06-25,"Bootsy's Rubber Band - Ahh, The Name Is Bootsy, Baby",19,18,22,1.0,19,"Ahh, The Name Is Bootsy, Baby",24.0,20,-3,0,-1,1,down,1977-02-05
5929,Bootsy's Rubber Band,1977-07-02,"Bootsy's Rubber Band - Ahh, The Name Is Bootsy, Baby",19,19,35,1.0,22,"Ahh, The Name Is Bootsy, Baby",24.0,21,-13,-3,0,1,down,1977-02-05
5930,Bootsy's Rubber Band,1977-07-09,"Bootsy's Rubber Band - Ahh, The Name Is Bootsy, Baby",22,19,35,1.0,35,"Ahh, The Name Is Bootsy, Baby",24.0,22,0,-13,-3,0,stay,1977-02-05
5931,Bootsy's Rubber Band,1977-07-16,"Bootsy's Rubber Band - Ahh, The Name Is Bootsy, Baby",35,22,35,1.0,35,"Ahh, The Name Is Bootsy, Baby",24.0,23,0,0,-13,0,stay,1977-02-05
5932,Bootsy's Rubber Band,1977-07-23,"Bootsy's Rubber Band - Ahh, The Name Is Bootsy, Baby",35,35,51,1.0,35,"Ahh, The Name Is Bootsy, Baby",24.0,24,-16,0,0,1,down,1977-02-05
5933,Enchantment,1977-02-05,Enchantment - Enchantment,51,51,41,11.0,45,Enchantment,30.0,0,4,6,0,1,up,1977-02-05
5934,Enchantment,1977-02-12,Enchantment - Enchantment,45,51,39,11.0,41,Enchantment,30.0,1,2,4,6,1,up,1977-02-05
5935,Enchantment,1977-02-19,Enchantment - Enchantment,41,45,39,11.0,39,Enchantment,30.0,2,0,2,4,0,stay,1977-02-05
5936,Enchantment,1977-02-26,Enchantment - Enchantment,39,41,31,11.0,39,Enchantment,30.0,3,8,0,2,1,up,1977-02-05
5937,Enchantment,1977-03-05,Enchantment - Enchantment,39,39,25,11.0,31,Enchantment,30.0,4,6,8,0,1,up,1977-02-05
5938,Enchantment,1977-03-12,Enchantment - Enchantment,31,39,22,11.0,25,Enchantment,30.0,5,3,6,8,1,up,1977-02-05
5939,Enchantment,1977-03-19,Enchantment - Enchantment,25,31,22,11.0,22,Enchantment,30.0,6,0,3,6,0,stay,1977-02-05
5940,Enchantment,1977-03-26,Enchantment - Enchantment,22,25,21,11.0,22,Enchantment,30.0,7,1,0,3,1,up,1977-02-05
5941,Enchantment,1977-04-02,Enchantment - Enchantment,22,22,21,11.0,21,Enchantment,30.0,8,0,1,0,0,stay,1977-02-05
5942,Enchantment,1977-04-09,Enchantment - Enchantment,21,22,26,11.0,21,Enchantment,30.0,9,-5,0,1,1,down,1977-02-05
5943,Enchantment,1977-04-16,Enchantment - Enchantment,21,21,37,11.0,26,Enchantment,30.0,10,-11,-5,0,1,down,1977-02-05
5944,Enchantment,1977-04-23,Enchantment - Enchantment,26,21,41,11.0,37,Enchantment,30.0,11,-4,-11,-5,1,down,1977-02-05
5945,Enchantment,1977-04-30,Enchantment - Enchantment,37,26,40,11.0,41,Enchantment,30.0,12,1,-4,-11,1,up,1977-02-05
5946,Enchantment,1977-07-16,Enchantment - Enchantment,41,37,30,11.0,40,Enchantment,30.0,13,10,1,-4,1,up,1977-02-05
5947,Enchantment,1977-07-23,Enchantment - Enchantment,40,41,24,11.0,30,Enchantment,30.0,14,6,10,1,1,up,1977-02-05
5948,Enchantment,1977-07-30,Enchantment - Enchantment,30,40,18,11.0,24,Enchantment,30.0,15,6,6,10,1,up,1977-02-05
5949,Enchantment,1977-08-06,Enchantment - Enchantment,24,30,17,11.0,18,Enchantment,30.0,16,1,6,6,1,up,1977-02-05
5950,Enchantment,1977-08-13,Enchantment - Enchantment,18,24,12,11.0,17,Enchantment,30.0,17,5,1,6,1,up,1977-02-05
5951,Enchantment,1977-08-20,Enchantment - Enchantment,17,18,11,11.0,12,Enchantment,30.0,18,1,5,1,1,up,1977-02-05
5952,Enchantment,1977-08-27,Enchantment - Enchantment,12,17,11,11.0,11,Enchantment,30.0,19,0,1,5,0,stay,1977-02-05
5953,Enchantment,1977-09-03,Enchantment - Enchantment,11,12,16,11.0,11,Enchantment,30.0,20,-5,0,1,1,down,1977-02-05
5954,Enchantment,1977-09-10,Enchantment - Enchantment,11,11,18,11.0,16,Enchantment,30.0,21,-2,-5,0,1,down,1977-02-05
5955,Enchantment,1977-09-17,Enchantment - Enchantment,16,11,20,11.0,18,Enchantment,30.0,22,-2,-2,-5,1,down,1977-02-05
5956,Enchantment,1977-09-24,Enchantment - Enchantment,18,16,24,11.0,20,Enchantment,30.0,23,-4,-2,-2,1,down,1977-02-05
5957,Enchantment,1977-10-01,Enchantment - Enchantment,20,18,30,11.0,24,Enchantment,30.0,24,-6,-4,-2,1,down,1977-02-05
5958,Enchantment,1977-10-08,Enchantment - Enchantment,24,20,31,11.0,30,Enchantment,30.0,25,-1,-6,-4,1,down,1977-02-05
5959,Enchantment,1977-10-15,Enchantment - Enchantment,30,24,32,11.0,31,Enchantment,30.0,26,-1,-1,-6,1,down,1977-02-05
5960,Enchantment,1977-10-22,Enchantment - Enchantment,31,30,33,11.0,32,Enchantment,30.0,27,-1,-1,-1,1,down,1977-02-05
5961,Enchantment,1977-10-29,Enchantment - Enchantment,32,31,35,11.0,33,Enchantment,30.0,28,-2,-1,-1,1,down,1977-02-05
5962,Enchantment,1977-11-05,Enchantment - Enchantment,33,32,39,11.0,35,Enchantment,30.0,29,-4,-2,-1,1,down,1977-02-05
5963,Enchantment,1977-11-12,Enchantment - Enchantment,35,33,51,11.0,39,Enchantment,30.0,30,-12,-4,-2,1,down,1977-02-05
5964,Arthur Prysock,1977-02-05,Arthur Prysock - All My Life,51,51,40,36.0,46,All My Life,5.0,0,6,5,0,1,up,1977-02-05
5965,Arthur Prysock,1977-02-12,Arthur Prysock - All My Life,46,51,36,36.0,40,All My Life,5.0,1,4,6,5,1,up,1977-02-05
5966,Arthur Prysock,1977-02-19,Arthur Prysock - All My Life,40,46,36,36.0,36,All My Life,5.0,2,0,4,6,0,stay,1977-02-05
5967,Arthur Prysock,1977-02-26,Arthur Prysock - All My Life,36,40,41,36.0,36,All My Life,5.0,3,-5,0,4,1,down,1977-02-05
5968,Arthur Prysock,1977-03-05,Arthur Prysock - All My Life,36,36,43,36.0,41,All My Life,5.0,4,-2,-5,0,1,down,1977-02-05
5969,Arthur Prysock,1977-03-12,Arthur Prysock - All My Life,41,36,51,36.0,43,All My Life,5.0,5,-8,-2,-5,1,down,1977-02-05
5970,Johnny Bristol,1977-02-05,Johnny Bristol - Bristol's Creme,51,51,43,43.0,50,Bristol's Creme,1.0,0,7,1,0,1,up,1977-02-05
5971,Johnny Bristol,1977-02-12,Johnny Bristol - Bristol's Creme,50,51,51,43.0,43,Bristol's Creme,1.0,1,-8,7,1,1,down,1977-02-05
5972,Harold Melvin And The Blue Notes,1977-02-12,Harold Melvin And The Blue Notes - Reaching For The World,51,51,19,15.0,25,Reaching For The World,10.0,0,6,26,0,1,up,1977-02-12
5973,Harold Melvin And The Blue Notes,1977-02-19,Harold Melvin And The Blue Notes - Reaching For The World,25,51,18,15.0,19,Reaching For The World,10.0,1,1,6,26,1,up,1977-02-12
5974,Harold Melvin And The Blue Notes,1977-02-26,Harold Melvin And The Blue Notes - Reaching For The World,19,25,15,15.0,18,Reaching For The World,10.0,2,3,1,6,1,up,1977-02-12
5975,Harold Melvin And The Blue Notes,1977-03-05,Harold Melvin And The Blue Notes - Reaching For The World,18,19,19,15.0,15,Reaching For The World,10.0,3,-4,3,1,1,down,1977-02-12
5976,Harold Melvin And The Blue Notes,1977-03-12,Harold Melvin And The Blue Notes - Reaching For The World,15,18,19,15.0,19,Reaching For The World,10.0,4,0,-4,3,0,stay,1977-02-12
5977,Harold Melvin And The Blue Notes,1977-03-19,Harold Melvin And The Blue Notes - Reaching For The World,19,15,23,15.0,19,Reaching For The World,10.0,5,-4,0,-4,1,down,1977-02-12
5978,Harold Melvin And The Blue Notes,1977-03-26,Harold Melvin And The Blue Notes - Reaching For The World,19,19,23,15.0,23,Reaching For The World,10.0,6,0,-4,0,0,stay,1977-02-12
5979,Harold Melvin And The Blue Notes,1977-04-02,Harold Melvin And The Blue Notes - Reaching For The World,23,19,47,15.0,23,Reaching For The World,10.0,7,-24,0,-4,1,down,1977-02-12
5980,Harold Melvin And The Blue Notes,1977-04-09,Harold Melvin And The Blue Notes - Reaching For The World,23,23,47,15.0,47,Reaching For The World,10.0,8,0,-24,0,0,stay,1977-02-12
5981,Harold Melvin And The Blue Notes,1977-04-16,Harold Melvin And The Blue Notes - Reaching For The World,47,23,46,15.0,47,Reaching For The World,10.0,9,1,0,-24,1,up,1977-02-12
5982,Harold Melvin And The Blue Notes,1977-04-23,Harold Melvin And The Blue Notes - Reaching For The World,47,47,51,15.0,46,Reaching For The World,10.0,10,-5,1,0,1,down,1977-02-12
5983,George Benson,1977-02-12,George Benson - In Flight,51,51,15,2.0,36,In Flight,27.0,0,21,15,0,1,up,1977-02-12
5984,George Benson,1977-02-19,George Benson - In Flight,36,51,5,2.0,15,In Flight,27.0,1,10,21,15,1,up,1977-02-12
5985,George Benson,1977-02-26,George Benson - In Flight,15,36,4,2.0,5,In Flight,27.0,2,1,10,21,1,up,1977-02-12
5986,George Benson,1977-03-05,George Benson - In Flight,5,15,2,2.0,4,In Flight,27.0,3,2,1,10,1,up,1977-02-12
5987,George Benson,1977-03-12,George Benson - In Flight,4,5,2,2.0,2,In Flight,27.0,4,0,2,1,0,stay,1977-02-12
5988,George Benson,1977-03-19,George Benson - In Flight,2,4,2,2.0,2,In Flight,27.0,5,0,0,2,0,stay,1977-02-12
5989,George Benson,1977-03-26,George Benson - In Flight,2,2,3,2.0,2,In Flight,27.0,6,-1,0,0,1,down,1977-02-12
5990,George Benson,1977-04-02,George Benson - In Flight,2,2,4,2.0,3,In Flight,27.0,7,-1,-1,0,1,down,1977-02-12
5991,George Benson,1977-04-09,George Benson - In Flight,3,2,3,2.0,4,In Flight,27.0,8,1,-1,-1,1,up,1977-02-12
5992,George Benson,1977-04-16,George Benson - In Flight,4,3,4,2.0,3,In Flight,27.0,9,-1,1,-1,1,down,1977-02-12
5993,George Benson,1977-04-23,George Benson - In Flight,3,4,9,2.0,4,In Flight,27.0,10,-5,-1,1,1,down,1977-02-12
5994,George Benson,1977-04-30,George Benson - In Flight,4,3,11,2.0,9,In Flight,27.0,11,-2,-5,-1,1,down,1977-02-12
5995,George Benson,1977-05-07,George Benson - In Flight,9,4,11,2.0,11,In Flight,27.0,12,0,-2,-5,0,stay,1977-02-12
5996,George Benson,1977-05-14,George Benson - In Flight,11,9,11,2.0,11,In Flight,27.0,13,0,0,-2,0,stay,1977-02-12
5997,George Benson,1977-05-21,George Benson - In Flight,11,11,22,2.0,11,In Flight,27.0,14,-11,0,0,1,down,1977-02-12
5998,George Benson,1977-05-28,George Benson - In Flight,11,11,22,2.0,22,In Flight,27.0,15,0,-11,0,0,stay,1977-02-12
5999,George Benson,1977-06-04,George Benson - In Flight,22,11,20,2.0,22,In Flight,27.0,16,2,0,-11,1,up,1977-02-12
6000,George Benson,1977-06-11,George Benson - In Flight,22,22,27,2.0,20,In Flight,27.0,17,-7,2,0,1,down,1977-02-12
6001,George Benson,1977-06-18,George Benson - In Flight,20,22,21,2.0,27,In Flight,27.0,18,6,-7,2,1,up,1977-02-12
6002,George Benson,1977-06-25,George Benson - In Flight,27,20,19,2.0,21,In Flight,27.0,19,2,6,-7,1,up,1977-02-12
6003,George Benson,1977-07-02,George Benson - In Flight,21,27,22,2.0,19,In Flight,27.0,20,-3,2,6,1,down,1977-02-12
6004,George Benson,1977-07-09,George Benson - In Flight,19,21,28,2.0,22,In Flight,27.0,21,-6,-3,2,1,down,1977-02-12
6005,George Benson,1977-07-16,George Benson - In Flight,22,19,28,2.0,28,In Flight,27.0,22,0,-6,-3,0,stay,1977-02-12
6006,George Benson,1977-07-23,George Benson - In Flight,28,22,28,2.0,28,In Flight,27.0,23,0,0,-6,0,stay,1977-02-12
6007,George Benson,1977-07-30,George Benson - In Flight,28,28,28,2.0,28,In Flight,27.0,24,0,0,0,0,stay,1977-02-12
6008,George Benson,1977-08-06,George Benson - In Flight,28,28,28,2.0,28,In Flight,27.0,25,0,0,0,0,stay,1977-02-12
6009,George Benson,1977-08-13,George Benson - In Flight,28,28,47,2.0,28,In Flight,27.0,26,-19,0,0,1,down,1977-02-12
6010,George Benson,1977-08-20,George Benson - In Flight,28,28,51,2.0,47,In Flight,27.0,27,-4,-19,0,1,down,1977-02-12
6011,Donald Byrd,1977-02-12,Donald Byrd - Caricatures,51,51,35,12.0,45,Caricatures,11.0,0,10,6,0,1,up,1977-02-12
6012,Donald Byrd,1977-02-19,Donald Byrd - Caricatures,45,51,25,12.0,35,Caricatures,11.0,1,10,10,6,1,up,1977-02-12
6013,Donald Byrd,1977-02-26,Donald Byrd - Caricatures,35,45,20,12.0,25,Caricatures,11.0,2,5,10,10,1,up,1977-02-12
6014,Donald Byrd,1977-03-05,Donald Byrd - Caricatures,25,35,17,12.0,20,Caricatures,11.0,3,3,5,10,1,up,1977-02-12
6015,Donald Byrd,1977-03-12,Donald Byrd - Caricatures,20,25,16,12.0,17,Caricatures,11.0,4,1,3,5,1,up,1977-02-12
6016,Donald Byrd,1977-03-19,Donald Byrd - Caricatures,17,20,12,12.0,16,Caricatures,11.0,5,4,1,3,1,up,1977-02-12
6017,Donald Byrd,1977-03-26,Donald Byrd - Caricatures,16,17,12,12.0,12,Caricatures,11.0,6,0,4,1,0,stay,1977-02-12
6018,Donald Byrd,1977-04-02,Donald Byrd - Caricatures,12,16,45,12.0,12,Caricatures,11.0,7,-33,0,4,1,down,1977-02-12
6019,Donald Byrd,1977-04-09,Donald Byrd - Caricatures,12,12,44,12.0,45,Caricatures,11.0,8,1,-33,0,1,up,1977-02-12
6020,Donald Byrd,1977-04-16,Donald Byrd - Caricatures,45,12,45,12.0,44,Caricatures,11.0,9,-1,1,-33,1,down,1977-02-12
6021,Donald Byrd,1977-04-23,Donald Byrd - Caricatures,44,45,45,12.0,45,Caricatures,11.0,10,0,-1,1,0,stay,1977-02-12
6022,Donald Byrd,1977-04-30,Donald Byrd - Caricatures,45,44,51,12.0,45,Caricatures,11.0,11,-6,0,-1,1,down,1977-02-12
6023,Santana,1977-02-12,Santana - Festival,51,51,33,29.0,48,Festival,5.0,0,15,3,0,1,up,1977-02-12
6024,Santana,1977-02-19,Santana - Festival,48,51,29,29.0,33,Festival,5.0,1,4,15,3,1,up,1977-02-12
6025,Santana,1977-02-26,Santana - Festival,33,48,39,29.0,29,Festival,5.0,2,-10,4,15,1,down,1977-02-12
6026,Santana,1977-03-05,Santana - Festival,29,33,39,29.0,39,Festival,5.0,3,0,-10,4,0,stay,1977-02-12
6027,Santana,1977-03-12,Santana - Festival,39,29,41,29.0,39,Festival,5.0,4,-2,0,-10,1,down,1977-02-12
6028,Santana,1977-03-19,Santana - Festival,39,39,51,29.0,41,Festival,5.0,5,-10,-2,0,1,down,1977-02-12
6029,George Benson,1977-02-12,George Benson - George Benson In Concert-Carnegie Hall,51,51,48,43.0,50,George Benson In Concert-Carnegie Hall,3.0,0,2,1,0,1,up,1977-02-12
6030,George Benson,1977-02-19,George Benson - George Benson In Concert-Carnegie Hall,50,51,43,43.0,48,George Benson In Concert-Carnegie Hall,3.0,1,5,2,1,1,up,1977-02-12
6031,George Benson,1977-02-26,George Benson - George Benson In Concert-Carnegie Hall,48,50,43,43.0,43,George Benson In Concert-Carnegie Hall,3.0,2,0,5,2,0,stay,1977-02-12
6032,George Benson,1977-03-05,George Benson - George Benson In Concert-Carnegie Hall,43,48,51,43.0,43,George Benson In Concert-Carnegie Hall,3.0,3,-8,0,5,1,down,1977-02-12
6033,Diana Ross,1977-02-19,Diana Ross - An Evening With Diana Ross,51,51,20,14.0,40,An Evening With Diana Ross,6.0,0,20,11,0,1,up,1977-02-19
6034,Diana Ross,1977-02-26,Diana Ross - An Evening With Diana Ross,40,51,16,14.0,20,An Evening With Diana Ross,6.0,1,4,20,11,1,up,1977-02-19
6035,Diana Ross,1977-03-05,Diana Ross - An Evening With Diana Ross,20,40,14,14.0,16,An Evening With Diana Ross,6.0,2,2,4,20,1,up,1977-02-19
6036,Diana Ross,1977-03-12,Diana Ross - An Evening With Diana Ross,16,20,14,14.0,14,An Evening With Diana Ross,6.0,3,0,2,4,0,stay,1977-02-19
6037,Diana Ross,1977-03-19,Diana Ross - An Evening With Diana Ross,14,16,14,14.0,14,An Evening With Diana Ross,6.0,4,0,0,2,0,stay,1977-02-19
6038,Diana Ross,1977-03-26,Diana Ross - An Evening With Diana Ross,14,14,24,14.0,14,An Evening With Diana Ross,6.0,5,-10,0,0,1,down,1977-02-19
6039,Diana Ross,1977-04-02,Diana Ross - An Evening With Diana Ross,14,14,51,14.0,24,An Evening With Diana Ross,6.0,6,-27,-10,0,1,down,1977-02-19
6040,The Edwin Hawkins' Singers,1977-02-19,The Edwin Hawkins' Singers - Wonderful,51,51,41,40.0,44,Wonderful,5.0,0,3,7,0,1,up,1977-02-19
6041,The Edwin Hawkins' Singers,1977-02-26,The Edwin Hawkins' Singers - Wonderful,44,51,40,40.0,41,Wonderful,5.0,1,1,3,7,1,up,1977-02-19
6042,The Edwin Hawkins' Singers,1977-03-05,The Edwin Hawkins' Singers - Wonderful,41,44,40,40.0,40,Wonderful,5.0,2,0,1,3,0,stay,1977-02-19
6043,The Edwin Hawkins' Singers,1977-03-12,The Edwin Hawkins' Singers - Wonderful,40,41,44,40.0,40,Wonderful,5.0,3,-4,0,1,1,down,1977-02-19
6044,The Edwin Hawkins' Singers,1977-03-19,The Edwin Hawkins' Singers - Wonderful,40,40,45,40.0,44,Wonderful,5.0,4,-1,-4,0,1,down,1977-02-19
6045,The Edwin Hawkins' Singers,1977-03-26,The Edwin Hawkins' Singers - Wonderful,44,40,51,40.0,45,Wonderful,5.0,5,-6,-1,-4,1,down,1977-02-19
6046,B.B. King,1977-02-19,B.B. King - King Size,51,51,37,34.0,45,King Size,5.0,0,8,6,0,1,up,1977-02-19
6047,B.B. King,1977-02-26,B.B. King - King Size,45,51,35,34.0,37,King Size,5.0,1,2,8,6,1,up,1977-02-19
6048,B.B. King,1977-03-05,B.B. King - King Size,37,45,34,34.0,35,King Size,5.0,2,1,2,8,1,up,1977-02-19
6049,B.B. King,1977-03-12,B.B. King - King Size,35,37,40,34.0,34,King Size,5.0,3,-6,1,2,1,down,1977-02-19
6050,B.B. King,1977-03-19,B.B. King - King Size,34,35,42,34.0,40,King Size,5.0,4,-2,-6,1,1,down,1977-02-19
6051,B.B. King,1977-03-26,B.B. King - King Size,40,34,51,34.0,42,King Size,5.0,5,-9,-2,-6,1,down,1977-02-19
6052,Herbie Mann,1977-02-19,Herbie Mann - Bird In A Silver Cage,51,51,46,46.0,50,Bird In A Silver Cage,1.0,0,4,1,0,1,up,1977-02-19
6053,Herbie Mann,1977-02-26,Herbie Mann - Bird In A Silver Cage,50,51,51,46.0,46,Bird In A Silver Cage,1.0,1,-5,4,1,1,down,1977-02-19
6054,Quincy Jones,1977-02-26,Quincy Jones - Roots,51,51,14,6.0,30,Roots,10.0,0,16,21,0,1,up,1977-02-26
6055,Quincy Jones,1977-03-05,Quincy Jones - Roots,30,51,9,6.0,14,Roots,10.0,1,5,16,21,1,up,1977-02-26
6056,Quincy Jones,1977-03-12,Quincy Jones - Roots,14,30,7,6.0,9,Roots,10.0,2,2,5,16,1,up,1977-02-26
6057,Quincy Jones,1977-03-19,Quincy Jones - Roots,9,14,6,6.0,7,Roots,10.0,3,1,2,5,1,up,1977-02-26
6058,Quincy Jones,1977-03-26,Quincy Jones - Roots,7,9,6,6.0,6,Roots,10.0,4,0,1,2,0,stay,1977-02-26
6059,Quincy Jones,1977-04-02,Quincy Jones - Roots,6,7,8,6.0,6,Roots,10.0,5,-2,0,1,1,down,1977-02-26
6060,Quincy Jones,1977-04-09,Quincy Jones - Roots,6,6,16,6.0,8,Roots,10.0,6,-8,-2,0,1,down,1977-02-26
6061,Quincy Jones,1977-04-16,Quincy Jones - Roots,8,6,18,6.0,16,Roots,10.0,7,-2,-8,-2,1,down,1977-02-26
6062,Quincy Jones,1977-04-23,Quincy Jones - Roots,16,8,23,6.0,18,Roots,10.0,8,-5,-2,-8,1,down,1977-02-26
6063,Quincy Jones,1977-04-30,Quincy Jones - Roots,18,16,47,6.0,23,Roots,10.0,9,-24,-5,-2,1,down,1977-02-26
6064,Quincy Jones,1977-05-07,Quincy Jones - Roots,23,18,51,6.0,47,Roots,10.0,10,-4,-24,-5,1,down,1977-02-26
6065,Issac Hayes And Dionne Warwick,1977-02-26,Issac Hayes And Dionne Warwick - A Man And A Woman,51,51,29,20.0,40,A Man And A Woman,7.0,0,11,11,0,1,up,1977-02-26
6066,Issac Hayes And Dionne Warwick,1977-03-05,Issac Hayes And Dionne Warwick - A Man And A Woman,40,51,26,20.0,29,A Man And A Woman,7.0,1,3,11,11,1,up,1977-02-26
6067,Issac Hayes And Dionne Warwick,1977-03-12,Issac Hayes And Dionne Warwick - A Man And A Woman,29,40,23,20.0,26,A Man And A Woman,7.0,2,3,3,11,1,up,1977-02-26
6068,Issac Hayes And Dionne Warwick,1977-03-19,Issac Hayes And Dionne Warwick - A Man And A Woman,26,29,20,20.0,23,A Man And A Woman,7.0,3,3,3,3,1,up,1977-02-26
6069,Issac Hayes And Dionne Warwick,1977-03-26,Issac Hayes And Dionne Warwick - A Man And A Woman,23,26,30,20.0,20,A Man And A Woman,7.0,4,-10,3,3,1,down,1977-02-26
6070,Issac Hayes And Dionne Warwick,1977-04-02,Issac Hayes And Dionne Warwick - A Man And A Woman,20,23,30,20.0,30,A Man And A Woman,7.0,5,0,-10,3,0,stay,1977-02-26
6071,Issac Hayes And Dionne Warwick,1977-04-09,Issac Hayes And Dionne Warwick - A Man And A Woman,30,20,30,20.0,30,A Man And A Woman,7.0,6,0,0,-10,0,stay,1977-02-26
6072,Issac Hayes And Dionne Warwick,1977-04-16,Issac Hayes And Dionne Warwick - A Man And A Woman,30,30,51,20.0,30,A Man And A Woman,7.0,7,-21,0,0,1,down,1977-02-26
6073,Smokey Robinson,1977-02-26,Smokey Robinson - Deep In My Soul,51,51,34,16.0,42,Deep In My Soul,12.0,0,8,9,0,1,up,1977-02-26
6074,Smokey Robinson,1977-03-05,Smokey Robinson - Deep In My Soul,42,51,30,16.0,34,Deep In My Soul,12.0,1,4,8,9,1,up,1977-02-26
6075,Smokey Robinson,1977-03-12,Smokey Robinson - Deep In My Soul,34,42,24,16.0,30,Deep In My Soul,12.0,2,6,4,8,1,up,1977-02-26
6076,Smokey Robinson,1977-03-19,Smokey Robinson - Deep In My Soul,30,34,21,16.0,24,Deep In My Soul,12.0,3,3,6,4,1,up,1977-02-26
6077,Smokey Robinson,1977-03-26,Smokey Robinson - Deep In My Soul,24,30,19,16.0,21,Deep In My Soul,12.0,4,2,3,6,1,up,1977-02-26
6078,Smokey Robinson,1977-04-02,Smokey Robinson - Deep In My Soul,21,24,18,16.0,19,Deep In My Soul,12.0,5,1,2,3,1,up,1977-02-26
6079,Smokey Robinson,1977-04-09,Smokey Robinson - Deep In My Soul,19,21,17,16.0,18,Deep In My Soul,12.0,6,1,1,2,1,up,1977-02-26
6080,Smokey Robinson,1977-04-16,Smokey Robinson - Deep In My Soul,18,19,16,16.0,17,Deep In My Soul,12.0,7,1,1,1,1,up,1977-02-26
6081,Smokey Robinson,1977-04-23,Smokey Robinson - Deep In My Soul,17,18,21,16.0,16,Deep In My Soul,12.0,8,-5,1,1,1,down,1977-02-26
6082,Smokey Robinson,1977-04-30,Smokey Robinson - Deep In My Soul,16,17,23,16.0,21,Deep In My Soul,12.0,9,-2,-5,1,1,down,1977-02-26
6083,Smokey Robinson,1977-05-07,Smokey Robinson - Deep In My Soul,21,16,38,16.0,23,Deep In My Soul,12.0,10,-15,-2,-5,1,down,1977-02-26
6084,Smokey Robinson,1977-05-14,Smokey Robinson - Deep In My Soul,23,21,38,16.0,38,Deep In My Soul,12.0,11,0,-15,-2,0,stay,1977-02-26
6085,Smokey Robinson,1977-05-21,Smokey Robinson - Deep In My Soul,38,23,51,16.0,38,Deep In My Soul,12.0,12,-13,0,-15,1,down,1977-02-26
6086,Natalie Cole,1977-02-26,Natalie Cole - Unpredictable,51,51,30,1.0,45,Unpredictable,27.0,0,15,6,0,1,up,1977-02-26
6087,Natalie Cole,1977-03-05,Natalie Cole - Unpredictable,45,51,8,1.0,30,Unpredictable,27.0,1,22,15,6,1,up,1977-02-26
6088,Natalie Cole,1977-03-12,Natalie Cole - Unpredictable,30,45,6,1.0,8,Unpredictable,27.0,2,2,22,15,1,up,1977-02-26
6089,Natalie Cole,1977-03-19,Natalie Cole - Unpredictable,8,30,4,1.0,6,Unpredictable,27.0,3,2,2,22,1,up,1977-02-26
6090,Natalie Cole,1977-03-26,Natalie Cole - Unpredictable,6,8,1,1.0,4,Unpredictable,27.0,4,3,2,2,1,up,1977-02-26
6091,Natalie Cole,1977-04-02,Natalie Cole - Unpredictable,4,6,1,1.0,1,Unpredictable,27.0,5,0,3,2,0,stay,1977-02-26
6092,Natalie Cole,1977-04-09,Natalie Cole - Unpredictable,1,4,1,1.0,1,Unpredictable,27.0,6,0,0,3,0,stay,1977-02-26
6093,Natalie Cole,1977-04-16,Natalie Cole - Unpredictable,1,1,2,1.0,1,Unpredictable,27.0,7,-1,0,0,1,down,1977-02-26
6094,Natalie Cole,1977-04-23,Natalie Cole - Unpredictable,1,1,6,1.0,2,Unpredictable,27.0,8,-4,-1,0,1,down,1977-02-26
6095,Natalie Cole,1977-04-30,Natalie Cole - Unpredictable,2,1,6,1.0,6,Unpredictable,27.0,9,0,-4,-1,0,stay,1977-02-26
6096,Natalie Cole,1977-05-07,Natalie Cole - Unpredictable,6,2,6,1.0,6,Unpredictable,27.0,10,0,0,-4,0,stay,1977-02-26
6097,Natalie Cole,1977-05-14,Natalie Cole - Unpredictable,6,6,5,1.0,6,Unpredictable,27.0,11,1,0,0,1,up,1977-02-26
6098,Natalie Cole,1977-05-21,Natalie Cole - Unpredictable,6,6,5,1.0,5,Unpredictable,27.0,12,0,1,0,0,stay,1977-02-26
6099,Natalie Cole,1977-05-28,Natalie Cole - Unpredictable,5,6,8,1.0,5,Unpredictable,27.0,13,-3,0,1,1,down,1977-02-26
6100,Natalie Cole,1977-06-04,Natalie Cole - Unpredictable,5,5,10,1.0,8,Unpredictable,27.0,14,-2,-3,0,1,down,1977-02-26
6101,Natalie Cole,1977-06-11,Natalie Cole - Unpredictable,8,5,10,1.0,10,Unpredictable,27.0,15,0,-2,-3,0,stay,1977-02-26
6102,Natalie Cole,1977-06-18,Natalie Cole - Unpredictable,10,8,12,1.0,10,Unpredictable,27.0,16,-2,0,-2,1,down,1977-02-26
6103,Natalie Cole,1977-06-25,Natalie Cole - Unpredictable,10,10,12,1.0,12,Unpredictable,27.0,17,0,-2,0,0,stay,1977-02-26
6104,Natalie Cole,1977-07-02,Natalie Cole - Unpredictable,12,10,14,1.0,12,Unpredictable,27.0,18,-2,0,-2,1,down,1977-02-26
6105,Natalie Cole,1977-07-09,Natalie Cole - Unpredictable,12,12,15,1.0,14,Unpredictable,27.0,19,-1,-2,0,1,down,1977-02-26
6106,Natalie Cole,1977-07-16,Natalie Cole - Unpredictable,14,12,15,1.0,15,Unpredictable,27.0,20,0,-1,-2,0,stay,1977-02-26
6107,Natalie Cole,1977-07-23,Natalie Cole - Unpredictable,15,14,16,1.0,15,Unpredictable,27.0,21,-1,0,-1,1,down,1977-02-26
6108,Natalie Cole,1977-07-30,Natalie Cole - Unpredictable,15,15,16,1.0,16,Unpredictable,27.0,22,0,-1,0,0,stay,1977-02-26
6109,Natalie Cole,1977-08-06,Natalie Cole - Unpredictable,16,15,21,1.0,16,Unpredictable,27.0,23,-5,0,-1,1,down,1977-02-26
6110,Natalie Cole,1977-08-13,Natalie Cole - Unpredictable,16,16,38,1.0,21,Unpredictable,27.0,24,-17,-5,0,1,down,1977-02-26
6111,Natalie Cole,1977-08-20,Natalie Cole - Unpredictable,21,16,38,1.0,38,Unpredictable,27.0,25,0,-17,-5,0,stay,1977-02-26
6112,Natalie Cole,1977-08-27,Natalie Cole - Unpredictable,38,21,49,1.0,38,Unpredictable,27.0,26,-11,0,-17,1,down,1977-02-26
6113,Natalie Cole,1977-09-03,Natalie Cole - Unpredictable,38,38,51,1.0,49,Unpredictable,27.0,27,-2,-11,0,1,down,1977-02-26
6114,The Manhattans,1977-02-26,The Manhattans - It Feels So Good,51,51,33,12.0,48,It Feels So Good,23.0,0,15,3,0,1,up,1977-02-26
6115,The Manhattans,1977-03-05,The Manhattans - It Feels So Good,48,51,27,12.0,33,It Feels So Good,23.0,1,6,15,3,1,up,1977-02-26
6116,The Manhattans,1977-03-12,The Manhattans - It Feels So Good,33,48,26,12.0,27,It Feels So Good,23.0,2,1,6,15,1,up,1977-02-26
6117,The Manhattans,1977-03-19,The Manhattans - It Feels So Good,27,33,18,12.0,26,It Feels So Good,23.0,3,8,1,6,1,up,1977-02-26
6118,The Manhattans,1977-03-26,The Manhattans - It Feels So Good,26,27,14,12.0,18,It Feels So Good,23.0,4,4,8,1,1,up,1977-02-26
6119,The Manhattans,1977-04-02,The Manhattans - It Feels So Good,18,26,13,12.0,14,It Feels So Good,23.0,5,1,4,8,1,up,1977-02-26
6120,The Manhattans,1977-04-09,The Manhattans - It Feels So Good,14,18,12,12.0,13,It Feels So Good,23.0,6,1,1,4,1,up,1977-02-26
6121,The Manhattans,1977-04-16,The Manhattans - It Feels So Good,13,14,15,12.0,12,It Feels So Good,23.0,7,-3,1,1,1,down,1977-02-26
6122,The Manhattans,1977-04-23,The Manhattans - It Feels So Good,12,13,15,12.0,15,It Feels So Good,23.0,8,0,-3,1,0,stay,1977-02-26
6123,The Manhattans,1977-04-30,The Manhattans - It Feels So Good,15,12,17,12.0,15,It Feels So Good,23.0,9,-2,0,-3,1,down,1977-02-26
6124,The Manhattans,1977-05-07,The Manhattans - It Feels So Good,15,15,18,12.0,17,It Feels So Good,23.0,10,-1,-2,0,1,down,1977-02-26
6125,The Manhattans,1977-05-14,The Manhattans - It Feels So Good,17,15,23,12.0,18,It Feels So Good,23.0,11,-5,-1,-2,1,down,1977-02-26
6126,The Manhattans,1977-05-21,The Manhattans - It Feels So Good,18,17,23,12.0,23,It Feels So Good,23.0,12,0,-5,-1,0,stay,1977-02-26
6127,The Manhattans,1977-05-28,The Manhattans - It Feels So Good,23,18,19,12.0,23,It Feels So Good,23.0,13,4,0,-5,1,up,1977-02-26
6128,The Manhattans,1977-06-04,The Manhattans - It Feels So Good,23,23,17,12.0,19,It Feels So Good,23.0,14,2,4,0,1,up,1977-02-26
6129,The Manhattans,1977-06-11,The Manhattans - It Feels So Good,19,23,18,12.0,17,It Feels So Good,23.0,15,-1,2,4,1,down,1977-02-26
6130,The Manhattans,1977-06-18,The Manhattans - It Feels So Good,17,19,18,12.0,18,It Feels So Good,23.0,16,0,-1,2,0,stay,1977-02-26
6131,The Manhattans,1977-06-25,The Manhattans - It Feels So Good,18,17,21,12.0,18,It Feels So Good,23.0,17,-3,0,-1,1,down,1977-02-26
6132,The Manhattans,1977-07-02,The Manhattans - It Feels So Good,18,18,21,12.0,21,It Feels So Good,23.0,18,0,-3,0,0,stay,1977-02-26
6133,The Manhattans,1977-07-09,The Manhattans - It Feels So Good,21,18,27,12.0,21,It Feels So Good,23.0,19,-6,0,-3,1,down,1977-02-26
6134,The Manhattans,1977-07-16,The Manhattans - It Feels So Good,21,21,27,12.0,27,It Feels So Good,23.0,20,0,-6,0,0,stay,1977-02-26
6135,The Manhattans,1977-07-23,The Manhattans - It Feels So Good,27,21,29,12.0,27,It Feels So Good,23.0,21,-2,0,-6,1,down,1977-02-26
6136,The Manhattans,1977-07-30,The Manhattans - It Feels So Good,27,27,29,12.0,29,It Feels So Good,23.0,22,0,-2,0,0,stay,1977-02-26
6137,The Manhattans,1977-08-06,The Manhattans - It Feels So Good,29,27,51,12.0,29,It Feels So Good,23.0,23,-22,0,-2,1,down,1977-02-26
6138,Jerry Butler,1977-03-05,Jerry Butler - Suite For The Single Girl,51,51,41,22.0,49,Suite For The Single Girl,14.0,0,8,2,0,1,up,1977-03-05
6139,Jerry Butler,1977-03-12,Jerry Butler - Suite For The Single Girl,49,51,39,22.0,41,Suite For The Single Girl,14.0,1,2,8,2,1,up,1977-03-05
6140,Jerry Butler,1977-03-19,Jerry Butler - Suite For The Single Girl,41,49,36,22.0,39,Suite For The Single Girl,14.0,2,3,2,8,1,up,1977-03-05
6141,Jerry Butler,1977-03-26,Jerry Butler - Suite For The Single Girl,39,41,33,22.0,36,Suite For The Single Girl,14.0,3,3,3,2,1,up,1977-03-05
6142,Jerry Butler,1977-04-02,Jerry Butler - Suite For The Single Girl,36,39,29,22.0,33,Suite For The Single Girl,14.0,4,4,3,3,1,up,1977-03-05
6143,Jerry Butler,1977-04-09,Jerry Butler - Suite For The Single Girl,33,36,28,22.0,29,Suite For The Single Girl,14.0,5,1,4,3,1,up,1977-03-05
6144,Jerry Butler,1977-04-16,Jerry Butler - Suite For The Single Girl,29,33,24,22.0,28,Suite For The Single Girl,14.0,6,4,1,4,1,up,1977-03-05
6145,Jerry Butler,1977-04-23,Jerry Butler - Suite For The Single Girl,28,29,25,22.0,24,Suite For The Single Girl,14.0,7,-1,4,1,1,down,1977-03-05
6146,Jerry Butler,1977-04-30,Jerry Butler - Suite For The Single Girl,24,28,22,22.0,25,Suite For The Single Girl,14.0,8,3,-1,4,1,up,1977-03-05
6147,Jerry Butler,1977-05-07,Jerry Butler - Suite For The Single Girl,25,24,22,22.0,22,Suite For The Single Girl,14.0,9,0,3,-1,0,stay,1977-03-05
6148,Jerry Butler,1977-05-14,Jerry Butler - Suite For The Single Girl,22,25,31,22.0,22,Suite For The Single Girl,14.0,10,-9,0,3,1,down,1977-03-05
6149,Jerry Butler,1977-05-21,Jerry Butler - Suite For The Single Girl,22,22,41,22.0,31,Suite For The Single Girl,14.0,11,-10,-9,0,1,down,1977-03-05
6150,Jerry Butler,1977-05-28,Jerry Butler - Suite For The Single Girl,31,22,41,22.0,41,Suite For The Single Girl,14.0,12,0,-10,-9,0,stay,1977-03-05
6151,Jerry Butler,1977-06-04,Jerry Butler - Suite For The Single Girl,41,31,44,22.0,41,Suite For The Single Girl,14.0,13,-3,0,-10,1,down,1977-03-05
6152,Jerry Butler,1977-06-11,Jerry Butler - Suite For The Single Girl,41,41,51,22.0,44,Suite For The Single Girl,14.0,14,-7,-3,0,1,down,1977-03-05
6153,Andrae Crouch,1977-03-05,Andrae Crouch - This Is Another Day,51,51,46,41.0,50,This Is Another Day,4.0,0,4,1,0,1,up,1977-03-05
6154,Andrae Crouch,1977-03-12,Andrae Crouch - This Is Another Day,50,51,42,41.0,46,This Is Another Day,4.0,1,4,4,1,1,up,1977-03-05
6155,Andrae Crouch,1977-03-19,Andrae Crouch - This Is Another Day,46,50,41,41.0,42,This Is Another Day,4.0,2,1,4,4,1,up,1977-03-05
6156,Andrae Crouch,1977-03-26,Andrae Crouch - This Is Another Day,42,46,41,41.0,41,This Is Another Day,4.0,3,0,1,4,0,stay,1977-03-05
6157,Andrae Crouch,1977-04-02,Andrae Crouch - This Is Another Day,41,42,51,41.0,41,This Is Another Day,4.0,4,-10,0,1,1,down,1977-03-05
6158,Johnnie Taylor,1977-03-12,Johnnie Taylor - Rated Extraordinaire,51,51,25,6.0,42,Rated Extraordinaire,14.0,0,17,9,0,1,up,1977-03-12
6159,Johnnie Taylor,1977-03-19,Johnnie Taylor - Rated Extraordinaire,42,51,17,6.0,25,Rated Extraordinaire,14.0,1,8,17,9,1,up,1977-03-12
6160,Johnnie Taylor,1977-03-26,Johnnie Taylor - Rated Extraordinaire,25,42,8,6.0,17,Rated Extraordinaire,14.0,2,9,8,17,1,up,1977-03-12
6161,Johnnie Taylor,1977-04-02,Johnnie Taylor - Rated Extraordinaire,17,25,6,6.0,8,Rated Extraordinaire,14.0,3,2,9,8,1,up,1977-03-12
6162,Johnnie Taylor,1977-04-09,Johnnie Taylor - Rated Extraordinaire,8,17,6,6.0,6,Rated Extraordinaire,14.0,4,0,2,9,0,stay,1977-03-12
6163,Johnnie Taylor,1977-04-16,Johnnie Taylor - Rated Extraordinaire,6,8,9,6.0,6,Rated Extraordinaire,14.0,5,-3,0,2,1,down,1977-03-12
6164,Johnnie Taylor,1977-04-23,Johnnie Taylor - Rated Extraordinaire,6,6,11,6.0,9,Rated Extraordinaire,14.0,6,-2,-3,0,1,down,1977-03-12
6165,Johnnie Taylor,1977-04-30,Johnnie Taylor - Rated Extraordinaire,9,6,20,6.0,11,Rated Extraordinaire,14.0,7,-9,-2,-3,1,down,1977-03-12
6166,Johnnie Taylor,1977-05-07,Johnnie Taylor - Rated Extraordinaire,11,9,30,6.0,20,Rated Extraordinaire,14.0,8,-10,-9,-2,1,down,1977-03-12
6167,Johnnie Taylor,1977-05-14,Johnnie Taylor - Rated Extraordinaire,20,11,29,6.0,30,Rated Extraordinaire,14.0,9,1,-10,-9,1,up,1977-03-12
6168,Johnnie Taylor,1977-05-21,Johnnie Taylor - Rated Extraordinaire,30,20,31,6.0,29,Rated Extraordinaire,14.0,10,-2,1,-10,1,down,1977-03-12
6169,Johnnie Taylor,1977-05-28,Johnnie Taylor - Rated Extraordinaire,29,30,40,6.0,31,Rated Extraordinaire,14.0,11,-9,-2,1,1,down,1977-03-12
6170,Johnnie Taylor,1977-06-04,Johnnie Taylor - Rated Extraordinaire,31,29,40,6.0,40,Rated Extraordinaire,14.0,12,0,-9,-2,0,stay,1977-03-12
6171,Johnnie Taylor,1977-06-11,Johnnie Taylor - Rated Extraordinaire,40,31,38,6.0,40,Rated Extraordinaire,14.0,13,2,0,-9,1,up,1977-03-12
6172,Johnnie Taylor,1977-06-18,Johnnie Taylor - Rated Extraordinaire,40,40,51,6.0,38,Rated Extraordinaire,14.0,14,-13,2,0,1,down,1977-03-12
6173,Maze Featuring Frankie Beverly,1977-03-12,Maze Featuring Frankie Beverly - Maze Featuring Frankie Beverly,51,51,47,6.0,50,Maze Featuring Frankie Beverly,38.0,0,3,1,0,1,up,1977-03-12
6174,Maze Featuring Frankie Beverly,1977-03-19,Maze Featuring Frankie Beverly - Maze Featuring Frankie Beverly,50,51,47,6.0,47,Maze Featuring Frankie Beverly,38.0,1,0,3,1,0,stay,1977-03-12
6175,Maze Featuring Frankie Beverly,1977-03-26,Maze Featuring Frankie Beverly - Maze Featuring Frankie Beverly,47,50,50,6.0,47,Maze Featuring Frankie Beverly,38.0,2,-3,0,3,1,down,1977-03-12
6176,Maze Featuring Frankie Beverly,1977-04-09,Maze Featuring Frankie Beverly - Maze Featuring Frankie Beverly,47,47,46,6.0,50,Maze Featuring Frankie Beverly,38.0,3,4,-3,0,1,up,1977-03-12
6177,Maze Featuring Frankie Beverly,1977-04-16,Maze Featuring Frankie Beverly - Maze Featuring Frankie Beverly,50,47,43,6.0,46,Maze Featuring Frankie Beverly,38.0,4,3,4,-3,1,up,1977-03-12
6178,Maze Featuring Frankie Beverly,1977-04-23,Maze Featuring Frankie Beverly - Maze Featuring Frankie Beverly,46,50,35,6.0,43,Maze Featuring Frankie Beverly,38.0,5,8,3,4,1,up,1977-03-12
6179,Maze Featuring Frankie Beverly,1977-04-30,Maze Featuring Frankie Beverly - Maze Featuring Frankie Beverly,43,46,29,6.0,35,Maze Featuring Frankie Beverly,38.0,6,6,8,3,1,up,1977-03-12
6180,Maze Featuring Frankie Beverly,1977-05-07,Maze Featuring Frankie Beverly - Maze Featuring Frankie Beverly,35,43,19,6.0,29,Maze Featuring Frankie Beverly,38.0,7,10,6,8,1,up,1977-03-12
6181,Maze Featuring Frankie Beverly,1977-05-14,Maze Featuring Frankie Beverly - Maze Featuring Frankie Beverly,29,35,15,6.0,19,Maze Featuring Frankie Beverly,38.0,8,4,10,6,1,up,1977-03-12
6182,Maze Featuring Frankie Beverly,1977-05-21,Maze Featuring Frankie Beverly - Maze Featuring Frankie Beverly,19,29,15,6.0,15,Maze Featuring Frankie Beverly,38.0,9,0,4,10,0,stay,1977-03-12
6183,Maze Featuring Frankie Beverly,1977-05-28,Maze Featuring Frankie Beverly - Maze Featuring Frankie Beverly,15,19,14,6.0,15,Maze Featuring Frankie Beverly,38.0,10,1,0,4,1,up,1977-03-12
6184,Maze Featuring Frankie Beverly,1977-06-04,Maze Featuring Frankie Beverly - Maze Featuring Frankie Beverly,15,15,11,6.0,14,Maze Featuring Frankie Beverly,38.0,11,3,1,0,1,up,1977-03-12
6185,Maze Featuring Frankie Beverly,1977-06-11,Maze Featuring Frankie Beverly - Maze Featuring Frankie Beverly,14,15,11,6.0,11,Maze Featuring Frankie Beverly,38.0,12,0,3,1,0,stay,1977-03-12
6186,Maze Featuring Frankie Beverly,1977-06-18,Maze Featuring Frankie Beverly - Maze Featuring Frankie Beverly,11,14,11,6.0,11,Maze Featuring Frankie Beverly,38.0,13,0,0,3,0,stay,1977-03-12
6187,Maze Featuring Frankie Beverly,1977-06-25,Maze Featuring Frankie Beverly - Maze Featuring Frankie Beverly,11,11,13,6.0,11,Maze Featuring Frankie Beverly,38.0,14,-2,0,0,1,down,1977-03-12
6188,Maze Featuring Frankie Beverly,1977-07-02,Maze Featuring Frankie Beverly - Maze Featuring Frankie Beverly,11,11,13,6.0,13,Maze Featuring Frankie Beverly,38.0,15,0,-2,0,0,stay,1977-03-12
6189,Maze Featuring Frankie Beverly,1977-07-09,Maze Featuring Frankie Beverly - Maze Featuring Frankie Beverly,13,11,13,6.0,13,Maze Featuring Frankie Beverly,38.0,16,0,0,-2,0,stay,1977-03-12
6190,Maze Featuring Frankie Beverly,1977-07-16,Maze Featuring Frankie Beverly - Maze Featuring Frankie Beverly,13,13,11,6.0,13,Maze Featuring Frankie Beverly,38.0,17,2,0,0,1,up,1977-03-12
6191,Maze Featuring Frankie Beverly,1977-07-23,Maze Featuring Frankie Beverly - Maze Featuring Frankie Beverly,13,13,10,6.0,11,Maze Featuring Frankie Beverly,38.0,18,1,2,0,1,up,1977-03-12
6192,Maze Featuring Frankie Beverly,1977-07-30,Maze Featuring Frankie Beverly - Maze Featuring Frankie Beverly,11,13,9,6.0,10,Maze Featuring Frankie Beverly,38.0,19,1,1,2,1,up,1977-03-12
6193,Maze Featuring Frankie Beverly,1977-08-06,Maze Featuring Frankie Beverly - Maze Featuring Frankie Beverly,10,11,9,6.0,9,Maze Featuring Frankie Beverly,38.0,20,0,1,1,0,stay,1977-03-12
6194,Maze Featuring Frankie Beverly,1977-08-13,Maze Featuring Frankie Beverly - Maze Featuring Frankie Beverly,9,10,8,6.0,9,Maze Featuring Frankie Beverly,38.0,21,1,0,1,1,up,1977-03-12
6195,Maze Featuring Frankie Beverly,1977-08-20,Maze Featuring Frankie Beverly - Maze Featuring Frankie Beverly,9,9,7,6.0,8,Maze Featuring Frankie Beverly,38.0,22,1,1,0,1,up,1977-03-12
6196,Maze Featuring Frankie Beverly,1977-08-27,Maze Featuring Frankie Beverly - Maze Featuring Frankie Beverly,8,9,7,6.0,7,Maze Featuring Frankie Beverly,38.0,23,0,1,1,0,stay,1977-03-12
6197,Maze Featuring Frankie Beverly,1977-09-03,Maze Featuring Frankie Beverly - Maze Featuring Frankie Beverly,7,8,6,6.0,7,Maze Featuring Frankie Beverly,38.0,24,1,0,1,1,up,1977-03-12
6198,Maze Featuring Frankie Beverly,1977-09-10,Maze Featuring Frankie Beverly - Maze Featuring Frankie Beverly,7,7,6,6.0,6,Maze Featuring Frankie Beverly,38.0,25,0,1,0,0,stay,1977-03-12
6199,Maze Featuring Frankie Beverly,1977-09-17,Maze Featuring Frankie Beverly - Maze Featuring Frankie Beverly,6,7,10,6.0,6,Maze Featuring Frankie Beverly,38.0,26,-4,0,1,1,down,1977-03-12
6200,Maze Featuring Frankie Beverly,1977-09-24,Maze Featuring Frankie Beverly - Maze Featuring Frankie Beverly,6,6,11,6.0,10,Maze Featuring Frankie Beverly,38.0,27,-1,-4,0,1,down,1977-03-12
6201,Maze Featuring Frankie Beverly,1977-10-01,Maze Featuring Frankie Beverly - Maze Featuring Frankie Beverly,10,6,11,6.0,11,Maze Featuring Frankie Beverly,38.0,28,0,-1,-4,0,stay,1977-03-12
6202,Maze Featuring Frankie Beverly,1977-10-08,Maze Featuring Frankie Beverly - Maze Featuring Frankie Beverly,11,10,13,6.0,11,Maze Featuring Frankie Beverly,38.0,29,-2,0,-1,1,down,1977-03-12
6203,Maze Featuring Frankie Beverly,1977-10-15,Maze Featuring Frankie Beverly - Maze Featuring Frankie Beverly,11,11,14,6.0,13,Maze Featuring Frankie Beverly,38.0,30,-1,-2,0,1,down,1977-03-12
6204,Maze Featuring Frankie Beverly,1977-10-22,Maze Featuring Frankie Beverly - Maze Featuring Frankie Beverly,13,11,17,6.0,14,Maze Featuring Frankie Beverly,38.0,31,-3,-1,-2,1,down,1977-03-12
6205,Maze Featuring Frankie Beverly,1977-10-29,Maze Featuring Frankie Beverly - Maze Featuring Frankie Beverly,14,13,18,6.0,17,Maze Featuring Frankie Beverly,38.0,32,-1,-3,-1,1,down,1977-03-12
6206,Maze Featuring Frankie Beverly,1977-11-05,Maze Featuring Frankie Beverly - Maze Featuring Frankie Beverly,17,14,18,6.0,18,Maze Featuring Frankie Beverly,38.0,33,0,-1,-3,0,stay,1977-03-12
6207,Maze Featuring Frankie Beverly,1977-11-12,Maze Featuring Frankie Beverly - Maze Featuring Frankie Beverly,18,17,19,6.0,18,Maze Featuring Frankie Beverly,38.0,34,-1,0,-1,1,down,1977-03-12
6208,Maze Featuring Frankie Beverly,1977-11-19,Maze Featuring Frankie Beverly - Maze Featuring Frankie Beverly,18,18,30,6.0,19,Maze Featuring Frankie Beverly,38.0,35,-11,-1,0,1,down,1977-03-12
6209,Maze Featuring Frankie Beverly,1977-11-26,Maze Featuring Frankie Beverly - Maze Featuring Frankie Beverly,19,18,34,6.0,30,Maze Featuring Frankie Beverly,38.0,36,-4,-11,-1,1,down,1977-03-12
6210,Maze Featuring Frankie Beverly,1977-12-03,Maze Featuring Frankie Beverly - Maze Featuring Frankie Beverly,30,19,42,6.0,34,Maze Featuring Frankie Beverly,38.0,37,-8,-4,-11,1,down,1977-03-12
6211,Maze Featuring Frankie Beverly,1977-12-10,Maze Featuring Frankie Beverly - Maze Featuring Frankie Beverly,34,30,51,6.0,42,Maze Featuring Frankie Beverly,38.0,38,-9,-8,-4,1,down,1977-03-12
6212,Minnie Riperton,1977-03-19,Minnie Riperton - Stay In Love,51,51,34,19.0,43,Stay In Love,8.0,0,9,8,0,1,up,1977-03-19
6213,Minnie Riperton,1977-03-26,Minnie Riperton - Stay In Love,43,51,26,19.0,34,Stay In Love,8.0,1,8,9,8,1,up,1977-03-19
6214,Minnie Riperton,1977-04-02,Minnie Riperton - Stay In Love,34,43,20,19.0,26,Stay In Love,8.0,2,6,8,9,1,up,1977-03-19
6215,Minnie Riperton,1977-04-09,Minnie Riperton - Stay In Love,26,34,20,19.0,20,Stay In Love,8.0,3,0,6,8,0,stay,1977-03-19
6216,Minnie Riperton,1977-04-16,Minnie Riperton - Stay In Love,20,26,19,19.0,20,Stay In Love,8.0,4,1,0,6,1,up,1977-03-19
6217,Minnie Riperton,1977-04-23,Minnie Riperton - Stay In Love,20,20,22,19.0,19,Stay In Love,8.0,5,-3,1,0,1,down,1977-03-19
6218,Minnie Riperton,1977-04-30,Minnie Riperton - Stay In Love,19,20,33,19.0,22,Stay In Love,8.0,6,-11,-3,1,1,down,1977-03-19
6219,Minnie Riperton,1977-05-07,Minnie Riperton - Stay In Love,22,19,47,19.0,33,Stay In Love,8.0,7,-14,-11,-3,1,down,1977-03-19
6220,Minnie Riperton,1977-05-14,Minnie Riperton - Stay In Love,33,22,51,19.0,47,Stay In Love,8.0,8,-4,-14,-11,1,down,1977-03-19
6221,Marlena Shaw,1977-03-19,Marlena Shaw - Sweet Beginnings,51,51,33,14.0,45,Sweet Beginnings,16.0,0,12,6,0,1,up,1977-03-19
6222,Marlena Shaw,1977-03-26,Marlena Shaw - Sweet Beginnings,45,51,20,14.0,33,Sweet Beginnings,16.0,1,13,12,6,1,up,1977-03-19
6223,Marlena Shaw,1977-04-02,Marlena Shaw - Sweet Beginnings,33,45,16,14.0,20,Sweet Beginnings,16.0,2,4,13,12,1,up,1977-03-19
6224,Marlena Shaw,1977-04-09,Marlena Shaw - Sweet Beginnings,20,33,14,14.0,16,Sweet Beginnings,16.0,3,2,4,13,1,up,1977-03-19
6225,Marlena Shaw,1977-04-16,Marlena Shaw - Sweet Beginnings,16,20,14,14.0,14,Sweet Beginnings,16.0,4,0,2,4,0,stay,1977-03-19
6226,Marlena Shaw,1977-04-23,Marlena Shaw - Sweet Beginnings,14,16,14,14.0,14,Sweet Beginnings,16.0,5,0,0,2,0,stay,1977-03-19
6227,Marlena Shaw,1977-04-30,Marlena Shaw - Sweet Beginnings,14,14,14,14.0,14,Sweet Beginnings,16.0,6,0,0,0,0,stay,1977-03-19
6228,Marlena Shaw,1977-05-07,Marlena Shaw - Sweet Beginnings,14,14,14,14.0,14,Sweet Beginnings,16.0,7,0,0,0,0,stay,1977-03-19
6229,Marlena Shaw,1977-05-14,Marlena Shaw - Sweet Beginnings,14,14,14,14.0,14,Sweet Beginnings,16.0,8,0,0,0,0,stay,1977-03-19
6230,Marlena Shaw,1977-05-21,Marlena Shaw - Sweet Beginnings,14,14,20,14.0,14,Sweet Beginnings,16.0,9,-6,0,0,1,down,1977-03-19
6231,Marlena Shaw,1977-05-28,Marlena Shaw - Sweet Beginnings,14,14,20,14.0,20,Sweet Beginnings,16.0,10,0,-6,0,0,stay,1977-03-19
6232,Marlena Shaw,1977-06-04,Marlena Shaw - Sweet Beginnings,20,14,21,14.0,20,Sweet Beginnings,16.0,11,-1,0,-6,1,down,1977-03-19
6233,Marlena Shaw,1977-06-11,Marlena Shaw - Sweet Beginnings,20,20,21,14.0,21,Sweet Beginnings,16.0,12,0,-1,0,0,stay,1977-03-19
6234,Marlena Shaw,1977-06-18,Marlena Shaw - Sweet Beginnings,21,20,20,14.0,21,Sweet Beginnings,16.0,13,1,0,-1,1,up,1977-03-19
6235,Marlena Shaw,1977-06-25,Marlena Shaw - Sweet Beginnings,21,21,23,14.0,20,Sweet Beginnings,16.0,14,-3,1,0,1,down,1977-03-19
6236,Marlena Shaw,1977-07-02,Marlena Shaw - Sweet Beginnings,20,21,23,14.0,23,Sweet Beginnings,16.0,15,0,-3,1,0,stay,1977-03-19
6237,Marlena Shaw,1977-07-09,Marlena Shaw - Sweet Beginnings,23,20,51,14.0,23,Sweet Beginnings,16.0,16,-28,0,-3,1,down,1977-03-19
6238,Teddy Pendergrass,1977-03-19,Teddy Pendergrass - Teddy Pendergrass,51,51,38,5.0,48,Teddy Pendergrass,32.0,0,10,3,0,1,up,1977-03-19
6239,Teddy Pendergrass,1977-03-26,Teddy Pendergrass - Teddy Pendergrass,48,51,18,5.0,38,Teddy Pendergrass,32.0,1,20,10,3,1,up,1977-03-19
6240,Teddy Pendergrass,1977-04-02,Teddy Pendergrass - Teddy Pendergrass,38,48,9,5.0,18,Teddy Pendergrass,32.0,2,9,20,10,1,up,1977-03-19
6241,Teddy Pendergrass,1977-04-09,Teddy Pendergrass - Teddy Pendergrass,18,38,7,5.0,9,Teddy Pendergrass,32.0,3,2,9,20,1,up,1977-03-19
6242,Teddy Pendergrass,1977-04-16,Teddy Pendergrass - Teddy Pendergrass,9,18,5,5.0,7,Teddy Pendergrass,32.0,4,2,2,9,1,up,1977-03-19
6243,Teddy Pendergrass,1977-04-23,Teddy Pendergrass - Teddy Pendergrass,7,9,5,5.0,5,Teddy Pendergrass,32.0,5,0,2,2,0,stay,1977-03-19
6244,Teddy Pendergrass,1977-04-30,Teddy Pendergrass - Teddy Pendergrass,5,7,5,5.0,5,Teddy Pendergrass,32.0,6,0,0,2,0,stay,1977-03-19
6245,Teddy Pendergrass,1977-05-07,Teddy Pendergrass - Teddy Pendergrass,5,5,7,5.0,5,Teddy Pendergrass,32.0,7,-2,0,0,1,down,1977-03-19
6246,Teddy Pendergrass,1977-05-14,Teddy Pendergrass - Teddy Pendergrass,5,5,7,5.0,7,Teddy Pendergrass,32.0,8,0,-2,0,0,stay,1977-03-19
6247,Teddy Pendergrass,1977-05-21,Teddy Pendergrass - Teddy Pendergrass,7,5,7,5.0,7,Teddy Pendergrass,32.0,9,0,0,-2,0,stay,1977-03-19
6248,Teddy Pendergrass,1977-05-28,Teddy Pendergrass - Teddy Pendergrass,7,7,7,5.0,7,Teddy Pendergrass,32.0,10,0,0,0,0,stay,1977-03-19
6249,Teddy Pendergrass,1977-06-04,Teddy Pendergrass - Teddy Pendergrass,7,7,7,5.0,7,Teddy Pendergrass,32.0,11,0,0,0,0,stay,1977-03-19
6250,Teddy Pendergrass,1977-06-11,Teddy Pendergrass - Teddy Pendergrass,7,7,9,5.0,7,Teddy Pendergrass,32.0,12,-2,0,0,1,down,1977-03-19
6251,Teddy Pendergrass,1977-06-18,Teddy Pendergrass - Teddy Pendergrass,7,7,9,5.0,9,Teddy Pendergrass,32.0,13,0,-2,0,0,stay,1977-03-19
6252,Teddy Pendergrass,1977-06-25,Teddy Pendergrass - Teddy Pendergrass,9,7,8,5.0,9,Teddy Pendergrass,32.0,14,1,0,-2,1,up,1977-03-19
6253,Teddy Pendergrass,1977-07-02,Teddy Pendergrass - Teddy Pendergrass,9,9,12,5.0,8,Teddy Pendergrass,32.0,15,-4,1,0,1,down,1977-03-19
6254,Teddy Pendergrass,1977-07-09,Teddy Pendergrass - Teddy Pendergrass,8,9,12,5.0,12,Teddy Pendergrass,32.0,16,0,-4,1,0,stay,1977-03-19
6255,Teddy Pendergrass,1977-07-16,Teddy Pendergrass - Teddy Pendergrass,12,8,12,5.0,12,Teddy Pendergrass,32.0,17,0,0,-4,0,stay,1977-03-19
6256,Teddy Pendergrass,1977-07-23,Teddy Pendergrass - Teddy Pendergrass,12,12,11,5.0,12,Teddy Pendergrass,32.0,18,1,0,0,1,up,1977-03-19
6257,Teddy Pendergrass,1977-07-30,Teddy Pendergrass - Teddy Pendergrass,12,12,13,5.0,11,Teddy Pendergrass,32.0,19,-2,1,0,1,down,1977-03-19
6258,Teddy Pendergrass,1977-08-06,Teddy Pendergrass - Teddy Pendergrass,11,12,13,5.0,13,Teddy Pendergrass,32.0,20,0,-2,1,0,stay,1977-03-19
6259,Teddy Pendergrass,1977-08-13,Teddy Pendergrass - Teddy Pendergrass,13,11,24,5.0,13,Teddy Pendergrass,32.0,21,-11,0,-2,1,down,1977-03-19
6260,Teddy Pendergrass,1977-08-20,Teddy Pendergrass - Teddy Pendergrass,13,13,30,5.0,24,Teddy Pendergrass,32.0,22,-6,-11,0,1,down,1977-03-19
6261,Teddy Pendergrass,1977-08-27,Teddy Pendergrass - Teddy Pendergrass,24,13,30,5.0,30,Teddy Pendergrass,32.0,23,0,-6,-11,0,stay,1977-03-19
6262,Teddy Pendergrass,1977-09-03,Teddy Pendergrass - Teddy Pendergrass,30,24,32,5.0,30,Teddy Pendergrass,32.0,24,-2,0,-6,1,down,1977-03-19
6263,Teddy Pendergrass,1977-09-10,Teddy Pendergrass - Teddy Pendergrass,30,30,32,5.0,32,Teddy Pendergrass,32.0,25,0,-2,0,0,stay,1977-03-19
6264,Teddy Pendergrass,1977-09-17,Teddy Pendergrass - Teddy Pendergrass,32,30,28,5.0,32,Teddy Pendergrass,32.0,26,4,0,-2,1,up,1977-03-19
6265,Teddy Pendergrass,1977-09-24,Teddy Pendergrass - Teddy Pendergrass,32,32,28,5.0,28,Teddy Pendergrass,32.0,27,0,4,0,0,stay,1977-03-19
6266,Teddy Pendergrass,1977-10-01,Teddy Pendergrass - Teddy Pendergrass,28,32,28,5.0,28,Teddy Pendergrass,32.0,28,0,0,4,0,stay,1977-03-19
6267,Teddy Pendergrass,1977-10-08,Teddy Pendergrass - Teddy Pendergrass,28,28,28,5.0,28,Teddy Pendergrass,32.0,29,0,0,0,0,stay,1977-03-19
6268,Teddy Pendergrass,1977-10-15,Teddy Pendergrass - Teddy Pendergrass,28,28,30,5.0,28,Teddy Pendergrass,32.0,30,-2,0,0,1,down,1977-03-19
6269,Teddy Pendergrass,1977-10-22,Teddy Pendergrass - Teddy Pendergrass,28,28,37,5.0,30,Teddy Pendergrass,32.0,31,-7,-2,0,1,down,1977-03-19
6270,Teddy Pendergrass,1977-10-29,Teddy Pendergrass - Teddy Pendergrass,30,28,51,5.0,37,Teddy Pendergrass,32.0,32,-14,-7,-2,1,down,1977-03-19
6271,Gato Barbieri,1977-03-19,Gato Barbieri - Caliente,51,51,51,49.0,49,Caliente,0.0,0,-2,2,0,1,down,1977-03-19
6272,The Miracles,1977-03-19,The Miracles - Love Crazy,51,51,39,31.0,50,Love Crazy,3.0,0,11,1,0,1,up,1977-03-19
6273,The Miracles,1977-03-26,The Miracles - Love Crazy,50,51,31,31.0,39,Love Crazy,3.0,1,8,11,1,1,up,1977-03-19
6274,The Miracles,1977-04-02,The Miracles - Love Crazy,39,50,31,31.0,31,Love Crazy,3.0,2,0,8,11,0,stay,1977-03-19
6275,The Miracles,1977-04-09,The Miracles - Love Crazy,31,39,51,31.0,31,Love Crazy,3.0,3,-20,0,8,1,down,1977-03-19
6276,Curtis Mayfield,1977-03-26,Curtis Mayfield - Never Say You Can't Survive,51,51,32,32.0,40,Never Say You Can't Survive,3.0,0,8,11,0,1,up,1977-03-26
6277,Curtis Mayfield,1977-04-02,Curtis Mayfield - Never Say You Can't Survive,40,51,32,32.0,32,Never Say You Can't Survive,3.0,1,0,8,11,0,stay,1977-03-26
6278,Curtis Mayfield,1977-04-09,Curtis Mayfield - Never Say You Can't Survive,32,40,38,32.0,32,Never Say You Can't Survive,3.0,2,-6,0,8,1,down,1977-03-26
6279,Curtis Mayfield,1977-04-16,Curtis Mayfield - Never Say You Can't Survive,32,32,51,32.0,38,Never Say You Can't Survive,3.0,3,-13,-6,0,1,down,1977-03-26
6280,Side Effect,1977-03-26,Side Effect - What You Need,51,51,44,26.0,49,What You Need,15.0,0,5,2,0,1,up,1977-03-26
6281,Side Effect,1977-04-02,Side Effect - What You Need,49,51,42,26.0,44,What You Need,15.0,1,2,5,2,1,up,1977-03-26
6282,Side Effect,1977-04-09,Side Effect - What You Need,44,49,41,26.0,42,What You Need,15.0,2,1,2,5,1,up,1977-03-26
6283,Side Effect,1977-04-16,Side Effect - What You Need,42,44,41,26.0,41,What You Need,15.0,3,0,1,2,0,stay,1977-03-26
6284,Side Effect,1977-04-23,Side Effect - What You Need,41,42,36,26.0,41,What You Need,15.0,4,5,0,1,1,up,1977-03-26
6285,Side Effect,1977-04-30,Side Effect - What You Need,41,41,30,26.0,36,What You Need,15.0,5,6,5,0,1,up,1977-03-26
6286,Side Effect,1977-05-07,Side Effect - What You Need,36,41,26,26.0,30,What You Need,15.0,6,4,6,5,1,up,1977-03-26
6287,Side Effect,1977-05-14,Side Effect - What You Need,30,36,35,26.0,26,What You Need,15.0,7,-9,4,6,1,down,1977-03-26
6288,Side Effect,1977-05-21,Side Effect - What You Need,26,30,35,26.0,35,What You Need,15.0,8,0,-9,4,0,stay,1977-03-26
6289,Side Effect,1977-05-28,Side Effect - What You Need,35,26,44,26.0,35,What You Need,15.0,9,-9,0,-9,1,down,1977-03-26
6290,Side Effect,1977-06-04,Side Effect - What You Need,35,35,41,26.0,44,What You Need,15.0,10,3,-9,0,1,up,1977-03-26
6291,Side Effect,1977-06-11,Side Effect - What You Need,44,35,44,26.0,41,What You Need,15.0,11,-3,3,-9,1,down,1977-03-26
6292,Side Effect,1977-06-18,Side Effect - What You Need,41,44,44,26.0,44,What You Need,15.0,12,0,-3,3,0,stay,1977-03-26
6293,Side Effect,1977-06-25,Side Effect - What You Need,44,41,47,26.0,44,What You Need,15.0,13,-3,0,-3,1,down,1977-03-26
6294,Side Effect,1977-07-02,Side Effect - What You Need,44,44,45,26.0,47,What You Need,15.0,14,2,-3,0,1,up,1977-03-26
6295,Side Effect,1977-07-09,Side Effect - What You Need,47,44,51,26.0,45,What You Need,15.0,15,-6,2,-3,1,down,1977-03-26
6296,The Spinners,1977-04-02,The Spinners - Yesterday Today & Tomorrow,51,51,14,11.0,28,Yesterday Today & Tomorrow,11.0,0,14,23,0,1,up,1977-04-02
6297,The Spinners,1977-04-09,The Spinners - Yesterday Today & Tomorrow,28,51,11,11.0,14,Yesterday Today & Tomorrow,11.0,1,3,14,23,1,up,1977-04-02
6298,The Spinners,1977-04-16,The Spinners - Yesterday Today & Tomorrow,14,28,11,11.0,11,Yesterday Today & Tomorrow,11.0,2,0,3,14,0,stay,1977-04-02
6299,The Spinners,1977-04-23,The Spinners - Yesterday Today & Tomorrow,11,14,13,11.0,11,Yesterday Today & Tomorrow,11.0,3,-2,0,3,1,down,1977-04-02
6300,The Spinners,1977-04-30,The Spinners - Yesterday Today & Tomorrow,11,11,13,11.0,13,Yesterday Today & Tomorrow,11.0,4,0,-2,0,0,stay,1977-04-02
6301,The Spinners,1977-05-07,The Spinners - Yesterday Today & Tomorrow,13,11,21,11.0,13,Yesterday Today & Tomorrow,11.0,5,-8,0,-2,1,down,1977-04-02
6302,The Spinners,1977-05-14,The Spinners - Yesterday Today & Tomorrow,13,13,28,11.0,21,Yesterday Today & Tomorrow,11.0,6,-7,-8,0,1,down,1977-04-02
6303,The Spinners,1977-05-21,The Spinners - Yesterday Today & Tomorrow,21,13,28,11.0,28,Yesterday Today & Tomorrow,11.0,7,0,-7,-8,0,stay,1977-04-02
6304,The Spinners,1977-05-28,The Spinners - Yesterday Today & Tomorrow,28,21,28,11.0,28,Yesterday Today & Tomorrow,11.0,8,0,0,-7,0,stay,1977-04-02
6305,The Spinners,1977-06-04,The Spinners - Yesterday Today & Tomorrow,28,28,29,11.0,28,Yesterday Today & Tomorrow,11.0,9,-1,0,0,1,down,1977-04-02
6306,The Spinners,1977-06-11,The Spinners - Yesterday Today & Tomorrow,28,28,39,11.0,29,Yesterday Today & Tomorrow,11.0,10,-10,-1,0,1,down,1977-04-02
6307,The Spinners,1977-06-18,The Spinners - Yesterday Today & Tomorrow,29,28,51,11.0,39,Yesterday Today & Tomorrow,11.0,11,-12,-10,-1,1,down,1977-04-02
6308,Ohio Players,1977-04-02,Ohio Players - Angel,51,51,28,9.0,40,Angel,29.0,0,12,11,0,1,up,1977-04-02
6309,Ohio Players,1977-04-09,Ohio Players - Angel,40,51,15,9.0,28,Angel,29.0,1,13,12,11,1,up,1977-04-02
6310,Ohio Players,1977-04-16,Ohio Players - Angel,28,40,13,9.0,15,Angel,29.0,2,2,13,12,1,up,1977-04-02
6311,Ohio Players,1977-04-23,Ohio Players - Angel,15,28,10,9.0,13,Angel,29.0,3,3,2,13,1,up,1977-04-02
6312,Ohio Players,1977-04-30,Ohio Players - Angel,13,15,10,9.0,10,Angel,29.0,4,0,3,2,0,stay,1977-04-02
6313,Ohio Players,1977-05-07,Ohio Players - Angel,10,13,9,9.0,10,Angel,29.0,5,1,0,3,1,up,1977-04-02
6314,Ohio Players,1977-05-14,Ohio Players - Angel,10,10,9,9.0,9,Angel,29.0,6,0,1,0,0,stay,1977-04-02
6315,Ohio Players,1977-05-21,Ohio Players - Angel,9,10,9,9.0,9,Angel,29.0,7,0,0,1,0,stay,1977-04-02
6316,Ohio Players,1977-05-28,Ohio Players - Angel,9,9,12,9.0,9,Angel,29.0,8,-3,0,0,1,down,1977-04-02
6317,Ohio Players,1977-06-04,Ohio Players - Angel,9,9,23,9.0,12,Angel,29.0,9,-11,-3,0,1,down,1977-04-02
6318,Ohio Players,1977-06-11,Ohio Players - Angel,12,9,29,9.0,23,Angel,29.0,10,-6,-11,-3,1,down,1977-04-02
6319,Ohio Players,1977-06-18,Ohio Players - Angel,23,12,30,9.0,29,Angel,29.0,11,-1,-6,-11,1,down,1977-04-02
6320,Ohio Players,1977-06-25,Ohio Players - Angel,29,23,29,9.0,30,Angel,29.0,12,1,-1,-6,1,up,1977-04-02
6321,Ohio Players,1977-07-02,Ohio Players - Angel,30,29,30,9.0,29,Angel,29.0,13,-1,1,-1,1,down,1977-04-02
6322,Ohio Players,1977-07-09,Ohio Players - Angel,29,30,30,9.0,30,Angel,29.0,14,0,-1,1,0,stay,1977-04-02
6323,Ohio Players,1977-07-16,Ohio Players - Angel,30,29,31,9.0,30,Angel,29.0,15,-1,0,-1,1,down,1977-04-02
6324,Ohio Players,1977-07-23,Ohio Players - Angel,30,30,30,9.0,31,Angel,29.0,16,1,-1,0,1,up,1977-04-02
6325,Ohio Players,1977-07-30,Ohio Players - Angel,31,30,30,9.0,30,Angel,29.0,17,0,1,-1,0,stay,1977-04-02
6326,Ohio Players,1977-08-06,Ohio Players - Angel,30,31,27,9.0,30,Angel,29.0,18,3,0,1,1,up,1977-04-02
6327,Ohio Players,1977-08-13,Ohio Players - Angel,30,30,28,9.0,27,Angel,29.0,19,-1,3,0,1,down,1977-04-02
6328,Ohio Players,1977-08-20,Ohio Players - Angel,27,30,29,9.0,28,Angel,29.0,20,-1,-1,3,1,down,1977-04-02
6329,Ohio Players,1977-08-27,Ohio Players - Angel,28,27,31,9.0,29,Angel,29.0,21,-2,-1,-1,1,down,1977-04-02
6330,Ohio Players,1977-09-03,Ohio Players - Angel,29,28,31,9.0,31,Angel,29.0,22,0,-2,-1,0,stay,1977-04-02
6331,Ohio Players,1977-09-10,Ohio Players - Angel,31,29,35,9.0,31,Angel,29.0,23,-4,0,-2,1,down,1977-04-02
6332,Ohio Players,1977-09-17,Ohio Players - Angel,31,31,40,9.0,35,Angel,29.0,24,-5,-4,0,1,down,1977-04-02
6333,Ohio Players,1977-09-24,Ohio Players - Angel,35,31,46,9.0,40,Angel,29.0,25,-6,-5,-4,1,down,1977-04-02
6334,Ohio Players,1977-10-01,Ohio Players - Angel,40,35,46,9.0,46,Angel,29.0,26,0,-6,-5,0,stay,1977-04-02
6335,Ohio Players,1977-10-08,Ohio Players - Angel,46,40,47,9.0,46,Angel,29.0,27,-1,0,-6,1,down,1977-04-02
6336,Ohio Players,1977-10-15,Ohio Players - Angel,46,46,50,9.0,47,Angel,29.0,28,-3,-1,0,1,down,1977-04-02
6337,Ohio Players,1977-10-22,Ohio Players - Angel,47,46,51,9.0,50,Angel,29.0,29,-1,-3,-1,1,down,1977-04-02
6338,Slave,1977-04-02,Slave - Slave,51,51,37,6.0,45,Slave,30.0,0,8,6,0,1,up,1977-04-02
6339,Slave,1977-04-09,Slave - Slave,45,51,31,6.0,37,Slave,30.0,1,6,8,6,1,up,1977-04-02
6340,Slave,1977-04-16,Slave - Slave,37,45,23,6.0,31,Slave,30.0,2,8,6,8,1,up,1977-04-02
6341,Slave,1977-04-23,Slave - Slave,31,37,17,6.0,23,Slave,30.0,3,6,8,6,1,up,1977-04-02
6342,Slave,1977-04-30,Slave - Slave,23,31,16,6.0,17,Slave,30.0,4,1,6,8,1,up,1977-04-02
6343,Slave,1977-05-07,Slave - Slave,17,23,13,6.0,16,Slave,30.0,5,3,1,6,1,up,1977-04-02
6344,Slave,1977-05-14,Slave - Slave,16,17,13,6.0,13,Slave,30.0,6,0,3,1,0,stay,1977-04-02
6345,Slave,1977-05-21,Slave - Slave,13,16,11,6.0,13,Slave,30.0,7,2,0,3,1,up,1977-04-02
6346,Slave,1977-05-28,Slave - Slave,13,13,10,6.0,11,Slave,30.0,8,1,2,0,1,up,1977-04-02
6347,Slave,1977-06-04,Slave - Slave,11,13,9,6.0,10,Slave,30.0,9,1,1,2,1,up,1977-04-02
6348,Slave,1977-06-11,Slave - Slave,10,11,8,6.0,9,Slave,30.0,10,1,1,1,1,up,1977-04-02
6349,Slave,1977-06-18,Slave - Slave,9,10,8,6.0,8,Slave,30.0,11,0,1,1,0,stay,1977-04-02
6350,Slave,1977-06-25,Slave - Slave,8,9,11,6.0,8,Slave,30.0,12,-3,0,1,1,down,1977-04-02
6351,Slave,1977-07-02,Slave - Slave,8,8,11,6.0,11,Slave,30.0,13,0,-3,0,0,stay,1977-04-02
6352,Slave,1977-07-09,Slave - Slave,11,8,11,6.0,11,Slave,30.0,14,0,0,-3,0,stay,1977-04-02
6353,Slave,1977-07-16,Slave - Slave,11,11,10,6.0,11,Slave,30.0,15,1,0,0,1,up,1977-04-02
6354,Slave,1977-07-23,Slave - Slave,11,11,9,6.0,10,Slave,30.0,16,1,1,0,1,up,1977-04-02
6355,Slave,1977-07-30,Slave - Slave,10,11,8,6.0,9,Slave,30.0,17,1,1,1,1,up,1977-04-02
6356,Slave,1977-08-06,Slave - Slave,9,10,8,6.0,8,Slave,30.0,18,0,1,1,0,stay,1977-04-02
6357,Slave,1977-08-13,Slave - Slave,8,9,6,6.0,8,Slave,30.0,19,2,0,1,1,up,1977-04-02
6358,Slave,1977-08-20,Slave - Slave,8,8,8,6.0,6,Slave,30.0,20,-2,2,0,1,down,1977-04-02
6359,Slave,1977-08-27,Slave - Slave,6,8,9,6.0,8,Slave,30.0,21,-1,-2,2,1,down,1977-04-02
6360,Slave,1977-09-03,Slave - Slave,8,6,9,6.0,9,Slave,30.0,22,0,-1,-2,0,stay,1977-04-02
6361,Slave,1977-09-10,Slave - Slave,9,8,15,6.0,9,Slave,30.0,23,-6,0,-1,1,down,1977-04-02
6362,Slave,1977-09-17,Slave - Slave,9,9,16,6.0,15,Slave,30.0,24,-1,-6,0,1,down,1977-04-02
6363,Slave,1977-09-24,Slave - Slave,15,9,16,6.0,16,Slave,30.0,25,0,-1,-6,0,stay,1977-04-02
6364,Slave,1977-10-01,Slave - Slave,16,15,23,6.0,16,Slave,30.0,26,-7,0,-1,1,down,1977-04-02
6365,Slave,1977-10-08,Slave - Slave,16,16,25,6.0,23,Slave,30.0,27,-2,-7,0,1,down,1977-04-02
6366,Slave,1977-10-15,Slave - Slave,23,16,37,6.0,25,Slave,30.0,28,-12,-2,-7,1,down,1977-04-02
6367,Slave,1977-10-22,Slave - Slave,25,23,40,6.0,37,Slave,30.0,29,-3,-12,-2,1,down,1977-04-02
6368,Slave,1977-10-29,Slave - Slave,37,25,51,6.0,40,Slave,30.0,30,-11,-3,-12,1,down,1977-04-02
6369,Jean Cairn,1977-04-02,Jean Cairn - Jean Carn,51,51,46,46.0,46,Jean Carn,2.0,0,0,5,0,0,stay,1977-04-02
6370,Jean Cairn,1977-04-09,Jean Cairn - Jean Carn,46,51,50,46.0,46,Jean Carn,2.0,1,-4,0,5,1,down,1977-04-02
6371,Jean Cairn,1977-04-30,Jean Cairn - Jean Carn,46,46,51,46.0,50,Jean Carn,2.0,2,-1,-4,0,1,down,1977-04-02
6372,Wild Cherry,1977-04-02,Wild Cherry - Electrified Funk,51,51,35,33.0,47,Electrified Funk,4.0,0,12,4,0,1,up,1977-04-02
6373,Wild Cherry,1977-04-09,Wild Cherry - Electrified Funk,47,51,33,33.0,35,Electrified Funk,4.0,1,2,12,4,1,up,1977-04-02
6374,Wild Cherry,1977-04-16,Wild Cherry - Electrified Funk,35,47,33,33.0,33,Electrified Funk,4.0,2,0,2,12,0,stay,1977-04-02
6375,Wild Cherry,1977-04-23,Wild Cherry - Electrified Funk,33,35,43,33.0,33,Electrified Funk,4.0,3,-10,0,2,1,down,1977-04-02
6376,Wild Cherry,1977-04-30,Wild Cherry - Electrified Funk,33,33,51,33.0,43,Electrified Funk,4.0,4,-8,-10,0,1,down,1977-04-02
6377,The Steve Miller Band,1977-04-02,The Steve Miller Band - Fly Like An Eagle,51,51,38,19.0,48,Fly Like An Eagle,6.0,0,10,3,0,1,up,1977-04-02
6378,The Steve Miller Band,1977-04-09,The Steve Miller Band - Fly Like An Eagle,48,51,34,19.0,38,Fly Like An Eagle,6.0,1,4,10,3,1,up,1977-04-02
6379,The Steve Miller Band,1977-04-16,The Steve Miller Band - Fly Like An Eagle,38,48,26,19.0,34,Fly Like An Eagle,6.0,2,8,4,10,1,up,1977-04-02
6380,The Steve Miller Band,1977-04-23,The Steve Miller Band - Fly Like An Eagle,34,38,20,19.0,26,Fly Like An Eagle,6.0,3,6,8,4,1,up,1977-04-02
6381,The Steve Miller Band,1977-04-30,The Steve Miller Band - Fly Like An Eagle,26,34,19,19.0,20,Fly Like An Eagle,6.0,4,1,6,8,1,up,1977-04-02
6382,The Steve Miller Band,1977-05-07,The Steve Miller Band - Fly Like An Eagle,20,26,29,19.0,19,Fly Like An Eagle,6.0,5,-10,1,6,1,down,1977-04-02
6383,The Steve Miller Band,1977-05-14,The Steve Miller Band - Fly Like An Eagle,19,20,51,19.0,29,Fly Like An Eagle,6.0,6,-22,-10,1,1,down,1977-04-02
6384,William Bell,1977-04-02,William Bell - Coming Back For More,51,51,40,15.0,50,Coming Back For More,11.0,0,10,1,0,1,up,1977-04-02
6385,William Bell,1977-04-09,William Bell - Coming Back For More,50,51,32,15.0,40,Coming Back For More,11.0,1,8,10,1,1,up,1977-04-02
6386,William Bell,1977-04-16,William Bell - Coming Back For More,40,50,25,15.0,32,Coming Back For More,11.0,2,7,8,10,1,up,1977-04-02
6387,William Bell,1977-04-23,William Bell - Coming Back For More,32,40,19,15.0,25,Coming Back For More,11.0,3,6,7,8,1,up,1977-04-02
6388,William Bell,1977-04-30,William Bell - Coming Back For More,25,32,15,15.0,19,Coming Back For More,11.0,4,4,6,7,1,up,1977-04-02
6389,William Bell,1977-05-07,William Bell - Coming Back For More,19,25,15,15.0,15,Coming Back For More,11.0,5,0,4,6,0,stay,1977-04-02
6390,William Bell,1977-05-14,William Bell - Coming Back For More,15,19,16,15.0,15,Coming Back For More,11.0,6,-1,0,4,1,down,1977-04-02
6391,William Bell,1977-05-21,William Bell - Coming Back For More,15,15,29,15.0,16,Coming Back For More,11.0,7,-13,-1,0,1,down,1977-04-02
6392,William Bell,1977-05-28,William Bell - Coming Back For More,16,15,29,15.0,29,Coming Back For More,11.0,8,0,-13,-1,0,stay,1977-04-02
6393,William Bell,1977-06-04,William Bell - Coming Back For More,29,16,36,15.0,29,Coming Back For More,11.0,9,-7,0,-13,1,down,1977-04-02
6394,William Bell,1977-06-11,William Bell - Coming Back For More,29,29,36,15.0,36,Coming Back For More,11.0,10,0,-7,0,0,stay,1977-04-02
6395,William Bell,1977-06-18,William Bell - Coming Back For More,36,29,51,15.0,36,Coming Back For More,11.0,11,-15,0,-7,1,down,1977-04-02
6396,Marvin Gaye,1977-04-09,Marvin Gaye - Marvin Gaye Live At The London Palladium,51,51,9,1.0,22,Marvin Gaye Live At The London Palladium,29.0,0,13,29,0,1,up,1977-04-09
6397,Marvin Gaye,1977-04-16,Marvin Gaye - Marvin Gaye Live At The London Palladium,22,51,3,1.0,9,Marvin Gaye Live At The London Palladium,29.0,1,6,13,29,1,up,1977-04-09
6398,Marvin Gaye,1977-04-23,Marvin Gaye - Marvin Gaye Live At The London Palladium,9,22,1,1.0,3,Marvin Gaye Live At The London Palladium,29.0,2,2,6,13,1,up,1977-04-09
6399,Marvin Gaye,1977-04-30,Marvin Gaye - Marvin Gaye Live At The London Palladium,3,9,1,1.0,1,Marvin Gaye Live At The London Palladium,29.0,3,0,2,6,0,stay,1977-04-09
6400,Marvin Gaye,1977-05-07,Marvin Gaye - Marvin Gaye Live At The London Palladium,1,3,3,1.0,1,Marvin Gaye Live At The London Palladium,29.0,4,-2,0,2,1,down,1977-04-09
6401,Marvin Gaye,1977-05-14,Marvin Gaye - Marvin Gaye Live At The London Palladium,1,1,2,1.0,3,Marvin Gaye Live At The London Palladium,29.0,5,1,-2,0,1,up,1977-04-09
6402,Marvin Gaye,1977-05-21,Marvin Gaye - Marvin Gaye Live At The London Palladium,3,1,2,1.0,2,Marvin Gaye Live At The London Palladium,29.0,6,0,1,-2,0,stay,1977-04-09
6403,Marvin Gaye,1977-05-28,Marvin Gaye - Marvin Gaye Live At The London Palladium,2,3,2,1.0,2,Marvin Gaye Live At The London Palladium,29.0,7,0,0,1,0,stay,1977-04-09
6404,Marvin Gaye,1977-06-04,Marvin Gaye - Marvin Gaye Live At The London Palladium,2,2,2,1.0,2,Marvin Gaye Live At The London Palladium,29.0,8,0,0,0,0,stay,1977-04-09
6405,Marvin Gaye,1977-06-11,Marvin Gaye - Marvin Gaye Live At The London Palladium,2,2,2,1.0,2,Marvin Gaye Live At The London Palladium,29.0,9,0,0,0,0,stay,1977-04-09
6406,Marvin Gaye,1977-06-18,Marvin Gaye - Marvin Gaye Live At The London Palladium,2,2,3,1.0,2,Marvin Gaye Live At The London Palladium,29.0,10,-1,0,0,1,down,1977-04-09
6407,Marvin Gaye,1977-06-25,Marvin Gaye - Marvin Gaye Live At The London Palladium,2,2,5,1.0,3,Marvin Gaye Live At The London Palladium,29.0,11,-2,-1,0,1,down,1977-04-09
6408,Marvin Gaye,1977-07-02,Marvin Gaye - Marvin Gaye Live At The London Palladium,3,2,5,1.0,5,Marvin Gaye Live At The London Palladium,29.0,12,0,-2,-1,0,stay,1977-04-09
6409,Marvin Gaye,1977-07-09,Marvin Gaye - Marvin Gaye Live At The London Palladium,5,3,5,1.0,5,Marvin Gaye Live At The London Palladium,29.0,13,0,0,-2,0,stay,1977-04-09
6410,Marvin Gaye,1977-07-16,Marvin Gaye - Marvin Gaye Live At The London Palladium,5,5,5,1.0,5,Marvin Gaye Live At The London Palladium,29.0,14,0,0,0,0,stay,1977-04-09
6411,Marvin Gaye,1977-07-23,Marvin Gaye - Marvin Gaye Live At The London Palladium,5,5,7,1.0,5,Marvin Gaye Live At The London Palladium,29.0,15,-2,0,0,1,down,1977-04-09
6412,Marvin Gaye,1977-07-30,Marvin Gaye - Marvin Gaye Live At The London Palladium,5,5,10,1.0,7,Marvin Gaye Live At The London Palladium,29.0,16,-3,-2,0,1,down,1977-04-09
6413,Marvin Gaye,1977-08-06,Marvin Gaye - Marvin Gaye Live At The London Palladium,7,5,10,1.0,10,Marvin Gaye Live At The London Palladium,29.0,17,0,-3,-2,0,stay,1977-04-09
6414,Marvin Gaye,1977-08-13,Marvin Gaye - Marvin Gaye Live At The London Palladium,10,7,18,1.0,10,Marvin Gaye Live At The London Palladium,29.0,18,-8,0,-3,1,down,1977-04-09
6415,Marvin Gaye,1977-08-20,Marvin Gaye - Marvin Gaye Live At The London Palladium,10,10,22,1.0,18,Marvin Gaye Live At The London Palladium,29.0,19,-4,-8,0,1,down,1977-04-09
6416,Marvin Gaye,1977-08-27,Marvin Gaye - Marvin Gaye Live At The London Palladium,18,10,26,1.0,22,Marvin Gaye Live At The London Palladium,29.0,20,-4,-4,-8,1,down,1977-04-09
6417,Marvin Gaye,1977-09-03,Marvin Gaye - Marvin Gaye Live At The London Palladium,22,18,29,1.0,26,Marvin Gaye Live At The London Palladium,29.0,21,-3,-4,-4,1,down,1977-04-09
6418,Marvin Gaye,1977-09-10,Marvin Gaye - Marvin Gaye Live At The London Palladium,26,22,29,1.0,29,Marvin Gaye Live At The London Palladium,29.0,22,0,-3,-4,0,stay,1977-04-09
6419,Marvin Gaye,1977-09-17,Marvin Gaye - Marvin Gaye Live At The London Palladium,29,26,33,1.0,29,Marvin Gaye Live At The London Palladium,29.0,23,-4,0,-3,1,down,1977-04-09
6420,Marvin Gaye,1977-09-24,Marvin Gaye - Marvin Gaye Live At The London Palladium,29,29,34,1.0,33,Marvin Gaye Live At The London Palladium,29.0,24,-1,-4,0,1,down,1977-04-09
6421,Marvin Gaye,1977-10-01,Marvin Gaye - Marvin Gaye Live At The London Palladium,33,29,36,1.0,34,Marvin Gaye Live At The London Palladium,29.0,25,-2,-1,-4,1,down,1977-04-09
6422,Marvin Gaye,1977-10-08,Marvin Gaye - Marvin Gaye Live At The London Palladium,34,33,36,1.0,36,Marvin Gaye Live At The London Palladium,29.0,26,0,-2,-1,0,stay,1977-04-09
6423,Marvin Gaye,1977-10-15,Marvin Gaye - Marvin Gaye Live At The London Palladium,36,34,41,1.0,36,Marvin Gaye Live At The London Palladium,29.0,27,-5,0,-2,1,down,1977-04-09
6424,Marvin Gaye,1977-10-22,Marvin Gaye - Marvin Gaye Live At The London Palladium,36,36,50,1.0,41,Marvin Gaye Live At The London Palladium,29.0,28,-9,-5,0,1,down,1977-04-09
6425,Marvin Gaye,1977-10-29,Marvin Gaye - Marvin Gaye Live At The London Palladium,41,36,51,1.0,50,Marvin Gaye Live At The London Palladium,29.0,29,-1,-9,-5,1,down,1977-04-09
6426,Commodores,1977-04-09,Commodores - Commodores,51,51,10,1.0,27,Commodores,40.0,0,17,24,0,1,up,1977-04-09
6427,Commodores,1977-04-16,Commodores - Commodores,27,51,7,1.0,10,Commodores,40.0,1,3,17,24,1,up,1977-04-09
6428,Commodores,1977-04-23,Commodores - Commodores,10,27,4,1.0,7,Commodores,40.0,2,3,3,17,1,up,1977-04-09
6429,Commodores,1977-04-30,Commodores - Commodores,7,10,2,1.0,4,Commodores,40.0,3,2,3,3,1,up,1977-04-09
6430,Commodores,1977-05-07,Commodores - Commodores,4,7,2,1.0,2,Commodores,40.0,4,0,2,3,0,stay,1977-04-09
6431,Commodores,1977-05-14,Commodores - Commodores,2,4,1,1.0,2,Commodores,40.0,5,1,0,2,1,up,1977-04-09
6432,Commodores,1977-05-21,Commodores - Commodores,2,2,1,1.0,1,Commodores,40.0,6,0,1,0,0,stay,1977-04-09
6433,Commodores,1977-05-28,Commodores - Commodores,1,2,1,1.0,1,Commodores,40.0,7,0,0,1,0,stay,1977-04-09
6434,Commodores,1977-06-04,Commodores - Commodores,1,1,1,1.0,1,Commodores,40.0,8,0,0,0,0,stay,1977-04-09
6435,Commodores,1977-06-11,Commodores - Commodores,1,1,1,1.0,1,Commodores,40.0,9,0,0,0,0,stay,1977-04-09
6436,Commodores,1977-06-18,Commodores - Commodores,1,1,2,1.0,1,Commodores,40.0,10,-1,0,0,1,down,1977-04-09
6437,Commodores,1977-06-25,Commodores - Commodores,1,1,1,1.0,2,Commodores,40.0,11,1,-1,0,1,up,1977-04-09
6438,Commodores,1977-07-02,Commodores - Commodores,2,1,1,1.0,1,Commodores,40.0,12,0,1,-1,0,stay,1977-04-09
6439,Commodores,1977-07-09,Commodores - Commodores,1,2,1,1.0,1,Commodores,40.0,13,0,0,1,0,stay,1977-04-09
6440,Commodores,1977-07-16,Commodores - Commodores,1,1,4,1.0,1,Commodores,40.0,14,-3,0,0,1,down,1977-04-09
6441,Commodores,1977-07-23,Commodores - Commodores,1,1,3,1.0,4,Commodores,40.0,15,1,-3,0,1,up,1977-04-09
6442,Commodores,1977-07-30,Commodores - Commodores,4,1,2,1.0,3,Commodores,40.0,16,1,1,-3,1,up,1977-04-09
6443,Commodores,1977-08-06,Commodores - Commodores,3,4,2,1.0,2,Commodores,40.0,17,0,1,1,0,stay,1977-04-09
6444,Commodores,1977-08-13,Commodores - Commodores,2,3,3,1.0,2,Commodores,40.0,18,-1,0,1,1,down,1977-04-09
6445,Commodores,1977-08-20,Commodores - Commodores,2,2,3,1.0,3,Commodores,40.0,19,0,-1,0,0,stay,1977-04-09
6446,Commodores,1977-08-27,Commodores - Commodores,3,2,3,1.0,3,Commodores,40.0,20,0,0,-1,0,stay,1977-04-09
6447,Commodores,1977-09-03,Commodores - Commodores,3,3,3,1.0,3,Commodores,40.0,21,0,0,0,0,stay,1977-04-09
6448,Commodores,1977-09-10,Commodores - Commodores,3,3,3,1.0,3,Commodores,40.0,22,0,0,0,0,stay,1977-04-09
6449,Commodores,1977-09-17,Commodores - Commodores,3,3,4,1.0,3,Commodores,40.0,23,-1,0,0,1,down,1977-04-09
6450,Commodores,1977-09-24,Commodores - Commodores,3,3,6,1.0,4,Commodores,40.0,24,-2,-1,0,1,down,1977-04-09
6451,Commodores,1977-10-01,Commodores - Commodores,4,3,6,1.0,6,Commodores,40.0,25,0,-2,-1,0,stay,1977-04-09
6452,Commodores,1977-10-08,Commodores - Commodores,6,4,6,1.0,6,Commodores,40.0,26,0,0,-2,0,stay,1977-04-09
6453,Commodores,1977-10-15,Commodores - Commodores,6,6,7,1.0,6,Commodores,40.0,27,-1,0,0,1,down,1977-04-09
6454,Commodores,1977-10-22,Commodores - Commodores,6,6,9,1.0,7,Commodores,40.0,28,-2,-1,0,1,down,1977-04-09
6455,Commodores,1977-10-29,Commodores - Commodores,7,6,12,1.0,9,Commodores,40.0,29,-3,-2,-1,1,down,1977-04-09
6456,Commodores,1977-11-05,Commodores - Commodores,9,7,12,1.0,12,Commodores,40.0,30,0,-3,-2,0,stay,1977-04-09
6457,Commodores,1977-11-12,Commodores - Commodores,12,9,15,1.0,12,Commodores,40.0,31,-3,0,-3,1,down,1977-04-09
6458,Commodores,1977-11-19,Commodores - Commodores,12,12,27,1.0,15,Commodores,40.0,32,-12,-3,0,1,down,1977-04-09
6459,Commodores,1977-11-26,Commodores - Commodores,15,12,33,1.0,27,Commodores,40.0,33,-6,-12,-3,1,down,1977-04-09
6460,Commodores,1977-12-03,Commodores - Commodores,27,15,37,1.0,33,Commodores,40.0,34,-4,-6,-12,1,down,1977-04-09
6461,Commodores,1977-12-10,Commodores - Commodores,33,27,46,1.0,37,Commodores,40.0,35,-9,-4,-6,1,down,1977-04-09
6462,Commodores,1977-12-17,Commodores - Commodores,37,33,46,1.0,46,Commodores,40.0,36,0,-9,-4,0,stay,1977-04-09
6463,Commodores,1977-12-24,Commodores - Commodores,46,37,46,1.0,46,Commodores,40.0,37,0,0,-9,0,stay,1977-04-09
6464,Commodores,1977-12-31,Commodores - Commodores,46,46,46,1.0,46,Commodores,40.0,38,0,0,0,0,stay,1977-04-09
6465,Commodores,1978-01-07,Commodores - Commodores,46,46,48,1.0,46,Commodores,40.0,39,-2,0,0,1,down,1977-04-09
6466,Commodores,1978-01-14,Commodores - Commodores,46,46,51,1.0,48,Commodores,40.0,40,-3,-2,0,1,down,1977-04-09
6467,Norman Connors,1977-04-09,Norman Connors - Romantic Journey,51,51,35,24.0,44,Romantic Journey,14.0,0,9,7,0,1,up,1977-04-09
6468,Norman Connors,1977-04-16,Norman Connors - Romantic Journey,44,51,32,24.0,35,Romantic Journey,14.0,1,3,9,7,1,up,1977-04-09
6469,Norman Connors,1977-04-23,Norman Connors - Romantic Journey,35,44,27,24.0,32,Romantic Journey,14.0,2,5,3,9,1,up,1977-04-09
6470,Norman Connors,1977-04-30,Norman Connors - Romantic Journey,32,35,24,24.0,27,Romantic Journey,14.0,3,3,5,3,1,up,1977-04-09
6471,Norman Connors,1977-05-07,Norman Connors - Romantic Journey,27,32,24,24.0,24,Romantic Journey,14.0,4,0,3,5,0,stay,1977-04-09
6472,Norman Connors,1977-05-14,Norman Connors - Romantic Journey,24,27,24,24.0,24,Romantic Journey,14.0,5,0,0,3,0,stay,1977-04-09
6473,Norman Connors,1977-05-21,Norman Connors - Romantic Journey,24,24,25,24.0,24,Romantic Journey,14.0,6,-1,0,0,1,down,1977-04-09
6474,Norman Connors,1977-05-28,Norman Connors - Romantic Journey,24,24,27,24.0,25,Romantic Journey,14.0,7,-2,-1,0,1,down,1977-04-09
6475,Norman Connors,1977-06-04,Norman Connors - Romantic Journey,25,24,27,24.0,27,Romantic Journey,14.0,8,0,-2,-1,0,stay,1977-04-09
6476,Norman Connors,1977-06-11,Norman Connors - Romantic Journey,27,25,26,24.0,27,Romantic Journey,14.0,9,1,0,-2,1,up,1977-04-09
6477,Norman Connors,1977-06-18,Norman Connors - Romantic Journey,27,27,38,24.0,26,Romantic Journey,14.0,10,-12,1,0,1,down,1977-04-09
6478,Norman Connors,1977-06-25,Norman Connors - Romantic Journey,26,27,37,24.0,38,Romantic Journey,14.0,11,1,-12,1,1,up,1977-04-09
6479,Norman Connors,1977-07-02,Norman Connors - Romantic Journey,38,26,41,24.0,37,Romantic Journey,14.0,12,-4,1,-12,1,down,1977-04-09
6480,Norman Connors,1977-07-09,Norman Connors - Romantic Journey,37,38,48,24.0,41,Romantic Journey,14.0,13,-7,-4,1,1,down,1977-04-09
6481,Norman Connors,1977-07-16,Norman Connors - Romantic Journey,41,37,51,24.0,48,Romantic Journey,14.0,14,-3,-7,-4,1,down,1977-04-09
6482,The Isley Brothers,1977-04-16,The Isley Brothers - Go For Your Guns,51,51,10,1.0,25,Go For Your Guns,32.0,0,15,26,0,1,up,1977-04-16
6483,The Isley Brothers,1977-04-23,The Isley Brothers - Go For Your Guns,25,51,3,1.0,10,Go For Your Guns,32.0,1,7,15,26,1,up,1977-04-16
6484,The Isley Brothers,1977-04-30,The Isley Brothers - Go For Your Guns,10,25,3,1.0,3,Go For Your Guns,32.0,2,0,7,15,0,stay,1977-04-16
6485,The Isley Brothers,1977-05-07,The Isley Brothers - Go For Your Guns,3,10,1,1.0,3,Go For Your Guns,32.0,3,2,0,7,1,up,1977-04-16
6486,The Isley Brothers,1977-05-14,The Isley Brothers - Go For Your Guns,3,3,3,1.0,1,Go For Your Guns,32.0,4,-2,2,0,1,down,1977-04-16
6487,The Isley Brothers,1977-05-21,The Isley Brothers - Go For Your Guns,1,3,3,1.0,3,Go For Your Guns,32.0,5,0,-2,2,0,stay,1977-04-16
6488,The Isley Brothers,1977-05-28,The Isley Brothers - Go For Your Guns,3,1,3,1.0,3,Go For Your Guns,32.0,6,0,0,-2,0,stay,1977-04-16
6489,The Isley Brothers,1977-06-04,The Isley Brothers - Go For Your Guns,3,3,3,1.0,3,Go For Your Guns,32.0,7,0,0,0,0,stay,1977-04-16
6490,The Isley Brothers,1977-06-11,The Isley Brothers - Go For Your Guns,3,3,3,1.0,3,Go For Your Guns,32.0,8,0,0,0,0,stay,1977-04-16
6491,The Isley Brothers,1977-06-18,The Isley Brothers - Go For Your Guns,3,3,1,1.0,3,Go For Your Guns,32.0,9,2,0,0,1,up,1977-04-16
6492,The Isley Brothers,1977-06-25,The Isley Brothers - Go For Your Guns,3,3,2,1.0,1,Go For Your Guns,32.0,10,-1,2,0,1,down,1977-04-16
6493,The Isley Brothers,1977-07-02,The Isley Brothers - Go For Your Guns,1,3,2,1.0,2,Go For Your Guns,32.0,11,0,-1,2,0,stay,1977-04-16
6494,The Isley Brothers,1977-07-09,The Isley Brothers - Go For Your Guns,2,1,3,1.0,2,Go For Your Guns,32.0,12,-1,0,-1,1,down,1977-04-16
6495,The Isley Brothers,1977-07-16,The Isley Brothers - Go For Your Guns,2,2,3,1.0,3,Go For Your Guns,32.0,13,0,-1,0,0,stay,1977-04-16
6496,The Isley Brothers,1977-07-23,The Isley Brothers - Go For Your Guns,3,2,4,1.0,3,Go For Your Guns,32.0,14,-1,0,-1,1,down,1977-04-16
6497,The Isley Brothers,1977-07-30,The Isley Brothers - Go For Your Guns,3,3,5,1.0,4,Go For Your Guns,32.0,15,-1,-1,0,1,down,1977-04-16
6498,The Isley Brothers,1977-08-06,The Isley Brothers - Go For Your Guns,4,3,5,1.0,5,Go For Your Guns,32.0,16,0,-1,-1,0,stay,1977-04-16
6499,The Isley Brothers,1977-08-13,The Isley Brothers - Go For Your Guns,5,4,5,1.0,5,Go For Your Guns,32.0,17,0,0,-1,0,stay,1977-04-16
6500,The Isley Brothers,1977-08-20,The Isley Brothers - Go For Your Guns,5,5,5,1.0,5,Go For Your Guns,32.0,18,0,0,0,0,stay,1977-04-16
6501,The Isley Brothers,1977-08-27,The Isley Brothers - Go For Your Guns,5,5,5,1.0,5,Go For Your Guns,32.0,19,0,0,0,0,stay,1977-04-16
6502,The Isley Brothers,1977-09-03,The Isley Brothers - Go For Your Guns,5,5,7,1.0,5,Go For Your Guns,32.0,20,-2,0,0,1,down,1977-04-16
6503,The Isley Brothers,1977-09-10,The Isley Brothers - Go For Your Guns,5,5,8,1.0,7,Go For Your Guns,32.0,21,-1,-2,0,1,down,1977-04-16
6504,The Isley Brothers,1977-09-17,The Isley Brothers - Go For Your Guns,7,5,9,1.0,8,Go For Your Guns,32.0,22,-1,-1,-2,1,down,1977-04-16
6505,The Isley Brothers,1977-09-24,The Isley Brothers - Go For Your Guns,8,7,9,1.0,9,Go For Your Guns,32.0,23,0,-1,-1,0,stay,1977-04-16
6506,The Isley Brothers,1977-10-01,The Isley Brothers - Go For Your Guns,9,8,10,1.0,9,Go For Your Guns,32.0,24,-1,0,-1,1,down,1977-04-16
6507,The Isley Brothers,1977-10-08,The Isley Brothers - Go For Your Guns,9,9,16,1.0,10,Go For Your Guns,32.0,25,-6,-1,0,1,down,1977-04-16
6508,The Isley Brothers,1977-10-15,The Isley Brothers - Go For Your Guns,10,9,17,1.0,16,Go For Your Guns,32.0,26,-1,-6,-1,1,down,1977-04-16
6509,The Isley Brothers,1977-10-22,The Isley Brothers - Go For Your Guns,16,10,22,1.0,17,Go For Your Guns,32.0,27,-5,-1,-6,1,down,1977-04-16
6510,The Isley Brothers,1977-10-29,The Isley Brothers - Go For Your Guns,17,16,28,1.0,22,Go For Your Guns,32.0,28,-6,-5,-1,1,down,1977-04-16
6511,The Isley Brothers,1977-11-05,The Isley Brothers - Go For Your Guns,22,17,32,1.0,28,Go For Your Guns,32.0,29,-4,-6,-5,1,down,1977-04-16
6512,The Isley Brothers,1977-11-12,The Isley Brothers - Go For Your Guns,28,22,39,1.0,32,Go For Your Guns,32.0,30,-7,-4,-6,1,down,1977-04-16
6513,The Isley Brothers,1977-11-19,The Isley Brothers - Go For Your Guns,32,28,48,1.0,39,Go For Your Guns,32.0,31,-9,-7,-4,1,down,1977-04-16
6514,The Isley Brothers,1977-11-26,The Isley Brothers - Go For Your Guns,39,32,51,1.0,48,Go For Your Guns,32.0,32,-3,-9,-7,1,down,1977-04-16
6515,Lou Rawls,1977-04-16,Lou Rawls - Unmistakably Lou,51,51,30,14.0,39,Unmistakably Lou,17.0,0,9,12,0,1,up,1977-04-16
6516,Lou Rawls,1977-04-23,Lou Rawls - Unmistakably Lou,39,51,24,14.0,30,Unmistakably Lou,17.0,1,6,9,12,1,up,1977-04-16
6517,Lou Rawls,1977-04-30,Lou Rawls - Unmistakably Lou,30,39,18,14.0,24,Unmistakably Lou,17.0,2,6,6,9,1,up,1977-04-16
6518,Lou Rawls,1977-05-07,Lou Rawls - Unmistakably Lou,24,30,16,14.0,18,Unmistakably Lou,17.0,3,2,6,6,1,up,1977-04-16
6519,Lou Rawls,1977-05-14,Lou Rawls - Unmistakably Lou,18,24,19,14.0,16,Unmistakably Lou,17.0,4,-3,2,6,1,down,1977-04-16
6520,Lou Rawls,1977-05-21,Lou Rawls - Unmistakably Lou,16,18,19,14.0,19,Unmistakably Lou,17.0,5,0,-3,2,0,stay,1977-04-16
6521,Lou Rawls,1977-05-28,Lou Rawls - Unmistakably Lou,19,16,21,14.0,19,Unmistakably Lou,17.0,6,-2,0,-3,1,down,1977-04-16
6522,Lou Rawls,1977-06-04,Lou Rawls - Unmistakably Lou,19,19,22,14.0,21,Unmistakably Lou,17.0,7,-1,-2,0,1,down,1977-04-16
6523,Lou Rawls,1977-06-11,Lou Rawls - Unmistakably Lou,21,19,16,14.0,22,Unmistakably Lou,17.0,8,6,-1,-2,1,up,1977-04-16
6524,Lou Rawls,1977-06-18,Lou Rawls - Unmistakably Lou,22,21,14,14.0,16,Unmistakably Lou,17.0,9,2,6,-1,1,up,1977-04-16
6525,Lou Rawls,1977-06-25,Lou Rawls - Unmistakably Lou,16,22,20,14.0,14,Unmistakably Lou,17.0,10,-6,2,6,1,down,1977-04-16
6526,Lou Rawls,1977-07-02,Lou Rawls - Unmistakably Lou,14,16,27,14.0,20,Unmistakably Lou,17.0,11,-7,-6,2,1,down,1977-04-16
6527,Lou Rawls,1977-07-09,Lou Rawls - Unmistakably Lou,20,14,23,14.0,27,Unmistakably Lou,17.0,12,4,-7,-6,1,up,1977-04-16
6528,Lou Rawls,1977-07-16,Lou Rawls - Unmistakably Lou,27,20,19,14.0,23,Unmistakably Lou,17.0,13,4,4,-7,1,up,1977-04-16
6529,Lou Rawls,1977-07-23,Lou Rawls - Unmistakably Lou,23,27,17,14.0,19,Unmistakably Lou,17.0,14,2,4,4,1,up,1977-04-16
6530,Lou Rawls,1977-07-30,Lou Rawls - Unmistakably Lou,19,23,17,14.0,17,Unmistakably Lou,17.0,15,0,2,4,0,stay,1977-04-16
6531,Lou Rawls,1977-08-06,Lou Rawls - Unmistakably Lou,17,19,32,14.0,17,Unmistakably Lou,17.0,16,-15,0,2,1,down,1977-04-16
6532,Lou Rawls,1977-08-13,Lou Rawls - Unmistakably Lou,17,17,51,14.0,32,Unmistakably Lou,17.0,17,-19,-15,0,1,down,1977-04-16
6533,Gladys Knight And The Pips,1977-04-16,Gladys Knight And The Pips - Still Together,51,51,36,18.0,45,Still Together,12.0,0,9,6,0,1,up,1977-04-16
6534,Gladys Knight And The Pips,1977-04-23,Gladys Knight And The Pips - Still Together,45,51,32,18.0,36,Still Together,12.0,1,4,9,6,1,up,1977-04-16
6535,Gladys Knight And The Pips,1977-04-30,Gladys Knight And The Pips - Still Together,36,45,26,18.0,32,Still Together,12.0,2,6,4,9,1,up,1977-04-16
6536,Gladys Knight And The Pips,1977-05-07,Gladys Knight And The Pips - Still Together,32,36,20,18.0,26,Still Together,12.0,3,6,6,4,1,up,1977-04-16
6537,Gladys Knight And The Pips,1977-05-14,Gladys Knight And The Pips - Still Together,26,32,18,18.0,20,Still Together,12.0,4,2,6,6,1,up,1977-04-16
6538,Gladys Knight And The Pips,1977-05-21,Gladys Knight And The Pips - Still Together,20,26,18,18.0,18,Still Together,12.0,5,0,2,6,0,stay,1977-04-16
6539,Gladys Knight And The Pips,1977-05-28,Gladys Knight And The Pips - Still Together,18,20,24,18.0,18,Still Together,12.0,6,-6,0,2,1,down,1977-04-16
6540,Gladys Knight And The Pips,1977-06-04,Gladys Knight And The Pips - Still Together,18,18,25,18.0,24,Still Together,12.0,7,-1,-6,0,1,down,1977-04-16
6541,Gladys Knight And The Pips,1977-06-11,Gladys Knight And The Pips - Still Together,24,18,28,18.0,25,Still Together,12.0,8,-3,-1,-6,1,down,1977-04-16
6542,Gladys Knight And The Pips,1977-06-18,Gladys Knight And The Pips - Still Together,25,24,27,18.0,28,Still Together,12.0,9,1,-3,-1,1,up,1977-04-16
6543,Gladys Knight And The Pips,1977-06-25,Gladys Knight And The Pips - Still Together,28,25,33,18.0,27,Still Together,12.0,10,-6,1,-3,1,down,1977-04-16
6544,Gladys Knight And The Pips,1977-07-02,Gladys Knight And The Pips - Still Together,27,28,44,18.0,33,Still Together,12.0,11,-11,-6,1,1,down,1977-04-16
6545,Gladys Knight And The Pips,1977-07-09,Gladys Knight And The Pips - Still Together,33,27,51,18.0,44,Still Together,12.0,12,-7,-11,-6,1,down,1977-04-16
6546,Pleasure,1977-04-16,Pleasure - Joyous,51,51,47,34.0,49,Joyous,5.0,0,2,2,0,1,up,1977-04-16
6547,Pleasure,1977-04-23,Pleasure - Joyous,49,51,37,34.0,47,Joyous,5.0,1,10,2,2,1,up,1977-04-16
6548,Pleasure,1977-04-30,Pleasure - Joyous,47,49,34,34.0,37,Joyous,5.0,2,3,10,2,1,up,1977-04-16
6549,Pleasure,1977-05-07,Pleasure - Joyous,37,47,37,34.0,34,Joyous,5.0,3,-3,3,10,1,down,1977-04-16
6550,Pleasure,1977-05-14,Pleasure - Joyous,34,37,43,34.0,37,Joyous,5.0,4,-6,-3,3,1,down,1977-04-16
6551,Pleasure,1977-05-21,Pleasure - Joyous,37,34,51,34.0,43,Joyous,5.0,5,-8,-6,-3,1,down,1977-04-16
6552,Walter Jackson,1977-04-16,Walter Jackson - I Want To Come Back As A Song,51,51,40,25.0,50,I Want To Come Back As A Song,7.0,0,10,1,0,1,up,1977-04-16
6553,Walter Jackson,1977-04-23,Walter Jackson - I Want To Come Back As A Song,50,51,31,25.0,40,I Want To Come Back As A Song,7.0,1,9,10,1,1,up,1977-04-16
6554,Walter Jackson,1977-04-30,Walter Jackson - I Want To Come Back As A Song,40,50,25,25.0,31,I Want To Come Back As A Song,7.0,2,6,9,10,1,up,1977-04-16
6555,Walter Jackson,1977-05-07,Walter Jackson - I Want To Come Back As A Song,31,40,25,25.0,25,I Want To Come Back As A Song,7.0,3,0,6,9,0,stay,1977-04-16
6556,Walter Jackson,1977-05-14,Walter Jackson - I Want To Come Back As A Song,25,31,25,25.0,25,I Want To Come Back As A Song,7.0,4,0,0,6,0,stay,1977-04-16
6557,Walter Jackson,1977-05-21,Walter Jackson - I Want To Come Back As A Song,25,25,46,25.0,25,I Want To Come Back As A Song,7.0,5,-21,0,0,1,down,1977-04-16
6558,Walter Jackson,1977-06-04,Walter Jackson - I Want To Come Back As A Song,25,25,46,25.0,46,I Want To Come Back As A Song,7.0,6,0,-21,0,0,stay,1977-04-16
6559,Walter Jackson,1977-06-11,Walter Jackson - I Want To Come Back As A Song,46,25,51,25.0,46,I Want To Come Back As A Song,7.0,7,-5,0,-21,1,down,1977-04-16
6560,Johnny Guitar Watson,1977-04-23,Johnny Guitar Watson - A Real Mother For Ya,51,51,18,3.0,29,A Real Mother For Ya,30.0,0,11,22,0,1,up,1977-04-23
6561,Johnny Guitar Watson,1977-04-30,Johnny Guitar Watson - A Real Mother For Ya,29,51,9,3.0,18,A Real Mother For Ya,30.0,1,9,11,22,1,up,1977-04-23
6562,Johnny Guitar Watson,1977-05-07,Johnny Guitar Watson - A Real Mother For Ya,18,29,4,3.0,9,A Real Mother For Ya,30.0,2,5,9,11,1,up,1977-04-23
6563,Johnny Guitar Watson,1977-05-14,Johnny Guitar Watson - A Real Mother For Ya,9,18,4,3.0,4,A Real Mother For Ya,30.0,3,0,5,9,0,stay,1977-04-23
6564,Johnny Guitar Watson,1977-05-21,Johnny Guitar Watson - A Real Mother For Ya,4,9,4,3.0,4,A Real Mother For Ya,30.0,4,0,0,5,0,stay,1977-04-23
6565,Johnny Guitar Watson,1977-05-28,Johnny Guitar Watson - A Real Mother For Ya,4,4,4,3.0,4,A Real Mother For Ya,30.0,5,0,0,0,0,stay,1977-04-23
6566,Johnny Guitar Watson,1977-06-04,Johnny Guitar Watson - A Real Mother For Ya,4,4,5,3.0,4,A Real Mother For Ya,30.0,6,-1,0,0,1,down,1977-04-23
6567,Johnny Guitar Watson,1977-06-11,Johnny Guitar Watson - A Real Mother For Ya,4,4,5,3.0,5,A Real Mother For Ya,30.0,7,0,-1,0,0,stay,1977-04-23
6568,Johnny Guitar Watson,1977-06-18,Johnny Guitar Watson - A Real Mother For Ya,5,4,5,3.0,5,A Real Mother For Ya,30.0,8,0,0,-1,0,stay,1977-04-23
6569,Johnny Guitar Watson,1977-06-25,Johnny Guitar Watson - A Real Mother For Ya,5,5,3,3.0,5,A Real Mother For Ya,30.0,9,2,0,0,1,up,1977-04-23
6570,Johnny Guitar Watson,1977-07-02,Johnny Guitar Watson - A Real Mother For Ya,5,5,3,3.0,3,A Real Mother For Ya,30.0,10,0,2,0,0,stay,1977-04-23
6571,Johnny Guitar Watson,1977-07-09,Johnny Guitar Watson - A Real Mother For Ya,3,5,6,3.0,3,A Real Mother For Ya,30.0,11,-3,0,2,1,down,1977-04-23
6572,Johnny Guitar Watson,1977-07-16,Johnny Guitar Watson - A Real Mother For Ya,3,3,6,3.0,6,A Real Mother For Ya,30.0,12,0,-3,0,0,stay,1977-04-23
6573,Johnny Guitar Watson,1977-07-23,Johnny Guitar Watson - A Real Mother For Ya,6,3,6,3.0,6,A Real Mother For Ya,30.0,13,0,0,-3,0,stay,1977-04-23
6574,Johnny Guitar Watson,1977-07-30,Johnny Guitar Watson - A Real Mother For Ya,6,6,6,3.0,6,A Real Mother For Ya,30.0,14,0,0,0,0,stay,1977-04-23
6575,Johnny Guitar Watson,1977-08-06,Johnny Guitar Watson - A Real Mother For Ya,6,6,6,3.0,6,A Real Mother For Ya,30.0,15,0,0,0,0,stay,1977-04-23
6576,Johnny Guitar Watson,1977-08-13,Johnny Guitar Watson - A Real Mother For Ya,6,6,9,3.0,6,A Real Mother For Ya,30.0,16,-3,0,0,1,down,1977-04-23
6577,Johnny Guitar Watson,1977-08-20,Johnny Guitar Watson - A Real Mother For Ya,6,6,10,3.0,9,A Real Mother For Ya,30.0,17,-1,-3,0,1,down,1977-04-23
6578,Johnny Guitar Watson,1977-08-27,Johnny Guitar Watson - A Real Mother For Ya,9,6,15,3.0,10,A Real Mother For Ya,30.0,18,-5,-1,-3,1,down,1977-04-23
6579,Johnny Guitar Watson,1977-09-03,Johnny Guitar Watson - A Real Mother For Ya,10,9,15,3.0,15,A Real Mother For Ya,30.0,19,0,-5,-1,0,stay,1977-04-23
6580,Johnny Guitar Watson,1977-09-10,Johnny Guitar Watson - A Real Mother For Ya,15,10,16,3.0,15,A Real Mother For Ya,30.0,20,-1,0,-5,1,down,1977-04-23
6581,Johnny Guitar Watson,1977-09-17,Johnny Guitar Watson - A Real Mother For Ya,15,15,17,3.0,16,A Real Mother For Ya,30.0,21,-1,-1,0,1,down,1977-04-23
6582,Johnny Guitar Watson,1977-09-24,Johnny Guitar Watson - A Real Mother For Ya,16,15,17,3.0,17,A Real Mother For Ya,30.0,22,0,-1,-1,0,stay,1977-04-23
6583,Johnny Guitar Watson,1977-10-01,Johnny Guitar Watson - A Real Mother For Ya,17,16,21,3.0,17,A Real Mother For Ya,30.0,23,-4,0,-1,1,down,1977-04-23
6584,Johnny Guitar Watson,1977-10-08,Johnny Guitar Watson - A Real Mother For Ya,17,17,23,3.0,21,A Real Mother For Ya,30.0,24,-2,-4,0,1,down,1977-04-23
6585,Johnny Guitar Watson,1977-10-15,Johnny Guitar Watson - A Real Mother For Ya,21,17,24,3.0,23,A Real Mother For Ya,30.0,25,-1,-2,-4,1,down,1977-04-23
6586,Johnny Guitar Watson,1977-10-22,Johnny Guitar Watson - A Real Mother For Ya,23,21,24,3.0,24,A Real Mother For Ya,30.0,26,0,-1,-2,0,stay,1977-04-23
6587,Johnny Guitar Watson,1977-10-29,Johnny Guitar Watson - A Real Mother For Ya,24,23,31,3.0,24,A Real Mother For Ya,30.0,27,-7,0,-1,1,down,1977-04-23
6588,Johnny Guitar Watson,1977-11-05,Johnny Guitar Watson - A Real Mother For Ya,24,24,35,3.0,31,A Real Mother For Ya,30.0,28,-4,-7,0,1,down,1977-04-23
6589,Johnny Guitar Watson,1977-11-12,Johnny Guitar Watson - A Real Mother For Ya,31,24,38,3.0,35,A Real Mother For Ya,30.0,29,-3,-4,-7,1,down,1977-04-23
6590,Johnny Guitar Watson,1977-11-19,Johnny Guitar Watson - A Real Mother For Ya,35,31,51,3.0,38,A Real Mother For Ya,30.0,30,-13,-3,-4,1,down,1977-04-23
6591,Facts Of Life,1977-04-23,Facts Of Life - Sometimes,51,51,39,33.0,44,Sometimes,3.0,0,5,7,0,1,up,1977-04-23
6592,Facts Of Life,1977-04-30,Facts Of Life - Sometimes,44,51,36,33.0,39,Sometimes,3.0,1,3,5,7,1,up,1977-04-23
6593,Facts Of Life,1977-05-07,Facts Of Life - Sometimes,39,44,33,33.0,36,Sometimes,3.0,2,3,3,5,1,up,1977-04-23
6594,Facts Of Life,1977-05-14,Facts Of Life - Sometimes,36,39,51,33.0,33,Sometimes,3.0,3,-18,3,3,1,down,1977-04-23
6595,Alex Haley,1977-04-23,Alex Haley - Alex Haley Tells The Story Of His Search For Roots,51,51,46,46.0,50,Alex Haley Tells The Story Of His Search For Roots,1.0,0,4,1,0,1,up,1977-04-23
6596,Alex Haley,1977-04-30,Alex Haley - Alex Haley Tells The Story Of His Search For Roots,50,51,51,46.0,46,Alex Haley Tells The Story Of His Search For Roots,1.0,1,-5,4,1,1,down,1977-04-23
6597,Graham Central Station,1977-04-30,Graham Central Station - Now Do-u-wanta Dance,51,51,27,12.0,33,Now Do-u-wanta Dance,14.0,0,6,18,0,1,up,1977-04-30
6598,Graham Central Station,1977-05-07,Graham Central Station - Now Do-u-wanta Dance,33,51,17,12.0,27,Now Do-u-wanta Dance,14.0,1,10,6,18,1,up,1977-04-30
6599,Graham Central Station,1977-05-14,Graham Central Station - Now Do-u-wanta Dance,27,33,12,12.0,17,Now Do-u-wanta Dance,14.0,2,5,10,6,1,up,1977-04-30
6600,Graham Central Station,1977-05-21,Graham Central Station - Now Do-u-wanta Dance,17,27,12,12.0,12,Now Do-u-wanta Dance,14.0,3,0,5,10,0,stay,1977-04-30
6601,Graham Central Station,1977-05-28,Graham Central Station - Now Do-u-wanta Dance,12,17,17,12.0,12,Now Do-u-wanta Dance,14.0,4,-5,0,5,1,down,1977-04-30
6602,Graham Central Station,1977-06-04,Graham Central Station - Now Do-u-wanta Dance,12,12,16,12.0,17,Now Do-u-wanta Dance,14.0,5,1,-5,0,1,up,1977-04-30
6603,Graham Central Station,1977-06-11,Graham Central Station - Now Do-u-wanta Dance,17,12,20,12.0,16,Now Do-u-wanta Dance,14.0,6,-4,1,-5,1,down,1977-04-30
6604,Graham Central Station,1977-06-18,Graham Central Station - Now Do-u-wanta Dance,16,17,33,12.0,20,Now Do-u-wanta Dance,14.0,7,-13,-4,1,1,down,1977-04-30
6605,Graham Central Station,1977-06-25,Graham Central Station - Now Do-u-wanta Dance,20,16,41,12.0,33,Now Do-u-wanta Dance,14.0,8,-8,-13,-4,1,down,1977-04-30
6606,Graham Central Station,1977-07-02,Graham Central Station - Now Do-u-wanta Dance,33,20,37,12.0,41,Now Do-u-wanta Dance,14.0,9,4,-8,-13,1,up,1977-04-30
6607,Graham Central Station,1977-07-09,Graham Central Station - Now Do-u-wanta Dance,41,33,37,12.0,37,Now Do-u-wanta Dance,14.0,10,0,4,-8,0,stay,1977-04-30
6608,Graham Central Station,1977-07-16,Graham Central Station - Now Do-u-wanta Dance,37,41,41,12.0,37,Now Do-u-wanta Dance,14.0,11,-4,0,4,1,down,1977-04-30
6609,Graham Central Station,1977-07-23,Graham Central Station - Now Do-u-wanta Dance,37,37,38,12.0,41,Now Do-u-wanta Dance,14.0,12,3,-4,0,1,up,1977-04-30
6610,Graham Central Station,1977-07-30,Graham Central Station - Now Do-u-wanta Dance,41,37,48,12.0,38,Now Do-u-wanta Dance,14.0,13,-10,3,-4,1,down,1977-04-30
6611,Graham Central Station,1977-08-06,Graham Central Station - Now Do-u-wanta Dance,38,41,51,12.0,48,Now Do-u-wanta Dance,14.0,14,-3,-10,3,1,down,1977-04-30
6612,Tavares,1977-04-30,Tavares - Love Storm,51,51,32,15.0,44,Love Storm,13.0,0,12,7,0,1,up,1977-04-30
6613,Tavares,1977-05-07,Tavares - Love Storm,44,51,28,15.0,32,Love Storm,13.0,1,4,12,7,1,up,1977-04-30
6614,Tavares,1977-05-14,Tavares - Love Storm,32,44,22,15.0,28,Love Storm,13.0,2,6,4,12,1,up,1977-04-30
6615,Tavares,1977-05-21,Tavares - Love Storm,28,32,16,15.0,22,Love Storm,13.0,3,6,6,4,1,up,1977-04-30
6616,Tavares,1977-05-28,Tavares - Love Storm,22,28,15,15.0,16,Love Storm,13.0,4,1,6,6,1,up,1977-04-30
6617,Tavares,1977-06-04,Tavares - Love Storm,16,22,15,15.0,15,Love Storm,13.0,5,0,1,6,0,stay,1977-04-30
6618,Tavares,1977-06-11,Tavares - Love Storm,15,16,24,15.0,15,Love Storm,13.0,6,-9,0,1,1,down,1977-04-30
6619,Tavares,1977-06-18,Tavares - Love Storm,15,15,34,15.0,24,Love Storm,13.0,7,-10,-9,0,1,down,1977-04-30
6620,Tavares,1977-06-25,Tavares - Love Storm,24,15,39,15.0,34,Love Storm,13.0,8,-5,-10,-9,1,down,1977-04-30
6621,Tavares,1977-07-02,Tavares - Love Storm,34,24,39,15.0,39,Love Storm,13.0,9,0,-5,-10,0,stay,1977-04-30
6622,Tavares,1977-07-09,Tavares - Love Storm,39,34,39,15.0,39,Love Storm,13.0,10,0,0,-5,0,stay,1977-04-30
6623,Tavares,1977-07-16,Tavares - Love Storm,39,39,38,15.0,39,Love Storm,13.0,11,1,0,0,1,up,1977-04-30
6624,Tavares,1977-07-23,Tavares - Love Storm,39,39,46,15.0,38,Love Storm,13.0,12,-8,1,0,1,down,1977-04-30
6625,Tavares,1977-07-30,Tavares - Love Storm,38,39,51,15.0,46,Love Storm,13.0,13,-5,-8,1,1,down,1977-04-30
6626,Fred Wesley & The Horny Horns,1977-04-30,Fred Wesley & The Horny Horns - A Blow For Me A Toot For You,51,51,39,31.0,49,A Blow For Me A Toot For You,7.0,0,10,2,0,1,up,1977-04-30
6627,Fred Wesley & The Horny Horns,1977-05-07,Fred Wesley & The Horny Horns - A Blow For Me A Toot For You,49,51,34,31.0,39,A Blow For Me A Toot For You,7.0,1,5,10,2,1,up,1977-04-30
6628,Fred Wesley & The Horny Horns,1977-05-14,Fred Wesley & The Horny Horns - A Blow For Me A Toot For You,39,49,33,31.0,34,A Blow For Me A Toot For You,7.0,2,1,5,10,1,up,1977-04-30
6629,Fred Wesley & The Horny Horns,1977-05-21,Fred Wesley & The Horny Horns - A Blow For Me A Toot For You,34,39,33,31.0,33,A Blow For Me A Toot For You,7.0,3,0,1,5,0,stay,1977-04-30
6630,Fred Wesley & The Horny Horns,1977-05-28,Fred Wesley & The Horny Horns - A Blow For Me A Toot For You,33,34,31,31.0,33,A Blow For Me A Toot For You,7.0,4,2,0,1,1,up,1977-04-30
6631,Fred Wesley & The Horny Horns,1977-06-04,Fred Wesley & The Horny Horns - A Blow For Me A Toot For You,33,33,48,31.0,31,A Blow For Me A Toot For You,7.0,5,-17,2,0,1,down,1977-04-30
6632,Fred Wesley & The Horny Horns,1977-06-11,Fred Wesley & The Horny Horns - A Blow For Me A Toot For You,31,33,50,31.0,48,A Blow For Me A Toot For You,7.0,6,-2,-17,2,1,down,1977-04-30
6633,Fred Wesley & The Horny Horns,1977-06-25,Fred Wesley & The Horny Horns - A Blow For Me A Toot For You,48,31,51,31.0,50,A Blow For Me A Toot For You,7.0,7,-1,-2,-17,1,down,1977-04-30
6634,Ronnie Laws,1977-05-07,Ronnie Laws - Friends & Strangers,51,51,23,13.0,43,Friends & Strangers,30.0,0,20,8,0,1,up,1977-05-07
6635,Ronnie Laws,1977-05-14,Ronnie Laws - Friends & Strangers,43,51,17,13.0,23,Friends & Strangers,30.0,1,6,20,8,1,up,1977-05-07
6636,Ronnie Laws,1977-05-21,Ronnie Laws - Friends & Strangers,23,43,13,13.0,17,Friends & Strangers,30.0,2,4,6,20,1,up,1977-05-07
6637,Ronnie Laws,1977-05-28,Ronnie Laws - Friends & Strangers,17,23,13,13.0,13,Friends & Strangers,30.0,3,0,4,6,0,stay,1977-05-07
6638,Ronnie Laws,1977-06-04,Ronnie Laws - Friends & Strangers,13,17,13,13.0,13,Friends & Strangers,30.0,4,0,0,4,0,stay,1977-05-07
6639,Ronnie Laws,1977-06-11,Ronnie Laws - Friends & Strangers,13,13,13,13.0,13,Friends & Strangers,30.0,5,0,0,0,0,stay,1977-05-07
6640,Ronnie Laws,1977-06-18,Ronnie Laws - Friends & Strangers,13,13,17,13.0,13,Friends & Strangers,30.0,6,-4,0,0,1,down,1977-05-07
6641,Ronnie Laws,1977-06-25,Ronnie Laws - Friends & Strangers,13,13,16,13.0,17,Friends & Strangers,30.0,7,1,-4,0,1,up,1977-05-07
6642,Ronnie Laws,1977-07-02,Ronnie Laws - Friends & Strangers,17,13,18,13.0,16,Friends & Strangers,30.0,8,-2,1,-4,1,down,1977-05-07
6643,Ronnie Laws,1977-07-09,Ronnie Laws - Friends & Strangers,16,17,18,13.0,18,Friends & Strangers,30.0,9,0,-2,1,0,stay,1977-05-07
6644,Ronnie Laws,1977-07-16,Ronnie Laws - Friends & Strangers,18,16,21,13.0,18,Friends & Strangers,30.0,10,-3,0,-2,1,down,1977-05-07
6645,Ronnie Laws,1977-07-23,Ronnie Laws - Friends & Strangers,18,18,18,13.0,21,Friends & Strangers,30.0,11,3,-3,0,1,up,1977-05-07
6646,Ronnie Laws,1977-07-30,Ronnie Laws - Friends & Strangers,21,18,22,13.0,18,Friends & Strangers,30.0,12,-4,3,-3,1,down,1977-05-07
6647,Ronnie Laws,1977-08-06,Ronnie Laws - Friends & Strangers,18,21,22,13.0,22,Friends & Strangers,30.0,13,0,-4,3,0,stay,1977-05-07
6648,Ronnie Laws,1977-08-13,Ronnie Laws - Friends & Strangers,22,18,27,13.0,22,Friends & Strangers,30.0,14,-5,0,-4,1,down,1977-05-07
6649,Ronnie Laws,1977-08-20,Ronnie Laws - Friends & Strangers,22,22,28,13.0,27,Friends & Strangers,30.0,15,-1,-5,0,1,down,1977-05-07
6650,Ronnie Laws,1977-08-27,Ronnie Laws - Friends & Strangers,27,22,28,13.0,28,Friends & Strangers,30.0,16,0,-1,-5,0,stay,1977-05-07
6651,Ronnie Laws,1977-09-03,Ronnie Laws - Friends & Strangers,28,27,28,13.0,28,Friends & Strangers,30.0,17,0,0,-1,0,stay,1977-05-07
6652,Ronnie Laws,1977-09-10,Ronnie Laws - Friends & Strangers,28,28,28,13.0,28,Friends & Strangers,30.0,18,0,0,0,0,stay,1977-05-07
6653,Ronnie Laws,1977-09-17,Ronnie Laws - Friends & Strangers,28,28,24,13.0,28,Friends & Strangers,30.0,19,4,0,0,1,up,1977-05-07
6654,Ronnie Laws,1977-09-24,Ronnie Laws - Friends & Strangers,28,28,21,13.0,24,Friends & Strangers,30.0,20,3,4,0,1,up,1977-05-07
6655,Ronnie Laws,1977-10-01,Ronnie Laws - Friends & Strangers,24,28,17,13.0,21,Friends & Strangers,30.0,21,4,3,4,1,up,1977-05-07
6656,Ronnie Laws,1977-10-08,Ronnie Laws - Friends & Strangers,21,24,17,13.0,17,Friends & Strangers,30.0,22,0,4,3,0,stay,1977-05-07
6657,Ronnie Laws,1977-10-15,Ronnie Laws - Friends & Strangers,17,21,18,13.0,17,Friends & Strangers,30.0,23,-1,0,4,1,down,1977-05-07
6658,Ronnie Laws,1977-10-22,Ronnie Laws - Friends & Strangers,17,17,20,13.0,18,Friends & Strangers,30.0,24,-2,-1,0,1,down,1977-05-07
6659,Ronnie Laws,1977-10-29,Ronnie Laws - Friends & Strangers,18,17,21,13.0,20,Friends & Strangers,30.0,25,-1,-2,-1,1,down,1977-05-07
6660,Ronnie Laws,1977-11-05,Ronnie Laws - Friends & Strangers,20,18,25,13.0,21,Friends & Strangers,30.0,26,-4,-1,-2,1,down,1977-05-07
6661,Ronnie Laws,1977-11-12,Ronnie Laws - Friends & Strangers,21,20,27,13.0,25,Friends & Strangers,30.0,27,-2,-4,-1,1,down,1977-05-07
6662,Ronnie Laws,1977-11-19,Ronnie Laws - Friends & Strangers,25,21,34,13.0,27,Friends & Strangers,30.0,28,-7,-2,-4,1,down,1977-05-07
6663,Ronnie Laws,1977-11-26,Ronnie Laws - Friends & Strangers,27,25,37,13.0,34,Friends & Strangers,30.0,29,-3,-7,-2,1,down,1977-05-07
6664,Ronnie Laws,1977-12-03,Ronnie Laws - Friends & Strangers,34,27,51,13.0,37,Friends & Strangers,30.0,30,-14,-3,-7,1,down,1977-05-07
6665,Players Association,1977-05-07,Players Association - Players Association,51,51,36,30.0,44,Players Association,5.0,0,8,7,0,1,up,1977-05-07
6666,Players Association,1977-05-14,Players Association - Players Association,44,51,30,30.0,36,Players Association,5.0,1,6,8,7,1,up,1977-05-07
6667,Players Association,1977-05-21,Players Association - Players Association,36,44,30,30.0,30,Players Association,5.0,2,0,6,8,0,stay,1977-05-07
6668,Players Association,1977-05-28,Players Association - Players Association,30,36,30,30.0,30,Players Association,5.0,3,0,0,6,0,stay,1977-05-07
6669,Players Association,1977-06-04,Players Association - Players Association,30,30,30,30.0,30,Players Association,5.0,4,0,0,0,0,stay,1977-05-07
6670,Players Association,1977-06-11,Players Association - Players Association,30,30,51,30.0,30,Players Association,5.0,5,-21,0,0,1,down,1977-05-07
6671,Parliament,1977-05-07,Parliament - Parliament Live - P Funk Earth Tour,51,51,31,6.0,45,Parliament Live - P Funk Earth Tour,15.0,0,14,6,0,1,up,1977-05-07
6672,Parliament,1977-05-14,Parliament - Parliament Live - P Funk Earth Tour,45,51,20,6.0,31,Parliament Live - P Funk Earth Tour,15.0,1,11,14,6,1,up,1977-05-07
6673,Parliament,1977-05-21,Parliament - Parliament Live - P Funk Earth Tour,31,45,8,6.0,20,Parliament Live - P Funk Earth Tour,15.0,2,12,11,14,1,up,1977-05-07
6674,Parliament,1977-05-28,Parliament - Parliament Live - P Funk Earth Tour,20,31,6,6.0,8,Parliament Live - P Funk Earth Tour,15.0,3,2,12,11,1,up,1977-05-07
6675,Parliament,1977-06-04,Parliament - Parliament Live - P Funk Earth Tour,8,20,6,6.0,6,Parliament Live - P Funk Earth Tour,15.0,4,0,2,12,0,stay,1977-05-07
6676,Parliament,1977-06-11,Parliament - Parliament Live - P Funk Earth Tour,6,8,6,6.0,6,Parliament Live - P Funk Earth Tour,15.0,5,0,0,2,0,stay,1977-05-07
6677,Parliament,1977-06-18,Parliament - Parliament Live - P Funk Earth Tour,6,6,6,6.0,6,Parliament Live - P Funk Earth Tour,15.0,6,0,0,0,0,stay,1977-05-07
6678,Parliament,1977-06-25,Parliament - Parliament Live - P Funk Earth Tour,6,6,10,6.0,6,Parliament Live - P Funk Earth Tour,15.0,7,-4,0,0,1,down,1977-05-07
6679,Parliament,1977-07-02,Parliament - Parliament Live - P Funk Earth Tour,6,6,19,6.0,10,Parliament Live - P Funk Earth Tour,15.0,8,-9,-4,0,1,down,1977-05-07
6680,Parliament,1977-07-09,Parliament - Parliament Live - P Funk Earth Tour,10,6,19,6.0,19,Parliament Live - P Funk Earth Tour,15.0,9,0,-9,-4,0,stay,1977-05-07
6681,Parliament,1977-07-16,Parliament - Parliament Live - P Funk Earth Tour,19,10,23,6.0,19,Parliament Live - P Funk Earth Tour,15.0,10,-4,0,-9,1,down,1977-05-07
6682,Parliament,1977-07-23,Parliament - Parliament Live - P Funk Earth Tour,19,19,21,6.0,23,Parliament Live - P Funk Earth Tour,15.0,11,2,-4,0,1,up,1977-05-07
6683,Parliament,1977-07-30,Parliament - Parliament Live - P Funk Earth Tour,23,19,26,6.0,21,Parliament Live - P Funk Earth Tour,15.0,12,-5,2,-4,1,down,1977-05-07
6684,Parliament,1977-08-06,Parliament - Parliament Live - P Funk Earth Tour,21,23,29,6.0,26,Parliament Live - P Funk Earth Tour,15.0,13,-3,-5,2,1,down,1977-05-07
6685,Parliament,1977-08-13,Parliament - Parliament Live - P Funk Earth Tour,26,21,42,6.0,29,Parliament Live - P Funk Earth Tour,15.0,14,-13,-3,-5,1,down,1977-05-07
6686,Parliament,1977-08-20,Parliament - Parliament Live - P Funk Earth Tour,29,26,51,6.0,42,Parliament Live - P Funk Earth Tour,15.0,15,-9,-13,-3,1,down,1977-05-07
6687,Herbie Hancock,1977-05-07,Herbie Hancock - V.s.o.p.,51,51,32,24.0,46,V.s.o.p.,3.0,0,14,5,0,1,up,1977-05-07
6688,Herbie Hancock,1977-05-14,Herbie Hancock - V.s.o.p.,46,51,26,24.0,32,V.s.o.p.,3.0,1,6,14,5,1,up,1977-05-07
6689,Herbie Hancock,1977-05-21,Herbie Hancock - V.s.o.p.,32,46,24,24.0,26,V.s.o.p.,3.0,2,2,6,14,1,up,1977-05-07
6690,Herbie Hancock,1977-05-28,Herbie Hancock - V.s.o.p.,26,32,51,24.0,24,V.s.o.p.,3.0,3,-27,2,6,1,down,1977-05-07
6691,The Dells,1977-05-07,"The Dells - They Said It Couldn't Be Done, But We Did It",51,51,42,40.0,48,"They Said It Couldn't Be Done, But We Did It",4.0,0,6,3,0,1,up,1977-05-07
6692,The Dells,1977-05-14,"The Dells - They Said It Couldn't Be Done, But We Did It",48,51,42,40.0,42,"They Said It Couldn't Be Done, But We Did It",4.0,1,0,6,3,0,stay,1977-05-07
6693,The Dells,1977-05-21,"The Dells - They Said It Couldn't Be Done, But We Did It",42,48,40,40.0,42,"They Said It Couldn't Be Done, But We Did It",4.0,2,2,0,6,1,up,1977-05-07
6694,The Dells,1977-05-28,"The Dells - They Said It Couldn't Be Done, But We Did It",42,42,42,40.0,40,"They Said It Couldn't Be Done, But We Did It",4.0,3,-2,2,0,1,down,1977-05-07
6695,The Dells,1977-06-04,"The Dells - They Said It Couldn't Be Done, But We Did It",40,42,51,40.0,42,"They Said It Couldn't Be Done, But We Did It",4.0,4,-9,-2,2,1,down,1977-05-07
6696,Lifestyle,1977-05-07,Lifestyle - Lifestyle,51,51,41,41.0,49,Lifestyle,2.0,0,8,2,0,1,up,1977-05-07
6697,Lifestyle,1977-05-14,Lifestyle - Lifestyle,49,51,41,41.0,41,Lifestyle,2.0,1,0,8,2,0,stay,1977-05-07
6698,Lifestyle,1977-05-21,Lifestyle - Lifestyle,41,49,51,41.0,41,Lifestyle,2.0,2,-10,0,8,1,down,1977-05-07
6699,Soundtrack,1977-05-07,Soundtrack - Rocky,51,51,40,32.0,50,Rocky,4.0,0,10,1,0,1,up,1977-05-07
6700,Soundtrack,1977-05-14,Soundtrack - Rocky,50,51,32,32.0,40,Rocky,4.0,1,8,10,1,1,up,1977-05-07
6701,Soundtrack,1977-05-21,Soundtrack - Rocky,40,50,32,32.0,32,Rocky,4.0,2,0,8,10,0,stay,1977-05-07
6702,Soundtrack,1977-05-28,Soundtrack - Rocky,32,40,47,32.0,32,Rocky,4.0,3,-15,0,8,1,down,1977-05-07
6703,Soundtrack,1977-06-11,Soundtrack - Rocky,32,32,51,32.0,47,Rocky,4.0,4,-4,-15,0,1,down,1977-05-07
6704,Sun,1977-05-14,Sun - Sun-Power,51,51,39,39.0,43,Sun-Power,2.0,0,4,8,0,1,up,1977-05-14
6705,Sun,1977-05-21,Sun - Sun-Power,43,51,49,39.0,39,Sun-Power,2.0,1,-10,4,8,1,down,1977-05-14
6706,Sun,1977-05-28,Sun - Sun-Power,39,43,51,39.0,49,Sun-Power,2.0,2,-2,-10,4,1,down,1977-05-14
6707,Joe Tex,1977-05-14,Joe Tex - Bumps And Bruises,51,51,37,32.0,48,Bumps And Bruises,5.0,0,11,3,0,1,up,1977-05-14
6708,Joe Tex,1977-05-21,Joe Tex - Bumps And Bruises,48,51,34,32.0,37,Bumps And Bruises,5.0,1,3,11,3,1,up,1977-05-14
6709,Joe Tex,1977-05-28,Joe Tex - Bumps And Bruises,37,48,32,32.0,34,Bumps And Bruises,5.0,2,2,3,11,1,up,1977-05-14
6710,Joe Tex,1977-06-04,Joe Tex - Bumps And Bruises,34,37,42,32.0,32,Bumps And Bruises,5.0,3,-10,2,3,1,down,1977-05-14
6711,Joe Tex,1977-06-18,Joe Tex - Bumps And Bruises,32,34,42,32.0,42,Bumps And Bruises,5.0,4,0,-10,2,0,stay,1977-05-14
6712,Joe Tex,1977-06-25,Joe Tex - Bumps And Bruises,42,32,51,32.0,42,Bumps And Bruises,5.0,5,-9,0,-10,1,down,1977-05-14
6713,T-Connection,1977-05-14,T-Connection - Magic,51,51,45,32.0,49,Magic,8.0,0,4,2,0,1,up,1977-05-14
6714,T-Connection,1977-05-21,T-Connection - Magic,49,51,36,32.0,45,Magic,8.0,1,9,4,2,1,up,1977-05-14
6715,T-Connection,1977-05-28,T-Connection - Magic,45,49,33,32.0,36,Magic,8.0,2,3,9,4,1,up,1977-05-14
6716,T-Connection,1977-06-04,T-Connection - Magic,36,45,38,32.0,33,Magic,8.0,3,-5,3,9,1,down,1977-05-14
6717,T-Connection,1977-06-11,T-Connection - Magic,33,36,32,32.0,38,Magic,8.0,4,6,-5,3,1,up,1977-05-14
6718,T-Connection,1977-06-18,T-Connection - Magic,38,33,47,32.0,32,Magic,8.0,5,-15,6,-5,1,down,1977-05-14
6719,T-Connection,1977-07-09,T-Connection - Magic,32,38,45,32.0,47,Magic,8.0,6,2,-15,6,1,up,1977-05-14
6720,T-Connection,1977-07-16,T-Connection - Magic,47,32,42,32.0,45,Magic,8.0,7,3,2,-15,1,up,1977-05-14
6721,T-Connection,1977-07-23,T-Connection - Magic,45,47,51,32.0,42,Magic,8.0,8,-9,3,2,1,down,1977-05-14
6722,Celi Bee And The Buzzy Bunch,1977-05-14,Celi Bee And The Buzzy Bunch - Celi Bee & The Buzzy Bunch,51,51,40,39.0,50,Celi Bee & The Buzzy Bunch,3.0,0,10,1,0,1,up,1977-05-14
6723,Celi Bee And The Buzzy Bunch,1977-05-21,Celi Bee And The Buzzy Bunch - Celi Bee & The Buzzy Bunch,50,51,39,39.0,40,Celi Bee & The Buzzy Bunch,3.0,1,1,10,1,1,up,1977-05-14
6724,Celi Bee And The Buzzy Bunch,1977-05-28,Celi Bee And The Buzzy Bunch - Celi Bee & The Buzzy Bunch,40,50,43,39.0,39,Celi Bee & The Buzzy Bunch,3.0,2,-4,1,10,1,down,1977-05-14
6725,Celi Bee And The Buzzy Bunch,1977-06-04,Celi Bee And The Buzzy Bunch - Celi Bee & The Buzzy Bunch,39,40,51,39.0,43,Celi Bee & The Buzzy Bunch,3.0,3,-8,-4,1,1,down,1977-05-14
6726,The Brothers Johnson,1977-05-21,The Brothers Johnson - Right On Time,51,51,10,2.0,36,Right On Time,30.0,0,26,15,0,1,up,1977-05-21
6727,The Brothers Johnson,1977-05-28,The Brothers Johnson - Right On Time,36,51,5,2.0,10,Right On Time,30.0,1,5,26,15,1,up,1977-05-21
6728,The Brothers Johnson,1977-06-04,The Brothers Johnson - Right On Time,10,36,4,2.0,5,Right On Time,30.0,2,1,5,26,1,up,1977-05-21
6729,The Brothers Johnson,1977-06-11,The Brothers Johnson - Right On Time,5,10,4,2.0,4,Right On Time,30.0,3,0,1,5,0,stay,1977-05-21
6730,The Brothers Johnson,1977-06-18,The Brothers Johnson - Right On Time,4,5,4,2.0,4,Right On Time,30.0,4,0,0,1,0,stay,1977-05-21
6731,The Brothers Johnson,1977-06-25,The Brothers Johnson - Right On Time,4,4,4,2.0,4,Right On Time,30.0,5,0,0,0,0,stay,1977-05-21
6732,The Brothers Johnson,1977-07-02,The Brothers Johnson - Right On Time,4,4,4,2.0,4,Right On Time,30.0,6,0,0,0,0,stay,1977-05-21
6733,The Brothers Johnson,1977-07-09,The Brothers Johnson - Right On Time,4,4,2,2.0,4,Right On Time,30.0,7,2,0,0,1,up,1977-05-21
6734,The Brothers Johnson,1977-07-16,The Brothers Johnson - Right On Time,4,4,2,2.0,2,Right On Time,30.0,8,0,2,0,0,stay,1977-05-21
6735,The Brothers Johnson,1977-07-23,The Brothers Johnson - Right On Time,2,4,2,2.0,2,Right On Time,30.0,9,0,0,2,0,stay,1977-05-21
6736,The Brothers Johnson,1977-07-30,The Brothers Johnson - Right On Time,2,2,3,2.0,2,Right On Time,30.0,10,-1,0,0,1,down,1977-05-21
6737,The Brothers Johnson,1977-08-06,The Brothers Johnson - Right On Time,2,2,3,2.0,3,Right On Time,30.0,11,0,-1,0,0,stay,1977-05-21
6738,The Brothers Johnson,1977-08-13,The Brothers Johnson - Right On Time,3,2,4,2.0,3,Right On Time,30.0,12,-1,0,-1,1,down,1977-05-21
6739,The Brothers Johnson,1977-08-20,The Brothers Johnson - Right On Time,3,3,4,2.0,4,Right On Time,30.0,13,0,-1,0,0,stay,1977-05-21
6740,The Brothers Johnson,1977-08-27,The Brothers Johnson - Right On Time,4,3,4,2.0,4,Right On Time,30.0,14,0,0,-1,0,stay,1977-05-21
6741,The Brothers Johnson,1977-09-03,The Brothers Johnson - Right On Time,4,4,4,2.0,4,Right On Time,30.0,15,0,0,0,0,stay,1977-05-21
6742,The Brothers Johnson,1977-09-10,The Brothers Johnson - Right On Time,4,4,4,2.0,4,Right On Time,30.0,16,0,0,0,0,stay,1977-05-21
6743,The Brothers Johnson,1977-09-17,The Brothers Johnson - Right On Time,4,4,5,2.0,4,Right On Time,30.0,17,-1,0,0,1,down,1977-05-21
6744,The Brothers Johnson,1977-09-24,The Brothers Johnson - Right On Time,4,4,7,2.0,5,Right On Time,30.0,18,-2,-1,0,1,down,1977-05-21
6745,The Brothers Johnson,1977-10-01,The Brothers Johnson - Right On Time,5,4,7,2.0,7,Right On Time,30.0,19,0,-2,-1,0,stay,1977-05-21
6746,The Brothers Johnson,1977-10-08,The Brothers Johnson - Right On Time,7,5,9,2.0,7,Right On Time,30.0,20,-2,0,-2,1,down,1977-05-21
6747,The Brothers Johnson,1977-10-15,The Brothers Johnson - Right On Time,7,7,11,2.0,9,Right On Time,30.0,21,-2,-2,0,1,down,1977-05-21
6748,The Brothers Johnson,1977-10-22,The Brothers Johnson - Right On Time,9,7,14,2.0,11,Right On Time,30.0,22,-3,-2,-2,1,down,1977-05-21
6749,The Brothers Johnson,1977-10-29,The Brothers Johnson - Right On Time,11,9,17,2.0,14,Right On Time,30.0,23,-3,-3,-2,1,down,1977-05-21
6750,The Brothers Johnson,1977-11-05,The Brothers Johnson - Right On Time,14,11,19,2.0,17,Right On Time,30.0,24,-2,-3,-3,1,down,1977-05-21
6751,The Brothers Johnson,1977-11-12,The Brothers Johnson - Right On Time,17,14,21,2.0,19,Right On Time,30.0,25,-2,-2,-3,1,down,1977-05-21
6752,The Brothers Johnson,1977-11-19,The Brothers Johnson - Right On Time,19,17,26,2.0,21,Right On Time,30.0,26,-5,-2,-2,1,down,1977-05-21
6753,The Brothers Johnson,1977-11-26,The Brothers Johnson - Right On Time,21,19,39,2.0,26,Right On Time,30.0,27,-13,-5,-2,1,down,1977-05-21
6754,The Brothers Johnson,1977-12-03,The Brothers Johnson - Right On Time,26,21,39,2.0,39,Right On Time,30.0,28,0,-13,-5,0,stay,1977-05-21
6755,The Brothers Johnson,1977-12-10,The Brothers Johnson - Right On Time,39,26,41,2.0,39,Right On Time,30.0,29,-2,0,-13,1,down,1977-05-21
6756,The Brothers Johnson,1977-12-17,The Brothers Johnson - Right On Time,39,39,51,2.0,41,Right On Time,30.0,30,-10,-2,0,1,down,1977-05-21
6757,Richard Pryor,1977-05-21,Richard Pryor - Are You Serious,51,51,26,12.0,44,Are You Serious,11.0,0,18,7,0,1,up,1977-05-21
6758,Richard Pryor,1977-05-28,Richard Pryor - Are You Serious,44,51,16,12.0,26,Are You Serious,11.0,1,10,18,7,1,up,1977-05-21
6759,Richard Pryor,1977-06-04,Richard Pryor - Are You Serious,26,44,12,12.0,16,Are You Serious,11.0,2,4,10,18,1,up,1977-05-21
6760,Richard Pryor,1977-06-11,Richard Pryor - Are You Serious,16,26,12,12.0,12,Are You Serious,11.0,3,0,4,10,0,stay,1977-05-21
6761,Richard Pryor,1977-06-18,Richard Pryor - Are You Serious,12,16,16,12.0,12,Are You Serious,11.0,4,-4,0,4,1,down,1977-05-21
6762,Richard Pryor,1977-06-25,Richard Pryor - Are You Serious,12,12,24,12.0,16,Are You Serious,11.0,5,-8,-4,0,1,down,1977-05-21
6763,Richard Pryor,1977-07-02,Richard Pryor - Are You Serious,16,12,36,12.0,24,Are You Serious,11.0,6,-12,-8,-4,1,down,1977-05-21
6764,Richard Pryor,1977-07-09,Richard Pryor - Are You Serious,24,16,36,12.0,36,Are You Serious,11.0,7,0,-12,-8,0,stay,1977-05-21
6765,Richard Pryor,1977-07-16,Richard Pryor - Are You Serious,36,24,37,12.0,36,Are You Serious,11.0,8,-1,0,-12,1,down,1977-05-21
6766,Richard Pryor,1977-07-23,Richard Pryor - Are You Serious,36,36,37,12.0,37,Are You Serious,11.0,9,0,-1,0,0,stay,1977-05-21
6767,Richard Pryor,1977-07-30,Richard Pryor - Are You Serious,37,36,47,12.0,37,Are You Serious,11.0,10,-10,0,-1,1,down,1977-05-21
6768,Richard Pryor,1977-08-06,Richard Pryor - Are You Serious,37,37,51,12.0,47,Are You Serious,11.0,11,-4,-10,0,1,down,1977-05-21
6769,Dexter Wansel,1977-05-21,Dexter Wansel - What The World Is Comin' To,51,51,45,45.0,47,What The World Is Comin' To,1.0,0,2,4,0,1,up,1977-05-21
6770,Dexter Wansel,1977-05-28,Dexter Wansel - What The World Is Comin' To,47,51,51,45.0,45,What The World Is Comin' To,1.0,1,-6,2,4,1,down,1977-05-21
6771,Bobby Bland,1977-05-21,Bobby Bland - Reflections In Blue,51,51,47,47.0,48,Reflections In Blue,1.0,0,1,3,0,1,up,1977-05-21
6772,Bobby Bland,1977-05-28,Bobby Bland - Reflections In Blue,48,51,51,47.0,47,Reflections In Blue,1.0,1,-4,1,3,1,down,1977-05-21
6773,Phyllis Hyman,1977-05-21,Phyllis Hyman - Phyllis Hyman,51,51,51,49.0,49,Phyllis Hyman,0.0,0,-2,2,0,1,down,1977-05-21
6774,The O'Jays,1977-05-28,The O'Jays - Travelin' At The Speed Of Thought,51,51,25,6.0,38,Travelin' At The Speed Of Thought,25.0,0,13,13,0,1,up,1977-05-28
6775,The O'Jays,1977-06-04,The O'Jays - Travelin' At The Speed Of Thought,38,51,8,6.0,25,Travelin' At The Speed Of Thought,25.0,1,17,13,13,1,up,1977-05-28
6776,The O'Jays,1977-06-11,The O'Jays - Travelin' At The Speed Of Thought,25,38,7,6.0,8,Travelin' At The Speed Of Thought,25.0,2,1,17,13,1,up,1977-05-28
6777,The O'Jays,1977-06-18,The O'Jays - Travelin' At The Speed Of Thought,8,25,7,6.0,7,Travelin' At The Speed Of Thought,25.0,3,0,1,17,0,stay,1977-05-28
6778,The O'Jays,1977-06-25,The O'Jays - Travelin' At The Speed Of Thought,7,8,6,6.0,7,Travelin' At The Speed Of Thought,25.0,4,1,0,1,1,up,1977-05-28
6779,The O'Jays,1977-07-02,The O'Jays - Travelin' At The Speed Of Thought,7,7,9,6.0,6,Travelin' At The Speed Of Thought,25.0,5,-3,1,0,1,down,1977-05-28
6780,The O'Jays,1977-07-09,The O'Jays - Travelin' At The Speed Of Thought,6,7,9,6.0,9,Travelin' At The Speed Of Thought,25.0,6,0,-3,1,0,stay,1977-05-28
6781,The O'Jays,1977-07-16,The O'Jays - Travelin' At The Speed Of Thought,9,6,9,6.0,9,Travelin' At The Speed Of Thought,25.0,7,0,0,-3,0,stay,1977-05-28
6782,The O'Jays,1977-07-23,The O'Jays - Travelin' At The Speed Of Thought,9,9,8,6.0,9,Travelin' At The Speed Of Thought,25.0,8,1,0,0,1,up,1977-05-28
6783,The O'Jays,1977-07-30,The O'Jays - Travelin' At The Speed Of Thought,9,9,11,6.0,8,Travelin' At The Speed Of Thought,25.0,9,-3,1,0,1,down,1977-05-28
6784,The O'Jays,1977-08-06,The O'Jays - Travelin' At The Speed Of Thought,8,9,11,6.0,11,Travelin' At The Speed Of Thought,25.0,10,0,-3,1,0,stay,1977-05-28
6785,The O'Jays,1977-08-13,The O'Jays - Travelin' At The Speed Of Thought,11,8,11,6.0,11,Travelin' At The Speed Of Thought,25.0,11,0,0,-3,0,stay,1977-05-28
6786,The O'Jays,1977-08-20,The O'Jays - Travelin' At The Speed Of Thought,11,11,18,6.0,11,Travelin' At The Speed Of Thought,25.0,12,-7,0,0,1,down,1977-05-28
6787,The O'Jays,1977-08-27,The O'Jays - Travelin' At The Speed Of Thought,11,11,20,6.0,18,Travelin' At The Speed Of Thought,25.0,13,-2,-7,0,1,down,1977-05-28
6788,The O'Jays,1977-09-03,The O'Jays - Travelin' At The Speed Of Thought,18,11,25,6.0,20,Travelin' At The Speed Of Thought,25.0,14,-5,-2,-7,1,down,1977-05-28
6789,The O'Jays,1977-09-10,The O'Jays - Travelin' At The Speed Of Thought,20,18,25,6.0,25,Travelin' At The Speed Of Thought,25.0,15,0,-5,-2,0,stay,1977-05-28
6790,The O'Jays,1977-09-17,The O'Jays - Travelin' At The Speed Of Thought,25,20,25,6.0,25,Travelin' At The Speed Of Thought,25.0,16,0,0,-5,0,stay,1977-05-28
6791,The O'Jays,1977-09-24,The O'Jays - Travelin' At The Speed Of Thought,25,25,26,6.0,25,Travelin' At The Speed Of Thought,25.0,17,-1,0,0,1,down,1977-05-28
6792,The O'Jays,1977-10-01,The O'Jays - Travelin' At The Speed Of Thought,25,25,26,6.0,26,Travelin' At The Speed Of Thought,25.0,18,0,-1,0,0,stay,1977-05-28
6793,The O'Jays,1977-10-08,The O'Jays - Travelin' At The Speed Of Thought,26,25,21,6.0,26,Travelin' At The Speed Of Thought,25.0,19,5,0,-1,1,up,1977-05-28
6794,The O'Jays,1977-10-15,The O'Jays - Travelin' At The Speed Of Thought,26,26,21,6.0,21,Travelin' At The Speed Of Thought,25.0,20,0,5,0,0,stay,1977-05-28
6795,The O'Jays,1977-10-22,The O'Jays - Travelin' At The Speed Of Thought,21,26,27,6.0,21,Travelin' At The Speed Of Thought,25.0,21,-6,0,5,1,down,1977-05-28
6796,The O'Jays,1977-10-29,The O'Jays - Travelin' At The Speed Of Thought,21,21,29,6.0,27,Travelin' At The Speed Of Thought,25.0,22,-2,-6,0,1,down,1977-05-28
6797,The O'Jays,1977-11-05,The O'Jays - Travelin' At The Speed Of Thought,27,21,29,6.0,29,Travelin' At The Speed Of Thought,25.0,23,0,-2,-6,0,stay,1977-05-28
6798,The O'Jays,1977-11-12,The O'Jays - Travelin' At The Speed Of Thought,29,27,34,6.0,29,Travelin' At The Speed Of Thought,25.0,24,-5,0,-2,1,down,1977-05-28
6799,The O'Jays,1977-11-19,The O'Jays - Travelin' At The Speed Of Thought,29,29,51,6.0,34,Travelin' At The Speed Of Thought,25.0,25,-17,-5,0,1,down,1977-05-28
6800,B.T. Express,1977-05-28,B.T. Express - Function At The Junction,51,51,39,39.0,42,Function At The Junction,1.0,0,3,9,0,1,up,1977-05-28
6801,B.T. Express,1977-06-04,B.T. Express - Function At The Junction,42,51,51,39.0,39,Function At The Junction,1.0,1,-12,3,9,1,down,1977-05-28
6802,Weather Report,1977-05-28,Weather Report - Heavy Weather,51,51,35,33.0,43,Heavy Weather,2.0,0,8,8,0,1,up,1977-05-28
6803,Weather Report,1977-06-04,Weather Report - Heavy Weather,43,51,33,33.0,35,Heavy Weather,2.0,1,2,8,8,1,up,1977-05-28
6804,Weather Report,1977-06-11,Weather Report - Heavy Weather,35,43,51,33.0,33,Heavy Weather,2.0,2,-18,2,8,1,down,1977-05-28
6805,Shalamar,1977-05-28,Shalamar - Uptown Festival,51,51,36,22.0,44,Uptown Festival,6.0,0,8,7,0,1,up,1977-05-28
6806,Shalamar,1977-06-04,Shalamar - Uptown Festival,44,51,28,22.0,36,Uptown Festival,6.0,1,8,8,7,1,up,1977-05-28
6807,Shalamar,1977-06-11,Shalamar - Uptown Festival,36,44,22,22.0,28,Uptown Festival,6.0,2,6,8,8,1,up,1977-05-28
6808,Shalamar,1977-06-18,Shalamar - Uptown Festival,28,36,22,22.0,22,Uptown Festival,6.0,3,0,6,8,0,stay,1977-05-28
6809,Shalamar,1977-06-25,Shalamar - Uptown Festival,22,28,43,22.0,22,Uptown Festival,6.0,4,-21,0,6,1,down,1977-05-28
6810,Shalamar,1977-07-02,Shalamar - Uptown Festival,22,22,43,22.0,43,Uptown Festival,6.0,5,0,-21,0,0,stay,1977-05-28
6811,Shalamar,1977-07-09,Shalamar - Uptown Festival,43,22,51,22.0,43,Uptown Festival,6.0,6,-8,0,-21,1,down,1977-05-28
6812,Bob James,1977-05-28,Bob James - BJ4,51,51,38,33.0,46,BJ4,3.0,0,8,5,0,1,up,1977-05-28
6813,Bob James,1977-06-04,Bob James - BJ4,46,51,34,33.0,38,BJ4,3.0,1,4,8,5,1,up,1977-05-28
6814,Bob James,1977-06-11,Bob James - BJ4,38,46,33,33.0,34,BJ4,3.0,2,1,4,8,1,up,1977-05-28
6815,Bob James,1977-06-18,Bob James - BJ4,34,38,51,33.0,33,BJ4,3.0,3,-18,1,4,1,down,1977-05-28
6816,Ramsey Lewis,1977-05-28,Ramsey Lewis - Love Notes,51,51,37,31.0,48,Love Notes,3.0,0,11,3,0,1,up,1977-05-28
6817,Ramsey Lewis,1977-06-04,Ramsey Lewis - Love Notes,48,51,31,31.0,37,Love Notes,3.0,1,6,11,3,1,up,1977-05-28
6818,Ramsey Lewis,1977-06-11,Ramsey Lewis - Love Notes,37,48,31,31.0,31,Love Notes,3.0,2,0,6,11,0,stay,1977-05-28
6819,Ramsey Lewis,1977-06-18,Ramsey Lewis - Love Notes,31,37,51,31.0,31,Love Notes,3.0,3,-20,0,6,1,down,1977-05-28
6820,Idris Muhammad,1977-06-04,Idris Muhammad - Turn This Mutha Out,51,51,35,16.0,48,Turn This Mutha Out,23.0,0,13,3,0,1,up,1977-06-04
6821,Idris Muhammad,1977-06-11,Idris Muhammad - Turn This Mutha Out,48,51,35,16.0,35,Turn This Mutha Out,23.0,1,0,13,3,0,stay,1977-06-04
6822,Idris Muhammad,1977-06-18,Idris Muhammad - Turn This Mutha Out,35,48,32,16.0,35,Turn This Mutha Out,23.0,2,3,0,13,1,up,1977-06-04
6823,Idris Muhammad,1977-06-25,Idris Muhammad - Turn This Mutha Out,35,35,31,16.0,32,Turn This Mutha Out,23.0,3,1,3,0,1,up,1977-06-04
6824,Idris Muhammad,1977-07-02,Idris Muhammad - Turn This Mutha Out,32,35,33,16.0,31,Turn This Mutha Out,23.0,4,-2,1,3,1,down,1977-06-04
6825,Idris Muhammad,1977-07-09,Idris Muhammad - Turn This Mutha Out,31,32,31,16.0,33,Turn This Mutha Out,23.0,5,2,-2,1,1,up,1977-06-04
6826,Idris Muhammad,1977-07-16,Idris Muhammad - Turn This Mutha Out,33,31,29,16.0,31,Turn This Mutha Out,23.0,6,2,2,-2,1,up,1977-06-04
6827,Idris Muhammad,1977-07-23,Idris Muhammad - Turn This Mutha Out,31,33,27,16.0,29,Turn This Mutha Out,23.0,7,2,2,2,1,up,1977-06-04
6828,Idris Muhammad,1977-07-30,Idris Muhammad - Turn This Mutha Out,29,31,23,16.0,27,Turn This Mutha Out,23.0,8,4,2,2,1,up,1977-06-04
6829,Idris Muhammad,1977-08-06,Idris Muhammad - Turn This Mutha Out,27,29,23,16.0,23,Turn This Mutha Out,23.0,9,0,4,2,0,stay,1977-06-04
6830,Idris Muhammad,1977-08-13,Idris Muhammad - Turn This Mutha Out,23,27,16,16.0,23,Turn This Mutha Out,23.0,10,7,0,4,1,up,1977-06-04
6831,Idris Muhammad,1977-08-20,Idris Muhammad - Turn This Mutha Out,23,23,16,16.0,16,Turn This Mutha Out,23.0,11,0,7,0,0,stay,1977-06-04
6832,Idris Muhammad,1977-08-27,Idris Muhammad - Turn This Mutha Out,16,23,19,16.0,16,Turn This Mutha Out,23.0,12,-3,0,7,1,down,1977-06-04
6833,Idris Muhammad,1977-09-03,Idris Muhammad - Turn This Mutha Out,16,16,20,16.0,19,Turn This Mutha Out,23.0,13,-1,-3,0,1,down,1977-06-04
6834,Idris Muhammad,1977-09-10,Idris Muhammad - Turn This Mutha Out,19,16,24,16.0,20,Turn This Mutha Out,23.0,14,-4,-1,-3,1,down,1977-06-04
6835,Idris Muhammad,1977-09-17,Idris Muhammad - Turn This Mutha Out,20,19,26,16.0,24,Turn This Mutha Out,23.0,15,-2,-4,-1,1,down,1977-06-04
6836,Idris Muhammad,1977-09-24,Idris Muhammad - Turn This Mutha Out,24,20,27,16.0,26,Turn This Mutha Out,23.0,16,-1,-2,-4,1,down,1977-06-04
6837,Idris Muhammad,1977-10-01,Idris Muhammad - Turn This Mutha Out,26,24,29,16.0,27,Turn This Mutha Out,23.0,17,-2,-1,-2,1,down,1977-06-04
6838,Idris Muhammad,1977-10-08,Idris Muhammad - Turn This Mutha Out,27,26,33,16.0,29,Turn This Mutha Out,23.0,18,-4,-2,-1,1,down,1977-06-04
6839,Idris Muhammad,1977-10-15,Idris Muhammad - Turn This Mutha Out,29,27,35,16.0,33,Turn This Mutha Out,23.0,19,-2,-4,-2,1,down,1977-06-04
6840,Idris Muhammad,1977-10-22,Idris Muhammad - Turn This Mutha Out,33,29,41,16.0,35,Turn This Mutha Out,23.0,20,-6,-2,-4,1,down,1977-06-04
6841,Idris Muhammad,1977-10-29,Idris Muhammad - Turn This Mutha Out,35,33,42,16.0,41,Turn This Mutha Out,23.0,21,-1,-6,-2,1,down,1977-06-04
6842,Idris Muhammad,1977-11-05,Idris Muhammad - Turn This Mutha Out,41,35,47,16.0,42,Turn This Mutha Out,23.0,22,-5,-1,-6,1,down,1977-06-04
6843,Idris Muhammad,1977-11-12,Idris Muhammad - Turn This Mutha Out,42,41,51,16.0,47,Turn This Mutha Out,23.0,23,-4,-5,-1,1,down,1977-06-04
6844,Tropea,1977-06-04,Tropea - Short Trip To Space,51,51,43,43.0,49,Short Trip To Space,1.0,0,6,2,0,1,up,1977-06-04
6845,Tropea,1977-06-11,Tropea - Short Trip To Space,49,51,51,43.0,43,Short Trip To Space,1.0,1,-8,6,2,1,down,1977-06-04
6846,Hot,1977-06-04,Hot - Hot,51,51,39,28.0,50,Hot,11.0,0,11,1,0,1,up,1977-06-04
6847,Hot,1977-06-11,Hot - Hot,50,51,34,28.0,39,Hot,11.0,1,5,11,1,1,up,1977-06-04
6848,Hot,1977-06-18,Hot - Hot,39,50,28,28.0,34,Hot,11.0,2,6,5,11,1,up,1977-06-04
6849,Hot,1977-06-25,Hot - Hot,34,39,28,28.0,28,Hot,11.0,3,0,6,5,0,stay,1977-06-04
6850,Hot,1977-07-02,Hot - Hot,28,34,28,28.0,28,Hot,11.0,4,0,0,6,0,stay,1977-06-04
6851,Hot,1977-07-09,Hot - Hot,28,28,33,28.0,28,Hot,11.0,5,-5,0,0,1,down,1977-06-04
6852,Hot,1977-07-16,Hot - Hot,28,28,33,28.0,33,Hot,11.0,6,0,-5,0,0,stay,1977-06-04
6853,Hot,1977-07-23,Hot - Hot,33,28,46,28.0,33,Hot,11.0,7,-13,0,-5,1,down,1977-06-04
6854,Hot,1977-08-13,Hot - Hot,33,33,43,28.0,46,Hot,11.0,8,3,-13,0,1,up,1977-06-04
6855,Hot,1977-08-20,Hot - Hot,46,33,41,28.0,43,Hot,11.0,9,2,3,-13,1,up,1977-06-04
6856,Hot,1977-08-27,Hot - Hot,43,46,46,28.0,41,Hot,11.0,10,-5,2,3,1,down,1977-06-04
6857,Hot,1977-09-03,Hot - Hot,41,43,51,28.0,46,Hot,11.0,11,-5,-5,2,1,down,1977-06-04
6858,Donna Summer,1977-06-11,Donna Summer - I Remember Yesterday,51,51,25,11.0,32,I Remember Yesterday,26.0,0,7,19,0,1,up,1977-06-11
6859,Donna Summer,1977-06-18,Donna Summer - I Remember Yesterday,32,51,23,11.0,25,I Remember Yesterday,26.0,1,2,7,19,1,up,1977-06-11
6860,Donna Summer,1977-06-25,Donna Summer - I Remember Yesterday,25,32,17,11.0,23,I Remember Yesterday,26.0,2,6,2,7,1,up,1977-06-11
6861,Donna Summer,1977-07-02,Donna Summer - I Remember Yesterday,23,25,16,11.0,17,I Remember Yesterday,26.0,3,1,6,2,1,up,1977-06-11
6862,Donna Summer,1977-07-09,Donna Summer - I Remember Yesterday,17,23,22,11.0,16,I Remember Yesterday,26.0,4,-6,1,6,1,down,1977-06-11
6863,Donna Summer,1977-07-16,Donna Summer - I Remember Yesterday,16,17,24,11.0,22,I Remember Yesterday,26.0,5,-2,-6,1,1,down,1977-06-11
6864,Donna Summer,1977-07-23,Donna Summer - I Remember Yesterday,22,16,20,11.0,24,I Remember Yesterday,26.0,6,4,-2,-6,1,up,1977-06-11
6865,Donna Summer,1977-07-30,Donna Summer - I Remember Yesterday,24,22,25,11.0,20,I Remember Yesterday,26.0,7,-5,4,-2,1,down,1977-06-11
6866,Donna Summer,1977-08-06,Donna Summer - I Remember Yesterday,20,24,18,11.0,25,I Remember Yesterday,26.0,8,7,-5,4,1,up,1977-06-11
6867,Donna Summer,1977-08-13,Donna Summer - I Remember Yesterday,25,20,15,11.0,18,I Remember Yesterday,26.0,9,3,7,-5,1,up,1977-06-11
6868,Donna Summer,1977-08-20,Donna Summer - I Remember Yesterday,18,25,21,11.0,15,I Remember Yesterday,26.0,10,-6,3,7,1,down,1977-06-11
6869,Donna Summer,1977-08-27,Donna Summer - I Remember Yesterday,15,18,22,11.0,21,I Remember Yesterday,26.0,11,-1,-6,3,1,down,1977-06-11
6870,Donna Summer,1977-09-03,Donna Summer - I Remember Yesterday,21,15,22,11.0,22,I Remember Yesterday,26.0,12,0,-1,-6,0,stay,1977-06-11
6871,Donna Summer,1977-09-10,Donna Summer - I Remember Yesterday,22,21,17,11.0,22,I Remember Yesterday,26.0,13,5,0,-1,1,up,1977-06-11
6872,Donna Summer,1977-09-17,Donna Summer - I Remember Yesterday,22,22,14,11.0,17,I Remember Yesterday,26.0,14,3,5,0,1,up,1977-06-11
6873,Donna Summer,1977-09-24,Donna Summer - I Remember Yesterday,17,22,12,11.0,14,I Remember Yesterday,26.0,15,2,3,5,1,up,1977-06-11
6874,Donna Summer,1977-10-01,Donna Summer - I Remember Yesterday,14,17,12,11.0,12,I Remember Yesterday,26.0,16,0,2,3,0,stay,1977-06-11
6875,Donna Summer,1977-10-08,Donna Summer - I Remember Yesterday,12,14,11,11.0,12,I Remember Yesterday,26.0,17,1,0,2,1,up,1977-06-11
6876,Donna Summer,1977-10-15,Donna Summer - I Remember Yesterday,12,12,13,11.0,11,I Remember Yesterday,26.0,18,-2,1,0,1,down,1977-06-11
6877,Donna Summer,1977-10-22,Donna Summer - I Remember Yesterday,11,12,13,11.0,13,I Remember Yesterday,26.0,19,0,-2,1,0,stay,1977-06-11
6878,Donna Summer,1977-10-29,Donna Summer - I Remember Yesterday,13,11,13,11.0,13,I Remember Yesterday,26.0,20,0,0,-2,0,stay,1977-06-11
6879,Donna Summer,1977-11-05,Donna Summer - I Remember Yesterday,13,13,14,11.0,13,I Remember Yesterday,26.0,21,-1,0,0,1,down,1977-06-11
6880,Donna Summer,1977-11-12,Donna Summer - I Remember Yesterday,13,13,16,11.0,14,I Remember Yesterday,26.0,22,-2,-1,0,1,down,1977-06-11
6881,Donna Summer,1977-11-19,Donna Summer - I Remember Yesterday,14,13,24,11.0,16,I Remember Yesterday,26.0,23,-8,-2,-1,1,down,1977-06-11
6882,Donna Summer,1977-11-26,Donna Summer - I Remember Yesterday,16,14,31,11.0,24,I Remember Yesterday,26.0,24,-7,-8,-2,1,down,1977-06-11
6883,Donna Summer,1977-12-03,Donna Summer - I Remember Yesterday,24,16,36,11.0,31,I Remember Yesterday,26.0,25,-5,-7,-8,1,down,1977-06-11
6884,Donna Summer,1977-12-10,Donna Summer - I Remember Yesterday,31,24,51,11.0,36,I Remember Yesterday,26.0,26,-15,-5,-7,1,down,1977-06-11
6885,Bee Gees,1977-06-11,Bee Gees - Here At Last...Bee Gees...Live,51,51,37,25.0,45,Here At Last...Bee Gees...Live,9.0,0,8,6,0,1,up,1977-06-11
6886,Bee Gees,1977-06-18,Bee Gees - Here At Last...Bee Gees...Live,45,51,29,25.0,37,Here At Last...Bee Gees...Live,9.0,1,8,8,6,1,up,1977-06-11
6887,Bee Gees,1977-06-25,Bee Gees - Here At Last...Bee Gees...Live,37,45,27,25.0,29,Here At Last...Bee Gees...Live,9.0,2,2,8,8,1,up,1977-06-11
6888,Bee Gees,1977-07-02,Bee Gees - Here At Last...Bee Gees...Live,29,37,25,25.0,27,Here At Last...Bee Gees...Live,9.0,3,2,2,8,1,up,1977-06-11
6889,Bee Gees,1977-07-09,Bee Gees - Here At Last...Bee Gees...Live,27,29,29,25.0,25,Here At Last...Bee Gees...Live,9.0,4,-4,2,2,1,down,1977-06-11
6890,Bee Gees,1977-07-16,Bee Gees - Here At Last...Bee Gees...Live,25,27,32,25.0,29,Here At Last...Bee Gees...Live,9.0,5,-3,-4,2,1,down,1977-06-11
6891,Bee Gees,1977-07-23,Bee Gees - Here At Last...Bee Gees...Live,29,25,32,25.0,32,Here At Last...Bee Gees...Live,9.0,6,0,-3,-4,0,stay,1977-06-11
6892,Bee Gees,1977-07-30,Bee Gees - Here At Last...Bee Gees...Live,32,29,32,25.0,32,Here At Last...Bee Gees...Live,9.0,7,0,0,-3,0,stay,1977-06-11
6893,Bee Gees,1977-08-06,Bee Gees - Here At Last...Bee Gees...Live,32,32,50,25.0,32,Here At Last...Bee Gees...Live,9.0,8,-18,0,0,1,down,1977-06-11
6894,Bee Gees,1977-08-27,Bee Gees - Here At Last...Bee Gees...Live,32,32,51,25.0,50,Here At Last...Bee Gees...Live,9.0,9,-1,-18,0,1,down,1977-06-11
6895,Richard Pryor,1977-06-11,Richard Pryor - L.a. Jail,51,51,41,41.0,49,L.a. Jail,3.0,0,8,2,0,1,up,1977-06-11
6896,Richard Pryor,1977-06-18,Richard Pryor - L.a. Jail,49,51,41,41.0,41,L.a. Jail,3.0,1,0,8,2,0,stay,1977-06-11
6897,Richard Pryor,1977-06-25,Richard Pryor - L.a. Jail,41,49,48,41.0,41,L.a. Jail,3.0,2,-7,0,8,1,down,1977-06-11
6898,Richard Pryor,1977-07-02,Richard Pryor - L.a. Jail,41,41,51,41.0,48,L.a. Jail,3.0,3,-3,-7,0,1,down,1977-06-11
6899,Hamilton Bohannon,1977-06-11,Hamilton Bohannon - Phase II,51,51,48,46.0,50,Phase II,5.0,0,2,1,0,1,up,1977-06-11
6900,Hamilton Bohannon,1977-06-18,Hamilton Bohannon - Phase II,50,51,47,46.0,48,Phase II,5.0,1,1,2,1,1,up,1977-06-11
6901,Hamilton Bohannon,1977-06-25,Hamilton Bohannon - Phase II,48,50,49,46.0,47,Phase II,5.0,2,-2,1,2,1,down,1977-06-11
6902,Hamilton Bohannon,1977-07-02,Hamilton Bohannon - Phase II,47,48,49,46.0,49,Phase II,5.0,3,0,-2,1,0,stay,1977-06-11
6903,Hamilton Bohannon,1977-07-09,Hamilton Bohannon - Phase II,49,47,46,46.0,49,Phase II,5.0,4,3,0,-2,1,up,1977-06-11
6904,Hamilton Bohannon,1977-07-16,Hamilton Bohannon - Phase II,49,49,51,46.0,46,Phase II,5.0,5,-5,3,0,1,down,1977-06-11
6905,Aretha Franklin,1977-06-18,Aretha Franklin - Sweet Passion,51,51,10,6.0,15,Sweet Passion,21.0,0,5,36,0,1,up,1977-06-18
6906,Aretha Franklin,1977-06-25,Aretha Franklin - Sweet Passion,15,51,7,6.0,10,Sweet Passion,21.0,1,3,5,36,1,up,1977-06-18
6907,Aretha Franklin,1977-07-02,Aretha Franklin - Sweet Passion,10,15,6,6.0,7,Sweet Passion,21.0,2,1,3,5,1,up,1977-06-18
6908,Aretha Franklin,1977-07-09,Aretha Franklin - Sweet Passion,7,10,14,6.0,6,Sweet Passion,21.0,3,-8,1,3,1,down,1977-06-18
6909,Aretha Franklin,1977-07-16,Aretha Franklin - Sweet Passion,6,7,14,6.0,14,Sweet Passion,21.0,4,0,-8,1,0,stay,1977-06-18
6910,Aretha Franklin,1977-07-23,Aretha Franklin - Sweet Passion,14,6,14,6.0,14,Sweet Passion,21.0,5,0,0,-8,0,stay,1977-06-18
6911,Aretha Franklin,1977-07-30,Aretha Franklin - Sweet Passion,14,14,19,6.0,14,Sweet Passion,21.0,6,-5,0,0,1,down,1977-06-18
6912,Aretha Franklin,1977-08-06,Aretha Franklin - Sweet Passion,14,14,19,6.0,19,Sweet Passion,21.0,7,0,-5,0,0,stay,1977-06-18
6913,Aretha Franklin,1977-08-13,Aretha Franklin - Sweet Passion,19,14,17,6.0,19,Sweet Passion,21.0,8,2,0,-5,1,up,1977-06-18
6914,Aretha Franklin,1977-08-20,Aretha Franklin - Sweet Passion,19,19,13,6.0,17,Sweet Passion,21.0,9,4,2,0,1,up,1977-06-18
6915,Aretha Franklin,1977-08-27,Aretha Franklin - Sweet Passion,17,19,12,6.0,13,Sweet Passion,21.0,10,1,4,2,1,up,1977-06-18
6916,Aretha Franklin,1977-09-03,Aretha Franklin - Sweet Passion,13,17,12,6.0,12,Sweet Passion,21.0,11,0,1,4,0,stay,1977-06-18
6917,Aretha Franklin,1977-09-10,Aretha Franklin - Sweet Passion,12,13,14,6.0,12,Sweet Passion,21.0,12,-2,0,1,1,down,1977-06-18
6918,Aretha Franklin,1977-09-17,Aretha Franklin - Sweet Passion,12,12,15,6.0,14,Sweet Passion,21.0,13,-1,-2,0,1,down,1977-06-18
6919,Aretha Franklin,1977-09-24,Aretha Franklin - Sweet Passion,14,12,15,6.0,15,Sweet Passion,21.0,14,0,-1,-2,0,stay,1977-06-18
6920,Aretha Franklin,1977-10-01,Aretha Franklin - Sweet Passion,15,14,19,6.0,15,Sweet Passion,21.0,15,-4,0,-1,1,down,1977-06-18
6921,Aretha Franklin,1977-10-08,Aretha Franklin - Sweet Passion,15,15,22,6.0,19,Sweet Passion,21.0,16,-3,-4,0,1,down,1977-06-18
6922,Aretha Franklin,1977-10-15,Aretha Franklin - Sweet Passion,19,15,25,6.0,22,Sweet Passion,21.0,17,-3,-3,-4,1,down,1977-06-18
6923,Aretha Franklin,1977-10-22,Aretha Franklin - Sweet Passion,22,19,31,6.0,25,Sweet Passion,21.0,18,-6,-3,-3,1,down,1977-06-18
6924,Aretha Franklin,1977-10-29,Aretha Franklin - Sweet Passion,25,22,36,6.0,31,Sweet Passion,21.0,19,-5,-6,-3,1,down,1977-06-18
6925,Aretha Franklin,1977-11-05,Aretha Franklin - Sweet Passion,31,25,42,6.0,36,Sweet Passion,21.0,20,-6,-5,-6,1,down,1977-06-18
6926,Aretha Franklin,1977-11-12,Aretha Franklin - Sweet Passion,36,31,51,6.0,42,Sweet Passion,21.0,21,-9,-6,-5,1,down,1977-06-18
6927,The Crusaders,1977-06-18,The Crusaders - Free As The Wind,51,51,25,8.0,40,Free As The Wind,20.0,0,15,11,0,1,up,1977-06-18
6928,The Crusaders,1977-06-25,The Crusaders - Free As The Wind,40,51,14,8.0,25,Free As The Wind,20.0,1,11,15,11,1,up,1977-06-18
6929,The Crusaders,1977-07-02,The Crusaders - Free As The Wind,25,40,10,8.0,14,Free As The Wind,20.0,2,4,11,15,1,up,1977-06-18
6930,The Crusaders,1977-07-09,The Crusaders - Free As The Wind,14,25,8,8.0,10,Free As The Wind,20.0,3,2,4,11,1,up,1977-06-18
6931,The Crusaders,1977-07-16,The Crusaders - Free As The Wind,10,14,8,8.0,8,Free As The Wind,20.0,4,0,2,4,0,stay,1977-06-18
6932,The Crusaders,1977-07-23,The Crusaders - Free As The Wind,8,10,12,8.0,8,Free As The Wind,20.0,5,-4,0,2,1,down,1977-06-18
6933,The Crusaders,1977-07-30,The Crusaders - Free As The Wind,8,8,14,8.0,12,Free As The Wind,20.0,6,-2,-4,0,1,down,1977-06-18
6934,The Crusaders,1977-08-06,The Crusaders - Free As The Wind,12,8,14,8.0,14,Free As The Wind,20.0,7,0,-2,-4,0,stay,1977-06-18
6935,The Crusaders,1977-08-13,The Crusaders - Free As The Wind,14,12,22,8.0,14,Free As The Wind,20.0,8,-8,0,-2,1,down,1977-06-18
6936,The Crusaders,1977-08-20,The Crusaders - Free As The Wind,14,14,32,8.0,22,Free As The Wind,20.0,9,-10,-8,0,1,down,1977-06-18
6937,The Crusaders,1977-08-27,The Crusaders - Free As The Wind,22,14,34,8.0,32,Free As The Wind,20.0,10,-2,-10,-8,1,down,1977-06-18
6938,The Crusaders,1977-09-03,The Crusaders - Free As The Wind,32,22,34,8.0,34,Free As The Wind,20.0,11,0,-2,-10,0,stay,1977-06-18
6939,The Crusaders,1977-09-10,The Crusaders - Free As The Wind,34,32,34,8.0,34,Free As The Wind,20.0,12,0,0,-2,0,stay,1977-06-18
6940,The Crusaders,1977-09-17,The Crusaders - Free As The Wind,34,34,39,8.0,34,Free As The Wind,20.0,13,-5,0,0,1,down,1977-06-18
6941,The Crusaders,1977-09-24,The Crusaders - Free As The Wind,34,34,39,8.0,39,Free As The Wind,20.0,14,0,-5,0,0,stay,1977-06-18
6942,The Crusaders,1977-10-01,The Crusaders - Free As The Wind,39,34,42,8.0,39,Free As The Wind,20.0,15,-3,0,-5,1,down,1977-06-18
6943,The Crusaders,1977-10-08,The Crusaders - Free As The Wind,39,39,43,8.0,42,Free As The Wind,20.0,16,-1,-3,0,1,down,1977-06-18
6944,The Crusaders,1977-10-15,The Crusaders - Free As The Wind,42,39,43,8.0,43,Free As The Wind,20.0,17,0,-1,-3,0,stay,1977-06-18
6945,The Crusaders,1977-10-22,The Crusaders - Free As The Wind,43,42,44,8.0,43,Free As The Wind,20.0,18,-1,0,-1,1,down,1977-06-18
6946,The Crusaders,1977-10-29,The Crusaders - Free As The Wind,43,43,49,8.0,44,Free As The Wind,20.0,19,-5,-1,0,1,down,1977-06-18
6947,The Crusaders,1977-11-05,The Crusaders - Free As The Wind,44,43,51,8.0,49,Free As The Wind,20.0,20,-2,-5,-1,1,down,1977-06-18
6948,Brainstorm,1977-06-18,Brainstorm - Stormin',51,51,43,31.0,43,Stormin',13.0,0,0,8,0,0,stay,1977-06-18
6949,Brainstorm,1977-06-25,Brainstorm - Stormin',43,51,44,31.0,43,Stormin',13.0,1,-1,0,8,1,down,1977-06-18
6950,Brainstorm,1977-07-02,Brainstorm - Stormin',43,43,47,31.0,44,Stormin',13.0,2,-3,-1,0,1,down,1977-06-18
6951,Brainstorm,1977-07-30,Brainstorm - Stormin',44,43,37,31.0,47,Stormin',13.0,3,10,-3,-1,1,up,1977-06-18
6952,Brainstorm,1977-08-06,Brainstorm - Stormin',47,44,31,31.0,37,Stormin',13.0,4,6,10,-3,1,up,1977-06-18
6953,Brainstorm,1977-08-13,Brainstorm - Stormin',37,47,31,31.0,31,Stormin',13.0,5,0,6,10,0,stay,1977-06-18
6954,Brainstorm,1977-08-20,Brainstorm - Stormin',31,37,31,31.0,31,Stormin',13.0,6,0,0,6,0,stay,1977-06-18
6955,Brainstorm,1977-08-27,Brainstorm - Stormin',31,31,33,31.0,31,Stormin',13.0,7,-2,0,0,1,down,1977-06-18
6956,Brainstorm,1977-09-03,Brainstorm - Stormin',31,31,36,31.0,33,Stormin',13.0,8,-3,-2,0,1,down,1977-06-18
6957,Brainstorm,1977-09-10,Brainstorm - Stormin',33,31,41,31.0,36,Stormin',13.0,9,-5,-3,-2,1,down,1977-06-18
6958,Brainstorm,1977-09-17,Brainstorm - Stormin',36,33,41,31.0,41,Stormin',13.0,10,0,-5,-3,0,stay,1977-06-18
6959,Brainstorm,1977-09-24,Brainstorm - Stormin',41,36,47,31.0,41,Stormin',13.0,11,-6,0,-5,1,down,1977-06-18
6960,Brainstorm,1977-10-01,Brainstorm - Stormin',41,41,49,31.0,47,Stormin',13.0,12,-2,-6,0,1,down,1977-06-18
6961,Brainstorm,1977-10-08,Brainstorm - Stormin',47,41,51,31.0,49,Stormin',13.0,13,-2,-2,-6,1,down,1977-06-18
6962,David Ruffin,1977-06-18,David Ruffin - In My Stride,51,51,36,36.0,45,In My Stride,4.0,0,9,6,0,1,up,1977-06-18
6963,David Ruffin,1977-06-25,David Ruffin - In My Stride,45,51,36,36.0,36,In My Stride,4.0,1,0,9,6,0,stay,1977-06-18
6964,David Ruffin,1977-07-02,David Ruffin - In My Stride,36,45,42,36.0,36,In My Stride,4.0,2,-6,0,9,1,down,1977-06-18
6965,David Ruffin,1977-07-09,David Ruffin - In My Stride,36,36,49,36.0,42,In My Stride,4.0,3,-7,-6,0,1,down,1977-06-18
6966,David Ruffin,1977-07-16,David Ruffin - In My Stride,42,36,51,36.0,49,In My Stride,4.0,4,-2,-7,-6,1,down,1977-06-18
6967,Thelma Houston & Jerry Butler,1977-06-18,Thelma Houston & Jerry Butler - Thelma & Jerry,51,51,37,20.0,46,Thelma & Jerry,8.0,0,9,5,0,1,up,1977-06-18
6968,Thelma Houston & Jerry Butler,1977-06-25,Thelma Houston & Jerry Butler - Thelma & Jerry,46,51,30,20.0,37,Thelma & Jerry,8.0,1,7,9,5,1,up,1977-06-18
6969,Thelma Houston & Jerry Butler,1977-07-02,Thelma Houston & Jerry Butler - Thelma & Jerry,37,46,24,20.0,30,Thelma & Jerry,8.0,2,6,7,9,1,up,1977-06-18
6970,Thelma Houston & Jerry Butler,1977-07-09,Thelma Houston & Jerry Butler - Thelma & Jerry,30,37,21,20.0,24,Thelma & Jerry,8.0,3,3,6,7,1,up,1977-06-18
6971,Thelma Houston & Jerry Butler,1977-07-16,Thelma Houston & Jerry Butler - Thelma & Jerry,24,30,20,20.0,21,Thelma & Jerry,8.0,4,1,3,6,1,up,1977-06-18
6972,Thelma Houston & Jerry Butler,1977-07-23,Thelma Houston & Jerry Butler - Thelma & Jerry,21,24,35,20.0,20,Thelma & Jerry,8.0,5,-15,1,3,1,down,1977-06-18
6973,Thelma Houston & Jerry Butler,1977-07-30,Thelma Houston & Jerry Butler - Thelma & Jerry,20,21,45,20.0,35,Thelma & Jerry,8.0,6,-10,-15,1,1,down,1977-06-18
6974,Thelma Houston & Jerry Butler,1977-08-06,Thelma Houston & Jerry Butler - Thelma & Jerry,35,20,45,20.0,45,Thelma & Jerry,8.0,7,0,-10,-15,0,stay,1977-06-18
6975,Thelma Houston & Jerry Butler,1977-08-13,Thelma Houston & Jerry Butler - Thelma & Jerry,45,35,51,20.0,45,Thelma & Jerry,8.0,8,-6,0,-10,1,down,1977-06-18
6976,Willie Hutch,1977-06-18,Willie Hutch - Havin' A House Party,51,51,39,26.0,47,Havin' A House Party,20.0,0,8,4,0,1,up,1977-06-18
6977,Willie Hutch,1977-06-25,Willie Hutch - Havin' A House Party,47,51,35,26.0,39,Havin' A House Party,20.0,1,4,8,4,1,up,1977-06-18
6978,Willie Hutch,1977-07-02,Willie Hutch - Havin' A House Party,39,47,29,26.0,35,Havin' A House Party,20.0,2,6,4,8,1,up,1977-06-18
6979,Willie Hutch,1977-07-09,Willie Hutch - Havin' A House Party,35,39,26,26.0,29,Havin' A House Party,20.0,3,3,6,4,1,up,1977-06-18
6980,Willie Hutch,1977-07-16,Willie Hutch - Havin' A House Party,29,35,26,26.0,26,Havin' A House Party,20.0,4,0,3,6,0,stay,1977-06-18
6981,Willie Hutch,1977-07-23,Willie Hutch - Havin' A House Party,26,29,36,26.0,26,Havin' A House Party,20.0,5,-10,0,3,1,down,1977-06-18
6982,Willie Hutch,1977-07-30,Willie Hutch - Havin' A House Party,26,26,35,26.0,36,Havin' A House Party,20.0,6,1,-10,0,1,up,1977-06-18
6983,Willie Hutch,1977-08-06,Willie Hutch - Havin' A House Party,36,26,46,26.0,35,Havin' A House Party,20.0,7,-11,1,-10,1,down,1977-06-18
6984,Willie Hutch,1977-08-20,Willie Hutch - Havin' A House Party,35,36,44,26.0,46,Havin' A House Party,20.0,8,2,-11,1,1,up,1977-06-18
6985,Willie Hutch,1977-08-27,Willie Hutch - Havin' A House Party,46,35,44,26.0,44,Havin' A House Party,20.0,9,0,2,-11,0,stay,1977-06-18
6986,Willie Hutch,1977-09-03,Willie Hutch - Havin' A House Party,44,46,45,26.0,44,Havin' A House Party,20.0,10,-1,0,2,1,down,1977-06-18
6987,Willie Hutch,1977-09-10,Willie Hutch - Havin' A House Party,44,44,46,26.0,45,Havin' A House Party,20.0,11,-1,-1,0,1,down,1977-06-18
6988,Willie Hutch,1977-09-17,Willie Hutch - Havin' A House Party,45,44,48,26.0,46,Havin' A House Party,20.0,12,-2,-1,-1,1,down,1977-06-18
6989,Willie Hutch,1977-09-24,Willie Hutch - Havin' A House Party,46,45,48,26.0,48,Havin' A House Party,20.0,13,0,-2,-1,0,stay,1977-06-18
6990,Willie Hutch,1977-10-01,Willie Hutch - Havin' A House Party,48,46,43,26.0,48,Havin' A House Party,20.0,14,5,0,-2,1,up,1977-06-18
6991,Willie Hutch,1977-10-08,Willie Hutch - Havin' A House Party,48,48,40,26.0,43,Havin' A House Party,20.0,15,3,5,0,1,up,1977-06-18
6992,Willie Hutch,1977-10-15,Willie Hutch - Havin' A House Party,43,48,34,26.0,40,Havin' A House Party,20.0,16,6,3,5,1,up,1977-06-18
6993,Willie Hutch,1977-10-22,Willie Hutch - Havin' A House Party,40,43,34,26.0,34,Havin' A House Party,20.0,17,0,6,3,0,stay,1977-06-18
6994,Willie Hutch,1977-10-29,Willie Hutch - Havin' A House Party,34,40,38,26.0,34,Havin' A House Party,20.0,18,-4,0,6,1,down,1977-06-18
6995,Willie Hutch,1977-11-05,Willie Hutch - Havin' A House Party,34,34,45,26.0,38,Havin' A House Party,20.0,19,-7,-4,0,1,down,1977-06-18
6996,Willie Hutch,1977-11-12,Willie Hutch - Havin' A House Party,38,34,51,26.0,45,Havin' A House Party,20.0,20,-6,-7,-4,1,down,1977-06-18
6997,Noel Pointer,1977-06-18,Noel Pointer - Phantazia,51,51,45,45.0,50,Phantazia,2.0,0,5,1,0,1,up,1977-06-18
6998,Noel Pointer,1977-06-25,Noel Pointer - Phantazia,50,51,45,45.0,45,Phantazia,2.0,1,0,5,1,0,stay,1977-06-18
6999,Noel Pointer,1977-07-02,Noel Pointer - Phantazia,45,50,51,45.0,45,Phantazia,2.0,2,-6,0,5,1,down,1977-06-18
7000,Richard Pryor,1977-06-25,Richard Pryor - Richard Pryor's Greatest Hits,51,51,9,7.0,13,Richard Pryor's Greatest Hits,5.0,0,4,38,0,1,up,1977-06-25
7001,Richard Pryor,1977-07-02,Richard Pryor - Richard Pryor's Greatest Hits,13,51,7,7.0,9,Richard Pryor's Greatest Hits,5.0,1,2,4,38,1,up,1977-06-25
7002,Richard Pryor,1977-07-09,Richard Pryor - Richard Pryor's Greatest Hits,9,13,7,7.0,7,Richard Pryor's Greatest Hits,5.0,2,0,2,4,0,stay,1977-06-25
7003,Richard Pryor,1977-07-16,Richard Pryor - Richard Pryor's Greatest Hits,7,9,13,7.0,7,Richard Pryor's Greatest Hits,5.0,3,-6,0,2,1,down,1977-06-25
7004,Richard Pryor,1977-07-23,Richard Pryor - Richard Pryor's Greatest Hits,7,7,26,7.0,13,Richard Pryor's Greatest Hits,5.0,4,-13,-6,0,1,down,1977-06-25
7005,Richard Pryor,1977-07-30,Richard Pryor - Richard Pryor's Greatest Hits,13,7,51,7.0,26,Richard Pryor's Greatest Hits,5.0,5,-25,-13,-6,1,down,1977-06-25
7006,Tyrone Davis,1977-06-25,Tyrone Davis - Let's Be Closer Together,51,51,25,17.0,35,Let's Be Closer Together,5.0,0,10,16,0,1,up,1977-06-25
7007,Tyrone Davis,1977-07-02,Tyrone Davis - Let's Be Closer Together,35,51,20,17.0,25,Let's Be Closer Together,5.0,1,5,10,16,1,up,1977-06-25
7008,Tyrone Davis,1977-07-09,Tyrone Davis - Let's Be Closer Together,25,35,17,17.0,20,Let's Be Closer Together,5.0,2,3,5,10,1,up,1977-06-25
7009,Tyrone Davis,1977-07-16,Tyrone Davis - Let's Be Closer Together,20,25,40,17.0,17,Let's Be Closer Together,5.0,3,-23,3,5,1,down,1977-06-25
7010,Tyrone Davis,1977-07-23,Tyrone Davis - Let's Be Closer Together,17,20,42,17.0,40,Let's Be Closer Together,5.0,4,-2,-23,3,1,down,1977-06-25
7011,Tyrone Davis,1977-07-30,Tyrone Davis - Let's Be Closer Together,40,17,51,17.0,42,Let's Be Closer Together,5.0,5,-9,-2,-23,1,down,1977-06-25
7012,Bob Marley And The Wailers,1977-06-25,Bob Marley And The Wailers - Exodus,51,51,32,15.0,40,Exodus,15.0,0,8,11,0,1,up,1977-06-25
7013,Bob Marley And The Wailers,1977-07-02,Bob Marley And The Wailers - Exodus,40,51,26,15.0,32,Exodus,15.0,1,6,8,11,1,up,1977-06-25
7014,Bob Marley And The Wailers,1977-07-09,Bob Marley And The Wailers - Exodus,32,40,20,15.0,26,Exodus,15.0,2,6,6,8,1,up,1977-06-25
7015,Bob Marley And The Wailers,1977-07-16,Bob Marley And The Wailers - Exodus,26,32,16,15.0,20,Exodus,15.0,3,4,6,6,1,up,1977-06-25
7016,Bob Marley And The Wailers,1977-07-23,Bob Marley And The Wailers - Exodus,20,26,15,15.0,16,Exodus,15.0,4,1,4,6,1,up,1977-06-25
7017,Bob Marley And The Wailers,1977-07-30,Bob Marley And The Wailers - Exodus,16,20,15,15.0,15,Exodus,15.0,5,0,1,4,0,stay,1977-06-25
7018,Bob Marley And The Wailers,1977-08-06,Bob Marley And The Wailers - Exodus,15,16,20,15.0,15,Exodus,15.0,6,-5,0,1,1,down,1977-06-25
7019,Bob Marley And The Wailers,1977-08-13,Bob Marley And The Wailers - Exodus,15,15,20,15.0,20,Exodus,15.0,7,0,-5,0,0,stay,1977-06-25
7020,Bob Marley And The Wailers,1977-08-20,Bob Marley And The Wailers - Exodus,20,15,19,15.0,20,Exodus,15.0,8,1,0,-5,1,up,1977-06-25
7021,Bob Marley And The Wailers,1977-08-27,Bob Marley And The Wailers - Exodus,20,20,21,15.0,19,Exodus,15.0,9,-2,1,0,1,down,1977-06-25
7022,Bob Marley And The Wailers,1977-09-03,Bob Marley And The Wailers - Exodus,19,20,24,15.0,21,Exodus,15.0,10,-3,-2,1,1,down,1977-06-25
7023,Bob Marley And The Wailers,1977-09-10,Bob Marley And The Wailers - Exodus,21,19,27,15.0,24,Exodus,15.0,11,-3,-3,-2,1,down,1977-06-25
7024,Bob Marley And The Wailers,1977-09-17,Bob Marley And The Wailers - Exodus,24,21,32,15.0,27,Exodus,15.0,12,-5,-3,-3,1,down,1977-06-25
7025,Bob Marley And The Wailers,1977-09-24,Bob Marley And The Wailers - Exodus,27,24,32,15.0,32,Exodus,15.0,13,0,-5,-3,0,stay,1977-06-25
7026,Bob Marley And The Wailers,1977-10-01,Bob Marley And The Wailers - Exodus,32,27,34,15.0,32,Exodus,15.0,14,-2,0,-5,1,down,1977-06-25
7027,Bob Marley And The Wailers,1977-10-08,Bob Marley And The Wailers - Exodus,32,32,51,15.0,34,Exodus,15.0,15,-17,-2,0,1,down,1977-06-25
7028,The Floaters,1977-06-25,The Floaters - Floaters,51,51,26,1.0,46,Floaters,23.0,0,20,5,0,1,up,1977-06-25
7029,The Floaters,1977-07-02,The Floaters - Floaters,46,51,17,1.0,26,Floaters,23.0,1,9,20,5,1,up,1977-06-25
7030,The Floaters,1977-07-09,The Floaters - Floaters,26,46,10,1.0,17,Floaters,23.0,2,7,9,20,1,up,1977-06-25
7031,The Floaters,1977-07-16,The Floaters - Floaters,17,26,7,1.0,10,Floaters,23.0,3,3,7,9,1,up,1977-06-25
7032,The Floaters,1977-07-23,The Floaters - Floaters,10,17,5,1.0,7,Floaters,23.0,4,2,3,7,1,up,1977-06-25
7033,The Floaters,1977-07-30,The Floaters - Floaters,7,10,1,1.0,5,Floaters,23.0,5,4,2,3,1,up,1977-06-25
7034,The Floaters,1977-08-06,The Floaters - Floaters,5,7,1,1.0,1,Floaters,23.0,6,0,4,2,0,stay,1977-06-25
7035,The Floaters,1977-08-13,The Floaters - Floaters,1,5,1,1.0,1,Floaters,23.0,7,0,0,4,0,stay,1977-06-25
7036,The Floaters,1977-08-20,The Floaters - Floaters,1,1,2,1.0,1,Floaters,23.0,8,-1,0,0,1,down,1977-06-25
7037,The Floaters,1977-08-27,The Floaters - Floaters,1,1,2,1.0,2,Floaters,23.0,9,0,-1,0,0,stay,1977-06-25
7038,The Floaters,1977-09-03,The Floaters - Floaters,2,1,2,1.0,2,Floaters,23.0,10,0,0,-1,0,stay,1977-06-25
7039,The Floaters,1977-09-10,The Floaters - Floaters,2,2,2,1.0,2,Floaters,23.0,11,0,0,0,0,stay,1977-06-25
7040,The Floaters,1977-09-17,The Floaters - Floaters,2,2,3,1.0,2,Floaters,23.0,12,-1,0,0,1,down,1977-06-25
7041,The Floaters,1977-09-24,The Floaters - Floaters,2,2,4,1.0,3,Floaters,23.0,13,-1,-1,0,1,down,1977-06-25
7042,The Floaters,1977-10-01,The Floaters - Floaters,3,2,5,1.0,4,Floaters,23.0,14,-1,-1,-1,1,down,1977-06-25
7043,The Floaters,1977-10-08,The Floaters - Floaters,4,3,7,1.0,5,Floaters,23.0,15,-2,-1,-1,1,down,1977-06-25
7044,The Floaters,1977-10-15,The Floaters - Floaters,5,4,8,1.0,7,Floaters,23.0,16,-1,-2,-1,1,down,1977-06-25
7045,The Floaters,1977-10-22,The Floaters - Floaters,7,5,10,1.0,8,Floaters,23.0,17,-2,-1,-2,1,down,1977-06-25
7046,The Floaters,1977-10-29,The Floaters - Floaters,8,7,14,1.0,10,Floaters,23.0,18,-4,-2,-1,1,down,1977-06-25
7047,The Floaters,1977-11-05,The Floaters - Floaters,10,8,20,1.0,14,Floaters,23.0,19,-6,-4,-2,1,down,1977-06-25
7048,The Floaters,1977-11-12,The Floaters - Floaters,14,10,28,1.0,20,Floaters,23.0,20,-8,-6,-4,1,down,1977-06-25
7049,The Floaters,1977-11-19,The Floaters - Floaters,20,14,41,1.0,28,Floaters,23.0,21,-13,-8,-6,1,down,1977-06-25
7050,The Floaters,1977-11-26,The Floaters - Floaters,28,20,41,1.0,41,Floaters,23.0,22,0,-13,-8,0,stay,1977-06-25
7051,The Floaters,1977-12-03,The Floaters - Floaters,41,28,51,1.0,41,Floaters,23.0,23,-10,0,-13,1,down,1977-06-25
7052,Al Jarreau,1977-06-25,Al Jarreau - Look To The Rainbow: Live Recorded In Europe,51,51,40,19.0,48,Look To The Rainbow: Live Recorded In Europe,24.0,0,8,3,0,1,up,1977-06-25
7053,Al Jarreau,1977-07-02,Al Jarreau - Look To The Rainbow: Live Recorded In Europe,48,51,32,19.0,40,Look To The Rainbow: Live Recorded In Europe,24.0,1,8,8,3,1,up,1977-06-25
7054,Al Jarreau,1977-07-09,Al Jarreau - Look To The Rainbow: Live Recorded In Europe,40,48,25,19.0,32,Look To The Rainbow: Live Recorded In Europe,24.0,2,7,8,8,1,up,1977-06-25
7055,Al Jarreau,1977-07-16,Al Jarreau - Look To The Rainbow: Live Recorded In Europe,32,40,22,19.0,25,Look To The Rainbow: Live Recorded In Europe,24.0,3,3,7,8,1,up,1977-06-25
7056,Al Jarreau,1977-07-23,Al Jarreau - Look To The Rainbow: Live Recorded In Europe,25,32,19,19.0,22,Look To The Rainbow: Live Recorded In Europe,24.0,4,3,3,7,1,up,1977-06-25
7057,Al Jarreau,1977-07-30,Al Jarreau - Look To The Rainbow: Live Recorded In Europe,22,25,24,19.0,19,Look To The Rainbow: Live Recorded In Europe,24.0,5,-5,3,3,1,down,1977-06-25
7058,Al Jarreau,1977-08-06,Al Jarreau - Look To The Rainbow: Live Recorded In Europe,19,22,30,19.0,24,Look To The Rainbow: Live Recorded In Europe,24.0,6,-6,-5,3,1,down,1977-06-25
7059,Al Jarreau,1977-08-13,Al Jarreau - Look To The Rainbow: Live Recorded In Europe,24,19,30,19.0,30,Look To The Rainbow: Live Recorded In Europe,24.0,7,0,-6,-5,0,stay,1977-06-25
7060,Al Jarreau,1977-08-20,Al Jarreau - Look To The Rainbow: Live Recorded In Europe,30,24,34,19.0,30,Look To The Rainbow: Live Recorded In Europe,24.0,8,-4,0,-6,1,down,1977-06-25
7061,Al Jarreau,1977-08-27,Al Jarreau - Look To The Rainbow: Live Recorded In Europe,30,30,35,19.0,34,Look To The Rainbow: Live Recorded In Europe,24.0,9,-1,-4,0,1,down,1977-06-25
7062,Al Jarreau,1977-09-03,Al Jarreau - Look To The Rainbow: Live Recorded In Europe,34,30,35,19.0,35,Look To The Rainbow: Live Recorded In Europe,24.0,10,0,-1,-4,0,stay,1977-06-25
7063,Al Jarreau,1977-09-10,Al Jarreau - Look To The Rainbow: Live Recorded In Europe,35,34,36,19.0,35,Look To The Rainbow: Live Recorded In Europe,24.0,11,-1,0,-1,1,down,1977-06-25
7064,Al Jarreau,1977-09-17,Al Jarreau - Look To The Rainbow: Live Recorded In Europe,35,35,36,19.0,36,Look To The Rainbow: Live Recorded In Europe,24.0,12,0,-1,0,0,stay,1977-06-25
7065,Al Jarreau,1977-09-24,Al Jarreau - Look To The Rainbow: Live Recorded In Europe,36,35,36,19.0,36,Look To The Rainbow: Live Recorded In Europe,24.0,13,0,0,-1,0,stay,1977-06-25
7066,Al Jarreau,1977-10-01,Al Jarreau - Look To The Rainbow: Live Recorded In Europe,36,36,37,19.0,36,Look To The Rainbow: Live Recorded In Europe,24.0,14,-1,0,0,1,down,1977-06-25
7067,Al Jarreau,1977-10-08,Al Jarreau - Look To The Rainbow: Live Recorded In Europe,36,36,32,19.0,37,Look To The Rainbow: Live Recorded In Europe,24.0,15,5,-1,0,1,up,1977-06-25
7068,Al Jarreau,1977-10-15,Al Jarreau - Look To The Rainbow: Live Recorded In Europe,37,36,29,19.0,32,Look To The Rainbow: Live Recorded In Europe,24.0,16,3,5,-1,1,up,1977-06-25
7069,Al Jarreau,1977-10-22,Al Jarreau - Look To The Rainbow: Live Recorded In Europe,32,37,25,19.0,29,Look To The Rainbow: Live Recorded In Europe,24.0,17,4,3,5,1,up,1977-06-25
7070,Al Jarreau,1977-10-29,Al Jarreau - Look To The Rainbow: Live Recorded In Europe,29,32,23,19.0,25,Look To The Rainbow: Live Recorded In Europe,24.0,18,2,4,3,1,up,1977-06-25
7071,Al Jarreau,1977-11-05,Al Jarreau - Look To The Rainbow: Live Recorded In Europe,25,29,26,19.0,23,Look To The Rainbow: Live Recorded In Europe,24.0,19,-3,2,4,1,down,1977-06-25
7072,Al Jarreau,1977-11-12,Al Jarreau - Look To The Rainbow: Live Recorded In Europe,23,25,26,19.0,26,Look To The Rainbow: Live Recorded In Europe,24.0,20,0,-3,2,0,stay,1977-06-25
7073,Al Jarreau,1977-11-19,Al Jarreau - Look To The Rainbow: Live Recorded In Europe,26,23,39,19.0,26,Look To The Rainbow: Live Recorded In Europe,24.0,21,-13,0,-3,1,down,1977-06-25
7074,Al Jarreau,1977-11-26,Al Jarreau - Look To The Rainbow: Live Recorded In Europe,26,26,44,19.0,39,Look To The Rainbow: Live Recorded In Europe,24.0,22,-5,-13,0,1,down,1977-06-25
7075,Al Jarreau,1977-12-03,Al Jarreau - Look To The Rainbow: Live Recorded In Europe,39,26,49,19.0,44,Look To The Rainbow: Live Recorded In Europe,24.0,23,-5,-5,-13,1,down,1977-06-25
7076,Al Jarreau,1977-12-10,Al Jarreau - Look To The Rainbow: Live Recorded In Europe,44,39,51,19.0,49,Look To The Rainbow: Live Recorded In Europe,24.0,24,-2,-5,-5,1,down,1977-06-25
7077,Roy Ayers Ubiquity,1977-06-25,Roy Ayers Ubiquity - Lifeline,51,51,38,9.0,49,Lifeline,27.0,0,11,2,0,1,up,1977-06-25
7078,Roy Ayers Ubiquity,1977-07-02,Roy Ayers Ubiquity - Lifeline,49,51,31,9.0,38,Lifeline,27.0,1,7,11,2,1,up,1977-06-25
7079,Roy Ayers Ubiquity,1977-07-09,Roy Ayers Ubiquity - Lifeline,38,49,24,9.0,31,Lifeline,27.0,2,7,7,11,1,up,1977-06-25
7080,Roy Ayers Ubiquity,1977-07-16,Roy Ayers Ubiquity - Lifeline,31,38,18,9.0,24,Lifeline,27.0,3,6,7,7,1,up,1977-06-25
7081,Roy Ayers Ubiquity,1977-07-23,Roy Ayers Ubiquity - Lifeline,24,31,13,9.0,18,Lifeline,27.0,4,5,6,7,1,up,1977-06-25
7082,Roy Ayers Ubiquity,1977-07-30,Roy Ayers Ubiquity - Lifeline,18,24,12,9.0,13,Lifeline,27.0,5,1,5,6,1,up,1977-06-25
7083,Roy Ayers Ubiquity,1977-08-06,Roy Ayers Ubiquity - Lifeline,13,18,12,9.0,12,Lifeline,27.0,6,0,1,5,0,stay,1977-06-25
7084,Roy Ayers Ubiquity,1977-08-13,Roy Ayers Ubiquity - Lifeline,12,13,10,9.0,12,Lifeline,27.0,7,2,0,1,1,up,1977-06-25
7085,Roy Ayers Ubiquity,1977-08-20,Roy Ayers Ubiquity - Lifeline,12,12,9,9.0,10,Lifeline,27.0,8,1,2,0,1,up,1977-06-25
7086,Roy Ayers Ubiquity,1977-08-27,Roy Ayers Ubiquity - Lifeline,10,12,10,9.0,9,Lifeline,27.0,9,-1,1,2,1,down,1977-06-25
7087,Roy Ayers Ubiquity,1977-09-03,Roy Ayers Ubiquity - Lifeline,9,10,10,9.0,10,Lifeline,27.0,10,0,-1,1,0,stay,1977-06-25
7088,Roy Ayers Ubiquity,1977-09-10,Roy Ayers Ubiquity - Lifeline,10,9,11,9.0,10,Lifeline,27.0,11,-1,0,-1,1,down,1977-06-25
7089,Roy Ayers Ubiquity,1977-09-17,Roy Ayers Ubiquity - Lifeline,10,10,13,9.0,11,Lifeline,27.0,12,-2,-1,0,1,down,1977-06-25
7090,Roy Ayers Ubiquity,1977-09-24,Roy Ayers Ubiquity - Lifeline,11,10,13,9.0,13,Lifeline,27.0,13,0,-2,-1,0,stay,1977-06-25
7091,Roy Ayers Ubiquity,1977-10-01,Roy Ayers Ubiquity - Lifeline,13,11,15,9.0,13,Lifeline,27.0,14,-2,0,-2,1,down,1977-06-25
7092,Roy Ayers Ubiquity,1977-10-08,Roy Ayers Ubiquity - Lifeline,13,13,15,9.0,15,Lifeline,27.0,15,0,-2,0,0,stay,1977-06-25
7093,Roy Ayers Ubiquity,1977-10-15,Roy Ayers Ubiquity - Lifeline,15,13,15,9.0,15,Lifeline,27.0,16,0,0,-2,0,stay,1977-06-25
7094,Roy Ayers Ubiquity,1977-10-22,Roy Ayers Ubiquity - Lifeline,15,15,18,9.0,15,Lifeline,27.0,17,-3,0,0,1,down,1977-06-25
7095,Roy Ayers Ubiquity,1977-10-29,Roy Ayers Ubiquity - Lifeline,15,15,19,9.0,18,Lifeline,27.0,18,-1,-3,0,1,down,1977-06-25
7096,Roy Ayers Ubiquity,1977-11-05,Roy Ayers Ubiquity - Lifeline,18,15,21,9.0,19,Lifeline,27.0,19,-2,-1,-3,1,down,1977-06-25
7097,Roy Ayers Ubiquity,1977-11-12,Roy Ayers Ubiquity - Lifeline,19,18,23,9.0,21,Lifeline,27.0,20,-2,-2,-1,1,down,1977-06-25
7098,Roy Ayers Ubiquity,1977-11-19,Roy Ayers Ubiquity - Lifeline,21,19,23,9.0,23,Lifeline,27.0,21,0,-2,-2,0,stay,1977-06-25
7099,Roy Ayers Ubiquity,1977-11-26,Roy Ayers Ubiquity - Lifeline,23,21,24,9.0,23,Lifeline,27.0,22,-1,0,-2,1,down,1977-06-25
7100,Roy Ayers Ubiquity,1977-12-03,Roy Ayers Ubiquity - Lifeline,23,23,31,9.0,24,Lifeline,27.0,23,-7,-1,0,1,down,1977-06-25
7101,Roy Ayers Ubiquity,1977-12-10,Roy Ayers Ubiquity - Lifeline,24,23,31,9.0,31,Lifeline,27.0,24,0,-7,-1,0,stay,1977-06-25
7102,Roy Ayers Ubiquity,1977-12-17,Roy Ayers Ubiquity - Lifeline,31,24,34,9.0,31,Lifeline,27.0,25,-3,0,-7,1,down,1977-06-25
7103,Roy Ayers Ubiquity,1977-12-24,Roy Ayers Ubiquity - Lifeline,31,31,34,9.0,34,Lifeline,27.0,26,0,-3,0,0,stay,1977-06-25
7104,Roy Ayers Ubiquity,1977-12-31,Roy Ayers Ubiquity - Lifeline,34,31,51,9.0,34,Lifeline,27.0,27,-17,0,-3,1,down,1977-06-25
7105,The Emotions,1977-07-02,The Emotions - Rejoice,51,51,8,1.0,18,Rejoice,31.0,0,10,33,0,1,up,1977-07-02
7106,The Emotions,1977-07-09,The Emotions - Rejoice,18,51,4,1.0,8,Rejoice,31.0,1,4,10,33,1,up,1977-07-02
7107,The Emotions,1977-07-16,The Emotions - Rejoice,8,18,1,1.0,4,Rejoice,31.0,2,3,4,10,1,up,1977-07-02
7108,The Emotions,1977-07-23,The Emotions - Rejoice,4,8,1,1.0,1,Rejoice,31.0,3,0,3,4,0,stay,1977-07-02
7109,The Emotions,1977-07-30,The Emotions - Rejoice,1,4,4,1.0,1,Rejoice,31.0,4,-3,0,3,1,down,1977-07-02
7110,The Emotions,1977-08-06,The Emotions - Rejoice,1,1,4,1.0,4,Rejoice,31.0,5,0,-3,0,0,stay,1977-07-02
7111,The Emotions,1977-08-13,The Emotions - Rejoice,4,1,2,1.0,4,Rejoice,31.0,6,2,0,-3,1,up,1977-07-02
7112,The Emotions,1977-08-20,The Emotions - Rejoice,4,4,1,1.0,2,Rejoice,31.0,7,1,2,0,1,up,1977-07-02
7113,The Emotions,1977-08-27,The Emotions - Rejoice,2,4,1,1.0,1,Rejoice,31.0,8,0,1,2,0,stay,1977-07-02
7114,The Emotions,1977-09-03,The Emotions - Rejoice,1,2,1,1.0,1,Rejoice,31.0,9,0,0,1,0,stay,1977-07-02
7115,The Emotions,1977-09-10,The Emotions - Rejoice,1,1,1,1.0,1,Rejoice,31.0,10,0,0,0,0,stay,1977-07-02
7116,The Emotions,1977-09-17,The Emotions - Rejoice,1,1,1,1.0,1,Rejoice,31.0,11,0,0,0,0,stay,1977-07-02
7117,The Emotions,1977-09-24,The Emotions - Rejoice,1,1,2,1.0,1,Rejoice,31.0,12,-1,0,0,1,down,1977-07-02
7118,The Emotions,1977-10-01,The Emotions - Rejoice,1,1,4,1.0,2,Rejoice,31.0,13,-2,-1,0,1,down,1977-07-02
7119,The Emotions,1977-10-08,The Emotions - Rejoice,2,1,5,1.0,4,Rejoice,31.0,14,-1,-2,-1,1,down,1977-07-02
7120,The Emotions,1977-10-15,The Emotions - Rejoice,4,2,6,1.0,5,Rejoice,31.0,15,-1,-1,-2,1,down,1977-07-02
7121,The Emotions,1977-10-22,The Emotions - Rejoice,5,4,6,1.0,6,Rejoice,31.0,16,0,-1,-1,0,stay,1977-07-02
7122,The Emotions,1977-10-29,The Emotions - Rejoice,6,5,7,1.0,6,Rejoice,31.0,17,-1,0,-1,1,down,1977-07-02
7123,The Emotions,1977-11-05,The Emotions - Rejoice,6,6,7,1.0,7,Rejoice,31.0,18,0,-1,0,0,stay,1977-07-02
7124,The Emotions,1977-11-12,The Emotions - Rejoice,7,6,13,1.0,7,Rejoice,31.0,19,-6,0,-1,1,down,1977-07-02
7125,The Emotions,1977-11-19,The Emotions - Rejoice,7,7,14,1.0,13,Rejoice,31.0,20,-1,-6,0,1,down,1977-07-02
7126,The Emotions,1977-11-26,The Emotions - Rejoice,13,7,14,1.0,14,Rejoice,31.0,21,0,-1,-6,0,stay,1977-07-02
7127,The Emotions,1977-12-03,The Emotions - Rejoice,14,13,18,1.0,14,Rejoice,31.0,22,-4,0,-1,1,down,1977-07-02
7128,The Emotions,1977-12-10,The Emotions - Rejoice,14,14,18,1.0,18,Rejoice,31.0,23,0,-4,0,0,stay,1977-07-02
7129,The Emotions,1977-12-17,The Emotions - Rejoice,18,14,21,1.0,18,Rejoice,31.0,24,-3,0,-4,1,down,1977-07-02
7130,The Emotions,1977-12-24,The Emotions - Rejoice,18,18,21,1.0,21,Rejoice,31.0,25,0,-3,0,0,stay,1977-07-02
7131,The Emotions,1977-12-31,The Emotions - Rejoice,21,18,25,1.0,21,Rejoice,31.0,26,-4,0,-3,1,down,1977-07-02
7132,The Emotions,1978-01-07,The Emotions - Rejoice,21,21,32,1.0,25,Rejoice,31.0,27,-7,-4,0,1,down,1977-07-02
7133,The Emotions,1978-01-14,The Emotions - Rejoice,25,21,34,1.0,32,Rejoice,31.0,28,-2,-7,-4,1,down,1977-07-02
7134,The Emotions,1978-01-21,The Emotions - Rejoice,32,25,34,1.0,34,Rejoice,31.0,29,0,-2,-7,0,stay,1977-07-02
7135,The Emotions,1978-01-28,The Emotions - Rejoice,34,32,43,1.0,34,Rejoice,31.0,30,-9,0,-2,1,down,1977-07-02
7136,The Emotions,1978-02-04,The Emotions - Rejoice,34,34,51,1.0,43,Rejoice,31.0,31,-8,-9,0,1,down,1977-07-02
7137,C.J. & Company,1977-07-02,C.J. & Company - Devil's Gun,51,51,40,12.0,50,Devil's Gun,18.0,0,10,1,0,1,up,1977-07-02
7138,C.J. & Company,1977-07-09,C.J. & Company - Devil's Gun,50,51,32,12.0,40,Devil's Gun,18.0,1,8,10,1,1,up,1977-07-02
7139,C.J. & Company,1977-07-16,C.J. & Company - Devil's Gun,40,50,25,12.0,32,Devil's Gun,18.0,2,7,8,10,1,up,1977-07-02
7140,C.J. & Company,1977-07-23,C.J. & Company - Devil's Gun,32,40,22,12.0,25,Devil's Gun,18.0,3,3,7,8,1,up,1977-07-02
7141,C.J. & Company,1977-07-30,C.J. & Company - Devil's Gun,25,32,21,12.0,22,Devil's Gun,18.0,4,1,3,7,1,up,1977-07-02
7142,C.J. & Company,1977-08-06,C.J. & Company - Devil's Gun,22,25,15,12.0,21,Devil's Gun,18.0,5,6,1,3,1,up,1977-07-02
7143,C.J. & Company,1977-08-13,C.J. & Company - Devil's Gun,21,22,13,12.0,15,Devil's Gun,18.0,6,2,6,1,1,up,1977-07-02
7144,C.J. & Company,1977-08-20,C.J. & Company - Devil's Gun,15,21,12,12.0,13,Devil's Gun,18.0,7,1,2,6,1,up,1977-07-02
7145,C.J. & Company,1977-08-27,C.J. & Company - Devil's Gun,13,15,14,12.0,12,Devil's Gun,18.0,8,-2,1,2,1,down,1977-07-02
7146,C.J. & Company,1977-09-03,C.J. & Company - Devil's Gun,12,13,19,12.0,14,Devil's Gun,18.0,9,-5,-2,1,1,down,1977-07-02
7147,C.J. & Company,1977-09-10,C.J. & Company - Devil's Gun,14,12,19,12.0,19,Devil's Gun,18.0,10,0,-5,-2,0,stay,1977-07-02
7148,C.J. & Company,1977-09-17,C.J. & Company - Devil's Gun,19,14,19,12.0,19,Devil's Gun,18.0,11,0,0,-5,0,stay,1977-07-02
7149,C.J. & Company,1977-09-24,C.J. & Company - Devil's Gun,19,19,19,12.0,19,Devil's Gun,18.0,12,0,0,0,0,stay,1977-07-02
7150,C.J. & Company,1977-10-01,C.J. & Company - Devil's Gun,19,19,24,12.0,19,Devil's Gun,18.0,13,-5,0,0,1,down,1977-07-02
7151,C.J. & Company,1977-10-08,C.J. & Company - Devil's Gun,19,19,26,12.0,24,Devil's Gun,18.0,14,-2,-5,0,1,down,1977-07-02
7152,C.J. & Company,1977-10-15,C.J. & Company - Devil's Gun,24,19,33,12.0,26,Devil's Gun,18.0,15,-7,-2,-5,1,down,1977-07-02
7153,C.J. & Company,1977-10-22,C.J. & Company - Devil's Gun,26,24,39,12.0,33,Devil's Gun,18.0,16,-6,-7,-2,1,down,1977-07-02
7154,C.J. & Company,1977-10-29,C.J. & Company - Devil's Gun,33,26,39,12.0,39,Devil's Gun,18.0,17,0,-6,-7,0,stay,1977-07-02
7155,C.J. & Company,1977-11-05,C.J. & Company - Devil's Gun,39,33,51,12.0,39,Devil's Gun,18.0,18,-12,0,-6,1,down,1977-07-02
7156,Soundtrack,1977-07-09,Soundtrack - The Greatest,51,51,41,40.0,46,The Greatest,6.0,0,5,5,0,1,up,1977-07-09
7157,Soundtrack,1977-07-16,Soundtrack - The Greatest,46,51,43,40.0,41,The Greatest,6.0,1,-2,5,5,1,down,1977-07-09
7158,Soundtrack,1977-07-23,Soundtrack - The Greatest,41,46,43,40.0,43,The Greatest,6.0,2,0,-2,5,0,stay,1977-07-09
7159,Soundtrack,1977-07-30,Soundtrack - The Greatest,43,41,46,40.0,43,The Greatest,6.0,3,-3,0,-2,1,down,1977-07-09
7160,Soundtrack,1977-08-06,Soundtrack - The Greatest,43,43,40,40.0,46,The Greatest,6.0,4,6,-3,0,1,up,1977-07-09
7161,Soundtrack,1977-08-13,Soundtrack - The Greatest,46,43,49,40.0,40,The Greatest,6.0,5,-9,6,-3,1,down,1977-07-09
7162,Soundtrack,1977-08-20,Soundtrack - The Greatest,40,46,51,40.0,49,The Greatest,6.0,6,-2,-9,6,1,down,1977-07-09
7163,Shotgun,1977-07-09,Shotgun - Shotgun,51,51,42,42.0,48,Shotgun,7.0,0,6,3,0,1,up,1977-07-09
7164,Shotgun,1977-07-16,Shotgun - Shotgun,48,51,49,42.0,42,Shotgun,7.0,1,-7,6,3,1,down,1977-07-09
7165,Shotgun,1977-08-06,Shotgun - Shotgun,42,48,47,42.0,49,Shotgun,7.0,2,2,-7,6,1,up,1977-07-09
7166,Shotgun,1977-08-13,Shotgun - Shotgun,49,42,45,42.0,47,Shotgun,7.0,3,2,2,-7,1,up,1977-07-09
7167,Shotgun,1977-08-20,Shotgun - Shotgun,47,49,43,42.0,45,Shotgun,7.0,4,2,2,2,1,up,1977-07-09
7168,Shotgun,1977-08-27,Shotgun - Shotgun,45,47,47,42.0,43,Shotgun,7.0,5,-4,2,2,1,down,1977-07-09
7169,Shotgun,1977-09-03,Shotgun - Shotgun,43,45,49,42.0,47,Shotgun,7.0,6,-2,-4,2,1,down,1977-07-09
7170,Shotgun,1977-09-10,Shotgun - Shotgun,47,43,51,42.0,49,Shotgun,7.0,7,-2,-2,-4,1,down,1977-07-09
7171,Bobby Humphrey,1977-07-09,Bobby Humphrey - Tailor Made,51,51,44,44.0,50,Tailor Made,2.0,0,6,1,0,1,up,1977-07-09
7172,Bobby Humphrey,1977-07-16,Bobby Humphrey - Tailor Made,50,51,44,44.0,44,Tailor Made,2.0,1,0,6,1,0,stay,1977-07-09
7173,Bobby Humphrey,1977-07-23,Bobby Humphrey - Tailor Made,44,50,51,44.0,44,Tailor Made,2.0,2,-7,0,6,1,down,1977-07-09
7174,Al Green,1977-07-16,Al Green - Al Green's Greatest Hits Volume II,51,51,36,33.0,43,Al Green's Greatest Hits Volume II,2.0,0,7,8,0,1,up,1977-07-16
7175,Al Green,1977-07-23,Al Green - Al Green's Greatest Hits Volume II,43,51,33,33.0,36,Al Green's Greatest Hits Volume II,2.0,1,3,7,8,1,up,1977-07-16
7176,Al Green,1977-07-30,Al Green - Al Green's Greatest Hits Volume II,36,43,51,33.0,33,Al Green's Greatest Hits Volume II,2.0,2,-18,3,7,1,down,1977-07-16
7177,Earl Klugh,1977-07-16,Earl Klugh - Finger Paintings,51,51,39,31.0,47,Finger Paintings,8.0,0,8,4,0,1,up,1977-07-16
7178,Earl Klugh,1977-07-23,Earl Klugh - Finger Paintings,47,51,31,31.0,39,Finger Paintings,8.0,1,8,8,4,1,up,1977-07-16
7179,Earl Klugh,1977-07-30,Earl Klugh - Finger Paintings,39,47,31,31.0,31,Finger Paintings,8.0,2,0,8,8,0,stay,1977-07-16
7180,Earl Klugh,1977-08-06,Earl Klugh - Finger Paintings,31,39,48,31.0,31,Finger Paintings,8.0,3,-17,0,8,1,down,1977-07-16
7181,Earl Klugh,1977-08-27,Earl Klugh - Finger Paintings,31,31,47,31.0,48,Finger Paintings,8.0,4,1,-17,0,1,up,1977-07-16
7182,Earl Klugh,1977-09-10,Earl Klugh - Finger Paintings,48,31,47,31.0,47,Finger Paintings,8.0,5,0,1,-17,0,stay,1977-07-16
7183,Earl Klugh,1977-09-17,Earl Klugh - Finger Paintings,47,48,49,31.0,47,Finger Paintings,8.0,6,-2,0,1,1,down,1977-07-16
7184,Earl Klugh,1977-09-24,Earl Klugh - Finger Paintings,47,47,49,31.0,49,Finger Paintings,8.0,7,0,-2,0,0,stay,1977-07-16
7185,Earl Klugh,1977-10-01,Earl Klugh - Finger Paintings,49,47,51,31.0,49,Finger Paintings,8.0,8,-2,0,-2,1,down,1977-07-16
7186,Cameo,1977-07-16,Cameo - Cardiac Arrest,51,51,45,16.0,50,Cardiac Arrest,20.0,0,5,1,0,1,up,1977-07-16
7187,Cameo,1977-07-23,Cameo - Cardiac Arrest,50,51,42,16.0,45,Cardiac Arrest,20.0,1,3,5,1,1,up,1977-07-16
7188,Cameo,1977-08-06,Cameo - Cardiac Arrest,45,50,34,16.0,42,Cardiac Arrest,20.0,2,8,3,5,1,up,1977-07-16
7189,Cameo,1977-08-13,Cameo - Cardiac Arrest,42,45,26,16.0,34,Cardiac Arrest,20.0,3,8,8,3,1,up,1977-07-16
7190,Cameo,1977-08-20,Cameo - Cardiac Arrest,34,42,25,16.0,26,Cardiac Arrest,20.0,4,1,8,8,1,up,1977-07-16
7191,Cameo,1977-08-27,Cameo - Cardiac Arrest,26,34,25,16.0,25,Cardiac Arrest,20.0,5,0,1,8,0,stay,1977-07-16
7192,Cameo,1977-09-03,Cameo - Cardiac Arrest,25,26,23,16.0,25,Cardiac Arrest,20.0,6,2,0,1,1,up,1977-07-16
7193,Cameo,1977-09-10,Cameo - Cardiac Arrest,25,25,23,16.0,23,Cardiac Arrest,20.0,7,0,2,0,0,stay,1977-07-16
7194,Cameo,1977-09-17,Cameo - Cardiac Arrest,23,25,23,16.0,23,Cardiac Arrest,20.0,8,0,0,2,0,stay,1977-07-16
7195,Cameo,1977-09-24,Cameo - Cardiac Arrest,23,23,23,16.0,23,Cardiac Arrest,20.0,9,0,0,0,0,stay,1977-07-16
7196,Cameo,1977-10-01,Cameo - Cardiac Arrest,23,23,22,16.0,23,Cardiac Arrest,20.0,10,1,0,0,1,up,1977-07-16
7197,Cameo,1977-10-08,Cameo - Cardiac Arrest,23,23,18,16.0,22,Cardiac Arrest,20.0,11,4,1,0,1,up,1977-07-16
7198,Cameo,1977-10-15,Cameo - Cardiac Arrest,22,23,16,16.0,18,Cardiac Arrest,20.0,12,2,4,1,1,up,1977-07-16
7199,Cameo,1977-10-22,Cameo - Cardiac Arrest,18,22,19,16.0,16,Cardiac Arrest,20.0,13,-3,2,4,1,down,1977-07-16
7200,Cameo,1977-10-29,Cameo - Cardiac Arrest,16,18,20,16.0,19,Cardiac Arrest,20.0,14,-1,-3,2,1,down,1977-07-16
7201,Cameo,1977-11-05,Cameo - Cardiac Arrest,19,16,24,16.0,20,Cardiac Arrest,20.0,15,-4,-1,-3,1,down,1977-07-16
7202,Cameo,1977-11-12,Cameo - Cardiac Arrest,20,19,32,16.0,24,Cardiac Arrest,20.0,16,-8,-4,-1,1,down,1977-07-16
7203,Cameo,1977-11-19,Cameo - Cardiac Arrest,24,20,32,16.0,32,Cardiac Arrest,20.0,17,0,-8,-4,0,stay,1977-07-16
7204,Cameo,1977-11-26,Cameo - Cardiac Arrest,32,24,35,16.0,32,Cardiac Arrest,20.0,18,-3,0,-8,1,down,1977-07-16
7205,Cameo,1977-12-03,Cameo - Cardiac Arrest,32,32,47,16.0,35,Cardiac Arrest,20.0,19,-12,-3,0,1,down,1977-07-16
7206,Cameo,1977-12-10,Cameo - Cardiac Arrest,35,32,51,16.0,47,Cardiac Arrest,20.0,20,-4,-12,-3,1,down,1977-07-16
7207,War,1977-07-23,War - Platinum Jazz,51,51,23,6.0,46,Platinum Jazz,17.0,0,23,5,0,1,up,1977-07-23
7208,War,1977-07-30,War - Platinum Jazz,46,51,7,6.0,23,Platinum Jazz,17.0,1,16,23,5,1,up,1977-07-23
7209,War,1977-08-06,War - Platinum Jazz,23,46,7,6.0,7,Platinum Jazz,17.0,2,0,16,23,0,stay,1977-07-23
7210,War,1977-08-13,War - Platinum Jazz,7,23,7,6.0,7,Platinum Jazz,17.0,3,0,0,16,0,stay,1977-07-23
7211,War,1977-08-20,War - Platinum Jazz,7,7,6,6.0,7,Platinum Jazz,17.0,4,1,0,0,1,up,1977-07-23
7212,War,1977-08-27,War - Platinum Jazz,7,7,6,6.0,6,Platinum Jazz,17.0,5,0,1,0,0,stay,1977-07-23
7213,War,1977-09-03,War - Platinum Jazz,6,7,8,6.0,6,Platinum Jazz,17.0,6,-2,0,1,1,down,1977-07-23
7214,War,1977-09-10,War - Platinum Jazz,6,6,10,6.0,8,Platinum Jazz,17.0,7,-2,-2,0,1,down,1977-07-23
7215,War,1977-09-17,War - Platinum Jazz,8,6,12,6.0,10,Platinum Jazz,17.0,8,-2,-2,-2,1,down,1977-07-23
7216,War,1977-09-24,War - Platinum Jazz,10,8,14,6.0,12,Platinum Jazz,17.0,9,-2,-2,-2,1,down,1977-07-23
7217,War,1977-10-01,War - Platinum Jazz,12,10,18,6.0,14,Platinum Jazz,17.0,10,-4,-2,-2,1,down,1977-07-23
7218,War,1977-10-08,War - Platinum Jazz,14,12,19,6.0,18,Platinum Jazz,17.0,11,-1,-4,-2,1,down,1977-07-23
7219,War,1977-10-15,War - Platinum Jazz,18,14,26,6.0,19,Platinum Jazz,17.0,12,-7,-1,-4,1,down,1977-07-23
7220,War,1977-10-22,War - Platinum Jazz,19,18,28,6.0,26,Platinum Jazz,17.0,13,-2,-7,-1,1,down,1977-07-23
7221,War,1977-10-29,War - Platinum Jazz,26,19,34,6.0,28,Platinum Jazz,17.0,14,-6,-2,-7,1,down,1977-07-23
7222,War,1977-11-05,War - Platinum Jazz,28,26,41,6.0,34,Platinum Jazz,17.0,15,-7,-6,-2,1,down,1977-07-23
7223,War,1977-11-12,War - Platinum Jazz,34,28,50,6.0,41,Platinum Jazz,17.0,16,-9,-7,-6,1,down,1977-07-23
7224,War,1977-11-19,War - Platinum Jazz,41,34,51,6.0,50,Platinum Jazz,17.0,17,-1,-9,-7,1,down,1977-07-23
7225,The Whispers,1977-07-23,The Whispers - Open Up Your Love,51,51,39,23.0,47,Open Up Your Love,15.0,0,8,4,0,1,up,1977-07-23
7226,The Whispers,1977-07-30,The Whispers - Open Up Your Love,47,51,33,23.0,39,Open Up Your Love,15.0,1,6,8,4,1,up,1977-07-23
7227,The Whispers,1977-08-06,The Whispers - Open Up Your Love,39,47,24,23.0,33,Open Up Your Love,15.0,2,9,6,8,1,up,1977-07-23
7228,The Whispers,1977-08-13,The Whispers - Open Up Your Love,33,39,23,23.0,24,Open Up Your Love,15.0,3,1,9,6,1,up,1977-07-23
7229,The Whispers,1977-08-20,The Whispers - Open Up Your Love,24,33,23,23.0,23,Open Up Your Love,15.0,4,0,1,9,0,stay,1977-07-23
7230,The Whispers,1977-08-27,The Whispers - Open Up Your Love,23,24,27,23.0,23,Open Up Your Love,15.0,5,-4,0,1,1,down,1977-07-23
7231,The Whispers,1977-09-03,The Whispers - Open Up Your Love,23,23,27,23.0,27,Open Up Your Love,15.0,6,0,-4,0,0,stay,1977-07-23
7232,The Whispers,1977-09-10,The Whispers - Open Up Your Love,27,23,30,23.0,27,Open Up Your Love,15.0,7,-3,0,-4,1,down,1977-07-23
7233,The Whispers,1977-09-17,The Whispers - Open Up Your Love,27,27,31,23.0,30,Open Up Your Love,15.0,8,-1,-3,0,1,down,1977-07-23
7234,The Whispers,1977-09-24,The Whispers - Open Up Your Love,30,27,35,23.0,31,Open Up Your Love,15.0,9,-4,-1,-3,1,down,1977-07-23
7235,The Whispers,1977-10-01,The Whispers - Open Up Your Love,31,30,35,23.0,35,Open Up Your Love,15.0,10,0,-4,-1,0,stay,1977-07-23
7236,The Whispers,1977-10-08,The Whispers - Open Up Your Love,35,31,45,23.0,35,Open Up Your Love,15.0,11,-10,0,-4,1,down,1977-07-23
7237,The Whispers,1977-10-15,The Whispers - Open Up Your Love,35,35,45,23.0,45,Open Up Your Love,15.0,12,0,-10,0,0,stay,1977-07-23
7238,The Whispers,1977-10-22,The Whispers - Open Up Your Love,45,35,46,23.0,45,Open Up Your Love,15.0,13,-1,0,-10,1,down,1977-07-23
7239,The Whispers,1977-10-29,The Whispers - Open Up Your Love,45,45,48,23.0,46,Open Up Your Love,15.0,14,-2,-1,0,1,down,1977-07-23
7240,The Whispers,1977-11-05,The Whispers - Open Up Your Love,46,45,51,23.0,48,Open Up Your Love,15.0,15,-3,-2,-1,1,down,1977-07-23
7241,Nancy Wilson,1977-07-23,Nancy Wilson - I've Never Been To Me,51,51,44,42.0,48,I've Never Been To Me,3.0,0,4,3,0,1,up,1977-07-23
7242,Nancy Wilson,1977-07-30,Nancy Wilson - I've Never Been To Me,48,51,44,42.0,44,I've Never Been To Me,3.0,1,0,4,3,0,stay,1977-07-23
7243,Nancy Wilson,1977-08-06,Nancy Wilson - I've Never Been To Me,44,48,42,42.0,44,I've Never Been To Me,3.0,2,2,0,4,1,up,1977-07-23
7244,Nancy Wilson,1977-08-13,Nancy Wilson - I've Never Been To Me,44,44,51,42.0,42,I've Never Been To Me,3.0,3,-9,2,0,1,down,1977-07-23
7245,Shirley Caesar,1977-07-23,Shirley Caesar - First Lady,51,51,41,36.0,49,First Lady,10.0,0,8,2,0,1,up,1977-07-23
7246,Shirley Caesar,1977-07-30,Shirley Caesar - First Lady,49,51,41,36.0,41,First Lady,10.0,1,0,8,2,0,stay,1977-07-23
7247,Shirley Caesar,1977-08-06,Shirley Caesar - First Lady,41,49,41,36.0,41,First Lady,10.0,2,0,0,8,0,stay,1977-07-23
7248,Shirley Caesar,1977-08-13,Shirley Caesar - First Lady,41,41,36,36.0,41,First Lady,10.0,3,5,0,0,1,up,1977-07-23
7249,Shirley Caesar,1977-08-20,Shirley Caesar - First Lady,41,41,36,36.0,36,First Lady,10.0,4,0,5,0,0,stay,1977-07-23
7250,Shirley Caesar,1977-08-27,Shirley Caesar - First Lady,36,41,42,36.0,36,First Lady,10.0,5,-6,0,5,1,down,1977-07-23
7251,Shirley Caesar,1977-09-03,Shirley Caesar - First Lady,36,36,46,36.0,42,First Lady,10.0,6,-4,-6,0,1,down,1977-07-23
7252,Shirley Caesar,1977-09-10,Shirley Caesar - First Lady,42,36,50,36.0,46,First Lady,10.0,7,-4,-4,-6,1,down,1977-07-23
7253,Shirley Caesar,1977-09-17,Shirley Caesar - First Lady,46,42,50,36.0,50,First Lady,10.0,8,0,-4,-4,0,stay,1977-07-23
7254,Shirley Caesar,1977-09-24,Shirley Caesar - First Lady,50,46,50,36.0,50,First Lady,10.0,9,0,0,-4,0,stay,1977-07-23
7255,Shirley Caesar,1977-10-01,Shirley Caesar - First Lady,50,50,51,36.0,50,First Lady,10.0,10,-1,0,0,1,down,1977-07-23
7256,Heatwave,1977-07-23,Heatwave - Too Hot To Handle,51,51,40,5.0,50,Too Hot To Handle,41.0,0,10,1,0,1,up,1977-07-23
7257,Heatwave,1977-07-30,Heatwave - Too Hot To Handle,50,51,36,5.0,40,Too Hot To Handle,41.0,1,4,10,1,1,up,1977-07-23
7258,Heatwave,1977-08-06,Heatwave - Too Hot To Handle,40,50,26,5.0,36,Too Hot To Handle,41.0,2,10,4,10,1,up,1977-07-23
7259,Heatwave,1977-08-13,Heatwave - Too Hot To Handle,36,40,21,5.0,26,Too Hot To Handle,41.0,3,5,10,4,1,up,1977-07-23
7260,Heatwave,1977-08-20,Heatwave - Too Hot To Handle,26,36,17,5.0,21,Too Hot To Handle,41.0,4,4,5,10,1,up,1977-07-23
7261,Heatwave,1977-08-27,Heatwave - Too Hot To Handle,21,26,8,5.0,17,Too Hot To Handle,41.0,5,9,4,5,1,up,1977-07-23
7262,Heatwave,1977-09-03,Heatwave - Too Hot To Handle,17,21,5,5.0,8,Too Hot To Handle,41.0,6,3,9,4,1,up,1977-07-23
7263,Heatwave,1977-09-10,Heatwave - Too Hot To Handle,8,17,5,5.0,5,Too Hot To Handle,41.0,7,0,3,9,0,stay,1977-07-23
7264,Heatwave,1977-09-17,Heatwave - Too Hot To Handle,5,8,8,5.0,5,Too Hot To Handle,41.0,8,-3,0,3,1,down,1977-07-23
7265,Heatwave,1977-09-24,Heatwave - Too Hot To Handle,5,5,8,5.0,8,Too Hot To Handle,41.0,9,0,-3,0,0,stay,1977-07-23
7266,Heatwave,1977-10-01,Heatwave - Too Hot To Handle,8,5,8,5.0,8,Too Hot To Handle,41.0,10,0,0,-3,0,stay,1977-07-23
7267,Heatwave,1977-10-08,Heatwave - Too Hot To Handle,8,8,8,5.0,8,Too Hot To Handle,41.0,11,0,0,0,0,stay,1977-07-23
7268,Heatwave,1977-10-15,Heatwave - Too Hot To Handle,8,8,5,5.0,8,Too Hot To Handle,41.0,12,3,0,0,1,up,1977-07-23
7269,Heatwave,1977-10-22,Heatwave - Too Hot To Handle,8,8,5,5.0,5,Too Hot To Handle,41.0,13,0,3,0,0,stay,1977-07-23
7270,Heatwave,1977-10-29,Heatwave - Too Hot To Handle,5,8,5,5.0,5,Too Hot To Handle,41.0,14,0,0,3,0,stay,1977-07-23
7271,Heatwave,1977-11-05,Heatwave - Too Hot To Handle,5,5,5,5.0,5,Too Hot To Handle,41.0,15,0,0,0,0,stay,1977-07-23
7272,Heatwave,1977-11-12,Heatwave - Too Hot To Handle,5,5,6,5.0,5,Too Hot To Handle,41.0,16,-1,0,0,1,down,1977-07-23
7273,Heatwave,1977-11-19,Heatwave - Too Hot To Handle,5,5,6,5.0,6,Too Hot To Handle,41.0,17,0,-1,0,0,stay,1977-07-23
7274,Heatwave,1977-11-26,Heatwave - Too Hot To Handle,6,5,6,5.0,6,Too Hot To Handle,41.0,18,0,0,-1,0,stay,1977-07-23
7275,Heatwave,1977-12-03,Heatwave - Too Hot To Handle,6,6,9,5.0,6,Too Hot To Handle,41.0,19,-3,0,0,1,down,1977-07-23
7276,Heatwave,1977-12-10,Heatwave - Too Hot To Handle,6,6,10,5.0,9,Too Hot To Handle,41.0,20,-1,-3,0,1,down,1977-07-23
7277,Heatwave,1977-12-17,Heatwave - Too Hot To Handle,9,6,13,5.0,10,Too Hot To Handle,41.0,21,-3,-1,-3,1,down,1977-07-23
7278,Heatwave,1977-12-24,Heatwave - Too Hot To Handle,10,9,13,5.0,13,Too Hot To Handle,41.0,22,0,-3,-1,0,stay,1977-07-23
7279,Heatwave,1977-12-31,Heatwave - Too Hot To Handle,13,10,15,5.0,13,Too Hot To Handle,41.0,23,-2,0,-3,1,down,1977-07-23
7280,Heatwave,1978-01-07,Heatwave - Too Hot To Handle,13,13,15,5.0,15,Too Hot To Handle,41.0,24,0,-2,0,0,stay,1977-07-23
7281,Heatwave,1978-01-14,Heatwave - Too Hot To Handle,15,13,17,5.0,15,Too Hot To Handle,41.0,25,-2,0,-2,1,down,1977-07-23
7282,Heatwave,1978-01-21,Heatwave - Too Hot To Handle,15,15,21,5.0,17,Too Hot To Handle,41.0,26,-4,-2,0,1,down,1977-07-23
7283,Heatwave,1978-01-28,Heatwave - Too Hot To Handle,17,15,16,5.0,21,Too Hot To Handle,41.0,27,5,-4,-2,1,up,1977-07-23
7284,Heatwave,1978-02-04,Heatwave - Too Hot To Handle,21,17,16,5.0,16,Too Hot To Handle,41.0,28,0,5,-4,0,stay,1977-07-23
7285,Heatwave,1978-02-11,Heatwave - Too Hot To Handle,16,21,14,5.0,16,Too Hot To Handle,41.0,29,2,0,5,1,up,1977-07-23
7286,Heatwave,1978-02-18,Heatwave - Too Hot To Handle,16,16,15,5.0,14,Too Hot To Handle,41.0,30,-1,2,0,1,down,1977-07-23
7287,Heatwave,1978-02-25,Heatwave - Too Hot To Handle,14,16,24,5.0,15,Too Hot To Handle,41.0,31,-9,-1,2,1,down,1977-07-23
7288,Heatwave,1978-03-04,Heatwave - Too Hot To Handle,15,14,26,5.0,24,Too Hot To Handle,41.0,32,-2,-9,-1,1,down,1977-07-23
7289,Heatwave,1978-03-11,Heatwave - Too Hot To Handle,24,15,22,5.0,26,Too Hot To Handle,41.0,33,4,-2,-9,1,up,1977-07-23
7290,Heatwave,1978-03-18,Heatwave - Too Hot To Handle,26,24,25,5.0,22,Too Hot To Handle,41.0,34,-3,4,-2,1,down,1977-07-23
7291,Heatwave,1978-03-25,Heatwave - Too Hot To Handle,22,26,25,5.0,25,Too Hot To Handle,41.0,35,0,-3,4,0,stay,1977-07-23
7292,Heatwave,1978-04-01,Heatwave - Too Hot To Handle,25,22,27,5.0,25,Too Hot To Handle,41.0,36,-2,0,-3,1,down,1977-07-23
7293,Heatwave,1978-04-08,Heatwave - Too Hot To Handle,25,25,29,5.0,27,Too Hot To Handle,41.0,37,-2,-2,0,1,down,1977-07-23
7294,Heatwave,1978-04-15,Heatwave - Too Hot To Handle,27,25,29,5.0,29,Too Hot To Handle,41.0,38,0,-2,-2,0,stay,1977-07-23
7295,Heatwave,1978-04-22,Heatwave - Too Hot To Handle,29,27,37,5.0,29,Too Hot To Handle,41.0,39,-8,0,-2,1,down,1977-07-23
7296,Heatwave,1978-04-29,Heatwave - Too Hot To Handle,29,29,48,5.0,37,Too Hot To Handle,41.0,40,-11,-8,0,1,down,1977-07-23
7297,Heatwave,1978-05-06,Heatwave - Too Hot To Handle,37,29,51,5.0,48,Too Hot To Handle,41.0,41,-3,-11,-8,1,down,1977-07-23
7298,Average White Band,1977-07-30,Average White Band - Benny And Us,51,51,20,14.0,45,Benny And Us,18.0,0,25,6,0,1,up,1977-07-30
7299,Average White Band,1977-08-06,Average White Band - Benny And Us,45,51,16,14.0,20,Benny And Us,18.0,1,4,25,6,1,up,1977-07-30
7300,Average White Band,1977-08-13,Average White Band - Benny And Us,20,45,14,14.0,16,Benny And Us,18.0,2,2,4,25,1,up,1977-07-30
7301,Average White Band,1977-08-20,Average White Band - Benny And Us,16,20,15,14.0,14,Benny And Us,18.0,3,-1,2,4,1,down,1977-07-30
7302,Average White Band,1977-08-27,Average White Band - Benny And Us,14,16,18,14.0,15,Benny And Us,18.0,4,-3,-1,2,1,down,1977-07-30
7303,Average White Band,1977-09-03,Average White Band - Benny And Us,15,14,18,14.0,18,Benny And Us,18.0,5,0,-3,-1,0,stay,1977-07-30
7304,Average White Band,1977-09-10,Average White Band - Benny And Us,18,15,20,14.0,18,Benny And Us,18.0,6,-2,0,-3,1,down,1977-07-30
7305,Average White Band,1977-09-17,Average White Band - Benny And Us,18,18,21,14.0,20,Benny And Us,18.0,7,-1,-2,0,1,down,1977-07-30
7306,Average White Band,1977-09-24,Average White Band - Benny And Us,20,18,25,14.0,21,Benny And Us,18.0,8,-4,-1,-2,1,down,1977-07-30
7307,Average White Band,1977-10-01,Average White Band - Benny And Us,21,20,25,14.0,25,Benny And Us,18.0,9,0,-4,-1,0,stay,1977-07-30
7308,Average White Band,1977-10-08,Average White Band - Benny And Us,25,21,27,14.0,25,Benny And Us,18.0,10,-2,0,-4,1,down,1977-07-30
7309,Average White Band,1977-10-15,Average White Band - Benny And Us,25,25,27,14.0,27,Benny And Us,18.0,11,0,-2,0,0,stay,1977-07-30
7310,Average White Band,1977-10-22,Average White Band - Benny And Us,27,25,32,14.0,27,Benny And Us,18.0,12,-5,0,-2,1,down,1977-07-30
7311,Average White Band,1977-10-29,Average White Band - Benny And Us,27,27,37,14.0,32,Benny And Us,18.0,13,-5,-5,0,1,down,1977-07-30
7312,Average White Band,1977-11-05,Average White Band - Benny And Us,32,27,37,14.0,37,Benny And Us,18.0,14,0,-5,-5,0,stay,1977-07-30
7313,Average White Band,1977-11-12,Average White Band - Benny And Us,37,32,49,14.0,37,Benny And Us,18.0,15,-12,0,-5,1,down,1977-07-30
7314,Average White Band,1977-11-19,Average White Band - Benny And Us,37,37,49,14.0,49,Benny And Us,18.0,16,0,-12,0,0,stay,1977-07-30
7315,Average White Band,1977-11-26,Average White Band - Benny And Us,49,37,50,14.0,49,Benny And Us,18.0,17,-1,0,-12,1,down,1977-07-30
7316,Average White Band,1977-12-03,Average White Band - Benny And Us,49,49,51,14.0,50,Benny And Us,18.0,18,-1,-1,0,1,down,1977-07-30
7317,Lonnie Liston Smith,1977-07-30,Lonnie Liston Smith - Live!,51,51,38,33.0,48,Live!,11.0,0,10,3,0,1,up,1977-07-30
7318,Lonnie Liston Smith,1977-08-06,Lonnie Liston Smith - Live!,48,51,36,33.0,38,Live!,11.0,1,2,10,3,1,up,1977-07-30
7319,Lonnie Liston Smith,1977-08-13,Lonnie Liston Smith - Live!,38,48,34,33.0,36,Live!,11.0,2,2,2,10,1,up,1977-07-30
7320,Lonnie Liston Smith,1977-08-20,Lonnie Liston Smith - Live!,36,38,33,33.0,34,Live!,11.0,3,1,2,2,1,up,1977-07-30
7321,Lonnie Liston Smith,1977-08-27,Lonnie Liston Smith - Live!,34,36,37,33.0,33,Live!,11.0,4,-4,1,2,1,down,1977-07-30
7322,Lonnie Liston Smith,1977-09-03,Lonnie Liston Smith - Live!,33,34,42,33.0,37,Live!,11.0,5,-5,-4,1,1,down,1977-07-30
7323,Lonnie Liston Smith,1977-09-10,Lonnie Liston Smith - Live!,37,33,44,33.0,42,Live!,11.0,6,-2,-5,-4,1,down,1977-07-30
7324,Lonnie Liston Smith,1977-09-17,Lonnie Liston Smith - Live!,42,37,45,33.0,44,Live!,11.0,7,-1,-2,-5,1,down,1977-07-30
7325,Lonnie Liston Smith,1977-09-24,Lonnie Liston Smith - Live!,44,42,45,33.0,45,Live!,11.0,8,0,-1,-2,0,stay,1977-07-30
7326,Lonnie Liston Smith,1977-10-01,Lonnie Liston Smith - Live!,45,44,48,33.0,45,Live!,11.0,9,-3,0,-1,1,down,1977-07-30
7327,Lonnie Liston Smith,1977-10-08,Lonnie Liston Smith - Live!,45,45,48,33.0,48,Live!,11.0,10,0,-3,0,0,stay,1977-07-30
7328,Lonnie Liston Smith,1977-10-15,Lonnie Liston Smith - Live!,48,45,51,33.0,48,Live!,11.0,11,-3,0,-3,1,down,1977-07-30
7329,LTD,1977-07-30,LTD - Something To Love,51,51,39,1.0,49,Something To Love,35.0,0,10,2,0,1,up,1977-07-30
7330,LTD,1977-08-06,LTD - Something To Love,49,51,25,1.0,39,Something To Love,35.0,1,14,10,2,1,up,1977-07-30
7331,LTD,1977-08-13,LTD - Something To Love,39,49,19,1.0,25,Something To Love,35.0,2,6,14,10,1,up,1977-07-30
7332,LTD,1977-08-20,LTD - Something To Love,25,39,14,1.0,19,Something To Love,35.0,3,5,6,14,1,up,1977-07-30
7333,LTD,1977-08-27,LTD - Something To Love,19,25,13,1.0,14,Something To Love,35.0,4,1,5,6,1,up,1977-07-30
7334,LTD,1977-09-03,LTD - Something To Love,14,19,13,1.0,13,Something To Love,35.0,5,0,1,5,0,stay,1977-07-30
7335,LTD,1977-09-10,LTD - Something To Love,13,14,9,1.0,13,Something To Love,35.0,6,4,0,1,1,up,1977-07-30
7336,LTD,1977-09-17,LTD - Something To Love,13,13,6,1.0,9,Something To Love,35.0,7,3,4,0,1,up,1977-07-30
7337,LTD,1977-09-24,LTD - Something To Love,9,13,3,1.0,6,Something To Love,35.0,8,3,3,4,1,up,1977-07-30
7338,LTD,1977-10-01,LTD - Something To Love,6,9,1,1.0,3,Something To Love,35.0,9,2,3,3,1,up,1977-07-30
7339,LTD,1977-10-08,LTD - Something To Love,3,6,3,1.0,1,Something To Love,35.0,10,-2,2,3,1,down,1977-07-30
7340,LTD,1977-10-15,LTD - Something To Love,1,3,2,1.0,3,Something To Love,35.0,11,1,-2,2,1,up,1977-07-30
7341,LTD,1977-10-22,LTD - Something To Love,3,1,2,1.0,2,Something To Love,35.0,12,0,1,-2,0,stay,1977-07-30
7342,LTD,1977-10-29,LTD - Something To Love,2,3,4,1.0,2,Something To Love,35.0,13,-2,0,1,1,down,1977-07-30
7343,LTD,1977-11-05,LTD - Something To Love,2,2,4,1.0,4,Something To Love,35.0,14,0,-2,0,0,stay,1977-07-30
7344,LTD,1977-11-12,LTD - Something To Love,4,2,4,1.0,4,Something To Love,35.0,15,0,0,-2,0,stay,1977-07-30
7345,LTD,1977-11-19,LTD - Something To Love,4,4,4,1.0,4,Something To Love,35.0,16,0,0,0,0,stay,1977-07-30
7346,LTD,1977-11-26,LTD - Something To Love,4,4,7,1.0,4,Something To Love,35.0,17,-3,0,0,1,down,1977-07-30
7347,LTD,1977-12-03,LTD - Something To Love,4,4,8,1.0,7,Something To Love,35.0,18,-1,-3,0,1,down,1977-07-30
7348,LTD,1977-12-10,LTD - Something To Love,7,4,9,1.0,8,Something To Love,35.0,19,-1,-1,-3,1,down,1977-07-30
7349,LTD,1977-12-17,LTD - Something To Love,8,7,11,1.0,9,Something To Love,35.0,20,-2,-1,-1,1,down,1977-07-30
7350,LTD,1977-12-24,LTD - Something To Love,9,8,11,1.0,11,Something To Love,35.0,21,0,-2,-1,0,stay,1977-07-30
7351,LTD,1977-12-31,LTD - Something To Love,11,9,13,1.0,11,Something To Love,35.0,22,-2,0,-2,1,down,1977-07-30
7352,LTD,1978-01-07,LTD - Something To Love,11,11,14,1.0,13,Something To Love,35.0,23,-1,-2,0,1,down,1977-07-30
7353,LTD,1978-01-14,LTD - Something To Love,13,11,19,1.0,14,Something To Love,35.0,24,-5,-1,-2,1,down,1977-07-30
7354,LTD,1978-01-21,LTD - Something To Love,14,13,27,1.0,19,Something To Love,35.0,25,-8,-5,-1,1,down,1977-07-30
7355,LTD,1978-01-28,LTD - Something To Love,19,14,28,1.0,27,Something To Love,35.0,26,-1,-8,-5,1,down,1977-07-30
7356,LTD,1978-02-04,LTD - Something To Love,27,19,45,1.0,28,Something To Love,35.0,27,-17,-1,-8,1,down,1977-07-30
7357,LTD,1978-02-11,LTD - Something To Love,28,27,45,1.0,45,Something To Love,35.0,28,0,-17,-1,0,stay,1977-07-30
7358,LTD,1978-02-18,LTD - Something To Love,45,28,39,1.0,45,Something To Love,35.0,29,6,0,-17,1,up,1977-07-30
7359,LTD,1978-02-25,LTD - Something To Love,45,45,39,1.0,39,Something To Love,35.0,30,0,6,0,0,stay,1977-07-30
7360,LTD,1978-03-04,LTD - Something To Love,39,45,47,1.0,39,Something To Love,35.0,31,-8,0,6,1,down,1977-07-30
7361,LTD,1978-03-11,LTD - Something To Love,39,39,47,1.0,47,Something To Love,35.0,32,0,-8,0,0,stay,1977-07-30
7362,LTD,1978-03-18,LTD - Something To Love,47,39,46,1.0,47,Something To Love,35.0,33,1,0,-8,1,up,1977-07-30
7363,LTD,1978-03-25,LTD - Something To Love,47,47,49,1.0,46,Something To Love,35.0,34,-3,1,0,1,down,1977-07-30
7364,LTD,1978-04-01,LTD - Something To Love,46,47,51,1.0,49,Something To Love,35.0,35,-2,-3,1,1,down,1977-07-30
7365,Lenny Williams,1977-07-30,Lenny Williams - Choosing You,51,51,40,25.0,50,Choosing You,22.0,0,10,1,0,1,up,1977-07-30
7366,Lenny Williams,1977-08-06,Lenny Williams - Choosing You,50,51,38,25.0,40,Choosing You,22.0,1,2,10,1,1,up,1977-07-30
7367,Lenny Williams,1977-08-13,Lenny Williams - Choosing You,40,50,33,25.0,38,Choosing You,22.0,2,5,2,10,1,up,1977-07-30
7368,Lenny Williams,1977-08-20,Lenny Williams - Choosing You,38,40,35,25.0,33,Choosing You,22.0,3,-2,5,2,1,down,1977-07-30
7369,Lenny Williams,1977-08-27,Lenny Williams - Choosing You,33,38,38,25.0,35,Choosing You,22.0,4,-3,-2,5,1,down,1977-07-30
7370,Lenny Williams,1977-09-03,Lenny Williams - Choosing You,35,33,39,25.0,38,Choosing You,22.0,5,-1,-3,-2,1,down,1977-07-30
7371,Lenny Williams,1977-09-10,Lenny Williams - Choosing You,38,35,39,25.0,39,Choosing You,22.0,6,0,-1,-3,0,stay,1977-07-30
7372,Lenny Williams,1977-09-17,Lenny Williams - Choosing You,39,38,37,25.0,39,Choosing You,22.0,7,2,0,-1,1,up,1977-07-30
7373,Lenny Williams,1977-09-24,Lenny Williams - Choosing You,39,39,37,25.0,37,Choosing You,22.0,8,0,2,0,0,stay,1977-07-30
7374,Lenny Williams,1977-10-01,Lenny Williams - Choosing You,37,39,38,25.0,37,Choosing You,22.0,9,-1,0,2,1,down,1977-07-30
7375,Lenny Williams,1977-10-08,Lenny Williams - Choosing You,37,37,38,25.0,38,Choosing You,22.0,10,0,-1,0,0,stay,1977-07-30
7376,Lenny Williams,1977-10-15,Lenny Williams - Choosing You,38,37,28,25.0,38,Choosing You,22.0,11,10,0,-1,1,up,1977-07-30
7377,Lenny Williams,1977-10-22,Lenny Williams - Choosing You,38,38,26,25.0,28,Choosing You,22.0,12,2,10,0,1,up,1977-07-30
7378,Lenny Williams,1977-10-29,Lenny Williams - Choosing You,28,38,25,25.0,26,Choosing You,22.0,13,1,2,10,1,up,1977-07-30
7379,Lenny Williams,1977-11-05,Lenny Williams - Choosing You,26,28,28,25.0,25,Choosing You,22.0,14,-3,1,2,1,down,1977-07-30
7380,Lenny Williams,1977-11-12,Lenny Williams - Choosing You,25,26,31,25.0,28,Choosing You,22.0,15,-3,-3,1,1,down,1977-07-30
7381,Lenny Williams,1977-11-19,Lenny Williams - Choosing You,28,25,35,25.0,31,Choosing You,22.0,16,-4,-3,-3,1,down,1977-07-30
7382,Lenny Williams,1977-11-26,Lenny Williams - Choosing You,31,28,40,25.0,35,Choosing You,22.0,17,-5,-4,-3,1,down,1977-07-30
7383,Lenny Williams,1977-12-03,Lenny Williams - Choosing You,35,31,40,25.0,40,Choosing You,22.0,18,0,-5,-4,0,stay,1977-07-30
7384,Lenny Williams,1977-12-10,Lenny Williams - Choosing You,40,35,44,25.0,40,Choosing You,22.0,19,-4,0,-5,1,down,1977-07-30
7385,Lenny Williams,1977-12-17,Lenny Williams - Choosing You,40,40,44,25.0,44,Choosing You,22.0,20,0,-4,0,0,stay,1977-07-30
7386,Lenny Williams,1977-12-24,Lenny Williams - Choosing You,44,40,44,25.0,44,Choosing You,22.0,21,0,0,-4,0,stay,1977-07-30
7387,Lenny Williams,1977-12-31,Lenny Williams - Choosing You,44,44,51,25.0,44,Choosing You,22.0,22,-7,0,0,1,down,1977-07-30
7388,Various Artists,1977-08-06,Various Artists - Let's Clean Up The Ghetto,51,51,33,17.0,43,Let's Clean Up The Ghetto,9.0,0,10,8,0,1,up,1977-08-06
7389,Various Artists,1977-08-13,Various Artists - Let's Clean Up The Ghetto,43,51,25,17.0,33,Let's Clean Up The Ghetto,9.0,1,8,10,8,1,up,1977-08-06
7390,Various Artists,1977-08-20,Various Artists - Let's Clean Up The Ghetto,33,43,20,17.0,25,Let's Clean Up The Ghetto,9.0,2,5,8,10,1,up,1977-08-06
7391,Various Artists,1977-08-27,Various Artists - Let's Clean Up The Ghetto,25,33,17,17.0,20,Let's Clean Up The Ghetto,9.0,3,3,5,8,1,up,1977-08-06
7392,Various Artists,1977-09-03,Various Artists - Let's Clean Up The Ghetto,20,25,17,17.0,17,Let's Clean Up The Ghetto,9.0,4,0,3,5,0,stay,1977-08-06
7393,Various Artists,1977-09-10,Various Artists - Let's Clean Up The Ghetto,17,20,22,17.0,17,Let's Clean Up The Ghetto,9.0,5,-5,0,3,1,down,1977-08-06
7394,Various Artists,1977-09-17,Various Artists - Let's Clean Up The Ghetto,17,17,22,17.0,22,Let's Clean Up The Ghetto,9.0,6,0,-5,0,0,stay,1977-08-06
7395,Various Artists,1977-09-24,Various Artists - Let's Clean Up The Ghetto,22,17,30,17.0,22,Let's Clean Up The Ghetto,9.0,7,-8,0,-5,1,down,1977-08-06
7396,Various Artists,1977-10-01,Various Artists - Let's Clean Up The Ghetto,22,22,33,17.0,30,Let's Clean Up The Ghetto,9.0,8,-3,-8,0,1,down,1977-08-06
7397,Various Artists,1977-10-08,Various Artists - Let's Clean Up The Ghetto,30,22,51,17.0,33,Let's Clean Up The Ghetto,9.0,9,-18,-3,-8,1,down,1977-08-06
7398,Dorothy Moore,1977-08-06,Dorothy Moore - Dorothy Moore,51,51,39,26.0,50,Dorothy Moore,16.0,0,11,1,0,1,up,1977-08-06
7399,Dorothy Moore,1977-08-13,Dorothy Moore - Dorothy Moore,50,51,32,26.0,39,Dorothy Moore,16.0,1,7,11,1,1,up,1977-08-06
7400,Dorothy Moore,1977-08-20,Dorothy Moore - Dorothy Moore,39,50,26,26.0,32,Dorothy Moore,16.0,2,6,7,11,1,up,1977-08-06
7401,Dorothy Moore,1977-08-27,Dorothy Moore - Dorothy Moore,32,39,29,26.0,26,Dorothy Moore,16.0,3,-3,6,7,1,down,1977-08-06
7402,Dorothy Moore,1977-09-03,Dorothy Moore - Dorothy Moore,26,32,30,26.0,29,Dorothy Moore,16.0,4,-1,-3,6,1,down,1977-08-06
7403,Dorothy Moore,1977-09-10,Dorothy Moore - Dorothy Moore,29,26,33,26.0,30,Dorothy Moore,16.0,5,-3,-1,-3,1,down,1977-08-06
7404,Dorothy Moore,1977-09-17,Dorothy Moore - Dorothy Moore,30,29,43,26.0,33,Dorothy Moore,16.0,6,-10,-3,-1,1,down,1977-08-06
7405,Dorothy Moore,1977-09-24,Dorothy Moore - Dorothy Moore,33,30,43,26.0,43,Dorothy Moore,16.0,7,0,-10,-3,0,stay,1977-08-06
7406,Dorothy Moore,1977-10-01,Dorothy Moore - Dorothy Moore,43,33,44,26.0,43,Dorothy Moore,16.0,8,-1,0,-10,1,down,1977-08-06
7407,Dorothy Moore,1977-10-08,Dorothy Moore - Dorothy Moore,43,43,44,26.0,44,Dorothy Moore,16.0,9,0,-1,0,0,stay,1977-08-06
7408,Dorothy Moore,1977-10-15,Dorothy Moore - Dorothy Moore,44,43,42,26.0,44,Dorothy Moore,16.0,10,2,0,-1,1,up,1977-08-06
7409,Dorothy Moore,1977-10-22,Dorothy Moore - Dorothy Moore,44,44,35,26.0,42,Dorothy Moore,16.0,11,7,2,0,1,up,1977-08-06
7410,Dorothy Moore,1977-10-29,Dorothy Moore - Dorothy Moore,42,44,33,26.0,35,Dorothy Moore,16.0,12,2,7,2,1,up,1977-08-06
7411,Dorothy Moore,1977-11-05,Dorothy Moore - Dorothy Moore,35,42,33,26.0,33,Dorothy Moore,16.0,13,0,2,7,0,stay,1977-08-06
7412,Dorothy Moore,1977-11-12,Dorothy Moore - Dorothy Moore,33,35,42,26.0,33,Dorothy Moore,16.0,14,-9,0,2,1,down,1977-08-06
7413,Dorothy Moore,1977-11-19,Dorothy Moore - Dorothy Moore,33,33,50,26.0,42,Dorothy Moore,16.0,15,-8,-9,0,1,down,1977-08-06
7414,Dorothy Moore,1977-11-26,Dorothy Moore - Dorothy Moore,42,33,51,26.0,50,Dorothy Moore,16.0,16,-1,-8,-9,1,down,1977-08-06
7415,Michael Henderson,1977-08-13,Michael Henderson - Goin' Places,51,51,37,18.0,43,Goin' Places,15.0,0,6,8,0,1,up,1977-08-13
7416,Michael Henderson,1977-08-20,Michael Henderson - Goin' Places,43,51,27,18.0,37,Goin' Places,15.0,1,10,6,8,1,up,1977-08-13
7417,Michael Henderson,1977-08-27,Michael Henderson - Goin' Places,37,43,24,18.0,27,Goin' Places,15.0,2,3,10,6,1,up,1977-08-13
7418,Michael Henderson,1977-09-03,Michael Henderson - Goin' Places,27,37,21,18.0,24,Goin' Places,15.0,3,3,3,10,1,up,1977-08-13
7419,Michael Henderson,1977-09-10,Michael Henderson - Goin' Places,24,27,21,18.0,21,Goin' Places,15.0,4,0,3,3,0,stay,1977-08-13
7420,Michael Henderson,1977-09-17,Michael Henderson - Goin' Places,21,24,18,18.0,21,Goin' Places,15.0,5,3,0,3,1,up,1977-08-13
7421,Michael Henderson,1977-09-24,Michael Henderson - Goin' Places,21,21,18,18.0,18,Goin' Places,15.0,6,0,3,0,0,stay,1977-08-13
7422,Michael Henderson,1977-10-01,Michael Henderson - Goin' Places,18,21,20,18.0,18,Goin' Places,15.0,7,-2,0,3,1,down,1977-08-13
7423,Michael Henderson,1977-10-08,Michael Henderson - Goin' Places,18,18,20,18.0,20,Goin' Places,15.0,8,0,-2,0,0,stay,1977-08-13
7424,Michael Henderson,1977-10-15,Michael Henderson - Goin' Places,20,18,22,18.0,20,Goin' Places,15.0,9,-2,0,-2,1,down,1977-08-13
7425,Michael Henderson,1977-10-22,Michael Henderson - Goin' Places,20,20,23,18.0,22,Goin' Places,15.0,10,-1,-2,0,1,down,1977-08-13
7426,Michael Henderson,1977-10-29,Michael Henderson - Goin' Places,22,20,30,18.0,23,Goin' Places,15.0,11,-7,-1,-2,1,down,1977-08-13
7427,Michael Henderson,1977-11-05,Michael Henderson - Goin' Places,23,22,38,18.0,30,Goin' Places,15.0,12,-8,-7,-1,1,down,1977-08-13
7428,Michael Henderson,1977-11-12,Michael Henderson - Goin' Places,30,23,41,18.0,38,Goin' Places,15.0,13,-3,-8,-7,1,down,1977-08-13
7429,Michael Henderson,1977-11-19,Michael Henderson - Goin' Places,38,30,44,18.0,41,Goin' Places,15.0,14,-3,-3,-8,1,down,1977-08-13
7430,Michael Henderson,1977-11-26,Michael Henderson - Goin' Places,41,38,51,18.0,44,Goin' Places,15.0,15,-7,-3,-3,1,down,1977-08-13
7431,The Dramatics,1977-08-13,The Dramatics - Shake It Well,51,51,29,9.0,44,Shake It Well,21.0,0,15,7,0,1,up,1977-08-13
7432,The Dramatics,1977-08-20,The Dramatics - Shake It Well,44,51,24,9.0,29,Shake It Well,21.0,1,5,15,7,1,up,1977-08-13
7433,The Dramatics,1977-08-27,The Dramatics - Shake It Well,29,44,16,9.0,24,Shake It Well,21.0,2,8,5,15,1,up,1977-08-13
7434,The Dramatics,1977-09-03,The Dramatics - Shake It Well,24,29,14,9.0,16,Shake It Well,21.0,3,2,8,5,1,up,1977-08-13
7435,The Dramatics,1977-09-10,The Dramatics - Shake It Well,16,24,13,9.0,14,Shake It Well,21.0,4,1,2,8,1,up,1977-08-13
7436,The Dramatics,1977-09-17,The Dramatics - Shake It Well,14,16,11,9.0,13,Shake It Well,21.0,5,2,1,2,1,up,1977-08-13
7437,The Dramatics,1977-09-24,The Dramatics - Shake It Well,13,14,10,9.0,11,Shake It Well,21.0,6,1,2,1,1,up,1977-08-13
7438,The Dramatics,1977-10-01,The Dramatics - Shake It Well,11,13,14,9.0,10,Shake It Well,21.0,7,-4,1,2,1,down,1977-08-13
7439,The Dramatics,1977-10-08,The Dramatics - Shake It Well,10,11,14,9.0,14,Shake It Well,21.0,8,0,-4,1,0,stay,1977-08-13
7440,The Dramatics,1977-10-15,The Dramatics - Shake It Well,14,10,12,9.0,14,Shake It Well,21.0,9,2,0,-4,1,up,1977-08-13
7441,The Dramatics,1977-10-22,The Dramatics - Shake It Well,14,14,11,9.0,12,Shake It Well,21.0,10,1,2,0,1,up,1977-08-13
7442,The Dramatics,1977-10-29,The Dramatics - Shake It Well,12,14,10,9.0,11,Shake It Well,21.0,11,1,1,2,1,up,1977-08-13
7443,The Dramatics,1977-11-05,The Dramatics - Shake It Well,11,12,10,9.0,10,Shake It Well,21.0,12,0,1,1,0,stay,1977-08-13
7444,The Dramatics,1977-11-12,The Dramatics - Shake It Well,10,11,9,9.0,10,Shake It Well,21.0,13,1,0,1,1,up,1977-08-13
7445,The Dramatics,1977-11-19,The Dramatics - Shake It Well,10,10,15,9.0,9,Shake It Well,21.0,14,-6,1,0,1,down,1977-08-13
7446,The Dramatics,1977-11-26,The Dramatics - Shake It Well,9,10,22,9.0,15,Shake It Well,21.0,15,-7,-6,1,1,down,1977-08-13
7447,The Dramatics,1977-12-03,The Dramatics - Shake It Well,15,9,27,9.0,22,Shake It Well,21.0,16,-5,-7,-6,1,down,1977-08-13
7448,The Dramatics,1977-12-10,The Dramatics - Shake It Well,22,15,28,9.0,27,Shake It Well,21.0,17,-1,-5,-7,1,down,1977-08-13
7449,The Dramatics,1977-12-17,The Dramatics - Shake It Well,27,22,40,9.0,28,Shake It Well,21.0,18,-12,-1,-5,1,down,1977-08-13
7450,The Dramatics,1977-12-24,The Dramatics - Shake It Well,28,27,40,9.0,40,Shake It Well,21.0,19,0,-12,-1,0,stay,1977-08-13
7451,The Dramatics,1977-12-31,The Dramatics - Shake It Well,40,28,48,9.0,40,Shake It Well,21.0,20,-8,0,-12,1,down,1977-08-13
7452,The Dramatics,1978-01-07,The Dramatics - Shake It Well,40,40,51,9.0,48,Shake It Well,21.0,21,-3,-8,0,1,down,1977-08-13
7453,O.V. Wright,1977-08-13,O.V. Wright - Into Something (can't Shake Loose),51,51,41,40.0,48,Into Something (can't Shake Loose),12.0,0,7,3,0,1,up,1977-08-13
7454,O.V. Wright,1977-08-20,O.V. Wright - Into Something (can't Shake Loose),48,51,40,40.0,41,Into Something (can't Shake Loose),12.0,1,1,7,3,1,up,1977-08-13
7455,O.V. Wright,1977-08-27,O.V. Wright - Into Something (can't Shake Loose),41,48,40,40.0,40,Into Something (can't Shake Loose),12.0,2,0,1,7,0,stay,1977-08-13
7456,O.V. Wright,1977-09-03,O.V. Wright - Into Something (can't Shake Loose),40,41,41,40.0,40,Into Something (can't Shake Loose),12.0,3,-1,0,1,1,down,1977-08-13
7457,O.V. Wright,1977-09-10,O.V. Wright - Into Something (can't Shake Loose),40,40,42,40.0,41,Into Something (can't Shake Loose),12.0,4,-1,-1,0,1,down,1977-08-13
7458,O.V. Wright,1977-09-17,O.V. Wright - Into Something (can't Shake Loose),41,40,42,40.0,42,Into Something (can't Shake Loose),12.0,5,0,-1,-1,0,stay,1977-08-13
7459,O.V. Wright,1977-09-24,O.V. Wright - Into Something (can't Shake Loose),42,41,42,40.0,42,Into Something (can't Shake Loose),12.0,6,0,0,-1,0,stay,1977-08-13
7460,O.V. Wright,1977-10-01,O.V. Wright - Into Something (can't Shake Loose),42,42,45,40.0,42,Into Something (can't Shake Loose),12.0,7,-3,0,0,1,down,1977-08-13
7461,O.V. Wright,1977-10-08,O.V. Wright - Into Something (can't Shake Loose),42,42,46,40.0,45,Into Something (can't Shake Loose),12.0,8,-1,-3,0,1,down,1977-08-13
7462,O.V. Wright,1977-10-15,O.V. Wright - Into Something (can't Shake Loose),45,42,48,40.0,46,Into Something (can't Shake Loose),12.0,9,-2,-1,-3,1,down,1977-08-13
7463,O.V. Wright,1977-10-22,O.V. Wright - Into Something (can't Shake Loose),46,45,49,40.0,48,Into Something (can't Shake Loose),12.0,10,-1,-2,-1,1,down,1977-08-13
7464,O.V. Wright,1977-10-29,O.V. Wright - Into Something (can't Shake Loose),48,46,50,40.0,49,Into Something (can't Shake Loose),12.0,11,-1,-1,-2,1,down,1977-08-13
7465,O.V. Wright,1977-11-05,O.V. Wright - Into Something (can't Shake Loose),49,48,51,40.0,50,Into Something (can't Shake Loose),12.0,12,-1,-1,-1,1,down,1977-08-13
7466,Smokey Robinson,1977-08-13,Smokey Robinson - Big Time/ Soundtrack,51,51,39,39.0,49,Big Time/ Soundtrack,5.0,0,10,2,0,1,up,1977-08-13
7467,Smokey Robinson,1977-08-20,Smokey Robinson - Big Time/ Soundtrack,49,51,39,39.0,39,Big Time/ Soundtrack,5.0,1,0,10,2,0,stay,1977-08-13
7468,Smokey Robinson,1977-08-27,Smokey Robinson - Big Time/ Soundtrack,39,49,39,39.0,39,Big Time/ Soundtrack,5.0,2,0,0,10,0,stay,1977-08-13
7469,Smokey Robinson,1977-09-03,Smokey Robinson - Big Time/ Soundtrack,39,39,40,39.0,39,Big Time/ Soundtrack,5.0,3,-1,0,0,1,down,1977-08-13
7470,Smokey Robinson,1977-09-10,Smokey Robinson - Big Time/ Soundtrack,39,39,49,39.0,40,Big Time/ Soundtrack,5.0,4,-9,-1,0,1,down,1977-08-13
7471,Smokey Robinson,1977-09-17,Smokey Robinson - Big Time/ Soundtrack,40,39,51,39.0,49,Big Time/ Soundtrack,5.0,5,-2,-9,-1,1,down,1977-08-13
7472,Jermaine Jackson,1977-08-13,Jermaine Jackson - Feel The Fire,51,51,40,36.0,50,Feel The Fire,5.0,0,10,1,0,1,up,1977-08-13
7473,Jermaine Jackson,1977-08-20,Jermaine Jackson - Feel The Fire,50,51,37,36.0,40,Feel The Fire,5.0,1,3,10,1,1,up,1977-08-13
7474,Jermaine Jackson,1977-08-27,Jermaine Jackson - Feel The Fire,40,50,36,36.0,37,Feel The Fire,5.0,2,1,3,10,1,up,1977-08-13
7475,Jermaine Jackson,1977-09-03,Jermaine Jackson - Feel The Fire,37,40,37,36.0,36,Feel The Fire,5.0,3,-1,1,3,1,down,1977-08-13
7476,Jermaine Jackson,1977-09-10,Jermaine Jackson - Feel The Fire,36,37,48,36.0,37,Feel The Fire,5.0,4,-11,-1,1,1,down,1977-08-13
7477,Jermaine Jackson,1977-09-17,Jermaine Jackson - Feel The Fire,37,36,51,36.0,48,Feel The Fire,5.0,5,-3,-11,-1,1,down,1977-08-13
7478,Candi Staton,1977-08-20,Candi Staton - Music Speaks Louder Than Words,51,51,46,46.0,48,Music Speaks Louder Than Words,3.0,0,2,3,0,1,up,1977-08-20
7479,Candi Staton,1977-08-27,Candi Staton - Music Speaks Louder Than Words,48,51,48,46.0,46,Music Speaks Louder Than Words,3.0,1,-2,2,3,1,down,1977-08-20
7480,Candi Staton,1977-09-03,Candi Staton - Music Speaks Louder Than Words,46,48,50,46.0,48,Music Speaks Louder Than Words,3.0,2,-2,-2,2,1,down,1977-08-20
7481,Candi Staton,1977-09-10,Candi Staton - Music Speaks Louder Than Words,48,46,51,46.0,50,Music Speaks Louder Than Words,3.0,3,-1,-2,-2,1,down,1977-08-20
7482,John Klemmer,1977-08-20,John Klemmer - Lifestyle (living & Loving),51,51,49,49.0,50,Lifestyle (living & Loving),1.0,0,1,1,0,1,up,1977-08-20
7483,John Klemmer,1977-08-27,John Klemmer - Lifestyle (living & Loving),50,51,51,49.0,49,Lifestyle (living & Loving),1.0,1,-2,1,1,1,down,1977-08-20
7484,"Marilyn McCoo & Billy Davis, Jr.",1977-08-27,"Marilyn McCoo & Billy Davis, Jr. - The Two Of Us",51,51,32,26.0,42,The Two Of Us,10.0,0,10,9,0,1,up,1977-08-27
7485,"Marilyn McCoo & Billy Davis, Jr.",1977-09-03,"Marilyn McCoo & Billy Davis, Jr. - The Two Of Us",42,51,26,26.0,32,The Two Of Us,10.0,1,6,10,9,1,up,1977-08-27
7486,"Marilyn McCoo & Billy Davis, Jr.",1977-09-10,"Marilyn McCoo & Billy Davis, Jr. - The Two Of Us",32,42,26,26.0,26,The Two Of Us,10.0,2,0,6,10,0,stay,1977-08-27
7487,"Marilyn McCoo & Billy Davis, Jr.",1977-09-17,"Marilyn McCoo & Billy Davis, Jr. - The Two Of Us",26,32,27,26.0,26,The Two Of Us,10.0,3,-1,0,6,1,down,1977-08-27
7488,"Marilyn McCoo & Billy Davis, Jr.",1977-09-24,"Marilyn McCoo & Billy Davis, Jr. - The Two Of Us",26,26,29,26.0,27,The Two Of Us,10.0,4,-2,-1,0,1,down,1977-08-27
7489,"Marilyn McCoo & Billy Davis, Jr.",1977-10-01,"Marilyn McCoo & Billy Davis, Jr. - The Two Of Us",27,26,32,26.0,29,The Two Of Us,10.0,5,-3,-2,-1,1,down,1977-08-27
7490,"Marilyn McCoo & Billy Davis, Jr.",1977-10-08,"Marilyn McCoo & Billy Davis, Jr. - The Two Of Us",29,27,34,26.0,32,The Two Of Us,10.0,6,-2,-3,-2,1,down,1977-08-27
7491,"Marilyn McCoo & Billy Davis, Jr.",1977-10-15,"Marilyn McCoo & Billy Davis, Jr. - The Two Of Us",32,29,39,26.0,34,The Two Of Us,10.0,7,-5,-2,-3,1,down,1977-08-27
7492,"Marilyn McCoo & Billy Davis, Jr.",1977-10-22,"Marilyn McCoo & Billy Davis, Jr. - The Two Of Us",34,32,42,26.0,39,The Two Of Us,10.0,8,-3,-5,-2,1,down,1977-08-27
7493,"Marilyn McCoo & Billy Davis, Jr.",1977-10-29,"Marilyn McCoo & Billy Davis, Jr. - The Two Of Us",39,34,47,26.0,42,The Two Of Us,10.0,9,-5,-3,-5,1,down,1977-08-27
7494,"Marilyn McCoo & Billy Davis, Jr.",1977-11-05,"Marilyn McCoo & Billy Davis, Jr. - The Two Of Us",42,39,51,26.0,47,The Two Of Us,10.0,10,-4,-5,-3,1,down,1977-08-27
7495,Stuff,1977-08-27,Stuff - More Stuff,51,51,43,43.0,45,More Stuff,4.0,0,2,6,0,1,up,1977-08-27
7496,Stuff,1977-09-03,Stuff - More Stuff,45,51,43,43.0,43,More Stuff,4.0,1,0,2,6,0,stay,1977-08-27
7497,Stuff,1977-09-10,Stuff - More Stuff,43,45,45,43.0,43,More Stuff,4.0,2,-2,0,2,1,down,1977-08-27
7498,Stuff,1977-09-17,Stuff - More Stuff,43,43,47,43.0,45,More Stuff,4.0,3,-2,-2,0,1,down,1977-08-27
7499,Stuff,1977-09-24,Stuff - More Stuff,45,43,51,43.0,47,More Stuff,4.0,4,-4,-2,-2,1,down,1977-08-27
7500,Rose Royce,1977-09-03,Rose Royce - Rose Royce II/In Full Bloom,51,51,11,1.0,23,Rose Royce II/In Full Bloom,32.0,0,12,28,0,1,up,1977-09-03
7501,Rose Royce,1977-09-10,Rose Royce - Rose Royce II/In Full Bloom,23,51,7,1.0,11,Rose Royce II/In Full Bloom,32.0,1,4,12,28,1,up,1977-09-03
7502,Rose Royce,1977-09-17,Rose Royce - Rose Royce II/In Full Bloom,11,23,2,1.0,7,Rose Royce II/In Full Bloom,32.0,2,5,4,12,1,up,1977-09-03
7503,Rose Royce,1977-09-24,Rose Royce - Rose Royce II/In Full Bloom,7,11,1,1.0,2,Rose Royce II/In Full Bloom,32.0,3,1,5,4,1,up,1977-09-03
7504,Rose Royce,1977-10-01,Rose Royce - Rose Royce II/In Full Bloom,2,7,2,1.0,1,Rose Royce II/In Full Bloom,32.0,4,-1,1,5,1,down,1977-09-03
7505,Rose Royce,1977-10-08,Rose Royce - Rose Royce II/In Full Bloom,1,2,4,1.0,2,Rose Royce II/In Full Bloom,32.0,5,-2,-1,1,1,down,1977-09-03
7506,Rose Royce,1977-10-15,Rose Royce - Rose Royce II/In Full Bloom,2,1,4,1.0,4,Rose Royce II/In Full Bloom,32.0,6,0,-2,-1,0,stay,1977-09-03
7507,Rose Royce,1977-10-22,Rose Royce - Rose Royce II/In Full Bloom,4,2,4,1.0,4,Rose Royce II/In Full Bloom,32.0,7,0,0,-2,0,stay,1977-09-03
7508,Rose Royce,1977-10-29,Rose Royce - Rose Royce II/In Full Bloom,4,4,2,1.0,4,Rose Royce II/In Full Bloom,32.0,8,2,0,0,1,up,1977-09-03
7509,Rose Royce,1977-11-05,Rose Royce - Rose Royce II/In Full Bloom,4,4,3,1.0,2,Rose Royce II/In Full Bloom,32.0,9,-1,2,0,1,down,1977-09-03
7510,Rose Royce,1977-11-12,Rose Royce - Rose Royce II/In Full Bloom,2,4,3,1.0,3,Rose Royce II/In Full Bloom,32.0,10,0,-1,2,0,stay,1977-09-03
7511,Rose Royce,1977-11-19,Rose Royce - Rose Royce II/In Full Bloom,3,2,2,1.0,3,Rose Royce II/In Full Bloom,32.0,11,1,0,-1,1,up,1977-09-03
7512,Rose Royce,1977-11-26,Rose Royce - Rose Royce II/In Full Bloom,3,3,1,1.0,2,Rose Royce II/In Full Bloom,32.0,12,1,1,0,1,up,1977-09-03
7513,Rose Royce,1977-12-03,Rose Royce - Rose Royce II/In Full Bloom,2,3,1,1.0,1,Rose Royce II/In Full Bloom,32.0,13,0,1,1,0,stay,1977-09-03
7514,Rose Royce,1977-12-10,Rose Royce - Rose Royce II/In Full Bloom,1,2,3,1.0,1,Rose Royce II/In Full Bloom,32.0,14,-2,0,1,1,down,1977-09-03
7515,Rose Royce,1977-12-17,Rose Royce - Rose Royce II/In Full Bloom,1,1,3,1.0,3,Rose Royce II/In Full Bloom,32.0,15,0,-2,0,0,stay,1977-09-03
7516,Rose Royce,1977-12-24,Rose Royce - Rose Royce II/In Full Bloom,3,1,3,1.0,3,Rose Royce II/In Full Bloom,32.0,16,0,0,-2,0,stay,1977-09-03
7517,Rose Royce,1977-12-31,Rose Royce - Rose Royce II/In Full Bloom,3,3,3,1.0,3,Rose Royce II/In Full Bloom,32.0,17,0,0,0,0,stay,1977-09-03
7518,Rose Royce,1978-01-07,Rose Royce - Rose Royce II/In Full Bloom,3,3,3,1.0,3,Rose Royce II/In Full Bloom,32.0,18,0,0,0,0,stay,1977-09-03
7519,Rose Royce,1978-01-14,Rose Royce - Rose Royce II/In Full Bloom,3,3,4,1.0,3,Rose Royce II/In Full Bloom,32.0,19,-1,0,0,1,down,1977-09-03
7520,Rose Royce,1978-01-21,Rose Royce - Rose Royce II/In Full Bloom,3,3,5,1.0,4,Rose Royce II/In Full Bloom,32.0,20,-1,-1,0,1,down,1977-09-03
7521,Rose Royce,1978-01-28,Rose Royce - Rose Royce II/In Full Bloom,4,3,9,1.0,5,Rose Royce II/In Full Bloom,32.0,21,-4,-1,-1,1,down,1977-09-03
7522,Rose Royce,1978-02-04,Rose Royce - Rose Royce II/In Full Bloom,5,4,9,1.0,9,Rose Royce II/In Full Bloom,32.0,22,0,-4,-1,0,stay,1977-09-03
7523,Rose Royce,1978-02-11,Rose Royce - Rose Royce II/In Full Bloom,9,5,10,1.0,9,Rose Royce II/In Full Bloom,32.0,23,-1,0,-4,1,down,1977-09-03
7524,Rose Royce,1978-02-18,Rose Royce - Rose Royce II/In Full Bloom,9,9,16,1.0,10,Rose Royce II/In Full Bloom,32.0,24,-6,-1,0,1,down,1977-09-03
7525,Rose Royce,1978-02-25,Rose Royce - Rose Royce II/In Full Bloom,10,9,16,1.0,16,Rose Royce II/In Full Bloom,32.0,25,0,-6,-1,0,stay,1977-09-03
7526,Rose Royce,1978-03-04,Rose Royce - Rose Royce II/In Full Bloom,16,10,18,1.0,16,Rose Royce II/In Full Bloom,32.0,26,-2,0,-6,1,down,1977-09-03
7527,Rose Royce,1978-03-11,Rose Royce - Rose Royce II/In Full Bloom,16,16,29,1.0,18,Rose Royce II/In Full Bloom,32.0,27,-11,-2,0,1,down,1977-09-03
7528,Rose Royce,1978-03-18,Rose Royce - Rose Royce II/In Full Bloom,18,16,38,1.0,29,Rose Royce II/In Full Bloom,32.0,28,-9,-11,-2,1,down,1977-09-03
7529,Rose Royce,1978-03-25,Rose Royce - Rose Royce II/In Full Bloom,29,18,43,1.0,38,Rose Royce II/In Full Bloom,32.0,29,-5,-9,-11,1,down,1977-09-03
7530,Rose Royce,1978-04-01,Rose Royce - Rose Royce II/In Full Bloom,38,29,43,1.0,43,Rose Royce II/In Full Bloom,32.0,30,0,-5,-9,0,stay,1977-09-03
7531,Rose Royce,1978-04-08,Rose Royce - Rose Royce II/In Full Bloom,43,38,48,1.0,43,Rose Royce II/In Full Bloom,32.0,31,-5,0,-5,1,down,1977-09-03
7532,Rose Royce,1978-04-15,Rose Royce - Rose Royce II/In Full Bloom,43,43,51,1.0,48,Rose Royce II/In Full Bloom,32.0,32,-3,-5,0,1,down,1977-09-03
7533,James Brown,1977-09-03,James Brown - Mutha's Nature,51,51,33,31.0,41,Mutha's Nature,5.0,0,8,10,0,1,up,1977-09-03
7534,James Brown,1977-09-10,James Brown - Mutha's Nature,41,51,31,31.0,33,Mutha's Nature,5.0,1,2,8,10,1,up,1977-09-03
7535,James Brown,1977-09-17,James Brown - Mutha's Nature,33,41,34,31.0,31,Mutha's Nature,5.0,2,-3,2,8,1,down,1977-09-03
7536,James Brown,1977-09-24,James Brown - Mutha's Nature,31,33,38,31.0,34,Mutha's Nature,5.0,3,-4,-3,2,1,down,1977-09-03
7537,James Brown,1977-10-01,James Brown - Mutha's Nature,34,31,41,31.0,38,Mutha's Nature,5.0,4,-3,-4,-3,1,down,1977-09-03
7538,James Brown,1977-10-08,James Brown - Mutha's Nature,38,34,51,31.0,41,Mutha's Nature,5.0,5,-10,-3,-4,1,down,1977-09-03
7539,Mass Production,1977-09-03,Mass Production - Believe,51,51,38,38.0,45,Believe,7.0,0,7,6,0,1,up,1977-09-03
7540,Mass Production,1977-09-10,Mass Production - Believe,45,51,38,38.0,38,Believe,7.0,1,0,7,6,0,stay,1977-09-03
7541,Mass Production,1977-09-17,Mass Production - Believe,38,45,38,38.0,38,Believe,7.0,2,0,0,7,0,stay,1977-09-03
7542,Mass Production,1977-09-24,Mass Production - Believe,38,38,40,38.0,38,Believe,7.0,3,-2,0,0,1,down,1977-09-03
7543,Mass Production,1977-10-01,Mass Production - Believe,38,38,40,38.0,40,Believe,7.0,4,0,-2,0,0,stay,1977-09-03
7544,Mass Production,1977-10-08,Mass Production - Believe,40,38,42,38.0,40,Believe,7.0,5,-2,0,-2,1,down,1977-09-03
7545,Mass Production,1977-10-15,Mass Production - Believe,40,40,44,38.0,42,Believe,7.0,6,-2,-2,0,1,down,1977-09-03
7546,Mass Production,1977-10-22,Mass Production - Believe,42,40,51,38.0,44,Believe,7.0,7,-7,-2,-2,1,down,1977-09-03
7547,Brick,1977-09-10,Brick - Brick,51,51,12,1.0,44,Brick,32.0,0,32,7,0,1,up,1977-09-10
7548,Brick,1977-09-17,Brick - Brick,44,51,7,1.0,12,Brick,32.0,1,5,32,7,1,up,1977-09-10
7549,Brick,1977-09-24,Brick - Brick,12,44,5,1.0,7,Brick,32.0,2,2,5,32,1,up,1977-09-10
7550,Brick,1977-10-01,Brick - Brick,7,12,3,1.0,5,Brick,32.0,3,2,2,5,1,up,1977-09-10
7551,Brick,1977-10-08,Brick - Brick,5,7,2,1.0,3,Brick,32.0,4,1,2,2,1,up,1977-09-10
7552,Brick,1977-10-15,Brick - Brick,3,5,3,1.0,2,Brick,32.0,5,-1,1,2,1,down,1977-09-10
7553,Brick,1977-10-22,Brick - Brick,2,3,3,1.0,3,Brick,32.0,6,0,-1,1,0,stay,1977-09-10
7554,Brick,1977-10-29,Brick - Brick,3,2,3,1.0,3,Brick,32.0,7,0,0,-1,0,stay,1977-09-10
7555,Brick,1977-11-05,Brick - Brick,3,3,1,1.0,3,Brick,32.0,8,2,0,0,1,up,1977-09-10
7556,Brick,1977-11-12,Brick - Brick,3,3,1,1.0,1,Brick,32.0,9,0,2,0,0,stay,1977-09-10
7557,Brick,1977-11-19,Brick - Brick,1,3,3,1.0,1,Brick,32.0,10,-2,0,2,1,down,1977-09-10
7558,Brick,1977-11-26,Brick - Brick,1,1,4,1.0,3,Brick,32.0,11,-1,-2,0,1,down,1977-09-10
7559,Brick,1977-12-03,Brick - Brick,3,1,5,1.0,4,Brick,32.0,12,-1,-1,-2,1,down,1977-09-10
7560,Brick,1977-12-10,Brick - Brick,4,3,8,1.0,5,Brick,32.0,13,-3,-1,-1,1,down,1977-09-10
7561,Brick,1977-12-17,Brick - Brick,5,4,8,1.0,8,Brick,32.0,14,0,-3,-1,0,stay,1977-09-10
7562,Brick,1977-12-24,Brick - Brick,8,5,8,1.0,8,Brick,32.0,15,0,0,-3,0,stay,1977-09-10
7563,Brick,1977-12-31,Brick - Brick,8,8,8,1.0,8,Brick,32.0,16,0,0,0,0,stay,1977-09-10
7564,Brick,1978-01-07,Brick - Brick,8,8,9,1.0,8,Brick,32.0,17,-1,0,0,1,down,1977-09-10
7565,Brick,1978-01-14,Brick - Brick,8,8,12,1.0,9,Brick,32.0,18,-3,-1,0,1,down,1977-09-10
7566,Brick,1978-01-21,Brick - Brick,9,8,12,1.0,12,Brick,32.0,19,0,-3,-1,0,stay,1977-09-10
7567,Brick,1978-01-28,Brick - Brick,12,9,12,1.0,12,Brick,32.0,20,0,0,-3,0,stay,1977-09-10
7568,Brick,1978-02-04,Brick - Brick,12,12,15,1.0,12,Brick,32.0,21,-3,0,0,1,down,1977-09-10
7569,Brick,1978-02-11,Brick - Brick,12,12,18,1.0,15,Brick,32.0,22,-3,-3,0,1,down,1977-09-10
7570,Brick,1978-02-18,Brick - Brick,15,12,18,1.0,18,Brick,32.0,23,0,-3,-3,0,stay,1977-09-10
7571,Brick,1978-02-25,Brick - Brick,18,15,18,1.0,18,Brick,32.0,24,0,0,-3,0,stay,1977-09-10
7572,Brick,1978-03-04,Brick - Brick,18,18,15,1.0,18,Brick,32.0,25,3,0,0,1,up,1977-09-10
7573,Brick,1978-03-11,Brick - Brick,18,18,26,1.0,15,Brick,32.0,26,-11,3,0,1,down,1977-09-10
7574,Brick,1978-03-18,Brick - Brick,15,18,36,1.0,26,Brick,32.0,27,-10,-11,3,1,down,1977-09-10
7575,Brick,1978-03-25,Brick - Brick,26,15,36,1.0,36,Brick,32.0,28,0,-10,-11,0,stay,1977-09-10
7576,Brick,1978-04-01,Brick - Brick,36,26,41,1.0,36,Brick,32.0,29,-5,0,-10,1,down,1977-09-10
7577,Brick,1978-04-08,Brick - Brick,36,36,41,1.0,41,Brick,32.0,30,0,-5,0,0,stay,1977-09-10
7578,Brick,1978-04-15,Brick - Brick,41,36,50,1.0,41,Brick,32.0,31,-9,0,-5,1,down,1977-09-10
7579,Brick,1978-04-22,Brick - Brick,41,41,51,1.0,50,Brick,32.0,32,-1,-9,0,1,down,1977-09-10
7580,Millie Jackson,1977-09-10,Millie Jackson - Feelin Bitchy,51,51,37,4.0,48,Feelin Bitchy,37.0,0,11,3,0,1,up,1977-09-10
7581,Millie Jackson,1977-09-17,Millie Jackson - Feelin Bitchy,48,51,29,4.0,37,Feelin Bitchy,37.0,1,8,11,3,1,up,1977-09-10
7582,Millie Jackson,1977-09-24,Millie Jackson - Feelin Bitchy,37,48,22,4.0,29,Feelin Bitchy,37.0,2,7,8,11,1,up,1977-09-10
7583,Millie Jackson,1977-10-01,Millie Jackson - Feelin Bitchy,29,37,16,4.0,22,Feelin Bitchy,37.0,3,6,7,8,1,up,1977-09-10
7584,Millie Jackson,1977-10-08,Millie Jackson - Feelin Bitchy,22,29,12,4.0,16,Feelin Bitchy,37.0,4,4,6,7,1,up,1977-09-10
7585,Millie Jackson,1977-10-15,Millie Jackson - Feelin Bitchy,16,22,10,4.0,12,Feelin Bitchy,37.0,5,2,4,6,1,up,1977-09-10
7586,Millie Jackson,1977-10-22,Millie Jackson - Feelin Bitchy,12,16,7,4.0,10,Feelin Bitchy,37.0,6,3,2,4,1,up,1977-09-10
7587,Millie Jackson,1977-10-29,Millie Jackson - Feelin Bitchy,10,12,6,4.0,7,Feelin Bitchy,37.0,7,1,3,2,1,up,1977-09-10
7588,Millie Jackson,1977-11-05,Millie Jackson - Feelin Bitchy,7,10,6,4.0,6,Feelin Bitchy,37.0,8,0,1,3,0,stay,1977-09-10
7589,Millie Jackson,1977-11-12,Millie Jackson - Feelin Bitchy,6,7,5,4.0,6,Feelin Bitchy,37.0,9,1,0,1,1,up,1977-09-10
7590,Millie Jackson,1977-11-19,Millie Jackson - Feelin Bitchy,6,6,8,4.0,5,Feelin Bitchy,37.0,10,-3,1,0,1,down,1977-09-10
7591,Millie Jackson,1977-11-26,Millie Jackson - Feelin Bitchy,5,6,5,4.0,8,Feelin Bitchy,37.0,11,3,-3,1,1,up,1977-09-10
7592,Millie Jackson,1977-12-03,Millie Jackson - Feelin Bitchy,8,5,4,4.0,5,Feelin Bitchy,37.0,12,1,3,-3,1,up,1977-09-10
7593,Millie Jackson,1977-12-10,Millie Jackson - Feelin Bitchy,5,8,5,4.0,4,Feelin Bitchy,37.0,13,-1,1,3,1,down,1977-09-10
7594,Millie Jackson,1977-12-17,Millie Jackson - Feelin Bitchy,4,5,5,4.0,5,Feelin Bitchy,37.0,14,0,-1,1,0,stay,1977-09-10
7595,Millie Jackson,1977-12-24,Millie Jackson - Feelin Bitchy,5,4,5,4.0,5,Feelin Bitchy,37.0,15,0,0,-1,0,stay,1977-09-10
7596,Millie Jackson,1977-12-31,Millie Jackson - Feelin Bitchy,5,5,5,4.0,5,Feelin Bitchy,37.0,16,0,0,0,0,stay,1977-09-10
7597,Millie Jackson,1978-01-07,Millie Jackson - Feelin Bitchy,5,5,8,4.0,5,Feelin Bitchy,37.0,17,-3,0,0,1,down,1977-09-10
7598,Millie Jackson,1978-01-14,Millie Jackson - Feelin Bitchy,5,5,13,4.0,8,Feelin Bitchy,37.0,18,-5,-3,0,1,down,1977-09-10
7599,Millie Jackson,1978-01-21,Millie Jackson - Feelin Bitchy,8,5,17,4.0,13,Feelin Bitchy,37.0,19,-4,-5,-3,1,down,1977-09-10
7600,Millie Jackson,1978-01-28,Millie Jackson - Feelin Bitchy,13,8,26,4.0,17,Feelin Bitchy,37.0,20,-9,-4,-5,1,down,1977-09-10
7601,Millie Jackson,1978-02-04,Millie Jackson - Feelin Bitchy,17,13,27,4.0,26,Feelin Bitchy,37.0,21,-1,-9,-4,1,down,1977-09-10
7602,Millie Jackson,1978-02-11,Millie Jackson - Feelin Bitchy,26,17,27,4.0,27,Feelin Bitchy,37.0,22,0,-1,-9,0,stay,1977-09-10
7603,Millie Jackson,1978-02-18,Millie Jackson - Feelin Bitchy,27,26,24,4.0,27,Feelin Bitchy,37.0,23,3,0,-1,1,up,1977-09-10
7604,Millie Jackson,1978-02-25,Millie Jackson - Feelin Bitchy,27,27,20,4.0,24,Feelin Bitchy,37.0,24,4,3,0,1,up,1977-09-10
7605,Millie Jackson,1978-03-04,Millie Jackson - Feelin Bitchy,24,27,21,4.0,20,Feelin Bitchy,37.0,25,-1,4,3,1,down,1977-09-10
7606,Millie Jackson,1978-03-11,Millie Jackson - Feelin Bitchy,20,24,28,4.0,21,Feelin Bitchy,37.0,26,-7,-1,4,1,down,1977-09-10
7607,Millie Jackson,1978-03-18,Millie Jackson - Feelin Bitchy,21,20,28,4.0,28,Feelin Bitchy,37.0,27,0,-7,-1,0,stay,1977-09-10
7608,Millie Jackson,1978-03-25,Millie Jackson - Feelin Bitchy,28,21,26,4.0,28,Feelin Bitchy,37.0,28,2,0,-7,1,up,1977-09-10
7609,Millie Jackson,1978-04-01,Millie Jackson - Feelin Bitchy,28,28,23,4.0,26,Feelin Bitchy,37.0,29,3,2,0,1,up,1977-09-10
7610,Millie Jackson,1978-04-08,Millie Jackson - Feelin Bitchy,26,28,23,4.0,23,Feelin Bitchy,37.0,30,0,3,2,0,stay,1977-09-10
7611,Millie Jackson,1978-04-15,Millie Jackson - Feelin Bitchy,23,26,25,4.0,23,Feelin Bitchy,37.0,31,-2,0,3,1,down,1977-09-10
7612,Millie Jackson,1978-04-22,Millie Jackson - Feelin Bitchy,23,23,29,4.0,25,Feelin Bitchy,37.0,32,-4,-2,0,1,down,1977-09-10
7613,Millie Jackson,1978-04-29,Millie Jackson - Feelin Bitchy,25,23,29,4.0,29,Feelin Bitchy,37.0,33,0,-4,-2,0,stay,1977-09-10
7614,Millie Jackson,1978-05-06,Millie Jackson - Feelin Bitchy,29,25,38,4.0,29,Feelin Bitchy,37.0,34,-9,0,-4,1,down,1977-09-10
7615,Millie Jackson,1978-05-13,Millie Jackson - Feelin Bitchy,29,29,38,4.0,38,Feelin Bitchy,37.0,35,0,-9,0,0,stay,1977-09-10
7616,Millie Jackson,1978-05-20,Millie Jackson - Feelin Bitchy,38,29,39,4.0,38,Feelin Bitchy,37.0,36,-1,0,-9,1,down,1977-09-10
7617,Millie Jackson,1978-05-27,Millie Jackson - Feelin Bitchy,38,38,51,4.0,39,Feelin Bitchy,37.0,37,-12,-1,0,1,down,1977-09-10
7618,Meco,1977-09-17,Meco - Star Wars & Other Galactic Funk,51,51,30,8.0,40,Star Wars & Other Galactic Funk,13.0,0,10,11,0,1,up,1977-09-17
7619,Meco,1977-09-24,Meco - Star Wars & Other Galactic Funk,40,51,20,8.0,30,Star Wars & Other Galactic Funk,13.0,1,10,10,11,1,up,1977-09-17
7620,Meco,1977-10-01,Meco - Star Wars & Other Galactic Funk,30,40,13,8.0,20,Star Wars & Other Galactic Funk,13.0,2,7,10,10,1,up,1977-09-17
7621,Meco,1977-10-08,Meco - Star Wars & Other Galactic Funk,20,30,10,8.0,13,Star Wars & Other Galactic Funk,13.0,3,3,7,10,1,up,1977-09-17
7622,Meco,1977-10-15,Meco - Star Wars & Other Galactic Funk,13,20,9,8.0,10,Star Wars & Other Galactic Funk,13.0,4,1,3,7,1,up,1977-09-17
7623,Meco,1977-10-22,Meco - Star Wars & Other Galactic Funk,10,13,8,8.0,9,Star Wars & Other Galactic Funk,13.0,5,1,1,3,1,up,1977-09-17
7624,Meco,1977-10-29,Meco - Star Wars & Other Galactic Funk,9,10,8,8.0,8,Star Wars & Other Galactic Funk,13.0,6,0,1,1,0,stay,1977-09-17
7625,Meco,1977-11-05,Meco - Star Wars & Other Galactic Funk,8,9,11,8.0,8,Star Wars & Other Galactic Funk,13.0,7,-3,0,1,1,down,1977-09-17
7626,Meco,1977-11-12,Meco - Star Wars & Other Galactic Funk,8,8,14,8.0,11,Star Wars & Other Galactic Funk,13.0,8,-3,-3,0,1,down,1977-09-17
7627,Meco,1977-11-19,Meco - Star Wars & Other Galactic Funk,11,8,19,8.0,14,Star Wars & Other Galactic Funk,13.0,9,-5,-3,-3,1,down,1977-09-17
7628,Meco,1977-11-26,Meco - Star Wars & Other Galactic Funk,14,11,25,8.0,19,Star Wars & Other Galactic Funk,13.0,10,-6,-5,-3,1,down,1977-09-17
7629,Meco,1977-12-03,Meco - Star Wars & Other Galactic Funk,19,14,30,8.0,25,Star Wars & Other Galactic Funk,13.0,11,-5,-6,-5,1,down,1977-09-17
7630,Meco,1977-12-10,Meco - Star Wars & Other Galactic Funk,25,19,50,8.0,30,Star Wars & Other Galactic Funk,13.0,12,-20,-5,-6,1,down,1977-09-17
7631,Meco,1977-12-17,Meco - Star Wars & Other Galactic Funk,30,25,51,8.0,50,Star Wars & Other Galactic Funk,13.0,13,-1,-20,-5,1,down,1977-09-17
7632,Patti LaBelle,1977-09-17,Patti LaBelle - Patti La Belle,51,51,35,16.0,43,Patti La Belle,20.0,0,8,8,0,1,up,1977-09-17
7633,Patti LaBelle,1977-09-24,Patti LaBelle - Patti La Belle,43,51,31,16.0,35,Patti La Belle,20.0,1,4,8,8,1,up,1977-09-17
7634,Patti LaBelle,1977-10-01,Patti LaBelle - Patti La Belle,35,43,27,16.0,31,Patti La Belle,20.0,2,4,4,8,1,up,1977-09-17
7635,Patti LaBelle,1977-10-08,Patti LaBelle - Patti La Belle,31,35,24,16.0,27,Patti La Belle,20.0,3,3,4,4,1,up,1977-09-17
7636,Patti LaBelle,1977-10-15,Patti LaBelle - Patti La Belle,27,31,19,16.0,24,Patti La Belle,20.0,4,5,3,4,1,up,1977-09-17
7637,Patti LaBelle,1977-10-22,Patti LaBelle - Patti La Belle,24,27,16,16.0,19,Patti La Belle,20.0,5,3,5,3,1,up,1977-09-17
7638,Patti LaBelle,1977-10-29,Patti LaBelle - Patti La Belle,19,24,16,16.0,16,Patti La Belle,20.0,6,0,3,5,0,stay,1977-09-17
7639,Patti LaBelle,1977-11-05,Patti LaBelle - Patti La Belle,16,19,17,16.0,16,Patti La Belle,20.0,7,-1,0,3,1,down,1977-09-17
7640,Patti LaBelle,1977-11-12,Patti LaBelle - Patti La Belle,16,16,17,16.0,17,Patti La Belle,20.0,8,0,-1,0,0,stay,1977-09-17
7641,Patti LaBelle,1977-11-19,Patti LaBelle - Patti La Belle,17,16,18,16.0,17,Patti La Belle,20.0,9,-1,0,-1,1,down,1977-09-17
7642,Patti LaBelle,1977-11-26,Patti LaBelle - Patti La Belle,17,17,18,16.0,18,Patti La Belle,20.0,10,0,-1,0,0,stay,1977-09-17
7643,Patti LaBelle,1977-12-03,Patti LaBelle - Patti La Belle,18,17,21,16.0,18,Patti La Belle,20.0,11,-3,0,-1,1,down,1977-09-17
7644,Patti LaBelle,1977-12-10,Patti LaBelle - Patti La Belle,18,18,21,16.0,21,Patti La Belle,20.0,12,0,-3,0,0,stay,1977-09-17
7645,Patti LaBelle,1977-12-17,Patti LaBelle - Patti La Belle,21,18,23,16.0,21,Patti La Belle,20.0,13,-2,0,-3,1,down,1977-09-17
7646,Patti LaBelle,1977-12-24,Patti LaBelle - Patti La Belle,21,21,23,16.0,23,Patti La Belle,20.0,14,0,-2,0,0,stay,1977-09-17
7647,Patti LaBelle,1977-12-31,Patti LaBelle - Patti La Belle,23,21,33,16.0,23,Patti La Belle,20.0,15,-10,0,-2,1,down,1977-09-17
7648,Patti LaBelle,1978-01-07,Patti LaBelle - Patti La Belle,23,23,35,16.0,33,Patti La Belle,20.0,16,-2,-10,0,1,down,1977-09-17
7649,Patti LaBelle,1978-01-14,Patti LaBelle - Patti La Belle,33,23,37,16.0,35,Patti La Belle,20.0,17,-2,-2,-10,1,down,1977-09-17
7650,Patti LaBelle,1978-01-21,Patti LaBelle - Patti La Belle,35,33,42,16.0,37,Patti La Belle,20.0,18,-5,-2,-2,1,down,1977-09-17
7651,Patti LaBelle,1978-01-28,Patti LaBelle - Patti La Belle,37,35,46,16.0,42,Patti La Belle,20.0,19,-4,-5,-2,1,down,1977-09-17
7652,Patti LaBelle,1978-02-04,Patti LaBelle - Patti La Belle,42,37,51,16.0,46,Patti La Belle,20.0,20,-5,-4,-5,1,down,1977-09-17
7653,Barry White,1977-09-24,Barry White - Barry White Sings For Someone You Love,51,51,33,1.0,44,Barry White Sings For Someone You Love,32.0,0,11,7,0,1,up,1977-09-24
7654,Barry White,1977-10-01,Barry White - Barry White Sings For Someone You Love,44,51,9,1.0,33,Barry White Sings For Someone You Love,32.0,1,24,11,7,1,up,1977-09-24
7655,Barry White,1977-10-08,Barry White - Barry White Sings For Someone You Love,33,44,1,1.0,9,Barry White Sings For Someone You Love,32.0,2,8,24,11,1,up,1977-09-24
7656,Barry White,1977-10-15,Barry White - Barry White Sings For Someone You Love,9,33,1,1.0,1,Barry White Sings For Someone You Love,32.0,3,0,8,24,0,stay,1977-09-24
7657,Barry White,1977-10-22,Barry White - Barry White Sings For Someone You Love,1,9,1,1.0,1,Barry White Sings For Someone You Love,32.0,4,0,0,8,0,stay,1977-09-24
7658,Barry White,1977-10-29,Barry White - Barry White Sings For Someone You Love,1,1,1,1.0,1,Barry White Sings For Someone You Love,32.0,5,0,0,0,0,stay,1977-09-24
7659,Barry White,1977-11-05,Barry White - Barry White Sings For Someone You Love,1,1,2,1.0,1,Barry White Sings For Someone You Love,32.0,6,-1,0,0,1,down,1977-09-24
7660,Barry White,1977-11-12,Barry White - Barry White Sings For Someone You Love,1,1,2,1.0,2,Barry White Sings For Someone You Love,32.0,7,0,-1,0,0,stay,1977-09-24
7661,Barry White,1977-11-19,Barry White - Barry White Sings For Someone You Love,2,1,1,1.0,2,Barry White Sings For Someone You Love,32.0,8,1,0,-1,1,up,1977-09-24
7662,Barry White,1977-11-26,Barry White - Barry White Sings For Someone You Love,2,2,3,1.0,1,Barry White Sings For Someone You Love,32.0,9,-2,1,0,1,down,1977-09-24
7663,Barry White,1977-12-03,Barry White - Barry White Sings For Someone You Love,1,2,3,1.0,3,Barry White Sings For Someone You Love,32.0,10,0,-2,1,0,stay,1977-09-24
7664,Barry White,1977-12-10,Barry White - Barry White Sings For Someone You Love,3,1,4,1.0,3,Barry White Sings For Someone You Love,32.0,11,-1,0,-2,1,down,1977-09-24
7665,Barry White,1977-12-17,Barry White - Barry White Sings For Someone You Love,3,3,6,1.0,4,Barry White Sings For Someone You Love,32.0,12,-2,-1,0,1,down,1977-09-24
7666,Barry White,1977-12-24,Barry White - Barry White Sings For Someone You Love,4,3,6,1.0,6,Barry White Sings For Someone You Love,32.0,13,0,-2,-1,0,stay,1977-09-24
7667,Barry White,1977-12-31,Barry White - Barry White Sings For Someone You Love,6,4,6,1.0,6,Barry White Sings For Someone You Love,32.0,14,0,0,-2,0,stay,1977-09-24
7668,Barry White,1978-01-07,Barry White - Barry White Sings For Someone You Love,6,6,7,1.0,6,Barry White Sings For Someone You Love,32.0,15,-1,0,0,1,down,1977-09-24
7669,Barry White,1978-01-14,Barry White - Barry White Sings For Someone You Love,6,6,8,1.0,7,Barry White Sings For Someone You Love,32.0,16,-1,-1,0,1,down,1977-09-24
7670,Barry White,1978-01-21,Barry White - Barry White Sings For Someone You Love,7,6,16,1.0,8,Barry White Sings For Someone You Love,32.0,17,-8,-1,-1,1,down,1977-09-24
7671,Barry White,1978-01-28,Barry White - Barry White Sings For Someone You Love,8,7,17,1.0,16,Barry White Sings For Someone You Love,32.0,18,-1,-8,-1,1,down,1977-09-24
7672,Barry White,1978-02-04,Barry White - Barry White Sings For Someone You Love,16,8,18,1.0,17,Barry White Sings For Someone You Love,32.0,19,-1,-1,-8,1,down,1977-09-24
7673,Barry White,1978-02-11,Barry White - Barry White Sings For Someone You Love,17,16,21,1.0,18,Barry White Sings For Someone You Love,32.0,20,-3,-1,-1,1,down,1977-09-24
7674,Barry White,1978-02-18,Barry White - Barry White Sings For Someone You Love,18,17,21,1.0,21,Barry White Sings For Someone You Love,32.0,21,0,-3,-1,0,stay,1977-09-24
7675,Barry White,1978-02-25,Barry White - Barry White Sings For Someone You Love,21,18,23,1.0,21,Barry White Sings For Someone You Love,32.0,22,-2,0,-3,1,down,1977-09-24
7676,Barry White,1978-03-04,Barry White - Barry White Sings For Someone You Love,21,21,25,1.0,23,Barry White Sings For Someone You Love,32.0,23,-2,-2,0,1,down,1977-09-24
7677,Barry White,1978-03-11,Barry White - Barry White Sings For Someone You Love,23,21,25,1.0,25,Barry White Sings For Someone You Love,32.0,24,0,-2,-2,0,stay,1977-09-24
7678,Barry White,1978-03-18,Barry White - Barry White Sings For Someone You Love,25,23,34,1.0,25,Barry White Sings For Someone You Love,32.0,25,-9,0,-2,1,down,1977-09-24
7679,Barry White,1978-03-25,Barry White - Barry White Sings For Someone You Love,25,25,38,1.0,34,Barry White Sings For Someone You Love,32.0,26,-4,-9,0,1,down,1977-09-24
7680,Barry White,1978-04-01,Barry White - Barry White Sings For Someone You Love,34,25,42,1.0,38,Barry White Sings For Someone You Love,32.0,27,-4,-4,-9,1,down,1977-09-24
7681,Barry White,1978-04-08,Barry White - Barry White Sings For Someone You Love,38,34,42,1.0,42,Barry White Sings For Someone You Love,32.0,28,0,-4,-4,0,stay,1977-09-24
7682,Barry White,1978-04-15,Barry White - Barry White Sings For Someone You Love,42,38,42,1.0,42,Barry White Sings For Someone You Love,32.0,29,0,0,-4,0,stay,1977-09-24
7683,Barry White,1978-04-22,Barry White - Barry White Sings For Someone You Love,42,42,48,1.0,42,Barry White Sings For Someone You Love,32.0,30,-6,0,0,1,down,1977-09-24
7684,Barry White,1978-04-29,Barry White - Barry White Sings For Someone You Love,42,42,50,1.0,48,Barry White Sings For Someone You Love,32.0,31,-2,-6,0,1,down,1977-09-24
7685,Barry White,1978-05-06,Barry White - Barry White Sings For Someone You Love,48,42,51,1.0,50,Barry White Sings For Someone You Love,32.0,32,-1,-2,-6,1,down,1977-09-24
7686,Tom Scott,1977-09-24,Tom Scott - Blow It Out,51,51,44,39.0,46,Blow It Out,3.0,0,2,5,0,1,up,1977-09-24
7687,Tom Scott,1977-10-01,Tom Scott - Blow It Out,46,51,39,39.0,44,Blow It Out,3.0,1,5,2,5,1,up,1977-09-24
7688,Tom Scott,1977-10-08,Tom Scott - Blow It Out,44,46,39,39.0,39,Blow It Out,3.0,2,0,5,2,0,stay,1977-09-24
7689,Tom Scott,1977-10-15,Tom Scott - Blow It Out,39,44,51,39.0,39,Blow It Out,3.0,3,-12,0,5,1,down,1977-09-24
7690,Manchild,1977-10-01,Manchild - Power And Love,51,51,31,29.0,41,Power And Love,4.0,0,10,10,0,1,up,1977-10-01
7691,Manchild,1977-10-08,Manchild - Power And Love,41,51,29,29.0,31,Power And Love,4.0,1,2,10,10,1,up,1977-10-01
7692,Manchild,1977-10-15,Manchild - Power And Love,31,41,38,29.0,29,Power And Love,4.0,2,-9,2,10,1,down,1977-10-01
7693,Manchild,1977-10-22,Manchild - Power And Love,29,31,38,29.0,38,Power And Love,4.0,3,0,-9,2,0,stay,1977-10-01
7694,Manchild,1977-10-29,Manchild - Power And Love,38,29,51,29.0,38,Power And Love,4.0,4,-13,0,-9,1,down,1977-10-01
7695,ConFunkShun,1977-10-08,ConFunkShun - Secrets,51,51,37,6.0,47,Secrets,28.0,0,10,4,0,1,up,1977-10-08
7696,ConFunkShun,1977-10-15,ConFunkShun - Secrets,47,51,36,6.0,37,Secrets,28.0,1,1,10,4,1,up,1977-10-08
7697,ConFunkShun,1977-10-22,ConFunkShun - Secrets,37,47,29,6.0,36,Secrets,28.0,2,7,1,10,1,up,1977-10-08
7698,ConFunkShun,1977-10-29,ConFunkShun - Secrets,36,37,22,6.0,29,Secrets,28.0,3,7,7,1,1,up,1977-10-08
7699,ConFunkShun,1977-11-05,ConFunkShun - Secrets,29,36,22,6.0,22,Secrets,28.0,4,0,7,7,0,stay,1977-10-08
7700,ConFunkShun,1977-11-12,ConFunkShun - Secrets,22,29,20,6.0,22,Secrets,28.0,5,2,0,7,1,up,1977-10-08
7701,ConFunkShun,1977-11-19,ConFunkShun - Secrets,22,22,16,6.0,20,Secrets,28.0,6,4,2,0,1,up,1977-10-08
7702,ConFunkShun,1977-11-26,ConFunkShun - Secrets,20,22,15,6.0,16,Secrets,28.0,7,1,4,2,1,up,1977-10-08
7703,ConFunkShun,1977-12-03,ConFunkShun - Secrets,16,20,11,6.0,15,Secrets,28.0,8,4,1,4,1,up,1977-10-08
7704,ConFunkShun,1977-12-10,ConFunkShun - Secrets,15,16,14,6.0,11,Secrets,28.0,9,-3,4,1,1,down,1977-10-08
7705,ConFunkShun,1977-12-17,ConFunkShun - Secrets,11,15,12,6.0,14,Secrets,28.0,10,2,-3,4,1,up,1977-10-08
7706,ConFunkShun,1977-12-24,ConFunkShun - Secrets,14,11,12,6.0,12,Secrets,28.0,11,0,2,-3,0,stay,1977-10-08
7707,ConFunkShun,1977-12-31,ConFunkShun - Secrets,12,14,10,6.0,12,Secrets,28.0,12,2,0,2,1,up,1977-10-08
7708,ConFunkShun,1978-01-07,ConFunkShun - Secrets,12,12,11,6.0,10,Secrets,28.0,13,-1,2,0,1,down,1977-10-08
7709,ConFunkShun,1978-01-14,ConFunkShun - Secrets,10,12,14,6.0,11,Secrets,28.0,14,-3,-1,2,1,down,1977-10-08
7710,ConFunkShun,1978-01-21,ConFunkShun - Secrets,11,10,13,6.0,14,Secrets,28.0,15,1,-3,-1,1,up,1977-10-08
7711,ConFunkShun,1978-01-28,ConFunkShun - Secrets,14,11,10,6.0,13,Secrets,28.0,16,3,1,-3,1,up,1977-10-08
7712,ConFunkShun,1978-02-04,ConFunkShun - Secrets,13,14,6,6.0,10,Secrets,28.0,17,4,3,1,1,up,1977-10-08
7713,ConFunkShun,1978-02-11,ConFunkShun - Secrets,10,13,6,6.0,6,Secrets,28.0,18,0,4,3,0,stay,1977-10-08
7714,ConFunkShun,1978-02-18,ConFunkShun - Secrets,6,10,11,6.0,6,Secrets,28.0,19,-5,0,4,1,down,1977-10-08
7715,ConFunkShun,1978-02-25,ConFunkShun - Secrets,6,6,13,6.0,11,Secrets,28.0,20,-2,-5,0,1,down,1977-10-08
7716,ConFunkShun,1978-03-04,ConFunkShun - Secrets,11,6,17,6.0,13,Secrets,28.0,21,-4,-2,-5,1,down,1977-10-08
7717,ConFunkShun,1978-03-11,ConFunkShun - Secrets,13,11,30,6.0,17,Secrets,28.0,22,-13,-4,-2,1,down,1977-10-08
7718,ConFunkShun,1978-03-18,ConFunkShun - Secrets,17,13,31,6.0,30,Secrets,28.0,23,-1,-13,-4,1,down,1977-10-08
7719,ConFunkShun,1978-03-25,ConFunkShun - Secrets,30,17,33,6.0,31,Secrets,28.0,24,-2,-1,-13,1,down,1977-10-08
7720,ConFunkShun,1978-04-01,ConFunkShun - Secrets,31,30,35,6.0,33,Secrets,28.0,25,-2,-2,-1,1,down,1977-10-08
7721,ConFunkShun,1978-04-08,ConFunkShun - Secrets,33,31,45,6.0,35,Secrets,28.0,26,-10,-2,-2,1,down,1977-10-08
7722,ConFunkShun,1978-04-15,ConFunkShun - Secrets,35,33,47,6.0,45,Secrets,28.0,27,-2,-10,-2,1,down,1977-10-08
7723,ConFunkShun,1978-04-22,ConFunkShun - Secrets,45,35,51,6.0,47,Secrets,28.0,28,-4,-2,-10,1,down,1977-10-08
7724,Diana Ross,1977-10-08,Diana Ross - Baby It's Me,51,51,35,7.0,50,Baby It's Me,15.0,0,15,1,0,1,up,1977-10-08
7725,Diana Ross,1977-10-15,Diana Ross - Baby It's Me,50,51,23,7.0,35,Baby It's Me,15.0,1,12,15,1,1,up,1977-10-08
7726,Diana Ross,1977-10-22,Diana Ross - Baby It's Me,35,50,15,7.0,23,Baby It's Me,15.0,2,8,12,15,1,up,1977-10-08
7727,Diana Ross,1977-10-29,Diana Ross - Baby It's Me,23,35,11,7.0,15,Baby It's Me,15.0,3,4,8,12,1,up,1977-10-08
7728,Diana Ross,1977-11-05,Diana Ross - Baby It's Me,15,23,9,7.0,11,Baby It's Me,15.0,4,2,4,8,1,up,1977-10-08
7729,Diana Ross,1977-11-12,Diana Ross - Baby It's Me,11,15,7,7.0,9,Baby It's Me,15.0,5,2,2,4,1,up,1977-10-08
7730,Diana Ross,1977-11-19,Diana Ross - Baby It's Me,9,11,7,7.0,7,Baby It's Me,15.0,6,0,2,2,0,stay,1977-10-08
7731,Diana Ross,1977-11-26,Diana Ross - Baby It's Me,7,9,10,7.0,7,Baby It's Me,15.0,7,-3,0,2,1,down,1977-10-08
7732,Diana Ross,1977-12-03,Diana Ross - Baby It's Me,7,7,13,7.0,10,Baby It's Me,15.0,8,-3,-3,0,1,down,1977-10-08
7733,Diana Ross,1977-12-10,Diana Ross - Baby It's Me,10,7,19,7.0,13,Baby It's Me,15.0,9,-6,-3,-3,1,down,1977-10-08
7734,Diana Ross,1977-12-17,Diana Ross - Baby It's Me,13,10,24,7.0,19,Baby It's Me,15.0,10,-5,-6,-3,1,down,1977-10-08
7735,Diana Ross,1977-12-24,Diana Ross - Baby It's Me,19,13,24,7.0,24,Baby It's Me,15.0,11,0,-5,-6,0,stay,1977-10-08
7736,Diana Ross,1977-12-31,Diana Ross - Baby It's Me,24,19,34,7.0,24,Baby It's Me,15.0,12,-10,0,-5,1,down,1977-10-08
7737,Diana Ross,1978-01-07,Diana Ross - Baby It's Me,24,24,42,7.0,34,Baby It's Me,15.0,13,-8,-10,0,1,down,1977-10-08
7738,Diana Ross,1978-01-14,Diana Ross - Baby It's Me,34,24,42,7.0,42,Baby It's Me,15.0,14,0,-8,-10,0,stay,1977-10-08
7739,Diana Ross,1978-01-21,Diana Ross - Baby It's Me,42,34,51,7.0,42,Baby It's Me,15.0,15,-9,0,-8,1,down,1977-10-08
7740,The Blackbyrds,1977-10-15,The Blackbyrds - Action,51,51,20,8.0,30,Action,27.0,0,10,21,0,1,up,1977-10-15
7741,The Blackbyrds,1977-10-22,The Blackbyrds - Action,30,51,12,8.0,20,Action,27.0,1,8,10,21,1,up,1977-10-15
7742,The Blackbyrds,1977-10-29,The Blackbyrds - Action,20,30,9,8.0,12,Action,27.0,2,3,8,10,1,up,1977-10-15
7743,The Blackbyrds,1977-11-05,The Blackbyrds - Action,12,20,8,8.0,9,Action,27.0,3,1,3,8,1,up,1977-10-15
7744,The Blackbyrds,1977-11-12,The Blackbyrds - Action,9,12,8,8.0,8,Action,27.0,4,0,1,3,0,stay,1977-10-15
7745,The Blackbyrds,1977-11-19,The Blackbyrds - Action,8,9,9,8.0,8,Action,27.0,5,-1,0,1,1,down,1977-10-15
7746,The Blackbyrds,1977-11-26,The Blackbyrds - Action,8,8,11,8.0,9,Action,27.0,6,-2,-1,0,1,down,1977-10-15
7747,The Blackbyrds,1977-12-03,The Blackbyrds - Action,9,8,10,8.0,11,Action,27.0,7,1,-2,-1,1,up,1977-10-15
7748,The Blackbyrds,1977-12-10,The Blackbyrds - Action,11,9,15,8.0,10,Action,27.0,8,-5,1,-2,1,down,1977-10-15
7749,The Blackbyrds,1977-12-17,The Blackbyrds - Action,10,11,15,8.0,15,Action,27.0,9,0,-5,1,0,stay,1977-10-15
7750,The Blackbyrds,1977-12-24,The Blackbyrds - Action,15,10,15,8.0,15,Action,27.0,10,0,0,-5,0,stay,1977-10-15
7751,The Blackbyrds,1977-12-31,The Blackbyrds - Action,15,15,17,8.0,15,Action,27.0,11,-2,0,0,1,down,1977-10-15
7752,The Blackbyrds,1978-01-07,The Blackbyrds - Action,15,15,22,8.0,17,Action,27.0,12,-5,-2,0,1,down,1977-10-15
7753,The Blackbyrds,1978-01-14,The Blackbyrds - Action,17,15,29,8.0,22,Action,27.0,13,-7,-5,-2,1,down,1977-10-15
7754,The Blackbyrds,1978-01-21,The Blackbyrds - Action,22,17,25,8.0,29,Action,27.0,14,4,-7,-5,1,up,1977-10-15
7755,The Blackbyrds,1978-01-28,The Blackbyrds - Action,29,22,29,8.0,25,Action,27.0,15,-4,4,-7,1,down,1977-10-15
7756,The Blackbyrds,1978-02-04,The Blackbyrds - Action,25,29,29,8.0,29,Action,27.0,16,0,-4,4,0,stay,1977-10-15
7757,The Blackbyrds,1978-02-11,The Blackbyrds - Action,29,25,29,8.0,29,Action,27.0,17,0,0,-4,0,stay,1977-10-15
7758,The Blackbyrds,1978-02-18,The Blackbyrds - Action,29,29,27,8.0,29,Action,27.0,18,2,0,0,1,up,1977-10-15
7759,The Blackbyrds,1978-02-25,The Blackbyrds - Action,29,29,27,8.0,27,Action,27.0,19,0,2,0,0,stay,1977-10-15
7760,The Blackbyrds,1978-03-04,The Blackbyrds - Action,27,29,31,8.0,27,Action,27.0,20,-4,0,2,1,down,1977-10-15
7761,The Blackbyrds,1978-03-11,The Blackbyrds - Action,27,27,34,8.0,31,Action,27.0,21,-3,-4,0,1,down,1977-10-15
7762,The Blackbyrds,1978-03-18,The Blackbyrds - Action,31,27,39,8.0,34,Action,27.0,22,-5,-3,-4,1,down,1977-10-15
7763,The Blackbyrds,1978-03-25,The Blackbyrds - Action,34,31,42,8.0,39,Action,27.0,23,-3,-5,-3,1,down,1977-10-15
7764,The Blackbyrds,1978-04-01,The Blackbyrds - Action,39,34,47,8.0,42,Action,27.0,24,-5,-3,-5,1,down,1977-10-15
7765,The Blackbyrds,1978-04-08,The Blackbyrds - Action,42,39,47,8.0,47,Action,27.0,25,0,-5,-3,0,stay,1977-10-15
7766,The Blackbyrds,1978-04-15,The Blackbyrds - Action,47,42,46,8.0,47,Action,27.0,26,1,0,-5,1,up,1977-10-15
7767,The Blackbyrds,1978-04-22,The Blackbyrds - Action,47,47,51,8.0,46,Action,27.0,27,-5,1,0,1,down,1977-10-15
7768,Ashford & Simpson,1977-10-15,Ashford & Simpson - Send It,51,51,31,10.0,41,Send It,35.0,0,10,10,0,1,up,1977-10-15
7769,Ashford & Simpson,1977-10-22,Ashford & Simpson - Send It,41,51,21,10.0,31,Send It,35.0,1,10,10,10,1,up,1977-10-15
7770,Ashford & Simpson,1977-10-29,Ashford & Simpson - Send It,31,41,15,10.0,21,Send It,35.0,2,6,10,10,1,up,1977-10-15
7771,Ashford & Simpson,1977-11-05,Ashford & Simpson - Send It,21,31,13,10.0,15,Send It,35.0,3,2,6,10,1,up,1977-10-15
7772,Ashford & Simpson,1977-11-12,Ashford & Simpson - Send It,15,21,10,10.0,13,Send It,35.0,4,3,2,6,1,up,1977-10-15
7773,Ashford & Simpson,1977-11-19,Ashford & Simpson - Send It,13,15,10,10.0,10,Send It,35.0,5,0,3,2,0,stay,1977-10-15
7774,Ashford & Simpson,1977-11-26,Ashford & Simpson - Send It,10,13,12,10.0,10,Send It,35.0,6,-2,0,3,1,down,1977-10-15
7775,Ashford & Simpson,1977-12-03,Ashford & Simpson - Send It,10,10,12,10.0,12,Send It,35.0,7,0,-2,0,0,stay,1977-10-15
7776,Ashford & Simpson,1977-12-10,Ashford & Simpson - Send It,12,10,17,10.0,12,Send It,35.0,8,-5,0,-2,1,down,1977-10-15
7777,Ashford & Simpson,1977-12-17,Ashford & Simpson - Send It,12,12,19,10.0,17,Send It,35.0,9,-2,-5,0,1,down,1977-10-15
7778,Ashford & Simpson,1977-12-24,Ashford & Simpson - Send It,17,12,19,10.0,19,Send It,35.0,10,0,-2,-5,0,stay,1977-10-15
7779,Ashford & Simpson,1977-12-31,Ashford & Simpson - Send It,19,17,24,10.0,19,Send It,35.0,11,-5,0,-2,1,down,1977-10-15
7780,Ashford & Simpson,1978-01-07,Ashford & Simpson - Send It,19,19,31,10.0,24,Send It,35.0,12,-7,-5,0,1,down,1977-10-15
7781,Ashford & Simpson,1978-01-14,Ashford & Simpson - Send It,24,19,31,10.0,31,Send It,35.0,13,0,-7,-5,0,stay,1977-10-15
7782,Ashford & Simpson,1978-01-21,Ashford & Simpson - Send It,31,24,31,10.0,31,Send It,35.0,14,0,0,-7,0,stay,1977-10-15
7783,Ashford & Simpson,1978-01-28,Ashford & Simpson - Send It,31,31,31,10.0,31,Send It,35.0,15,0,0,0,0,stay,1977-10-15
7784,Ashford & Simpson,1978-02-04,Ashford & Simpson - Send It,31,31,31,10.0,31,Send It,35.0,16,0,0,0,0,stay,1977-10-15
7785,Ashford & Simpson,1978-02-11,Ashford & Simpson - Send It,31,31,30,10.0,31,Send It,35.0,17,1,0,0,1,up,1977-10-15
7786,Ashford & Simpson,1978-02-18,Ashford & Simpson - Send It,31,31,29,10.0,30,Send It,35.0,18,1,1,0,1,up,1977-10-15
7787,Ashford & Simpson,1978-02-25,Ashford & Simpson - Send It,30,31,28,10.0,29,Send It,35.0,19,1,1,1,1,up,1977-10-15
7788,Ashford & Simpson,1978-03-04,Ashford & Simpson - Send It,29,30,28,10.0,28,Send It,35.0,20,0,1,1,0,stay,1977-10-15
7789,Ashford & Simpson,1978-03-11,Ashford & Simpson - Send It,28,29,27,10.0,28,Send It,35.0,21,1,0,1,1,up,1977-10-15
7790,Ashford & Simpson,1978-03-18,Ashford & Simpson - Send It,28,28,23,10.0,27,Send It,35.0,22,4,1,0,1,up,1977-10-15
7791,Ashford & Simpson,1978-03-25,Ashford & Simpson - Send It,27,28,21,10.0,23,Send It,35.0,23,2,4,1,1,up,1977-10-15
7792,Ashford & Simpson,1978-04-01,Ashford & Simpson - Send It,23,27,22,10.0,21,Send It,35.0,24,-1,2,4,1,down,1977-10-15
7793,Ashford & Simpson,1978-04-08,Ashford & Simpson - Send It,21,23,21,10.0,22,Send It,35.0,25,1,-1,2,1,up,1977-10-15
7794,Ashford & Simpson,1978-04-15,Ashford & Simpson - Send It,22,21,20,10.0,21,Send It,35.0,26,1,1,-1,1,up,1977-10-15
7795,Ashford & Simpson,1978-04-22,Ashford & Simpson - Send It,21,22,24,10.0,20,Send It,35.0,27,-4,1,1,1,down,1977-10-15
7796,Ashford & Simpson,1978-04-29,Ashford & Simpson - Send It,20,21,24,10.0,24,Send It,35.0,28,0,-4,1,0,stay,1977-10-15
7797,Ashford & Simpson,1978-05-06,Ashford & Simpson - Send It,24,20,33,10.0,24,Send It,35.0,29,-9,0,-4,1,down,1977-10-15
7798,Ashford & Simpson,1978-05-13,Ashford & Simpson - Send It,24,24,33,10.0,33,Send It,35.0,30,0,-9,0,0,stay,1977-10-15
7799,Ashford & Simpson,1978-05-20,Ashford & Simpson - Send It,33,24,35,10.0,33,Send It,35.0,31,-2,0,-9,1,down,1977-10-15
7800,Ashford & Simpson,1978-05-27,Ashford & Simpson - Send It,33,33,41,10.0,35,Send It,35.0,32,-6,-2,0,1,down,1977-10-15
7801,Ashford & Simpson,1978-06-03,Ashford & Simpson - Send It,35,33,45,10.0,41,Send It,35.0,33,-4,-6,-2,1,down,1977-10-15
7802,Ashford & Simpson,1978-06-10,Ashford & Simpson - Send It,41,35,49,10.0,45,Send It,35.0,34,-4,-4,-6,1,down,1977-10-15
7803,Ashford & Simpson,1978-06-17,Ashford & Simpson - Send It,45,41,51,10.0,49,Send It,35.0,35,-2,-4,-4,1,down,1977-10-15
7804,Eddie Kendricks,1977-10-15,Eddie Kendricks - Slick,51,51,47,47.0,49,Slick,2.0,0,2,2,0,1,up,1977-10-15
7805,Eddie Kendricks,1977-10-22,Eddie Kendricks - Slick,49,51,47,47.0,47,Slick,2.0,1,0,2,2,0,stay,1977-10-15
7806,Eddie Kendricks,1977-10-29,Eddie Kendricks - Slick,47,49,51,47.0,47,Slick,2.0,2,-4,0,2,1,down,1977-10-15
7807,Aalon,1977-10-15,Aalon - Cream City,51,51,49,45.0,50,Cream City,4.0,0,1,1,0,1,up,1977-10-15
7808,Aalon,1977-10-22,Aalon - Cream City,50,51,45,45.0,49,Cream City,4.0,1,4,1,1,1,up,1977-10-15
7809,Aalon,1977-10-29,Aalon - Cream City,49,50,45,45.0,45,Cream City,4.0,2,0,4,1,0,stay,1977-10-15
7810,Aalon,1977-11-05,Aalon - Cream City,45,49,46,45.0,45,Cream City,4.0,3,-1,0,4,1,down,1977-10-15
7811,Aalon,1977-11-12,Aalon - Cream City,45,45,51,45.0,46,Cream City,4.0,4,-5,-1,0,1,down,1977-10-15
7812,Odyssey,1977-10-22,Odyssey - Odyssey,51,51,30,16.0,40,Odyssey,23.0,0,10,11,0,1,up,1977-10-22
7813,Odyssey,1977-10-29,Odyssey - Odyssey,40,51,27,16.0,30,Odyssey,23.0,1,3,10,11,1,up,1977-10-22
7814,Odyssey,1977-11-05,Odyssey - Odyssey,30,40,27,16.0,27,Odyssey,23.0,2,0,3,10,0,stay,1977-10-22
7815,Odyssey,1977-11-12,Odyssey - Odyssey,27,30,25,16.0,27,Odyssey,23.0,3,2,0,3,1,up,1977-10-22
7816,Odyssey,1977-11-19,Odyssey - Odyssey,27,27,21,16.0,25,Odyssey,23.0,4,4,2,0,1,up,1977-10-22
7817,Odyssey,1977-11-26,Odyssey - Odyssey,25,27,19,16.0,21,Odyssey,23.0,5,2,4,2,1,up,1977-10-22
7818,Odyssey,1977-12-03,Odyssey - Odyssey,21,25,17,16.0,19,Odyssey,23.0,6,2,2,4,1,up,1977-10-22
7819,Odyssey,1977-12-10,Odyssey - Odyssey,19,21,16,16.0,17,Odyssey,23.0,7,1,2,2,1,up,1977-10-22
7820,Odyssey,1977-12-17,Odyssey - Odyssey,17,19,17,16.0,16,Odyssey,23.0,8,-1,1,2,1,down,1977-10-22
7821,Odyssey,1977-12-24,Odyssey - Odyssey,16,17,17,16.0,17,Odyssey,23.0,9,0,-1,1,0,stay,1977-10-22
7822,Odyssey,1977-12-31,Odyssey - Odyssey,17,16,27,16.0,17,Odyssey,23.0,10,-10,0,-1,1,down,1977-10-22
7823,Odyssey,1978-01-07,Odyssey - Odyssey,17,17,28,16.0,27,Odyssey,23.0,11,-1,-10,0,1,down,1977-10-22
7824,Odyssey,1978-01-14,Odyssey - Odyssey,27,17,28,16.0,28,Odyssey,23.0,12,0,-1,-10,0,stay,1977-10-22
7825,Odyssey,1978-01-21,Odyssey - Odyssey,28,27,28,16.0,28,Odyssey,23.0,13,0,0,-1,0,stay,1977-10-22
7826,Odyssey,1978-01-28,Odyssey - Odyssey,28,28,34,16.0,28,Odyssey,23.0,14,-6,0,0,1,down,1977-10-22
7827,Odyssey,1978-02-04,Odyssey - Odyssey,28,28,34,16.0,34,Odyssey,23.0,15,0,-6,0,0,stay,1977-10-22
7828,Odyssey,1978-02-11,Odyssey - Odyssey,34,28,34,16.0,34,Odyssey,23.0,16,0,0,-6,0,stay,1977-10-22
7829,Odyssey,1978-02-18,Odyssey - Odyssey,34,34,37,16.0,34,Odyssey,23.0,17,-3,0,0,1,down,1977-10-22
7830,Odyssey,1978-02-25,Odyssey - Odyssey,34,34,37,16.0,37,Odyssey,23.0,18,0,-3,0,0,stay,1977-10-22
7831,Odyssey,1978-03-04,Odyssey - Odyssey,37,34,37,16.0,37,Odyssey,23.0,19,0,0,-3,0,stay,1977-10-22
7832,Odyssey,1978-03-11,Odyssey - Odyssey,37,37,43,16.0,37,Odyssey,23.0,20,-6,0,0,1,down,1977-10-22
7833,Odyssey,1978-03-18,Odyssey - Odyssey,37,37,43,16.0,43,Odyssey,23.0,21,0,-6,0,0,stay,1977-10-22
7834,Odyssey,1978-03-25,Odyssey - Odyssey,43,37,45,16.0,43,Odyssey,23.0,22,-2,0,-6,1,down,1977-10-22
7835,Odyssey,1978-04-01,Odyssey - Odyssey,43,43,51,16.0,45,Odyssey,23.0,23,-6,-2,0,1,down,1977-10-22
7836,Pockets,1977-10-22,Pockets - Come Go With Us,51,51,36,17.0,46,Come Go With Us,18.0,0,10,5,0,1,up,1977-10-22
7837,Pockets,1977-10-29,Pockets - Come Go With Us,46,51,26,17.0,36,Come Go With Us,18.0,1,10,10,5,1,up,1977-10-22
7838,Pockets,1977-11-05,Pockets - Come Go With Us,36,46,23,17.0,26,Come Go With Us,18.0,2,3,10,10,1,up,1977-10-22
7839,Pockets,1977-11-12,Pockets - Come Go With Us,26,36,22,17.0,23,Come Go With Us,18.0,3,1,3,10,1,up,1977-10-22
7840,Pockets,1977-11-19,Pockets - Come Go With Us,23,26,17,17.0,22,Come Go With Us,18.0,4,5,1,3,1,up,1977-10-22
7841,Pockets,1977-11-26,Pockets - Come Go With Us,22,23,17,17.0,17,Come Go With Us,18.0,5,0,5,1,0,stay,1977-10-22
7842,Pockets,1977-12-03,Pockets - Come Go With Us,17,22,26,17.0,17,Come Go With Us,18.0,6,-9,0,5,1,down,1977-10-22
7843,Pockets,1977-12-10,Pockets - Come Go With Us,17,17,25,17.0,26,Come Go With Us,18.0,7,1,-9,0,1,up,1977-10-22
7844,Pockets,1977-12-17,Pockets - Come Go With Us,26,17,25,17.0,25,Come Go With Us,18.0,8,0,1,-9,0,stay,1977-10-22
7845,Pockets,1977-12-24,Pockets - Come Go With Us,25,26,25,17.0,25,Come Go With Us,18.0,9,0,0,1,0,stay,1977-10-22
7846,Pockets,1977-12-31,Pockets - Come Go With Us,25,25,21,17.0,25,Come Go With Us,18.0,10,4,0,0,1,up,1977-10-22
7847,Pockets,1978-01-07,Pockets - Come Go With Us,25,25,33,17.0,21,Come Go With Us,18.0,11,-12,4,0,1,down,1977-10-22
7848,Pockets,1978-01-14,Pockets - Come Go With Us,21,25,27,17.0,33,Come Go With Us,18.0,12,6,-12,4,1,up,1977-10-22
7849,Pockets,1978-01-21,Pockets - Come Go With Us,33,21,26,17.0,27,Come Go With Us,18.0,13,1,6,-12,1,up,1977-10-22
7850,Pockets,1978-01-28,Pockets - Come Go With Us,27,33,24,17.0,26,Come Go With Us,18.0,14,2,1,6,1,up,1977-10-22
7851,Pockets,1978-02-04,Pockets - Come Go With Us,26,27,24,17.0,24,Come Go With Us,18.0,15,0,2,1,0,stay,1977-10-22
7852,Pockets,1978-02-11,Pockets - Come Go With Us,24,26,32,17.0,24,Come Go With Us,18.0,16,-8,0,2,1,down,1977-10-22
7853,Pockets,1978-02-18,Pockets - Come Go With Us,24,24,34,17.0,32,Come Go With Us,18.0,17,-2,-8,0,1,down,1977-10-22
7854,Pockets,1978-02-25,Pockets - Come Go With Us,32,24,51,17.0,34,Come Go With Us,18.0,18,-17,-2,-8,1,down,1977-10-22
7855,High Inergy,1977-10-29,High Inergy - Turnin' On,51,51,24,6.0,43,Turnin' On,17.0,0,19,8,0,1,up,1977-10-29
7856,High Inergy,1977-11-05,High Inergy - Turnin' On,43,51,16,6.0,24,Turnin' On,17.0,1,8,19,8,1,up,1977-10-29
7857,High Inergy,1977-11-12,High Inergy - Turnin' On,24,43,12,6.0,16,Turnin' On,17.0,2,4,8,19,1,up,1977-10-29
7858,High Inergy,1977-11-19,High Inergy - Turnin' On,16,24,12,6.0,12,Turnin' On,17.0,3,0,4,8,0,stay,1977-10-29
7859,High Inergy,1977-11-26,High Inergy - Turnin' On,12,16,8,6.0,12,Turnin' On,17.0,4,4,0,4,1,up,1977-10-29
7860,High Inergy,1977-12-03,High Inergy - Turnin' On,12,12,6,6.0,8,Turnin' On,17.0,5,2,4,0,1,up,1977-10-29
7861,High Inergy,1977-12-10,High Inergy - Turnin' On,8,12,6,6.0,6,Turnin' On,17.0,6,0,2,4,0,stay,1977-10-29
7862,High Inergy,1977-12-17,High Inergy - Turnin' On,6,8,7,6.0,6,Turnin' On,17.0,7,-1,0,2,1,down,1977-10-29
7863,High Inergy,1977-12-24,High Inergy - Turnin' On,6,6,7,6.0,7,Turnin' On,17.0,8,0,-1,0,0,stay,1977-10-29
7864,High Inergy,1977-12-31,High Inergy - Turnin' On,7,6,16,6.0,7,Turnin' On,17.0,9,-9,0,-1,1,down,1977-10-29
7865,High Inergy,1978-01-07,High Inergy - Turnin' On,7,7,20,6.0,16,Turnin' On,17.0,10,-4,-9,0,1,down,1977-10-29
7866,High Inergy,1978-01-14,High Inergy - Turnin' On,16,7,22,6.0,20,Turnin' On,17.0,11,-2,-4,-9,1,down,1977-10-29
7867,High Inergy,1978-01-21,High Inergy - Turnin' On,20,16,22,6.0,22,Turnin' On,17.0,12,0,-2,-4,0,stay,1977-10-29
7868,High Inergy,1978-01-28,High Inergy - Turnin' On,22,20,27,6.0,22,Turnin' On,17.0,13,-5,0,-2,1,down,1977-10-29
7869,High Inergy,1978-02-04,High Inergy - Turnin' On,22,22,28,6.0,27,Turnin' On,17.0,14,-1,-5,0,1,down,1977-10-29
7870,High Inergy,1978-02-11,High Inergy - Turnin' On,27,22,35,6.0,28,Turnin' On,17.0,15,-7,-1,-5,1,down,1977-10-29
7871,High Inergy,1978-02-18,High Inergy - Turnin' On,28,27,38,6.0,35,Turnin' On,17.0,16,-3,-7,-1,1,down,1977-10-29
7872,High Inergy,1978-02-25,High Inergy - Turnin' On,35,28,51,6.0,38,Turnin' On,17.0,17,-13,-3,-7,1,down,1977-10-29
7873,The Isley Brothers,1977-10-29,The Isley Brothers - Forever Gold,51,51,43,40.0,48,Forever Gold,3.0,0,5,3,0,1,up,1977-10-29
7874,The Isley Brothers,1977-11-05,The Isley Brothers - Forever Gold,48,51,40,40.0,43,Forever Gold,3.0,1,3,5,3,1,up,1977-10-29
7875,The Isley Brothers,1977-11-12,The Isley Brothers - Forever Gold,43,48,40,40.0,40,Forever Gold,3.0,2,0,3,5,0,stay,1977-10-29
7876,The Isley Brothers,1977-11-19,The Isley Brothers - Forever Gold,40,43,51,40.0,40,Forever Gold,3.0,3,-11,0,3,1,down,1977-10-29
7877,The Jacksons,1977-11-05,The Jacksons - Goin' Places,51,51,15,11.0,32,Goin' Places,11.0,0,17,19,0,1,up,1977-11-05
7878,The Jacksons,1977-11-12,The Jacksons - Goin' Places,32,51,11,11.0,15,Goin' Places,11.0,1,4,17,19,1,up,1977-11-05
7879,The Jacksons,1977-11-19,The Jacksons - Goin' Places,15,32,11,11.0,11,Goin' Places,11.0,2,0,4,17,0,stay,1977-11-05
7880,The Jacksons,1977-11-26,The Jacksons - Goin' Places,11,15,13,11.0,11,Goin' Places,11.0,3,-2,0,4,1,down,1977-11-05
7881,The Jacksons,1977-12-03,The Jacksons - Goin' Places,11,11,25,11.0,13,Goin' Places,11.0,4,-12,-2,0,1,down,1977-11-05
7882,The Jacksons,1977-12-10,The Jacksons - Goin' Places,13,11,26,11.0,25,Goin' Places,11.0,5,-1,-12,-2,1,down,1977-11-05
7883,The Jacksons,1977-12-17,The Jacksons - Goin' Places,25,13,29,11.0,26,Goin' Places,11.0,6,-3,-1,-12,1,down,1977-11-05
7884,The Jacksons,1977-12-24,The Jacksons - Goin' Places,26,25,29,11.0,29,Goin' Places,11.0,7,0,-3,-1,0,stay,1977-11-05
7885,The Jacksons,1977-12-31,The Jacksons - Goin' Places,29,26,39,11.0,29,Goin' Places,11.0,8,-10,0,-3,1,down,1977-11-05
7886,The Jacksons,1978-01-07,The Jacksons - Goin' Places,29,29,43,11.0,39,Goin' Places,11.0,9,-4,-10,0,1,down,1977-11-05
7887,The Jacksons,1978-01-14,The Jacksons - Goin' Places,39,29,50,11.0,43,Goin' Places,11.0,10,-7,-4,-10,1,down,1977-11-05
7888,The Jacksons,1978-01-21,The Jacksons - Goin' Places,43,39,51,11.0,50,Goin' Places,11.0,11,-1,-7,-4,1,down,1977-11-05
7889,Bill Withers,1977-11-05,Bill Withers - Menagerie,51,51,30,16.0,40,Menagerie,22.0,0,10,11,0,1,up,1977-11-05
7890,Bill Withers,1977-11-12,Bill Withers - Menagerie,40,51,29,16.0,30,Menagerie,22.0,1,1,10,11,1,up,1977-11-05
7891,Bill Withers,1977-11-19,Bill Withers - Menagerie,30,40,22,16.0,29,Menagerie,22.0,2,7,1,10,1,up,1977-11-05
7892,Bill Withers,1977-11-26,Bill Withers - Menagerie,29,30,20,16.0,22,Menagerie,22.0,3,2,7,1,1,up,1977-11-05
7893,Bill Withers,1977-12-03,Bill Withers - Menagerie,22,29,19,16.0,20,Menagerie,22.0,4,1,2,7,1,up,1977-11-05
7894,Bill Withers,1977-12-10,Bill Withers - Menagerie,20,22,20,16.0,19,Menagerie,22.0,5,-1,1,2,1,down,1977-11-05
7895,Bill Withers,1977-12-17,Bill Withers - Menagerie,19,20,20,16.0,20,Menagerie,22.0,6,0,-1,1,0,stay,1977-11-05
7896,Bill Withers,1977-12-24,Bill Withers - Menagerie,20,19,20,16.0,20,Menagerie,22.0,7,0,0,-1,0,stay,1977-11-05
7897,Bill Withers,1977-12-31,Bill Withers - Menagerie,20,20,19,16.0,20,Menagerie,22.0,8,1,0,0,1,up,1977-11-05
7898,Bill Withers,1978-01-07,Bill Withers - Menagerie,20,20,16,16.0,19,Menagerie,22.0,9,3,1,0,1,up,1977-11-05
7899,Bill Withers,1978-01-14,Bill Withers - Menagerie,19,20,16,16.0,16,Menagerie,22.0,10,0,3,1,0,stay,1977-11-05
7900,Bill Withers,1978-01-21,Bill Withers - Menagerie,16,19,18,16.0,16,Menagerie,22.0,11,-2,0,3,1,down,1977-11-05
7901,Bill Withers,1978-01-28,Bill Withers - Menagerie,16,16,18,16.0,18,Menagerie,22.0,12,0,-2,0,0,stay,1977-11-05
7902,Bill Withers,1978-02-04,Bill Withers - Menagerie,18,16,21,16.0,18,Menagerie,22.0,13,-3,0,-2,1,down,1977-11-05
7903,Bill Withers,1978-02-11,Bill Withers - Menagerie,18,18,22,16.0,21,Menagerie,22.0,14,-1,-3,0,1,down,1977-11-05
7904,Bill Withers,1978-02-18,Bill Withers - Menagerie,21,18,22,16.0,22,Menagerie,22.0,15,0,-1,-3,0,stay,1977-11-05
7905,Bill Withers,1978-02-25,Bill Withers - Menagerie,22,21,38,16.0,22,Menagerie,22.0,16,-16,0,-1,1,down,1977-11-05
7906,Bill Withers,1978-03-04,Bill Withers - Menagerie,22,22,41,16.0,38,Menagerie,22.0,17,-3,-16,0,1,down,1977-11-05
7907,Bill Withers,1978-03-11,Bill Withers - Menagerie,38,22,42,16.0,41,Menagerie,22.0,18,-1,-3,-16,1,down,1977-11-05
7908,Bill Withers,1978-03-18,Bill Withers - Menagerie,41,38,45,16.0,42,Menagerie,22.0,19,-3,-1,-3,1,down,1977-11-05
7909,Bill Withers,1978-03-25,Bill Withers - Menagerie,42,41,50,16.0,45,Menagerie,22.0,20,-5,-3,-1,1,down,1977-11-05
7910,Bill Withers,1978-04-01,Bill Withers - Menagerie,45,42,50,16.0,50,Menagerie,22.0,21,0,-5,-3,0,stay,1977-11-05
7911,Bill Withers,1978-04-08,Bill Withers - Menagerie,50,45,51,16.0,50,Menagerie,22.0,22,-1,0,-5,1,down,1977-11-05
7912,Ray Charles,1977-11-05,Ray Charles - True To Life,51,51,31,23.0,41,True To Life,19.0,0,10,10,0,1,up,1977-11-05
7913,Ray Charles,1977-11-12,Ray Charles - True To Life,41,51,30,23.0,31,True To Life,19.0,1,1,10,10,1,up,1977-11-05
7914,Ray Charles,1977-11-19,Ray Charles - True To Life,31,41,25,23.0,30,True To Life,19.0,2,5,1,10,1,up,1977-11-05
7915,Ray Charles,1977-11-26,Ray Charles - True To Life,30,31,23,23.0,25,True To Life,19.0,3,2,5,1,1,up,1977-11-05
7916,Ray Charles,1977-12-03,Ray Charles - True To Life,25,30,23,23.0,23,True To Life,19.0,4,0,2,5,0,stay,1977-11-05
7917,Ray Charles,1977-12-10,Ray Charles - True To Life,23,25,23,23.0,23,True To Life,19.0,5,0,0,2,0,stay,1977-11-05
7918,Ray Charles,1977-12-17,Ray Charles - True To Life,23,23,28,23.0,23,True To Life,19.0,6,-5,0,0,1,down,1977-11-05
7919,Ray Charles,1977-12-24,Ray Charles - True To Life,23,23,28,23.0,28,True To Life,19.0,7,0,-5,0,0,stay,1977-11-05
7920,Ray Charles,1977-12-31,Ray Charles - True To Life,28,23,28,23.0,28,True To Life,19.0,8,0,0,-5,0,stay,1977-11-05
7921,Ray Charles,1978-01-07,Ray Charles - True To Life,28,28,26,23.0,28,True To Life,19.0,9,2,0,0,1,up,1977-11-05
7922,Ray Charles,1978-01-14,Ray Charles - True To Life,28,28,26,23.0,26,True To Life,19.0,10,0,2,0,0,stay,1977-11-05
7923,Ray Charles,1978-01-21,Ray Charles - True To Life,26,28,30,23.0,26,True To Life,19.0,11,-4,0,2,1,down,1977-11-05
7924,Ray Charles,1978-01-28,Ray Charles - True To Life,26,26,30,23.0,30,True To Life,19.0,12,0,-4,0,0,stay,1977-11-05
7925,Ray Charles,1978-02-04,Ray Charles - True To Life,30,26,33,23.0,30,True To Life,19.0,13,-3,0,-4,1,down,1977-11-05
7926,Ray Charles,1978-02-11,Ray Charles - True To Life,30,30,37,23.0,33,True To Life,19.0,14,-4,-3,0,1,down,1977-11-05
7927,Ray Charles,1978-02-18,Ray Charles - True To Life,33,30,41,23.0,37,True To Life,19.0,15,-4,-4,-3,1,down,1977-11-05
7928,Ray Charles,1978-02-25,Ray Charles - True To Life,37,33,41,23.0,41,True To Life,19.0,16,0,-4,-4,0,stay,1977-11-05
7929,Ray Charles,1978-03-04,Ray Charles - True To Life,41,37,43,23.0,41,True To Life,19.0,17,-2,0,-4,1,down,1977-11-05
7930,Ray Charles,1978-03-11,Ray Charles - True To Life,41,41,49,23.0,43,True To Life,19.0,18,-6,-2,0,1,down,1977-11-05
7931,Ray Charles,1978-03-18,Ray Charles - True To Life,43,41,51,23.0,49,True To Life,19.0,19,-2,-6,-2,1,down,1977-11-05
7932,George Duke,1977-11-05,George Duke - Reach For It,51,51,34,4.0,44,Reach For It,19.0,0,10,7,0,1,up,1977-11-05
7933,George Duke,1977-11-12,George Duke - Reach For It,44,51,24,4.0,34,Reach For It,19.0,1,10,10,7,1,up,1977-11-05
7934,George Duke,1977-11-19,George Duke - Reach For It,34,44,13,4.0,24,Reach For It,19.0,2,11,10,10,1,up,1977-11-05
7935,George Duke,1977-11-26,George Duke - Reach For It,24,34,9,4.0,13,Reach For It,19.0,3,4,11,10,1,up,1977-11-05
7936,George Duke,1977-12-03,George Duke - Reach For It,13,24,7,4.0,9,Reach For It,19.0,4,2,4,11,1,up,1977-11-05
7937,George Duke,1977-12-10,George Duke - Reach For It,9,13,7,4.0,7,Reach For It,19.0,5,0,2,4,0,stay,1977-11-05
7938,George Duke,1977-12-17,George Duke - Reach For It,7,9,4,4.0,7,Reach For It,19.0,6,3,0,2,1,up,1977-11-05
7939,George Duke,1977-12-24,George Duke - Reach For It,7,7,4,4.0,4,Reach For It,19.0,7,0,3,0,0,stay,1977-11-05
7940,George Duke,1977-12-31,George Duke - Reach For It,4,7,4,4.0,4,Reach For It,19.0,8,0,0,3,0,stay,1977-11-05
7941,George Duke,1978-01-07,George Duke - Reach For It,4,4,5,4.0,4,Reach For It,19.0,9,-1,0,0,1,down,1977-11-05
7942,George Duke,1978-01-14,George Duke - Reach For It,4,4,5,4.0,5,Reach For It,19.0,10,0,-1,0,0,stay,1977-11-05
7943,George Duke,1978-01-21,George Duke - Reach For It,5,4,4,4.0,5,Reach For It,19.0,11,1,0,-1,1,up,1977-11-05
7944,George Duke,1978-01-28,George Duke - Reach For It,5,5,5,4.0,4,Reach For It,19.0,12,-1,1,0,1,down,1977-11-05
7945,George Duke,1978-02-04,George Duke - Reach For It,4,5,14,4.0,5,Reach For It,19.0,13,-9,-1,1,1,down,1977-11-05
7946,George Duke,1978-02-11,George Duke - Reach For It,5,4,19,4.0,14,Reach For It,19.0,14,-5,-9,-1,1,down,1977-11-05
7947,George Duke,1978-02-18,George Duke - Reach For It,14,5,30,4.0,19,Reach For It,19.0,15,-11,-5,-9,1,down,1977-11-05
7948,George Duke,1978-02-25,George Duke - Reach For It,19,14,36,4.0,30,Reach For It,19.0,16,-6,-11,-5,1,down,1977-11-05
7949,George Duke,1978-03-04,George Duke - Reach For It,30,19,40,4.0,36,Reach For It,19.0,17,-4,-6,-11,1,down,1977-11-05
7950,George Duke,1978-03-11,George Duke - Reach For It,36,30,46,4.0,40,Reach For It,19.0,18,-6,-4,-6,1,down,1977-11-05
7951,George Duke,1978-03-18,George Duke - Reach For It,40,36,51,4.0,46,Reach For It,19.0,19,-5,-6,-4,1,down,1977-11-05
7952,Village People,1977-11-05,Village People - Village People,51,51,36,36.0,46,Village People,6.0,0,10,5,0,1,up,1977-11-05
7953,Village People,1977-11-12,Village People - Village People,46,51,36,36.0,36,Village People,6.0,1,0,10,5,0,stay,1977-11-05
7954,Village People,1977-11-19,Village People - Village People,36,46,42,36.0,36,Village People,6.0,2,-6,0,10,1,down,1977-11-05
7955,Village People,1977-11-26,Village People - Village People,36,36,42,36.0,42,Village People,6.0,3,0,-6,0,0,stay,1977-11-05
7956,Village People,1977-12-03,Village People - Village People,42,36,43,36.0,42,Village People,6.0,4,-1,0,-6,1,down,1977-11-05
7957,Village People,1977-12-10,Village People - Village People,42,42,48,36.0,43,Village People,6.0,5,-5,-1,0,1,down,1977-11-05
7958,Village People,1977-12-17,Village People - Village People,43,42,51,36.0,48,Village People,6.0,6,-3,-5,-1,1,down,1977-11-05
7959,The New Birth,1977-11-12,The New Birth - Behold The Mighty Army,51,51,33,28.0,43,Behold The Mighty Army,9.0,0,10,8,0,1,up,1977-11-12
7960,The New Birth,1977-11-19,The New Birth - Behold The Mighty Army,43,51,29,28.0,33,Behold The Mighty Army,9.0,1,4,10,8,1,up,1977-11-12
7961,The New Birth,1977-11-26,The New Birth - Behold The Mighty Army,33,43,28,28.0,29,Behold The Mighty Army,9.0,2,1,4,10,1,up,1977-11-12
7962,The New Birth,1977-12-03,The New Birth - Behold The Mighty Army,29,33,33,28.0,28,Behold The Mighty Army,9.0,3,-5,1,4,1,down,1977-11-12
7963,The New Birth,1977-12-10,The New Birth - Behold The Mighty Army,28,29,36,28.0,33,Behold The Mighty Army,9.0,4,-3,-5,1,1,down,1977-11-12
7964,The New Birth,1977-12-17,The New Birth - Behold The Mighty Army,33,28,36,28.0,36,Behold The Mighty Army,9.0,5,0,-3,-5,0,stay,1977-11-12
7965,The New Birth,1977-12-24,The New Birth - Behold The Mighty Army,36,33,36,28.0,36,Behold The Mighty Army,9.0,6,0,0,-3,0,stay,1977-11-12
7966,The New Birth,1977-12-31,The New Birth - Behold The Mighty Army,36,36,40,28.0,36,Behold The Mighty Army,9.0,7,-4,0,0,1,down,1977-11-12
7967,The New Birth,1978-01-07,The New Birth - Behold The Mighty Army,36,36,45,28.0,40,Behold The Mighty Army,9.0,8,-5,-4,0,1,down,1977-11-12
7968,The New Birth,1978-01-14,The New Birth - Behold The Mighty Army,40,36,51,28.0,45,Behold The Mighty Army,9.0,9,-6,-5,-4,1,down,1977-11-12
7969,Tavares,1977-11-12,Tavares - Best Of Tavares,51,51,43,42.0,44,Best Of Tavares,5.0,0,1,7,0,1,up,1977-11-12
7970,Tavares,1977-11-19,Tavares - Best Of Tavares,44,51,46,42.0,43,Best Of Tavares,5.0,1,-3,1,7,1,down,1977-11-12
7971,Tavares,1977-11-26,Tavares - Best Of Tavares,43,44,46,42.0,46,Best Of Tavares,5.0,2,0,-3,1,0,stay,1977-11-12
7972,Tavares,1977-12-03,Tavares - Best Of Tavares,46,43,46,42.0,46,Best Of Tavares,5.0,3,0,0,-3,0,stay,1977-11-12
7973,Tavares,1977-12-10,Tavares - Best Of Tavares,46,46,42,42.0,46,Best Of Tavares,5.0,4,4,0,0,1,up,1977-11-12
7974,Tavares,1977-12-17,Tavares - Best Of Tavares,46,46,51,42.0,42,Best Of Tavares,5.0,5,-9,4,0,1,down,1977-11-12
7975,El Coco,1977-11-12,El Coco - Cocomotion,51,51,48,35.0,48,Cocomotion,14.0,0,0,3,0,0,stay,1977-11-12
7976,El Coco,1977-11-19,El Coco - Cocomotion,48,51,43,35.0,48,Cocomotion,14.0,1,5,0,3,1,up,1977-11-12
7977,El Coco,1977-11-26,El Coco - Cocomotion,48,48,43,35.0,43,Cocomotion,14.0,2,0,5,0,0,stay,1977-11-12
7978,El Coco,1977-12-03,El Coco - Cocomotion,43,48,35,35.0,43,Cocomotion,14.0,3,8,0,5,1,up,1977-11-12
7979,El Coco,1977-12-10,El Coco - Cocomotion,43,43,37,35.0,35,Cocomotion,14.0,4,-2,8,0,1,down,1977-11-12
7980,El Coco,1977-12-17,El Coco - Cocomotion,35,43,39,35.0,37,Cocomotion,14.0,5,-2,-2,8,1,down,1977-11-12
7981,El Coco,1977-12-24,El Coco - Cocomotion,37,35,39,35.0,39,Cocomotion,14.0,6,0,-2,-2,0,stay,1977-11-12
7982,El Coco,1977-12-31,El Coco - Cocomotion,39,37,36,35.0,39,Cocomotion,14.0,7,3,0,-2,1,up,1977-11-12
7983,El Coco,1978-01-07,El Coco - Cocomotion,39,39,44,35.0,36,Cocomotion,14.0,8,-8,3,0,1,down,1977-11-12
7984,El Coco,1978-01-14,El Coco - Cocomotion,36,39,44,35.0,44,Cocomotion,14.0,9,0,-8,3,0,stay,1977-11-12
7985,El Coco,1978-01-21,El Coco - Cocomotion,44,36,41,35.0,44,Cocomotion,14.0,10,3,0,-8,1,up,1977-11-12
7986,El Coco,1978-01-28,El Coco - Cocomotion,44,44,41,35.0,41,Cocomotion,14.0,11,0,3,0,0,stay,1977-11-12
7987,El Coco,1978-02-04,El Coco - Cocomotion,41,44,46,35.0,41,Cocomotion,14.0,12,-5,0,3,1,down,1977-11-12
7988,El Coco,1978-02-11,El Coco - Cocomotion,41,41,48,35.0,46,Cocomotion,14.0,13,-2,-5,0,1,down,1977-11-12
7989,El Coco,1978-02-18,El Coco - Cocomotion,46,41,51,35.0,48,Cocomotion,14.0,14,-3,-2,-5,1,down,1977-11-12
7990,Ronnie Dyson,1977-11-12,Ronnie Dyson - Love In All Flavors,51,51,47,45.0,49,Love In All Flavors,2.0,0,2,2,0,1,up,1977-11-12
7991,Ronnie Dyson,1977-11-19,Ronnie Dyson - Love In All Flavors,49,51,45,45.0,47,Love In All Flavors,2.0,1,2,2,2,1,up,1977-11-12
7992,Ronnie Dyson,1977-12-03,Ronnie Dyson - Love In All Flavors,47,49,51,45.0,45,Love In All Flavors,2.0,2,-6,2,2,1,down,1977-11-12
7993,Kellee Patterson,1977-11-12,Kellee Patterson - Be Happy,51,51,45,38.0,50,Be Happy,5.0,0,5,1,0,1,up,1977-11-12
7994,Kellee Patterson,1977-11-19,Kellee Patterson - Be Happy,50,51,45,38.0,45,Be Happy,5.0,1,0,5,1,0,stay,1977-11-12
7995,Kellee Patterson,1977-11-26,Kellee Patterson - Be Happy,45,50,38,38.0,45,Be Happy,5.0,2,7,0,5,1,up,1977-11-12
7996,Kellee Patterson,1977-12-03,Kellee Patterson - Be Happy,45,45,38,38.0,38,Be Happy,5.0,3,0,7,0,0,stay,1977-11-12
7997,Kellee Patterson,1977-12-10,Kellee Patterson - Be Happy,38,45,39,38.0,38,Be Happy,5.0,4,-1,0,7,1,down,1977-11-12
7998,Kellee Patterson,1977-12-17,Kellee Patterson - Be Happy,38,38,51,38.0,39,Be Happy,5.0,5,-12,-1,0,1,down,1977-11-12
7999,Commodores,1977-11-19,Commodores - Commodores Live!,51,51,5,2.0,18,Commodores Live!,23.0,0,13,33,0,1,up,1977-11-19
8000,Commodores,1977-11-26,Commodores - Commodores Live!,18,51,2,2.0,5,Commodores Live!,23.0,1,3,13,33,1,up,1977-11-19
8001,Commodores,1977-12-03,Commodores - Commodores Live!,5,18,2,2.0,2,Commodores Live!,23.0,2,0,3,13,0,stay,1977-11-19
8002,Commodores,1977-12-10,Commodores - Commodores Live!,2,5,2,2.0,2,Commodores Live!,23.0,3,0,0,3,0,stay,1977-11-19
8003,Commodores,1977-12-17,Commodores - Commodores Live!,2,2,2,2.0,2,Commodores Live!,23.0,4,0,0,0,0,stay,1977-11-19
8004,Commodores,1977-12-24,Commodores - Commodores Live!,2,2,2,2.0,2,Commodores Live!,23.0,5,0,0,0,0,stay,1977-11-19
8005,Commodores,1977-12-31,Commodores - Commodores Live!,2,2,2,2.0,2,Commodores Live!,23.0,6,0,0,0,0,stay,1977-11-19
8006,Commodores,1978-01-07,Commodores - Commodores Live!,2,2,2,2.0,2,Commodores Live!,23.0,7,0,0,0,0,stay,1977-11-19
8007,Commodores,1978-01-14,Commodores - Commodores Live!,2,2,2,2.0,2,Commodores Live!,23.0,8,0,0,0,0,stay,1977-11-19
8008,Commodores,1978-01-21,Commodores - Commodores Live!,2,2,3,2.0,2,Commodores Live!,23.0,9,-1,0,0,1,down,1977-11-19
8009,Commodores,1978-01-28,Commodores - Commodores Live!,2,2,3,2.0,3,Commodores Live!,23.0,10,0,-1,0,0,stay,1977-11-19
8010,Commodores,1978-02-04,Commodores - Commodores Live!,3,2,11,2.0,3,Commodores Live!,23.0,11,-8,0,-1,1,down,1977-11-19
8011,Commodores,1978-02-11,Commodores - Commodores Live!,3,3,11,2.0,11,Commodores Live!,23.0,12,0,-8,0,0,stay,1977-11-19
8012,Commodores,1978-02-18,Commodores - Commodores Live!,11,3,13,2.0,11,Commodores Live!,23.0,13,-2,0,-8,1,down,1977-11-19
8013,Commodores,1978-02-25,Commodores - Commodores Live!,11,11,14,2.0,13,Commodores Live!,23.0,14,-1,-2,0,1,down,1977-11-19
8014,Commodores,1978-03-04,Commodores - Commodores Live!,13,11,19,2.0,14,Commodores Live!,23.0,15,-5,-1,-2,1,down,1977-11-19
8015,Commodores,1978-03-11,Commodores - Commodores Live!,14,13,21,2.0,19,Commodores Live!,23.0,16,-2,-5,-1,1,down,1977-11-19
8016,Commodores,1978-03-18,Commodores - Commodores Live!,19,14,24,2.0,21,Commodores Live!,23.0,17,-3,-2,-5,1,down,1977-11-19
8017,Commodores,1978-03-25,Commodores - Commodores Live!,21,19,28,2.0,24,Commodores Live!,23.0,18,-4,-3,-2,1,down,1977-11-19
8018,Commodores,1978-04-01,Commodores - Commodores Live!,24,21,33,2.0,28,Commodores Live!,23.0,19,-5,-4,-3,1,down,1977-11-19
8019,Commodores,1978-04-08,Commodores - Commodores Live!,28,24,36,2.0,33,Commodores Live!,23.0,20,-3,-5,-4,1,down,1977-11-19
8020,Commodores,1978-04-15,Commodores - Commodores Live!,33,28,35,2.0,36,Commodores Live!,23.0,21,1,-3,-5,1,up,1977-11-19
8021,Commodores,1978-04-22,Commodores - Commodores Live!,36,33,49,2.0,35,Commodores Live!,23.0,22,-14,1,-3,1,down,1977-11-19
8022,Commodores,1978-04-29,Commodores - Commodores Live!,35,36,51,2.0,49,Commodores Live!,23.0,23,-2,-14,1,1,down,1977-11-19
8023,Brass Construction,1977-11-19,Brass Construction - Brass Construction Iii,51,51,20,16.0,35,Brass Construction Iii,24.0,0,15,16,0,1,up,1977-11-19
8024,Brass Construction,1977-11-26,Brass Construction - Brass Construction Iii,35,51,16,16.0,20,Brass Construction Iii,24.0,1,4,15,16,1,up,1977-11-19
8025,Brass Construction,1977-12-03,Brass Construction - Brass Construction Iii,20,35,16,16.0,16,Brass Construction Iii,24.0,2,0,4,15,0,stay,1977-11-19
8026,Brass Construction,1977-12-10,Brass Construction - Brass Construction Iii,16,20,22,16.0,16,Brass Construction Iii,24.0,3,-6,0,4,1,down,1977-11-19
8027,Brass Construction,1977-12-17,Brass Construction - Brass Construction Iii,16,16,22,16.0,22,Brass Construction Iii,24.0,4,0,-6,0,0,stay,1977-11-19
8028,Brass Construction,1977-12-24,Brass Construction - Brass Construction Iii,22,16,22,16.0,22,Brass Construction Iii,24.0,5,0,0,-6,0,stay,1977-11-19
8029,Brass Construction,1977-12-31,Brass Construction - Brass Construction Iii,22,22,22,16.0,22,Brass Construction Iii,24.0,6,0,0,0,0,stay,1977-11-19
8030,Brass Construction,1978-01-07,Brass Construction - Brass Construction Iii,22,22,30,16.0,22,Brass Construction Iii,24.0,7,-8,0,0,1,down,1977-11-19
8031,Brass Construction,1978-01-14,Brass Construction - Brass Construction Iii,22,22,33,16.0,30,Brass Construction Iii,24.0,8,-3,-8,0,1,down,1977-11-19
8032,Brass Construction,1978-01-21,Brass Construction - Brass Construction Iii,30,22,36,16.0,33,Brass Construction Iii,24.0,9,-3,-3,-8,1,down,1977-11-19
8033,Brass Construction,1978-01-28,Brass Construction - Brass Construction Iii,33,30,40,16.0,36,Brass Construction Iii,24.0,10,-4,-3,-3,1,down,1977-11-19
8034,Brass Construction,1978-02-04,Brass Construction - Brass Construction Iii,36,33,43,16.0,40,Brass Construction Iii,24.0,11,-3,-4,-3,1,down,1977-11-19
8035,Brass Construction,1978-02-11,Brass Construction - Brass Construction Iii,40,36,43,16.0,43,Brass Construction Iii,24.0,12,0,-3,-4,0,stay,1977-11-19
8036,Brass Construction,1978-02-18,Brass Construction - Brass Construction Iii,43,40,43,16.0,43,Brass Construction Iii,24.0,13,0,0,-3,0,stay,1977-11-19
8037,Brass Construction,1978-02-25,Brass Construction - Brass Construction Iii,43,43,42,16.0,43,Brass Construction Iii,24.0,14,1,0,0,1,up,1977-11-19
8038,Brass Construction,1978-03-04,Brass Construction - Brass Construction Iii,43,43,38,16.0,42,Brass Construction Iii,24.0,15,4,1,0,1,up,1977-11-19
8039,Brass Construction,1978-03-11,Brass Construction - Brass Construction Iii,42,43,33,16.0,38,Brass Construction Iii,24.0,16,5,4,1,1,up,1977-11-19
8040,Brass Construction,1978-03-18,Brass Construction - Brass Construction Iii,38,42,33,16.0,33,Brass Construction Iii,24.0,17,0,5,4,0,stay,1977-11-19
8041,Brass Construction,1978-03-25,Brass Construction - Brass Construction Iii,33,38,31,16.0,33,Brass Construction Iii,24.0,18,2,0,5,1,up,1977-11-19
8042,Brass Construction,1978-04-01,Brass Construction - Brass Construction Iii,33,33,29,16.0,31,Brass Construction Iii,24.0,19,2,2,0,1,up,1977-11-19
8043,Brass Construction,1978-04-08,Brass Construction - Brass Construction Iii,31,33,32,16.0,29,Brass Construction Iii,24.0,20,-3,2,2,1,down,1977-11-19
8044,Brass Construction,1978-04-15,Brass Construction - Brass Construction Iii,29,31,31,16.0,32,Brass Construction Iii,24.0,21,1,-3,2,1,up,1977-11-19
8045,Brass Construction,1978-04-22,Brass Construction - Brass Construction Iii,32,29,31,16.0,31,Brass Construction Iii,24.0,22,0,1,-3,0,stay,1977-11-19
8046,Brass Construction,1978-04-29,Brass Construction - Brass Construction Iii,31,32,34,16.0,31,Brass Construction Iii,24.0,23,-3,0,1,1,down,1977-11-19
8047,Brass Construction,1978-05-06,Brass Construction - Brass Construction Iii,31,31,51,16.0,34,Brass Construction Iii,24.0,24,-17,-3,0,1,down,1977-11-19
8048,Memphis Horns,1977-11-19,Memphis Horns - Get Up & Dance,51,51,33,32.0,37,Get Up & Dance,6.0,0,4,14,0,1,up,1977-11-19
8049,Memphis Horns,1977-11-26,Memphis Horns - Get Up & Dance,37,51,32,32.0,33,Get Up & Dance,6.0,1,1,4,14,1,up,1977-11-19
8050,Memphis Horns,1977-12-03,Memphis Horns - Get Up & Dance,33,37,32,32.0,32,Get Up & Dance,6.0,2,0,1,4,0,stay,1977-11-19
8051,Memphis Horns,1977-12-10,Memphis Horns - Get Up & Dance,32,33,38,32.0,32,Get Up & Dance,6.0,3,-6,0,1,1,down,1977-11-19
8052,Memphis Horns,1977-12-17,Memphis Horns - Get Up & Dance,32,32,47,32.0,38,Get Up & Dance,6.0,4,-9,-6,0,1,down,1977-11-19
8053,Memphis Horns,1977-12-24,Memphis Horns - Get Up & Dance,38,32,47,32.0,47,Get Up & Dance,6.0,5,0,-9,-6,0,stay,1977-11-19
8054,Memphis Horns,1977-12-31,Memphis Horns - Get Up & Dance,47,38,51,32.0,47,Get Up & Dance,6.0,6,-4,0,-9,1,down,1977-11-19
8055,Phoebe Snow,1977-11-19,Phoebe Snow - Never Letting Go,51,51,36,36.0,44,Never Letting Go,8.0,0,8,7,0,1,up,1977-11-19
8056,Phoebe Snow,1977-11-26,Phoebe Snow - Never Letting Go,44,51,36,36.0,36,Never Letting Go,8.0,1,0,8,7,0,stay,1977-11-19
8057,Phoebe Snow,1977-12-03,Phoebe Snow - Never Letting Go,36,44,45,36.0,36,Never Letting Go,8.0,2,-9,0,8,1,down,1977-11-19
8058,Phoebe Snow,1977-12-10,Phoebe Snow - Never Letting Go,36,36,45,36.0,45,Never Letting Go,8.0,3,0,-9,0,0,stay,1977-11-19
8059,Phoebe Snow,1977-12-17,Phoebe Snow - Never Letting Go,45,36,46,36.0,45,Never Letting Go,8.0,4,-1,0,-9,1,down,1977-11-19
8060,Phoebe Snow,1978-01-28,Phoebe Snow - Never Letting Go,45,45,38,36.0,46,Never Letting Go,8.0,5,8,-1,0,1,up,1977-11-19
8061,Phoebe Snow,1978-02-04,Phoebe Snow - Never Letting Go,46,45,38,36.0,38,Never Letting Go,8.0,6,0,8,-1,0,stay,1977-11-19
8062,Phoebe Snow,1978-02-11,Phoebe Snow - Never Letting Go,38,46,47,36.0,38,Never Letting Go,8.0,7,-9,0,8,1,down,1977-11-19
8063,Phoebe Snow,1978-02-18,Phoebe Snow - Never Letting Go,38,38,51,36.0,47,Never Letting Go,8.0,8,-4,-9,0,1,down,1977-11-19
8064,Mandrill,1977-11-19,Mandrill - We Are One,51,51,28,26.0,46,We Are One,10.0,0,18,5,0,1,up,1977-11-19
8065,Mandrill,1977-11-26,Mandrill - We Are One,46,51,26,26.0,28,We Are One,10.0,1,2,18,5,1,up,1977-11-19
8066,Mandrill,1977-12-03,Mandrill - We Are One,28,46,28,26.0,26,We Are One,10.0,2,-2,2,18,1,down,1977-11-19
8067,Mandrill,1977-12-10,Mandrill - We Are One,26,28,32,26.0,28,We Are One,10.0,3,-4,-2,2,1,down,1977-11-19
8068,Mandrill,1977-12-17,Mandrill - We Are One,28,26,33,26.0,32,We Are One,10.0,4,-1,-4,-2,1,down,1977-11-19
8069,Mandrill,1977-12-24,Mandrill - We Are One,32,28,33,26.0,33,We Are One,10.0,5,0,-1,-4,0,stay,1977-11-19
8070,Mandrill,1977-12-31,Mandrill - We Are One,33,32,43,26.0,33,We Are One,10.0,6,-10,0,-1,1,down,1977-11-19
8071,Mandrill,1978-01-07,Mandrill - We Are One,33,33,46,26.0,43,We Are One,10.0,7,-3,-10,0,1,down,1977-11-19
8072,Mandrill,1978-01-14,Mandrill - We Are One,43,33,46,26.0,46,We Are One,10.0,8,0,-3,-10,0,stay,1977-11-19
8073,Mandrill,1978-01-21,Mandrill - We Are One,46,43,47,26.0,46,We Are One,10.0,9,-1,0,-3,1,down,1977-11-19
8074,Mandrill,1978-01-28,Mandrill - We Are One,46,46,51,26.0,47,We Are One,10.0,10,-4,-1,0,1,down,1977-11-19
8075,Donna Summer,1977-11-26,Donna Summer - Once Upon A Time,51,51,21,13.0,31,Once Upon A Time,22.0,0,10,20,0,1,up,1977-11-26
8076,Donna Summer,1977-12-03,Donna Summer - Once Upon A Time,31,51,14,13.0,21,Once Upon A Time,22.0,1,7,10,20,1,up,1977-11-26
8077,Donna Summer,1977-12-10,Donna Summer - Once Upon A Time,21,31,13,13.0,14,Once Upon A Time,22.0,2,1,7,10,1,up,1977-11-26
8078,Donna Summer,1977-12-17,Donna Summer - Once Upon A Time,14,21,18,13.0,13,Once Upon A Time,22.0,3,-5,1,7,1,down,1977-11-26
8079,Donna Summer,1977-12-24,Donna Summer - Once Upon A Time,13,14,18,13.0,18,Once Upon A Time,22.0,4,0,-5,1,0,stay,1977-11-26
8080,Donna Summer,1977-12-31,Donna Summer - Once Upon A Time,18,13,18,13.0,18,Once Upon A Time,22.0,5,0,0,-5,0,stay,1977-11-26
8081,Donna Summer,1978-01-07,Donna Summer - Once Upon A Time,18,18,18,13.0,18,Once Upon A Time,22.0,6,0,0,0,0,stay,1977-11-26
8082,Donna Summer,1978-01-14,Donna Summer - Once Upon A Time,18,18,24,13.0,18,Once Upon A Time,22.0,7,-6,0,0,1,down,1977-11-26
8083,Donna Summer,1978-01-21,Donna Summer - Once Upon A Time,18,18,24,13.0,24,Once Upon A Time,22.0,8,0,-6,0,0,stay,1977-11-26
8084,Donna Summer,1978-01-28,Donna Summer - Once Upon A Time,24,18,21,13.0,24,Once Upon A Time,22.0,9,3,0,-6,1,up,1977-11-26
8085,Donna Summer,1978-02-04,Donna Summer - Once Upon A Time,24,24,25,13.0,21,Once Upon A Time,22.0,10,-4,3,0,1,down,1977-11-26
8086,Donna Summer,1978-02-11,Donna Summer - Once Upon A Time,21,24,26,13.0,25,Once Upon A Time,22.0,11,-1,-4,3,1,down,1977-11-26
8087,Donna Summer,1978-02-18,Donna Summer - Once Upon A Time,25,21,26,13.0,26,Once Upon A Time,22.0,12,0,-1,-4,0,stay,1977-11-26
8088,Donna Summer,1978-02-25,Donna Summer - Once Upon A Time,26,25,26,13.0,26,Once Upon A Time,22.0,13,0,0,-1,0,stay,1977-11-26
8089,Donna Summer,1978-03-04,Donna Summer - Once Upon A Time,26,26,29,13.0,26,Once Upon A Time,22.0,14,-3,0,0,1,down,1977-11-26
8090,Donna Summer,1978-03-11,Donna Summer - Once Upon A Time,26,26,32,13.0,29,Once Upon A Time,22.0,15,-3,-3,0,1,down,1977-11-26
8091,Donna Summer,1978-03-18,Donna Summer - Once Upon A Time,29,26,32,13.0,32,Once Upon A Time,22.0,16,0,-3,-3,0,stay,1977-11-26
8092,Donna Summer,1978-03-25,Donna Summer - Once Upon A Time,32,29,32,13.0,32,Once Upon A Time,22.0,17,0,0,-3,0,stay,1977-11-26
8093,Donna Summer,1978-04-01,Donna Summer - Once Upon A Time,32,32,32,13.0,32,Once Upon A Time,22.0,18,0,0,0,0,stay,1977-11-26
8094,Donna Summer,1978-04-08,Donna Summer - Once Upon A Time,32,32,35,13.0,32,Once Upon A Time,22.0,19,-3,0,0,1,down,1977-11-26
8095,Donna Summer,1978-04-15,Donna Summer - Once Upon A Time,32,32,44,13.0,35,Once Upon A Time,22.0,20,-9,-3,0,1,down,1977-11-26
8096,Donna Summer,1978-04-22,Donna Summer - Once Upon A Time,35,32,50,13.0,44,Once Upon A Time,22.0,21,-6,-9,-3,1,down,1977-11-26
8097,Donna Summer,1978-04-29,Donna Summer - Once Upon A Time,44,35,51,13.0,50,Once Upon A Time,22.0,22,-1,-6,-9,1,down,1977-11-26
8098,Barkays,1977-11-26,Barkays - Flying High On Your Love,51,51,27,7.0,37,Flying High On Your Love,26.0,0,10,14,0,1,up,1977-11-26
8099,Barkays,1977-12-03,Barkays - Flying High On Your Love,37,51,15,7.0,27,Flying High On Your Love,26.0,1,12,10,14,1,up,1977-11-26
8100,Barkays,1977-12-10,Barkays - Flying High On Your Love,27,37,11,7.0,15,Flying High On Your Love,26.0,2,4,12,10,1,up,1977-11-26
8101,Barkays,1977-12-17,Barkays - Flying High On Your Love,15,27,10,7.0,11,Flying High On Your Love,26.0,3,1,4,12,1,up,1977-11-26
8102,Barkays,1977-12-24,Barkays - Flying High On Your Love,11,15,10,7.0,10,Flying High On Your Love,26.0,4,0,1,4,0,stay,1977-11-26
8103,Barkays,1977-12-31,Barkays - Flying High On Your Love,10,11,11,7.0,10,Flying High On Your Love,26.0,5,-1,0,1,1,down,1977-11-26
8104,Barkays,1978-01-07,Barkays - Flying High On Your Love,10,10,17,7.0,11,Flying High On Your Love,26.0,6,-6,-1,0,1,down,1977-11-26
8105,Barkays,1978-01-14,Barkays - Flying High On Your Love,11,10,9,7.0,17,Flying High On Your Love,26.0,7,8,-6,-1,1,up,1977-11-26
8106,Barkays,1978-01-21,Barkays - Flying High On Your Love,17,11,9,7.0,9,Flying High On Your Love,26.0,8,0,8,-6,0,stay,1977-11-26
8107,Barkays,1978-01-28,Barkays - Flying High On Your Love,9,17,7,7.0,9,Flying High On Your Love,26.0,9,2,0,8,1,up,1977-11-26
8108,Barkays,1978-02-04,Barkays - Flying High On Your Love,9,9,7,7.0,7,Flying High On Your Love,26.0,10,0,2,0,0,stay,1977-11-26
8109,Barkays,1978-02-11,Barkays - Flying High On Your Love,7,9,7,7.0,7,Flying High On Your Love,26.0,11,0,0,2,0,stay,1977-11-26
8110,Barkays,1978-02-18,Barkays - Flying High On Your Love,7,7,8,7.0,7,Flying High On Your Love,26.0,12,-1,0,0,1,down,1977-11-26
8111,Barkays,1978-02-25,Barkays - Flying High On Your Love,7,7,11,7.0,8,Flying High On Your Love,26.0,13,-3,-1,0,1,down,1977-11-26
8112,Barkays,1978-03-04,Barkays - Flying High On Your Love,8,7,12,7.0,11,Flying High On Your Love,26.0,14,-1,-3,-1,1,down,1977-11-26
8113,Barkays,1978-03-11,Barkays - Flying High On Your Love,11,8,12,7.0,12,Flying High On Your Love,26.0,15,0,-1,-3,0,stay,1977-11-26
8114,Barkays,1978-03-18,Barkays - Flying High On Your Love,12,11,15,7.0,12,Flying High On Your Love,26.0,16,-3,0,-1,1,down,1977-11-26
8115,Barkays,1978-03-25,Barkays - Flying High On Your Love,12,12,15,7.0,15,Flying High On Your Love,26.0,17,0,-3,0,0,stay,1977-11-26
8116,Barkays,1978-04-01,Barkays - Flying High On Your Love,15,12,20,7.0,15,Flying High On Your Love,26.0,18,-5,0,-3,1,down,1977-11-26
8117,Barkays,1978-04-08,Barkays - Flying High On Your Love,15,15,27,7.0,20,Flying High On Your Love,26.0,19,-7,-5,0,1,down,1977-11-26
8118,Barkays,1978-04-15,Barkays - Flying High On Your Love,20,15,30,7.0,27,Flying High On Your Love,26.0,20,-3,-7,-5,1,down,1977-11-26
8119,Barkays,1978-04-22,Barkays - Flying High On Your Love,27,20,40,7.0,30,Flying High On Your Love,26.0,21,-10,-3,-7,1,down,1977-11-26
8120,Barkays,1978-04-29,Barkays - Flying High On Your Love,30,27,40,7.0,40,Flying High On Your Love,26.0,22,0,-10,-3,0,stay,1977-11-26
8121,Barkays,1978-05-06,Barkays - Flying High On Your Love,40,30,42,7.0,40,Flying High On Your Love,26.0,23,-2,0,-10,1,down,1977-11-26
8122,Barkays,1978-05-13,Barkays - Flying High On Your Love,40,40,44,7.0,42,Flying High On Your Love,26.0,24,-2,-2,0,1,down,1977-11-26
8123,Barkays,1978-05-20,Barkays - Flying High On Your Love,42,40,47,7.0,44,Flying High On Your Love,26.0,25,-3,-2,-2,1,down,1977-11-26
8124,Barkays,1978-05-27,Barkays - Flying High On Your Love,44,42,51,7.0,47,Flying High On Your Love,26.0,26,-4,-3,-2,1,down,1977-11-26
8125,Thelma Houston,1977-11-26,Thelma Houston - The Devil In Me,51,51,29,29.0,38,The Devil In Me,7.0,0,9,13,0,1,up,1977-11-26
8126,Thelma Houston,1977-12-03,Thelma Houston - The Devil In Me,38,51,29,29.0,29,The Devil In Me,7.0,1,0,9,13,0,stay,1977-11-26
8127,Thelma Houston,1977-12-10,Thelma Houston - The Devil In Me,29,38,30,29.0,29,The Devil In Me,7.0,2,-1,0,9,1,down,1977-11-26
8128,Thelma Houston,1977-12-17,Thelma Houston - The Devil In Me,29,29,42,29.0,30,The Devil In Me,7.0,3,-12,-1,0,1,down,1977-11-26
8129,Thelma Houston,1977-12-24,Thelma Houston - The Devil In Me,30,29,42,29.0,42,The Devil In Me,7.0,4,0,-12,-1,0,stay,1977-11-26
8130,Thelma Houston,1977-12-31,Thelma Houston - The Devil In Me,42,30,47,29.0,42,The Devil In Me,7.0,5,-5,0,-12,1,down,1977-11-26
8131,Thelma Houston,1978-01-07,Thelma Houston - The Devil In Me,42,42,47,29.0,47,The Devil In Me,7.0,6,0,-5,0,0,stay,1977-11-26
8132,Thelma Houston,1978-01-14,Thelma Houston - The Devil In Me,47,42,51,29.0,47,The Devil In Me,7.0,7,-4,0,-5,1,down,1977-11-26
8133,Deniece Williams,1977-11-26,Deniece Williams - Songbird,51,51,30,23.0,40,Songbird,17.0,0,10,11,0,1,up,1977-11-26
8134,Deniece Williams,1977-12-03,Deniece Williams - Songbird,40,51,24,23.0,30,Songbird,17.0,1,6,10,11,1,up,1977-11-26
8135,Deniece Williams,1977-12-10,Deniece Williams - Songbird,30,40,24,23.0,24,Songbird,17.0,2,0,6,10,0,stay,1977-11-26
8136,Deniece Williams,1977-12-17,Deniece Williams - Songbird,24,30,31,23.0,24,Songbird,17.0,3,-7,0,6,1,down,1977-11-26
8137,Deniece Williams,1977-12-24,Deniece Williams - Songbird,24,24,31,23.0,31,Songbird,17.0,4,0,-7,0,0,stay,1977-11-26
8138,Deniece Williams,1977-12-31,Deniece Williams - Songbird,31,24,31,23.0,31,Songbird,17.0,5,0,0,-7,0,stay,1977-11-26
8139,Deniece Williams,1978-01-07,Deniece Williams - Songbird,31,31,23,23.0,31,Songbird,17.0,6,8,0,0,1,up,1977-11-26
8140,Deniece Williams,1978-01-14,Deniece Williams - Songbird,31,31,23,23.0,23,Songbird,17.0,7,0,8,0,0,stay,1977-11-26
8141,Deniece Williams,1978-01-21,Deniece Williams - Songbird,23,31,29,23.0,23,Songbird,17.0,8,-6,0,8,1,down,1977-11-26
8142,Deniece Williams,1978-01-28,Deniece Williams - Songbird,23,23,23,23.0,29,Songbird,17.0,9,6,-6,0,1,up,1977-11-26
8143,Deniece Williams,1978-02-04,Deniece Williams - Songbird,29,23,23,23.0,23,Songbird,17.0,10,0,6,-6,0,stay,1977-11-26
8144,Deniece Williams,1978-02-11,Deniece Williams - Songbird,23,29,28,23.0,23,Songbird,17.0,11,-5,0,6,1,down,1977-11-26
8145,Deniece Williams,1978-02-18,Deniece Williams - Songbird,23,23,28,23.0,28,Songbird,17.0,12,0,-5,0,0,stay,1977-11-26
8146,Deniece Williams,1978-02-25,Deniece Williams - Songbird,28,23,34,23.0,28,Songbird,17.0,13,-6,0,-5,1,down,1977-11-26
8147,Deniece Williams,1978-03-04,Deniece Williams - Songbird,28,28,36,23.0,34,Songbird,17.0,14,-2,-6,0,1,down,1977-11-26
8148,Deniece Williams,1978-03-11,Deniece Williams - Songbird,34,28,41,23.0,36,Songbird,17.0,15,-5,-2,-6,1,down,1977-11-26
8149,Deniece Williams,1978-03-18,Deniece Williams - Songbird,36,34,42,23.0,41,Songbird,17.0,16,-1,-5,-2,1,down,1977-11-26
8150,Deniece Williams,1978-03-25,Deniece Williams - Songbird,41,36,51,23.0,42,Songbird,17.0,17,-9,-1,-5,1,down,1977-11-26
8151,Stanley Turrentine,1977-11-26,Stanley Turrentine - Night Wings,51,51,47,47.0,47,Night Wings,1.0,0,0,4,0,0,stay,1977-11-26
8152,Stanley Turrentine,1977-12-03,Stanley Turrentine - Night Wings,47,51,51,47.0,47,Night Wings,1.0,1,-4,0,4,1,down,1977-11-26
8153,Santa Esmeralda,1977-12-03,Santa Esmeralda - Don't Let Me Be Misunderstood,51,51,44,23.0,48,Don't Let Me Be Misunderstood,13.0,0,4,3,0,1,up,1977-12-03
8154,Santa Esmeralda,1977-12-10,Santa Esmeralda - Don't Let Me Be Misunderstood,48,51,34,23.0,44,Don't Let Me Be Misunderstood,13.0,1,10,4,3,1,up,1977-12-03
8155,Santa Esmeralda,1977-12-17,Santa Esmeralda - Don't Let Me Be Misunderstood,44,48,32,23.0,34,Don't Let Me Be Misunderstood,13.0,2,2,10,4,1,up,1977-12-03
8156,Santa Esmeralda,1977-12-24,Santa Esmeralda - Don't Let Me Be Misunderstood,34,44,32,23.0,32,Don't Let Me Be Misunderstood,13.0,3,0,2,10,0,stay,1977-12-03
8157,Santa Esmeralda,1977-12-31,Santa Esmeralda - Don't Let Me Be Misunderstood,32,34,30,23.0,32,Don't Let Me Be Misunderstood,13.0,4,2,0,2,1,up,1977-12-03
8158,Santa Esmeralda,1978-01-07,Santa Esmeralda - Don't Let Me Be Misunderstood,32,32,25,23.0,30,Don't Let Me Be Misunderstood,13.0,5,5,2,0,1,up,1977-12-03
8159,Santa Esmeralda,1978-01-14,Santa Esmeralda - Don't Let Me Be Misunderstood,30,32,25,23.0,25,Don't Let Me Be Misunderstood,13.0,6,0,5,2,0,stay,1977-12-03
8160,Santa Esmeralda,1978-01-21,Santa Esmeralda - Don't Let Me Be Misunderstood,25,30,23,23.0,25,Don't Let Me Be Misunderstood,13.0,7,2,0,5,1,up,1977-12-03
8161,Santa Esmeralda,1978-01-28,Santa Esmeralda - Don't Let Me Be Misunderstood,25,25,36,23.0,23,Don't Let Me Be Misunderstood,13.0,8,-13,2,0,1,down,1977-12-03
8162,Santa Esmeralda,1978-02-04,Santa Esmeralda - Don't Let Me Be Misunderstood,23,25,42,23.0,36,Don't Let Me Be Misunderstood,13.0,9,-6,-13,2,1,down,1977-12-03
8163,Santa Esmeralda,1978-02-11,Santa Esmeralda - Don't Let Me Be Misunderstood,36,23,42,23.0,42,Don't Let Me Be Misunderstood,13.0,10,0,-6,-13,0,stay,1977-12-03
8164,Santa Esmeralda,1978-02-18,Santa Esmeralda - Don't Let Me Be Misunderstood,42,36,45,23.0,42,Don't Let Me Be Misunderstood,13.0,11,-3,0,-6,1,down,1977-12-03
8165,Santa Esmeralda,1978-02-25,Santa Esmeralda - Don't Let Me Be Misunderstood,42,42,48,23.0,45,Don't Let Me Be Misunderstood,13.0,12,-3,-3,0,1,down,1977-12-03
8166,Santa Esmeralda,1978-03-04,Santa Esmeralda - Don't Let Me Be Misunderstood,45,42,51,23.0,48,Don't Let Me Be Misunderstood,13.0,13,-3,-3,-3,1,down,1977-12-03
8167,The Sylvers,1977-12-03,The Sylvers - New Horizons,51,51,48,43.0,49,New Horizons,4.0,0,1,2,0,1,up,1977-12-03
8168,The Sylvers,1977-12-10,The Sylvers - New Horizons,49,51,43,43.0,48,New Horizons,4.0,1,5,1,2,1,up,1977-12-03
8169,The Sylvers,1977-12-17,The Sylvers - New Horizons,48,49,45,43.0,43,New Horizons,4.0,2,-2,5,1,1,down,1977-12-03
8170,The Sylvers,1977-12-24,The Sylvers - New Horizons,43,48,45,43.0,45,New Horizons,4.0,3,0,-2,5,0,stay,1977-12-03
8171,The Sylvers,1977-12-31,The Sylvers - New Horizons,45,43,51,43.0,45,New Horizons,4.0,4,-6,0,-2,1,down,1977-12-03
8172,War,1977-12-10,War - Galaxy,51,51,12,6.0,20,Galaxy,18.0,0,8,31,0,1,up,1977-12-10
8173,War,1977-12-17,War - Galaxy,20,51,9,6.0,12,Galaxy,18.0,1,3,8,31,1,up,1977-12-10
8174,War,1977-12-24,War - Galaxy,12,20,9,6.0,9,Galaxy,18.0,2,0,3,8,0,stay,1977-12-10
8175,War,1977-12-31,War - Galaxy,9,12,9,6.0,9,Galaxy,18.0,3,0,0,3,0,stay,1977-12-10
8176,War,1978-01-07,War - Galaxy,9,9,6,6.0,9,Galaxy,18.0,4,3,0,0,1,up,1977-12-10
8177,War,1978-01-14,War - Galaxy,9,9,6,6.0,6,Galaxy,18.0,5,0,3,0,0,stay,1977-12-10
8178,War,1978-01-21,War - Galaxy,6,9,8,6.0,6,Galaxy,18.0,6,-2,0,3,1,down,1977-12-10
8179,War,1978-01-28,War - Galaxy,6,6,8,6.0,8,Galaxy,18.0,7,0,-2,0,0,stay,1977-12-10
8180,War,1978-02-04,War - Galaxy,8,6,8,6.0,8,Galaxy,18.0,8,0,0,-2,0,stay,1977-12-10
8181,War,1978-02-11,War - Galaxy,8,8,9,6.0,8,Galaxy,18.0,9,-1,0,0,1,down,1977-12-10
8182,War,1978-02-18,War - Galaxy,8,8,12,6.0,9,Galaxy,18.0,10,-3,-1,0,1,down,1977-12-10
8183,War,1978-02-25,War - Galaxy,9,8,12,6.0,12,Galaxy,18.0,11,0,-3,-1,0,stay,1977-12-10
8184,War,1978-03-04,War - Galaxy,12,9,13,6.0,12,Galaxy,18.0,12,-1,0,-3,1,down,1977-12-10
8185,War,1978-03-11,War - Galaxy,12,12,13,6.0,13,Galaxy,18.0,13,0,-1,0,0,stay,1977-12-10
8186,War,1978-03-18,War - Galaxy,13,12,21,6.0,13,Galaxy,18.0,14,-8,0,-1,1,down,1977-12-10
8187,War,1978-03-25,War - Galaxy,13,13,27,6.0,21,Galaxy,18.0,15,-6,-8,0,1,down,1977-12-10
8188,War,1978-04-01,War - Galaxy,21,13,30,6.0,27,Galaxy,18.0,16,-3,-6,-8,1,down,1977-12-10
8189,War,1978-04-08,War - Galaxy,27,21,33,6.0,30,Galaxy,18.0,17,-3,-3,-6,1,down,1977-12-10
8190,War,1978-04-15,War - Galaxy,30,27,51,6.0,33,Galaxy,18.0,18,-18,-3,-3,1,down,1977-12-10
8191,"Earth, Wind & Fire",1977-12-10,"Earth, Wind & Fire - All 'n' All",51,51,1,1.0,22,All 'n' All,31.0,0,21,29,0,1,up,1977-12-10
8192,"Earth, Wind & Fire",1977-12-17,"Earth, Wind & Fire - All 'n' All",22,51,1,1.0,1,All 'n' All,31.0,1,0,21,29,0,stay,1977-12-10
8193,"Earth, Wind & Fire",1977-12-24,"Earth, Wind & Fire - All 'n' All",1,22,1,1.0,1,All 'n' All,31.0,2,0,0,21,0,stay,1977-12-10
8194,"Earth, Wind & Fire",1977-12-31,"Earth, Wind & Fire - All 'n' All",1,1,1,1.0,1,All 'n' All,31.0,3,0,0,0,0,stay,1977-12-10
8195,"Earth, Wind & Fire",1978-01-07,"Earth, Wind & Fire - All 'n' All",1,1,1,1.0,1,All 'n' All,31.0,4,0,0,0,0,stay,1977-12-10
8196,"Earth, Wind & Fire",1978-01-14,"Earth, Wind & Fire - All 'n' All",1,1,1,1.0,1,All 'n' All,31.0,5,0,0,0,0,stay,1977-12-10
8197,"Earth, Wind & Fire",1978-01-21,"Earth, Wind & Fire - All 'n' All",1,1,1,1.0,1,All 'n' All,31.0,6,0,0,0,0,stay,1977-12-10
8198,"Earth, Wind & Fire",1978-01-28,"Earth, Wind & Fire - All 'n' All",1,1,1,1.0,1,All 'n' All,31.0,7,0,0,0,0,stay,1977-12-10
8199,"Earth, Wind & Fire",1978-02-04,"Earth, Wind & Fire - All 'n' All",1,1,1,1.0,1,All 'n' All,31.0,8,0,0,0,0,stay,1977-12-10
8200,"Earth, Wind & Fire",1978-02-11,"Earth, Wind & Fire - All 'n' All",1,1,2,1.0,1,All 'n' All,31.0,9,-1,0,0,1,down,1977-12-10
8201,"Earth, Wind & Fire",1978-02-18,"Earth, Wind & Fire - All 'n' All",1,1,2,1.0,2,All 'n' All,31.0,10,0,-1,0,0,stay,1977-12-10
8202,"Earth, Wind & Fire",1978-02-25,"Earth, Wind & Fire - All 'n' All",2,1,2,1.0,2,All 'n' All,31.0,11,0,0,-1,0,stay,1977-12-10
8203,"Earth, Wind & Fire",1978-03-04,"Earth, Wind & Fire - All 'n' All",2,2,2,1.0,2,All 'n' All,31.0,12,0,0,0,0,stay,1977-12-10
8204,"Earth, Wind & Fire",1978-03-11,"Earth, Wind & Fire - All 'n' All",2,2,2,1.0,2,All 'n' All,31.0,13,0,0,0,0,stay,1977-12-10
8205,"Earth, Wind & Fire",1978-03-18,"Earth, Wind & Fire - All 'n' All",2,2,7,1.0,2,All 'n' All,31.0,14,-5,0,0,1,down,1977-12-10
8206,"Earth, Wind & Fire",1978-03-25,"Earth, Wind & Fire - All 'n' All",2,2,7,1.0,7,All 'n' All,31.0,15,0,-5,0,0,stay,1977-12-10
8207,"Earth, Wind & Fire",1978-04-01,"Earth, Wind & Fire - All 'n' All",7,2,7,1.0,7,All 'n' All,31.0,16,0,0,-5,0,stay,1977-12-10
8208,"Earth, Wind & Fire",1978-04-08,"Earth, Wind & Fire - All 'n' All",7,7,8,1.0,7,All 'n' All,31.0,17,-1,0,0,1,down,1977-12-10
8209,"Earth, Wind & Fire",1978-04-15,"Earth, Wind & Fire - All 'n' All",7,7,9,1.0,8,All 'n' All,31.0,18,-1,-1,0,1,down,1977-12-10
8210,"Earth, Wind & Fire",1978-04-22,"Earth, Wind & Fire - All 'n' All",8,7,9,1.0,9,All 'n' All,31.0,19,0,-1,-1,0,stay,1977-12-10
8211,"Earth, Wind & Fire",1978-04-29,"Earth, Wind & Fire - All 'n' All",9,8,11,1.0,9,All 'n' All,31.0,20,-2,0,-1,1,down,1977-12-10
8212,"Earth, Wind & Fire",1978-05-06,"Earth, Wind & Fire - All 'n' All",9,9,12,1.0,11,All 'n' All,31.0,21,-1,-2,0,1,down,1977-12-10
8213,"Earth, Wind & Fire",1978-05-13,"Earth, Wind & Fire - All 'n' All",11,9,15,1.0,12,All 'n' All,31.0,22,-3,-1,-2,1,down,1977-12-10
8214,"Earth, Wind & Fire",1978-05-20,"Earth, Wind & Fire - All 'n' All",12,11,23,1.0,15,All 'n' All,31.0,23,-8,-3,-1,1,down,1977-12-10
8215,"Earth, Wind & Fire",1978-05-27,"Earth, Wind & Fire - All 'n' All",15,12,25,1.0,23,All 'n' All,31.0,24,-2,-8,-3,1,down,1977-12-10
8216,"Earth, Wind & Fire",1978-06-03,"Earth, Wind & Fire - All 'n' All",23,15,25,1.0,25,All 'n' All,31.0,25,0,-2,-8,0,stay,1977-12-10
8217,"Earth, Wind & Fire",1978-06-10,"Earth, Wind & Fire - All 'n' All",25,23,25,1.0,25,All 'n' All,31.0,26,0,0,-2,0,stay,1977-12-10
8218,"Earth, Wind & Fire",1978-06-17,"Earth, Wind & Fire - All 'n' All",25,25,43,1.0,25,All 'n' All,31.0,27,-18,0,0,1,down,1977-12-10
8219,"Earth, Wind & Fire",1978-06-24,"Earth, Wind & Fire - All 'n' All",25,25,44,1.0,43,All 'n' All,31.0,28,-1,-18,0,1,down,1977-12-10
8220,"Earth, Wind & Fire",1978-07-01,"Earth, Wind & Fire - All 'n' All",43,25,44,1.0,44,All 'n' All,31.0,29,0,-1,-18,0,stay,1977-12-10
8221,"Earth, Wind & Fire",1978-07-08,"Earth, Wind & Fire - All 'n' All",44,43,45,1.0,44,All 'n' All,31.0,30,-1,0,-1,1,down,1977-12-10
8222,"Earth, Wind & Fire",1978-07-15,"Earth, Wind & Fire - All 'n' All",44,44,51,1.0,45,All 'n' All,31.0,31,-6,-1,0,1,down,1977-12-10
8223,The Trammps,1977-12-10,The Trammps - Trammps Iii,51,51,27,27.0,34,Trammps Iii,5.0,0,7,17,0,1,up,1977-12-10
8224,The Trammps,1977-12-17,The Trammps - Trammps Iii,34,51,27,27.0,27,Trammps Iii,5.0,1,0,7,17,0,stay,1977-12-10
8225,The Trammps,1977-12-24,The Trammps - Trammps Iii,27,34,27,27.0,27,Trammps Iii,5.0,2,0,0,7,0,stay,1977-12-10
8226,The Trammps,1977-12-31,The Trammps - Trammps Iii,27,27,50,27.0,27,Trammps Iii,5.0,3,-23,0,0,1,down,1977-12-10
8227,The Trammps,1978-01-28,The Trammps - Trammps Iii,27,27,47,27.0,50,Trammps Iii,5.0,4,3,-23,0,1,up,1977-12-10
8228,The Trammps,1978-02-04,The Trammps - Trammps Iii,50,27,51,27.0,47,Trammps Iii,5.0,5,-4,3,-23,1,down,1977-12-10
8229,Isaac Hayes,1977-12-10,Isaac Hayes - New Horizon,51,51,35,26.0,41,New Horizon,12.0,0,6,10,0,1,up,1977-12-10
8230,Isaac Hayes,1977-12-17,Isaac Hayes - New Horizon,41,51,26,26.0,35,New Horizon,12.0,1,9,6,10,1,up,1977-12-10
8231,Isaac Hayes,1977-12-24,Isaac Hayes - New Horizon,35,41,26,26.0,26,New Horizon,12.0,2,0,9,6,0,stay,1977-12-10
8232,Isaac Hayes,1977-12-31,Isaac Hayes - New Horizon,26,35,26,26.0,26,New Horizon,12.0,3,0,0,9,0,stay,1977-12-10
8233,Isaac Hayes,1978-01-07,Isaac Hayes - New Horizon,26,26,41,26.0,26,New Horizon,12.0,4,-15,0,0,1,down,1977-12-10
8234,Isaac Hayes,1978-01-14,Isaac Hayes - New Horizon,26,26,41,26.0,41,New Horizon,12.0,5,0,-15,0,0,stay,1977-12-10
8235,Isaac Hayes,1978-01-21,Isaac Hayes - New Horizon,41,26,39,26.0,41,New Horizon,12.0,6,2,0,-15,1,up,1977-12-10
8236,Isaac Hayes,1978-01-28,Isaac Hayes - New Horizon,41,41,39,26.0,39,New Horizon,12.0,7,0,2,0,0,stay,1977-12-10
8237,Isaac Hayes,1978-02-04,Isaac Hayes - New Horizon,39,41,39,26.0,39,New Horizon,12.0,8,0,0,2,0,stay,1977-12-10
8238,Isaac Hayes,1978-02-11,Isaac Hayes - New Horizon,39,39,46,26.0,39,New Horizon,12.0,9,-7,0,0,1,down,1977-12-10
8239,Isaac Hayes,1978-02-18,Isaac Hayes - New Horizon,39,39,49,26.0,46,New Horizon,12.0,10,-3,-7,0,1,down,1977-12-10
8240,Isaac Hayes,1978-02-25,Isaac Hayes - New Horizon,46,39,49,26.0,49,New Horizon,12.0,11,0,-3,-7,0,stay,1977-12-10
8241,Isaac Hayes,1978-03-04,Isaac Hayes - New Horizon,49,46,51,26.0,49,New Horizon,12.0,12,-2,0,-3,1,down,1977-12-10
8242,The Temptations,1977-12-10,The Temptations - Hear To Tempt You,51,51,40,38.0,50,Hear To Tempt You,8.0,0,10,1,0,1,up,1977-12-10
8243,The Temptations,1977-12-17,The Temptations - Hear To Tempt You,50,51,38,38.0,40,Hear To Tempt You,8.0,1,2,10,1,1,up,1977-12-10
8244,The Temptations,1977-12-24,The Temptations - Hear To Tempt You,40,50,38,38.0,38,Hear To Tempt You,8.0,2,0,2,10,0,stay,1977-12-10
8245,The Temptations,1977-12-31,The Temptations - Hear To Tempt You,38,40,44,38.0,38,Hear To Tempt You,8.0,3,-6,0,2,1,down,1977-12-10
8246,The Temptations,1978-01-07,The Temptations - Hear To Tempt You,38,38,40,38.0,44,Hear To Tempt You,8.0,4,4,-6,0,1,up,1977-12-10
8247,The Temptations,1978-01-14,The Temptations - Hear To Tempt You,44,38,40,38.0,40,Hear To Tempt You,8.0,5,0,4,-6,0,stay,1977-12-10
8248,The Temptations,1978-01-21,The Temptations - Hear To Tempt You,40,44,49,38.0,40,Hear To Tempt You,8.0,6,-9,0,4,1,down,1977-12-10
8249,The Temptations,1978-01-28,The Temptations - Hear To Tempt You,40,40,49,38.0,49,Hear To Tempt You,8.0,7,0,-9,0,0,stay,1977-12-10
8250,The Temptations,1978-02-04,The Temptations - Hear To Tempt You,49,40,51,38.0,49,Hear To Tempt You,8.0,8,-2,0,-9,1,down,1977-12-10
8251,Lou Rawls,1977-12-17,"Lou Rawls - When You Hear Lou, You've Heard It All",51,51,14,13.0,29,"When You Hear Lou, You've Heard It All",30.0,0,15,22,0,1,up,1977-12-17
8252,Lou Rawls,1977-12-24,"Lou Rawls - When You Hear Lou, You've Heard It All",29,51,14,13.0,14,"When You Hear Lou, You've Heard It All",30.0,1,0,15,22,0,stay,1977-12-17
8253,Lou Rawls,1977-12-31,"Lou Rawls - When You Hear Lou, You've Heard It All",14,29,14,13.0,14,"When You Hear Lou, You've Heard It All",30.0,2,0,0,15,0,stay,1977-12-17
8254,Lou Rawls,1978-01-07,"Lou Rawls - When You Hear Lou, You've Heard It All",14,14,21,13.0,14,"When You Hear Lou, You've Heard It All",30.0,3,-7,0,0,1,down,1977-12-17
8255,Lou Rawls,1978-01-14,"Lou Rawls - When You Hear Lou, You've Heard It All",14,14,20,13.0,21,"When You Hear Lou, You've Heard It All",30.0,4,1,-7,0,1,up,1977-12-17
8256,Lou Rawls,1978-01-21,"Lou Rawls - When You Hear Lou, You've Heard It All",21,14,20,13.0,20,"When You Hear Lou, You've Heard It All",30.0,5,0,1,-7,0,stay,1977-12-17
8257,Lou Rawls,1978-01-28,"Lou Rawls - When You Hear Lou, You've Heard It All",20,21,13,13.0,20,"When You Hear Lou, You've Heard It All",30.0,6,7,0,1,1,up,1977-12-17
8258,Lou Rawls,1978-02-04,"Lou Rawls - When You Hear Lou, You've Heard It All",20,20,13,13.0,13,"When You Hear Lou, You've Heard It All",30.0,7,0,7,0,0,stay,1977-12-17
8259,Lou Rawls,1978-02-11,"Lou Rawls - When You Hear Lou, You've Heard It All",13,20,17,13.0,13,"When You Hear Lou, You've Heard It All",30.0,8,-4,0,7,1,down,1977-12-17
8260,Lou Rawls,1978-02-18,"Lou Rawls - When You Hear Lou, You've Heard It All",13,13,17,13.0,17,"When You Hear Lou, You've Heard It All",30.0,9,0,-4,0,0,stay,1977-12-17
8261,Lou Rawls,1978-02-25,"Lou Rawls - When You Hear Lou, You've Heard It All",17,13,17,13.0,17,"When You Hear Lou, You've Heard It All",30.0,10,0,0,-4,0,stay,1977-12-17
8262,Lou Rawls,1978-03-04,"Lou Rawls - When You Hear Lou, You've Heard It All",17,17,14,13.0,17,"When You Hear Lou, You've Heard It All",30.0,11,3,0,0,1,up,1977-12-17
8263,Lou Rawls,1978-03-11,"Lou Rawls - When You Hear Lou, You've Heard It All",17,17,15,13.0,14,"When You Hear Lou, You've Heard It All",30.0,12,-1,3,0,1,down,1977-12-17
8264,Lou Rawls,1978-03-18,"Lou Rawls - When You Hear Lou, You've Heard It All",14,17,16,13.0,15,"When You Hear Lou, You've Heard It All",30.0,13,-1,-1,3,1,down,1977-12-17
8265,Lou Rawls,1978-03-25,"Lou Rawls - When You Hear Lou, You've Heard It All",15,14,17,13.0,16,"When You Hear Lou, You've Heard It All",30.0,14,-1,-1,-1,1,down,1977-12-17
8266,Lou Rawls,1978-04-01,"Lou Rawls - When You Hear Lou, You've Heard It All",16,15,17,13.0,17,"When You Hear Lou, You've Heard It All",30.0,15,0,-1,-1,0,stay,1977-12-17
8267,Lou Rawls,1978-04-08,"Lou Rawls - When You Hear Lou, You've Heard It All",17,16,22,13.0,17,"When You Hear Lou, You've Heard It All",30.0,16,-5,0,-1,1,down,1977-12-17
8268,Lou Rawls,1978-04-15,"Lou Rawls - When You Hear Lou, You've Heard It All",17,17,21,13.0,22,"When You Hear Lou, You've Heard It All",30.0,17,1,-5,0,1,up,1977-12-17
8269,Lou Rawls,1978-04-22,"Lou Rawls - When You Hear Lou, You've Heard It All",22,17,22,13.0,21,"When You Hear Lou, You've Heard It All",30.0,18,-1,1,-5,1,down,1977-12-17
8270,Lou Rawls,1978-04-29,"Lou Rawls - When You Hear Lou, You've Heard It All",21,22,25,13.0,22,"When You Hear Lou, You've Heard It All",30.0,19,-3,-1,1,1,down,1977-12-17
8271,Lou Rawls,1978-05-06,"Lou Rawls - When You Hear Lou, You've Heard It All",22,21,25,13.0,25,"When You Hear Lou, You've Heard It All",30.0,20,0,-3,-1,0,stay,1977-12-17
8272,Lou Rawls,1978-05-13,"Lou Rawls - When You Hear Lou, You've Heard It All",25,22,26,13.0,25,"When You Hear Lou, You've Heard It All",30.0,21,-1,0,-3,1,down,1977-12-17
8273,Lou Rawls,1978-05-20,"Lou Rawls - When You Hear Lou, You've Heard It All",25,25,27,13.0,26,"When You Hear Lou, You've Heard It All",30.0,22,-1,-1,0,1,down,1977-12-17
8274,Lou Rawls,1978-05-27,"Lou Rawls - When You Hear Lou, You've Heard It All",26,25,29,13.0,27,"When You Hear Lou, You've Heard It All",30.0,23,-2,-1,-1,1,down,1977-12-17
8275,Lou Rawls,1978-06-03,"Lou Rawls - When You Hear Lou, You've Heard It All",27,26,32,13.0,29,"When You Hear Lou, You've Heard It All",30.0,24,-3,-2,-1,1,down,1977-12-17
8276,Lou Rawls,1978-06-10,"Lou Rawls - When You Hear Lou, You've Heard It All",29,27,41,13.0,32,"When You Hear Lou, You've Heard It All",30.0,25,-9,-3,-2,1,down,1977-12-17
8277,Lou Rawls,1978-06-17,"Lou Rawls - When You Hear Lou, You've Heard It All",32,29,46,13.0,41,"When You Hear Lou, You've Heard It All",30.0,26,-5,-9,-3,1,down,1977-12-17
8278,Lou Rawls,1978-06-24,"Lou Rawls - When You Hear Lou, You've Heard It All",41,32,46,13.0,46,"When You Hear Lou, You've Heard It All",30.0,27,0,-5,-9,0,stay,1977-12-17
8279,Lou Rawls,1978-07-01,"Lou Rawls - When You Hear Lou, You've Heard It All",46,41,39,13.0,46,"When You Hear Lou, You've Heard It All",30.0,28,7,0,-5,1,up,1977-12-17
8280,Lou Rawls,1978-07-08,"Lou Rawls - When You Hear Lou, You've Heard It All",46,46,42,13.0,39,"When You Hear Lou, You've Heard It All",30.0,29,-3,7,0,1,down,1977-12-17
8281,Lou Rawls,1978-07-15,"Lou Rawls - When You Hear Lou, You've Heard It All",39,46,51,13.0,42,"When You Hear Lou, You've Heard It All",30.0,30,-9,-3,7,1,down,1977-12-17
8282,Natalie Cole,1977-12-17,Natalie Cole - Thankful,51,51,16,5.0,33,Thankful,36.0,0,17,18,0,1,up,1977-12-17
8283,Natalie Cole,1977-12-24,Natalie Cole - Thankful,33,51,16,5.0,16,Thankful,36.0,1,0,17,18,0,stay,1977-12-17
8284,Natalie Cole,1977-12-31,Natalie Cole - Thankful,16,33,12,5.0,16,Thankful,36.0,2,4,0,17,1,up,1977-12-17
8285,Natalie Cole,1978-01-07,Natalie Cole - Thankful,16,16,10,5.0,12,Thankful,36.0,3,2,4,0,1,up,1977-12-17
8286,Natalie Cole,1978-01-14,Natalie Cole - Thankful,12,16,7,5.0,10,Thankful,36.0,4,3,2,4,1,up,1977-12-17
8287,Natalie Cole,1978-01-21,Natalie Cole - Thankful,10,12,6,5.0,7,Thankful,36.0,5,1,3,2,1,up,1977-12-17
8288,Natalie Cole,1978-01-28,Natalie Cole - Thankful,7,10,6,5.0,6,Thankful,36.0,6,0,1,3,0,stay,1977-12-17
8289,Natalie Cole,1978-02-04,Natalie Cole - Thankful,6,7,5,5.0,6,Thankful,36.0,7,1,0,1,1,up,1977-12-17
8290,Natalie Cole,1978-02-11,Natalie Cole - Thankful,6,6,5,5.0,5,Thankful,36.0,8,0,1,0,0,stay,1977-12-17
8291,Natalie Cole,1978-02-18,Natalie Cole - Thankful,5,6,5,5.0,5,Thankful,36.0,9,0,0,1,0,stay,1977-12-17
8292,Natalie Cole,1978-02-25,Natalie Cole - Thankful,5,5,6,5.0,5,Thankful,36.0,10,-1,0,0,1,down,1977-12-17
8293,Natalie Cole,1978-03-04,Natalie Cole - Thankful,5,5,6,5.0,6,Thankful,36.0,11,0,-1,0,0,stay,1977-12-17
8294,Natalie Cole,1978-03-11,Natalie Cole - Thankful,6,5,8,5.0,6,Thankful,36.0,12,-2,0,-1,1,down,1977-12-17
8295,Natalie Cole,1978-03-18,Natalie Cole - Thankful,6,6,8,5.0,8,Thankful,36.0,13,0,-2,0,0,stay,1977-12-17
8296,Natalie Cole,1978-03-25,Natalie Cole - Thankful,8,6,8,5.0,8,Thankful,36.0,14,0,0,-2,0,stay,1977-12-17
8297,Natalie Cole,1978-04-01,Natalie Cole - Thankful,8,8,8,5.0,8,Thankful,36.0,15,0,0,0,0,stay,1977-12-17
8298,Natalie Cole,1978-04-08,Natalie Cole - Thankful,8,8,7,5.0,8,Thankful,36.0,16,1,0,0,1,up,1977-12-17
8299,Natalie Cole,1978-04-15,Natalie Cole - Thankful,8,8,7,5.0,7,Thankful,36.0,17,0,1,0,0,stay,1977-12-17
8300,Natalie Cole,1978-04-22,Natalie Cole - Thankful,7,8,7,5.0,7,Thankful,36.0,18,0,0,1,0,stay,1977-12-17
8301,Natalie Cole,1978-04-29,Natalie Cole - Thankful,7,7,16,5.0,7,Thankful,36.0,19,-9,0,0,1,down,1977-12-17
8302,Natalie Cole,1978-05-06,Natalie Cole - Thankful,7,7,16,5.0,16,Thankful,36.0,20,0,-9,0,0,stay,1977-12-17
8303,Natalie Cole,1978-05-13,Natalie Cole - Thankful,16,7,13,5.0,16,Thankful,36.0,21,3,0,-9,1,up,1977-12-17
8304,Natalie Cole,1978-05-20,Natalie Cole - Thankful,16,16,10,5.0,13,Thankful,36.0,22,3,3,0,1,up,1977-12-17
8305,Natalie Cole,1978-05-27,Natalie Cole - Thankful,13,16,10,5.0,10,Thankful,36.0,23,0,3,3,0,stay,1977-12-17
8306,Natalie Cole,1978-06-03,Natalie Cole - Thankful,10,13,13,5.0,10,Thankful,36.0,24,-3,0,3,1,down,1977-12-17
8307,Natalie Cole,1978-06-10,Natalie Cole - Thankful,10,10,13,5.0,13,Thankful,36.0,25,0,-3,0,0,stay,1977-12-17
8308,Natalie Cole,1978-06-17,Natalie Cole - Thankful,13,10,12,5.0,13,Thankful,36.0,26,1,0,-3,1,up,1977-12-17
8309,Natalie Cole,1978-06-24,Natalie Cole - Thankful,13,13,20,5.0,12,Thankful,36.0,27,-8,1,0,1,down,1977-12-17
8310,Natalie Cole,1978-07-01,Natalie Cole - Thankful,12,13,21,5.0,20,Thankful,36.0,28,-1,-8,1,1,down,1977-12-17
8311,Natalie Cole,1978-07-08,Natalie Cole - Thankful,20,12,21,5.0,21,Thankful,36.0,29,0,-1,-8,0,stay,1977-12-17
8312,Natalie Cole,1978-07-15,Natalie Cole - Thankful,21,20,26,5.0,21,Thankful,36.0,30,-5,0,-1,1,down,1977-12-17
8313,Natalie Cole,1978-07-22,Natalie Cole - Thankful,21,21,29,5.0,26,Thankful,36.0,31,-3,-5,0,1,down,1977-12-17
8314,Natalie Cole,1978-07-29,Natalie Cole - Thankful,26,21,34,5.0,29,Thankful,36.0,32,-5,-3,-5,1,down,1977-12-17
8315,Natalie Cole,1978-08-05,Natalie Cole - Thankful,29,26,41,5.0,34,Thankful,36.0,33,-7,-5,-3,1,down,1977-12-17
8316,Natalie Cole,1978-08-12,Natalie Cole - Thankful,34,29,45,5.0,41,Thankful,36.0,34,-4,-7,-5,1,down,1977-12-17
8317,Natalie Cole,1978-08-19,Natalie Cole - Thankful,41,34,48,5.0,45,Thankful,36.0,35,-3,-4,-7,1,down,1977-12-17
8318,Natalie Cole,1978-08-26,Natalie Cole - Thankful,45,41,51,5.0,48,Thankful,36.0,36,-3,-3,-4,1,down,1977-12-17
8319,The Spinners,1977-12-17,The Spinners - Spinners 8,51,51,37,34.0,47,Spinners 8,9.0,0,10,4,0,1,up,1977-12-17
8320,The Spinners,1977-12-24,The Spinners - Spinners 8,47,51,37,34.0,37,Spinners 8,9.0,1,0,10,4,0,stay,1977-12-17
8321,The Spinners,1977-12-31,The Spinners - Spinners 8,37,47,37,34.0,37,Spinners 8,9.0,2,0,0,10,0,stay,1977-12-17
8322,The Spinners,1978-01-07,The Spinners - Spinners 8,37,37,34,34.0,37,Spinners 8,9.0,3,3,0,0,1,up,1977-12-17
8323,The Spinners,1978-01-14,The Spinners - Spinners 8,37,37,38,34.0,34,Spinners 8,9.0,4,-4,3,0,1,down,1977-12-17
8324,The Spinners,1978-01-21,The Spinners - Spinners 8,34,37,48,34.0,38,Spinners 8,9.0,5,-10,-4,3,1,down,1977-12-17
8325,The Spinners,1978-01-28,The Spinners - Spinners 8,38,34,48,34.0,48,Spinners 8,9.0,6,0,-10,-4,0,stay,1977-12-17
8326,The Spinners,1978-02-04,The Spinners - Spinners 8,48,38,47,34.0,48,Spinners 8,9.0,7,1,0,-10,1,up,1977-12-17
8327,The Spinners,1978-02-11,The Spinners - Spinners 8,48,48,49,34.0,47,Spinners 8,9.0,8,-2,1,0,1,down,1977-12-17
8328,The Spinners,1978-02-18,The Spinners - Spinners 8,47,48,51,34.0,49,Spinners 8,9.0,9,-2,-2,1,1,down,1977-12-17
8329,Billy Preston,1977-12-17,Billy Preston - Whole New Thing,51,51,49,49.0,49,Whole New Thing,2.0,0,0,2,0,0,stay,1977-12-17
8330,Billy Preston,1977-12-24,Billy Preston - Whole New Thing,49,51,49,49.0,49,Whole New Thing,2.0,1,0,0,2,0,stay,1977-12-17
8331,Billy Preston,1977-12-31,Billy Preston - Whole New Thing,49,49,51,49.0,49,Whole New Thing,2.0,2,-2,0,0,1,down,1977-12-17
8332,Parliament,1977-12-24,Parliament - Funkentelechy Vs. The Placebo Syndrome,51,51,30,2.0,30,Funkentelechy Vs. The Placebo Syndrome,31.0,0,0,21,0,0,stay,1977-12-24
8333,Parliament,1977-12-31,Parliament - Funkentelechy Vs. The Placebo Syndrome,30,51,7,2.0,30,Funkentelechy Vs. The Placebo Syndrome,31.0,1,23,0,21,1,up,1977-12-24
8334,Parliament,1978-01-07,Parliament - Funkentelechy Vs. The Placebo Syndrome,30,30,4,2.0,7,Funkentelechy Vs. The Placebo Syndrome,31.0,2,3,23,0,1,up,1977-12-24
8335,Parliament,1978-01-14,Parliament - Funkentelechy Vs. The Placebo Syndrome,7,30,3,2.0,4,Funkentelechy Vs. The Placebo Syndrome,31.0,3,1,3,23,1,up,1977-12-24
8336,Parliament,1978-01-21,Parliament - Funkentelechy Vs. The Placebo Syndrome,4,7,2,2.0,3,Funkentelechy Vs. The Placebo Syndrome,31.0,4,1,1,3,1,up,1977-12-24
8337,Parliament,1978-01-28,Parliament - Funkentelechy Vs. The Placebo Syndrome,3,4,2,2.0,2,Funkentelechy Vs. The Placebo Syndrome,31.0,5,0,1,1,0,stay,1977-12-24
8338,Parliament,1978-02-04,Parliament - Funkentelechy Vs. The Placebo Syndrome,2,3,2,2.0,2,Funkentelechy Vs. The Placebo Syndrome,31.0,6,0,0,1,0,stay,1977-12-24
8339,Parliament,1978-02-11,Parliament - Funkentelechy Vs. The Placebo Syndrome,2,2,3,2.0,2,Funkentelechy Vs. The Placebo Syndrome,31.0,7,-1,0,0,1,down,1977-12-24
8340,Parliament,1978-02-18,Parliament - Funkentelechy Vs. The Placebo Syndrome,2,2,3,2.0,3,Funkentelechy Vs. The Placebo Syndrome,31.0,8,0,-1,0,0,stay,1977-12-24
8341,Parliament,1978-02-25,Parliament - Funkentelechy Vs. The Placebo Syndrome,3,2,3,2.0,3,Funkentelechy Vs. The Placebo Syndrome,31.0,9,0,0,-1,0,stay,1977-12-24
8342,Parliament,1978-03-04,Parliament - Funkentelechy Vs. The Placebo Syndrome,3,3,3,2.0,3,Funkentelechy Vs. The Placebo Syndrome,31.0,10,0,0,0,0,stay,1977-12-24
8343,Parliament,1978-03-11,Parliament - Funkentelechy Vs. The Placebo Syndrome,3,3,3,2.0,3,Funkentelechy Vs. The Placebo Syndrome,31.0,11,0,0,0,0,stay,1977-12-24
8344,Parliament,1978-03-18,Parliament - Funkentelechy Vs. The Placebo Syndrome,3,3,4,2.0,3,Funkentelechy Vs. The Placebo Syndrome,31.0,12,-1,0,0,1,down,1977-12-24
8345,Parliament,1978-03-25,Parliament - Funkentelechy Vs. The Placebo Syndrome,3,3,4,2.0,4,Funkentelechy Vs. The Placebo Syndrome,31.0,13,0,-1,0,0,stay,1977-12-24
8346,Parliament,1978-04-01,Parliament - Funkentelechy Vs. The Placebo Syndrome,4,3,3,2.0,4,Funkentelechy Vs. The Placebo Syndrome,31.0,14,1,0,-1,1,up,1977-12-24
8347,Parliament,1978-04-08,Parliament - Funkentelechy Vs. The Placebo Syndrome,4,4,3,2.0,3,Funkentelechy Vs. The Placebo Syndrome,31.0,15,0,1,0,0,stay,1977-12-24
8348,Parliament,1978-04-15,Parliament - Funkentelechy Vs. The Placebo Syndrome,3,4,3,2.0,3,Funkentelechy Vs. The Placebo Syndrome,31.0,16,0,0,1,0,stay,1977-12-24
8349,Parliament,1978-04-22,Parliament - Funkentelechy Vs. The Placebo Syndrome,3,3,4,2.0,3,Funkentelechy Vs. The Placebo Syndrome,31.0,17,-1,0,0,1,down,1977-12-24
8350,Parliament,1978-04-29,Parliament - Funkentelechy Vs. The Placebo Syndrome,3,3,8,2.0,4,Funkentelechy Vs. The Placebo Syndrome,31.0,18,-4,-1,0,1,down,1977-12-24
8351,Parliament,1978-05-06,Parliament - Funkentelechy Vs. The Placebo Syndrome,4,3,9,2.0,8,Funkentelechy Vs. The Placebo Syndrome,31.0,19,-1,-4,-1,1,down,1977-12-24
8352,Parliament,1978-05-13,Parliament - Funkentelechy Vs. The Placebo Syndrome,8,4,9,2.0,9,Funkentelechy Vs. The Placebo Syndrome,31.0,20,0,-1,-4,0,stay,1977-12-24
8353,Parliament,1978-05-20,Parliament - Funkentelechy Vs. The Placebo Syndrome,9,8,13,2.0,9,Funkentelechy Vs. The Placebo Syndrome,31.0,21,-4,0,-1,1,down,1977-12-24
8354,Parliament,1978-05-27,Parliament - Funkentelechy Vs. The Placebo Syndrome,9,9,16,2.0,13,Funkentelechy Vs. The Placebo Syndrome,31.0,22,-3,-4,0,1,down,1977-12-24
8355,Parliament,1978-06-03,Parliament - Funkentelechy Vs. The Placebo Syndrome,13,9,16,2.0,16,Funkentelechy Vs. The Placebo Syndrome,31.0,23,0,-3,-4,0,stay,1977-12-24
8356,Parliament,1978-06-10,Parliament - Funkentelechy Vs. The Placebo Syndrome,16,13,17,2.0,16,Funkentelechy Vs. The Placebo Syndrome,31.0,24,-1,0,-3,1,down,1977-12-24
8357,Parliament,1978-06-17,Parliament - Funkentelechy Vs. The Placebo Syndrome,16,16,26,2.0,17,Funkentelechy Vs. The Placebo Syndrome,31.0,25,-9,-1,0,1,down,1977-12-24
8358,Parliament,1978-06-24,Parliament - Funkentelechy Vs. The Placebo Syndrome,17,16,33,2.0,26,Funkentelechy Vs. The Placebo Syndrome,31.0,26,-7,-9,-1,1,down,1977-12-24
8359,Parliament,1978-07-01,Parliament - Funkentelechy Vs. The Placebo Syndrome,26,17,33,2.0,33,Funkentelechy Vs. The Placebo Syndrome,31.0,27,0,-7,-9,0,stay,1977-12-24
8360,Parliament,1978-07-08,Parliament - Funkentelechy Vs. The Placebo Syndrome,33,26,37,2.0,33,Funkentelechy Vs. The Placebo Syndrome,31.0,28,-4,0,-7,1,down,1977-12-24
8361,Parliament,1978-07-15,Parliament - Funkentelechy Vs. The Placebo Syndrome,33,33,43,2.0,37,Funkentelechy Vs. The Placebo Syndrome,31.0,29,-6,-4,0,1,down,1977-12-24
8362,Parliament,1978-07-22,Parliament - Funkentelechy Vs. The Placebo Syndrome,37,33,47,2.0,43,Funkentelechy Vs. The Placebo Syndrome,31.0,30,-4,-6,-4,1,down,1977-12-24
8363,Parliament,1978-07-29,Parliament - Funkentelechy Vs. The Placebo Syndrome,43,37,51,2.0,47,Funkentelechy Vs. The Placebo Syndrome,31.0,31,-4,-4,-6,1,down,1977-12-24
8364,Al Green,1977-12-24,Al Green - The Belle Album,51,51,35,29.0,35,The Belle Album,17.0,0,0,16,0,0,stay,1977-12-24
8365,Al Green,1977-12-31,Al Green - The Belle Album,35,51,29,29.0,35,The Belle Album,17.0,1,6,0,16,1,up,1977-12-24
8366,Al Green,1978-01-07,Al Green - The Belle Album,35,35,29,29.0,29,The Belle Album,17.0,2,0,6,0,0,stay,1977-12-24
8367,Al Green,1978-01-14,Al Green - The Belle Album,29,35,32,29.0,29,The Belle Album,17.0,3,-3,0,6,1,down,1977-12-24
8368,Al Green,1978-01-21,Al Green - The Belle Album,29,29,32,29.0,32,The Belle Album,17.0,4,0,-3,0,0,stay,1977-12-24
8369,Al Green,1978-01-28,Al Green - The Belle Album,32,29,37,29.0,32,The Belle Album,17.0,5,-5,0,-3,1,down,1977-12-24
8370,Al Green,1978-02-04,Al Green - The Belle Album,32,32,36,29.0,37,The Belle Album,17.0,6,1,-5,0,1,up,1977-12-24
8371,Al Green,1978-02-11,Al Green - The Belle Album,37,32,36,29.0,36,The Belle Album,17.0,7,0,1,-5,0,stay,1977-12-24
8372,Al Green,1978-02-18,Al Green - The Belle Album,36,37,36,29.0,36,The Belle Album,17.0,8,0,0,1,0,stay,1977-12-24
8373,Al Green,1978-02-25,Al Green - The Belle Album,36,36,31,29.0,36,The Belle Album,17.0,9,5,0,0,1,up,1977-12-24
8374,Al Green,1978-03-04,Al Green - The Belle Album,36,36,32,29.0,31,The Belle Album,17.0,10,-1,5,0,1,down,1977-12-24
8375,Al Green,1978-03-11,Al Green - The Belle Album,31,36,37,29.0,32,The Belle Album,17.0,11,-5,-1,5,1,down,1977-12-24
8376,Al Green,1978-03-18,Al Green - The Belle Album,32,31,37,29.0,37,The Belle Album,17.0,12,0,-5,-1,0,stay,1977-12-24
8377,Al Green,1978-03-25,Al Green - The Belle Album,37,32,35,29.0,37,The Belle Album,17.0,13,2,0,-5,1,up,1977-12-24
8378,Al Green,1978-04-01,Al Green - The Belle Album,37,37,44,29.0,35,The Belle Album,17.0,14,-9,2,0,1,down,1977-12-24
8379,Al Green,1978-04-08,Al Green - The Belle Album,35,37,44,29.0,44,The Belle Album,17.0,15,0,-9,2,0,stay,1977-12-24
8380,Al Green,1978-04-15,Al Green - The Belle Album,44,35,48,29.0,44,The Belle Album,17.0,16,-4,0,-9,1,down,1977-12-24
8381,Al Green,1978-04-22,Al Green - The Belle Album,44,44,51,29.0,48,The Belle Album,17.0,17,-3,-4,0,1,down,1977-12-24
8382,Slave,1977-12-24,Slave - The Hardness Of The World,51,51,41,31.0,41,The Hardness Of The World,12.0,0,0,10,0,0,stay,1977-12-24
8383,Slave,1977-12-31,Slave - The Hardness Of The World,41,51,38,31.0,41,The Hardness Of The World,12.0,1,3,0,10,1,up,1977-12-24
8384,Slave,1978-01-07,Slave - The Hardness Of The World,41,41,37,31.0,38,The Hardness Of The World,12.0,2,1,3,0,1,up,1977-12-24
8385,Slave,1978-01-14,Slave - The Hardness Of The World,38,41,35,31.0,37,The Hardness Of The World,12.0,3,2,1,3,1,up,1977-12-24
8386,Slave,1978-01-21,Slave - The Hardness Of The World,37,38,43,31.0,35,The Hardness Of The World,12.0,4,-8,2,1,1,down,1977-12-24
8387,Slave,1978-01-28,Slave - The Hardness Of The World,35,37,42,31.0,43,The Hardness Of The World,12.0,5,1,-8,2,1,up,1977-12-24
8388,Slave,1978-02-04,Slave - The Hardness Of The World,43,35,35,31.0,42,The Hardness Of The World,12.0,6,7,1,-8,1,up,1977-12-24
8389,Slave,1978-02-11,Slave - The Hardness Of The World,42,43,31,31.0,35,The Hardness Of The World,12.0,7,4,7,1,1,up,1977-12-24
8390,Slave,1978-02-18,Slave - The Hardness Of The World,35,42,35,31.0,31,The Hardness Of The World,12.0,8,-4,4,7,1,down,1977-12-24
8391,Slave,1978-02-25,Slave - The Hardness Of The World,31,35,43,31.0,35,The Hardness Of The World,12.0,9,-8,-4,4,1,down,1977-12-24
8392,Slave,1978-03-04,Slave - The Hardness Of The World,35,31,44,31.0,43,The Hardness Of The World,12.0,10,-1,-8,-4,1,down,1977-12-24
8393,Slave,1978-03-11,Slave - The Hardness Of The World,43,35,45,31.0,44,The Hardness Of The World,12.0,11,-1,-1,-8,1,down,1977-12-24
8394,Slave,1978-03-18,Slave - The Hardness Of The World,44,43,51,31.0,45,The Hardness Of The World,12.0,12,-6,-1,-1,1,down,1977-12-24
8395,Johnny Guitar Watson,1977-12-24,Johnny Guitar Watson - Funk Beyond The Call Of Duty,51,51,43,10.0,43,Funk Beyond The Call Of Duty,16.0,0,0,8,0,0,stay,1977-12-24
8396,Johnny Guitar Watson,1977-12-31,Johnny Guitar Watson - Funk Beyond The Call Of Duty,43,51,20,10.0,43,Funk Beyond The Call Of Duty,16.0,1,23,0,8,1,up,1977-12-24
8397,Johnny Guitar Watson,1978-01-07,Johnny Guitar Watson - Funk Beyond The Call Of Duty,43,43,12,10.0,20,Funk Beyond The Call Of Duty,16.0,2,8,23,0,1,up,1977-12-24
8398,Johnny Guitar Watson,1978-01-14,Johnny Guitar Watson - Funk Beyond The Call Of Duty,20,43,10,10.0,12,Funk Beyond The Call Of Duty,16.0,3,2,8,23,1,up,1977-12-24
8399,Johnny Guitar Watson,1978-01-21,Johnny Guitar Watson - Funk Beyond The Call Of Duty,12,20,10,10.0,10,Funk Beyond The Call Of Duty,16.0,4,0,2,8,0,stay,1977-12-24
8400,Johnny Guitar Watson,1978-01-28,Johnny Guitar Watson - Funk Beyond The Call Of Duty,10,12,19,10.0,10,Funk Beyond The Call Of Duty,16.0,5,-9,0,2,1,down,1977-12-24
8401,Johnny Guitar Watson,1978-02-04,Johnny Guitar Watson - Funk Beyond The Call Of Duty,10,10,19,10.0,19,Funk Beyond The Call Of Duty,16.0,6,0,-9,0,0,stay,1977-12-24
8402,Johnny Guitar Watson,1978-02-11,Johnny Guitar Watson - Funk Beyond The Call Of Duty,19,10,23,10.0,19,Funk Beyond The Call Of Duty,16.0,7,-4,0,-9,1,down,1977-12-24
8403,Johnny Guitar Watson,1978-02-18,Johnny Guitar Watson - Funk Beyond The Call Of Duty,19,19,23,10.0,23,Funk Beyond The Call Of Duty,16.0,8,0,-4,0,0,stay,1977-12-24
8404,Johnny Guitar Watson,1978-02-25,Johnny Guitar Watson - Funk Beyond The Call Of Duty,23,19,30,10.0,23,Funk Beyond The Call Of Duty,16.0,9,-7,0,-4,1,down,1977-12-24
8405,Johnny Guitar Watson,1978-03-04,Johnny Guitar Watson - Funk Beyond The Call Of Duty,23,23,35,10.0,30,Funk Beyond The Call Of Duty,16.0,10,-5,-7,0,1,down,1977-12-24
8406,Johnny Guitar Watson,1978-03-11,Johnny Guitar Watson - Funk Beyond The Call Of Duty,30,23,35,10.0,35,Funk Beyond The Call Of Duty,16.0,11,0,-5,-7,0,stay,1977-12-24
8407,Johnny Guitar Watson,1978-03-18,Johnny Guitar Watson - Funk Beyond The Call Of Duty,35,30,35,10.0,35,Funk Beyond The Call Of Duty,16.0,12,0,0,-5,0,stay,1977-12-24
8408,Johnny Guitar Watson,1978-03-25,Johnny Guitar Watson - Funk Beyond The Call Of Duty,35,35,41,10.0,35,Funk Beyond The Call Of Duty,16.0,13,-6,0,0,1,down,1977-12-24
8409,Johnny Guitar Watson,1978-04-01,Johnny Guitar Watson - Funk Beyond The Call Of Duty,35,35,46,10.0,41,Funk Beyond The Call Of Duty,16.0,14,-5,-6,0,1,down,1977-12-24
8410,Johnny Guitar Watson,1978-04-08,Johnny Guitar Watson - Funk Beyond The Call Of Duty,41,35,49,10.0,46,Funk Beyond The Call Of Duty,16.0,15,-3,-5,-6,1,down,1977-12-24
8411,Johnny Guitar Watson,1978-04-15,Johnny Guitar Watson - Funk Beyond The Call Of Duty,46,41,51,10.0,49,Funk Beyond The Call Of Duty,16.0,16,-2,-3,-5,1,down,1977-12-24
8412,The Emotions,1977-12-24,The Emotions - Sunshine,51,51,48,39.0,48,Sunshine,6.0,0,0,3,0,0,stay,1977-12-24
8413,The Emotions,1977-12-31,The Emotions - Sunshine,48,51,41,39.0,48,Sunshine,6.0,1,7,0,3,1,up,1977-12-24
8414,The Emotions,1978-01-07,The Emotions - Sunshine,48,48,39,39.0,41,Sunshine,6.0,2,2,7,0,1,up,1977-12-24
8415,The Emotions,1978-01-14,The Emotions - Sunshine,41,48,39,39.0,39,Sunshine,6.0,3,0,2,7,0,stay,1977-12-24
8416,The Emotions,1978-01-21,The Emotions - Sunshine,39,41,44,39.0,39,Sunshine,6.0,4,-5,0,2,1,down,1977-12-24
8417,The Emotions,1978-01-28,The Emotions - Sunshine,39,39,44,39.0,44,Sunshine,6.0,5,0,-5,0,0,stay,1977-12-24
8418,The Emotions,1978-02-04,The Emotions - Sunshine,44,39,51,39.0,44,Sunshine,6.0,6,-7,0,-5,1,down,1977-12-24
8419,Harold Melvin And The Blue Notes,1977-12-24,Harold Melvin And The Blue Notes - Now Is The Time,51,51,50,50.0,50,Now Is The Time,2.0,0,0,1,0,0,stay,1977-12-24
8420,Harold Melvin And The Blue Notes,1977-12-31,Harold Melvin And The Blue Notes - Now Is The Time,50,51,50,50.0,50,Now Is The Time,2.0,1,0,0,1,0,stay,1977-12-24
8421,Harold Melvin And The Blue Notes,1978-01-07,Harold Melvin And The Blue Notes - Now Is The Time,50,50,51,50.0,50,Now Is The Time,2.0,2,-1,0,0,1,down,1977-12-24
8422,Ohio Players,1978-01-07,Ohio Players - Mr. Mean,51,51,13,11.0,23,Mr. Mean,14.0,0,10,28,0,1,up,1978-01-07
8423,Ohio Players,1978-01-14,Ohio Players - Mr. Mean,23,51,11,11.0,13,Mr. Mean,14.0,1,2,10,28,1,up,1978-01-07
8424,Ohio Players,1978-01-21,Ohio Players - Mr. Mean,13,23,11,11.0,11,Mr. Mean,14.0,2,0,2,10,0,stay,1978-01-07
8425,Ohio Players,1978-01-28,Ohio Players - Mr. Mean,11,13,20,11.0,11,Mr. Mean,14.0,3,-9,0,2,1,down,1978-01-07
8426,Ohio Players,1978-02-04,Ohio Players - Mr. Mean,11,11,20,11.0,20,Mr. Mean,14.0,4,0,-9,0,0,stay,1978-01-07
8427,Ohio Players,1978-02-11,Ohio Players - Mr. Mean,20,11,25,11.0,20,Mr. Mean,14.0,5,-5,0,-9,1,down,1978-01-07
8428,Ohio Players,1978-02-18,Ohio Players - Mr. Mean,20,20,25,11.0,25,Mr. Mean,14.0,6,0,-5,0,0,stay,1978-01-07
8429,Ohio Players,1978-02-25,Ohio Players - Mr. Mean,25,20,33,11.0,25,Mr. Mean,14.0,7,-8,0,-5,1,down,1978-01-07
8430,Ohio Players,1978-03-04,Ohio Players - Mr. Mean,25,25,33,11.0,33,Mr. Mean,14.0,8,0,-8,0,0,stay,1978-01-07
8431,Ohio Players,1978-03-11,Ohio Players - Mr. Mean,33,25,40,11.0,33,Mr. Mean,14.0,9,-7,0,-8,1,down,1978-01-07
8432,Ohio Players,1978-03-18,Ohio Players - Mr. Mean,33,33,40,11.0,40,Mr. Mean,14.0,10,0,-7,0,0,stay,1978-01-07
8433,Ohio Players,1978-03-25,Ohio Players - Mr. Mean,40,33,44,11.0,40,Mr. Mean,14.0,11,-4,0,-7,1,down,1978-01-07
8434,Ohio Players,1978-04-01,Ohio Players - Mr. Mean,40,40,49,11.0,44,Mr. Mean,14.0,12,-5,-4,0,1,down,1978-01-07
8435,Ohio Players,1978-04-08,Ohio Players - Mr. Mean,44,40,50,11.0,49,Mr. Mean,14.0,13,-1,-5,-4,1,down,1978-01-07
8436,Ohio Players,1978-04-15,Ohio Players - Mr. Mean,49,44,51,11.0,50,Mr. Mean,14.0,14,-1,-1,-5,1,down,1978-01-07
8437,Roberta Flack,1978-01-07,Roberta Flack - Blue Lights In The Basement,51,51,24,5.0,32,Blue Lights In The Basement,26.0,0,8,19,0,1,up,1978-01-07
8438,Roberta Flack,1978-01-14,Roberta Flack - Blue Lights In The Basement,32,51,18,5.0,24,Blue Lights In The Basement,26.0,1,6,8,19,1,up,1978-01-07
8439,Roberta Flack,1978-01-21,Roberta Flack - Blue Lights In The Basement,24,32,14,5.0,18,Blue Lights In The Basement,26.0,2,4,6,8,1,up,1978-01-07
8440,Roberta Flack,1978-01-28,Roberta Flack - Blue Lights In The Basement,18,24,11,5.0,14,Blue Lights In The Basement,26.0,3,3,4,6,1,up,1978-01-07
8441,Roberta Flack,1978-02-04,Roberta Flack - Blue Lights In The Basement,14,18,10,5.0,11,Blue Lights In The Basement,26.0,4,1,3,4,1,up,1978-01-07
8442,Roberta Flack,1978-02-11,Roberta Flack - Blue Lights In The Basement,11,14,8,5.0,10,Blue Lights In The Basement,26.0,5,2,1,3,1,up,1978-01-07
8443,Roberta Flack,1978-02-18,Roberta Flack - Blue Lights In The Basement,10,11,6,5.0,8,Blue Lights In The Basement,26.0,6,2,2,1,1,up,1978-01-07
8444,Roberta Flack,1978-02-25,Roberta Flack - Blue Lights In The Basement,8,10,5,5.0,6,Blue Lights In The Basement,26.0,7,1,2,2,1,up,1978-01-07
8445,Roberta Flack,1978-03-04,Roberta Flack - Blue Lights In The Basement,6,8,5,5.0,5,Blue Lights In The Basement,26.0,8,0,1,2,0,stay,1978-01-07
8446,Roberta Flack,1978-03-11,Roberta Flack - Blue Lights In The Basement,5,6,5,5.0,5,Blue Lights In The Basement,26.0,9,0,0,1,0,stay,1978-01-07
8447,Roberta Flack,1978-03-18,Roberta Flack - Blue Lights In The Basement,5,5,5,5.0,5,Blue Lights In The Basement,26.0,10,0,0,0,0,stay,1978-01-07
8448,Roberta Flack,1978-03-25,Roberta Flack - Blue Lights In The Basement,5,5,6,5.0,5,Blue Lights In The Basement,26.0,11,-1,0,0,1,down,1978-01-07
8449,Roberta Flack,1978-04-01,Roberta Flack - Blue Lights In The Basement,5,5,5,5.0,6,Blue Lights In The Basement,26.0,12,1,-1,0,1,up,1978-01-07
8450,Roberta Flack,1978-04-08,Roberta Flack - Blue Lights In The Basement,6,5,5,5.0,5,Blue Lights In The Basement,26.0,13,0,1,-1,0,stay,1978-01-07
8451,Roberta Flack,1978-04-15,Roberta Flack - Blue Lights In The Basement,5,6,5,5.0,5,Blue Lights In The Basement,26.0,14,0,0,1,0,stay,1978-01-07
8452,Roberta Flack,1978-04-22,Roberta Flack - Blue Lights In The Basement,5,5,5,5.0,5,Blue Lights In The Basement,26.0,15,0,0,0,0,stay,1978-01-07
8453,Roberta Flack,1978-04-29,Roberta Flack - Blue Lights In The Basement,5,5,5,5.0,5,Blue Lights In The Basement,26.0,16,0,0,0,0,stay,1978-01-07
8454,Roberta Flack,1978-05-06,Roberta Flack - Blue Lights In The Basement,5,5,8,5.0,5,Blue Lights In The Basement,26.0,17,-3,0,0,1,down,1978-01-07
8455,Roberta Flack,1978-05-13,Roberta Flack - Blue Lights In The Basement,5,5,11,5.0,8,Blue Lights In The Basement,26.0,18,-3,-3,0,1,down,1978-01-07
8456,Roberta Flack,1978-05-20,Roberta Flack - Blue Lights In The Basement,8,5,12,5.0,11,Blue Lights In The Basement,26.0,19,-1,-3,-3,1,down,1978-01-07
8457,Roberta Flack,1978-05-27,Roberta Flack - Blue Lights In The Basement,11,8,17,5.0,12,Blue Lights In The Basement,26.0,20,-5,-1,-3,1,down,1978-01-07
8458,Roberta Flack,1978-06-03,Roberta Flack - Blue Lights In The Basement,12,11,17,5.0,17,Blue Lights In The Basement,26.0,21,0,-5,-1,0,stay,1978-01-07
8459,Roberta Flack,1978-06-10,Roberta Flack - Blue Lights In The Basement,17,12,22,5.0,17,Blue Lights In The Basement,26.0,22,-5,0,-5,1,down,1978-01-07
8460,Roberta Flack,1978-06-17,Roberta Flack - Blue Lights In The Basement,17,17,41,5.0,22,Blue Lights In The Basement,26.0,23,-19,-5,0,1,down,1978-01-07
8461,Roberta Flack,1978-06-24,Roberta Flack - Blue Lights In The Basement,22,17,41,5.0,41,Blue Lights In The Basement,26.0,24,0,-19,-5,0,stay,1978-01-07
8462,Roberta Flack,1978-07-01,Roberta Flack - Blue Lights In The Basement,41,22,47,5.0,41,Blue Lights In The Basement,26.0,25,-6,0,-19,1,down,1978-01-07
8463,Roberta Flack,1978-07-08,Roberta Flack - Blue Lights In The Basement,41,41,51,5.0,47,Blue Lights In The Basement,26.0,26,-4,-6,0,1,down,1978-01-07
8464,Stevie Wonder,1978-01-07,Stevie Wonder - Looking Back,51,51,27,15.0,35,Looking Back,7.0,0,8,16,0,1,up,1978-01-07
8465,Stevie Wonder,1978-01-14,Stevie Wonder - Looking Back,35,51,21,15.0,27,Looking Back,7.0,1,6,8,16,1,up,1978-01-07
8466,Stevie Wonder,1978-01-21,Stevie Wonder - Looking Back,27,35,15,15.0,21,Looking Back,7.0,2,6,6,8,1,up,1978-01-07
8467,Stevie Wonder,1978-01-28,Stevie Wonder - Looking Back,21,27,15,15.0,15,Looking Back,7.0,3,0,6,6,0,stay,1978-01-07
8468,Stevie Wonder,1978-02-04,Stevie Wonder - Looking Back,15,21,32,15.0,15,Looking Back,7.0,4,-17,0,6,1,down,1978-01-07
8469,Stevie Wonder,1978-02-11,Stevie Wonder - Looking Back,15,15,38,15.0,32,Looking Back,7.0,5,-6,-17,0,1,down,1978-01-07
8470,Stevie Wonder,1978-02-18,Stevie Wonder - Looking Back,32,15,42,15.0,38,Looking Back,7.0,6,-4,-6,-17,1,down,1978-01-07
8471,Stevie Wonder,1978-02-25,Stevie Wonder - Looking Back,38,32,51,15.0,42,Looking Back,7.0,7,-9,-4,-6,1,down,1978-01-07
8472,Soundtrack,1978-01-07,Soundtrack - Saturday Night Fever,51,51,19,1.0,42,Saturday Night Fever,37.0,0,23,9,0,1,up,1978-01-07
8473,Soundtrack,1978-01-14,Soundtrack - Saturday Night Fever,42,51,15,1.0,19,Saturday Night Fever,37.0,1,4,23,9,1,up,1978-01-07
8474,Soundtrack,1978-01-21,Soundtrack - Saturday Night Fever,19,42,7,1.0,15,Saturday Night Fever,37.0,2,8,4,23,1,up,1978-01-07
8475,Soundtrack,1978-01-28,Soundtrack - Saturday Night Fever,15,19,4,1.0,7,Saturday Night Fever,37.0,3,3,8,4,1,up,1978-01-07
8476,Soundtrack,1978-02-04,Soundtrack - Saturday Night Fever,7,15,3,1.0,4,Saturday Night Fever,37.0,4,1,3,8,1,up,1978-01-07
8477,Soundtrack,1978-02-11,Soundtrack - Saturday Night Fever,4,7,1,1.0,3,Saturday Night Fever,37.0,5,2,1,3,1,up,1978-01-07
8478,Soundtrack,1978-02-18,Soundtrack - Saturday Night Fever,3,4,1,1.0,1,Saturday Night Fever,37.0,6,0,2,1,0,stay,1978-01-07
8479,Soundtrack,1978-02-25,Soundtrack - Saturday Night Fever,1,3,1,1.0,1,Saturday Night Fever,37.0,7,0,0,2,0,stay,1978-01-07
8480,Soundtrack,1978-03-04,Soundtrack - Saturday Night Fever,1,1,1,1.0,1,Saturday Night Fever,37.0,8,0,0,0,0,stay,1978-01-07
8481,Soundtrack,1978-03-11,Soundtrack - Saturday Night Fever,1,1,1,1.0,1,Saturday Night Fever,37.0,9,0,0,0,0,stay,1978-01-07
8482,Soundtrack,1978-03-18,Soundtrack - Saturday Night Fever,1,1,2,1.0,1,Saturday Night Fever,37.0,10,-1,0,0,1,down,1978-01-07
8483,Soundtrack,1978-03-25,Soundtrack - Saturday Night Fever,1,1,2,1.0,2,Saturday Night Fever,37.0,11,0,-1,0,0,stay,1978-01-07
8484,Soundtrack,1978-04-01,Soundtrack - Saturday Night Fever,2,1,2,1.0,2,Saturday Night Fever,37.0,12,0,0,-1,0,stay,1978-01-07
8485,Soundtrack,1978-04-08,Soundtrack - Saturday Night Fever,2,2,2,1.0,2,Saturday Night Fever,37.0,13,0,0,0,0,stay,1978-01-07
8486,Soundtrack,1978-04-15,Soundtrack - Saturday Night Fever,2,2,1,1.0,2,Saturday Night Fever,37.0,14,1,0,0,1,up,1978-01-07
8487,Soundtrack,1978-04-22,Soundtrack - Saturday Night Fever,2,2,2,1.0,1,Saturday Night Fever,37.0,15,-1,1,0,1,down,1978-01-07
8488,Soundtrack,1978-04-29,Soundtrack - Saturday Night Fever,1,2,7,1.0,2,Saturday Night Fever,37.0,16,-5,-1,1,1,down,1978-01-07
8489,Soundtrack,1978-05-06,Soundtrack - Saturday Night Fever,2,1,7,1.0,7,Saturday Night Fever,37.0,17,0,-5,-1,0,stay,1978-01-07
8490,Soundtrack,1978-05-13,Soundtrack - Saturday Night Fever,7,2,7,1.0,7,Saturday Night Fever,37.0,18,0,0,-5,0,stay,1978-01-07
8491,Soundtrack,1978-05-20,Soundtrack - Saturday Night Fever,7,7,7,1.0,7,Saturday Night Fever,37.0,19,0,0,0,0,stay,1978-01-07
8492,Soundtrack,1978-05-27,Soundtrack - Saturday Night Fever,7,7,6,1.0,7,Saturday Night Fever,37.0,20,1,0,0,1,up,1978-01-07
8493,Soundtrack,1978-06-03,Soundtrack - Saturday Night Fever,7,7,8,1.0,6,Saturday Night Fever,37.0,21,-2,1,0,1,down,1978-01-07
8494,Soundtrack,1978-06-10,Soundtrack - Saturday Night Fever,6,7,8,1.0,8,Saturday Night Fever,37.0,22,0,-2,1,0,stay,1978-01-07
8495,Soundtrack,1978-06-17,Soundtrack - Saturday Night Fever,8,6,9,1.0,8,Saturday Night Fever,37.0,23,-1,0,-2,1,down,1978-01-07
8496,Soundtrack,1978-06-24,Soundtrack - Saturday Night Fever,8,8,10,1.0,9,Saturday Night Fever,37.0,24,-1,-1,0,1,down,1978-01-07
8497,Soundtrack,1978-07-01,Soundtrack - Saturday Night Fever,9,8,13,1.0,10,Saturday Night Fever,37.0,25,-3,-1,-1,1,down,1978-01-07
8498,Soundtrack,1978-07-08,Soundtrack - Saturday Night Fever,10,9,14,1.0,13,Saturday Night Fever,37.0,26,-1,-3,-1,1,down,1978-01-07
8499,Soundtrack,1978-07-15,Soundtrack - Saturday Night Fever,13,10,15,1.0,14,Saturday Night Fever,37.0,27,-1,-1,-3,1,down,1978-01-07
8500,Soundtrack,1978-07-22,Soundtrack - Saturday Night Fever,14,13,17,1.0,15,Saturday Night Fever,37.0,28,-2,-1,-1,1,down,1978-01-07
8501,Soundtrack,1978-07-29,Soundtrack - Saturday Night Fever,15,14,21,1.0,17,Saturday Night Fever,37.0,29,-4,-2,-1,1,down,1978-01-07
8502,Soundtrack,1978-08-05,Soundtrack - Saturday Night Fever,17,15,22,1.0,21,Saturday Night Fever,37.0,30,-1,-4,-2,1,down,1978-01-07
8503,Soundtrack,1978-08-12,Soundtrack - Saturday Night Fever,21,17,24,1.0,22,Saturday Night Fever,37.0,31,-2,-1,-4,1,down,1978-01-07
8504,Soundtrack,1978-08-19,Soundtrack - Saturday Night Fever,22,21,28,1.0,24,Saturday Night Fever,37.0,32,-4,-2,-1,1,down,1978-01-07
8505,Soundtrack,1978-08-26,Soundtrack - Saturday Night Fever,24,22,28,1.0,28,Saturday Night Fever,37.0,33,0,-4,-2,0,stay,1978-01-07
8506,Soundtrack,1978-09-02,Soundtrack - Saturday Night Fever,28,24,39,1.0,28,Saturday Night Fever,37.0,34,-11,0,-4,1,down,1978-01-07
8507,Soundtrack,1978-09-09,Soundtrack - Saturday Night Fever,28,28,44,1.0,39,Saturday Night Fever,37.0,35,-5,-11,0,1,down,1978-01-07
8508,Soundtrack,1978-09-16,Soundtrack - Saturday Night Fever,39,28,50,1.0,44,Saturday Night Fever,37.0,36,-6,-5,-11,1,down,1978-01-07
8509,Soundtrack,1978-09-23,Soundtrack - Saturday Night Fever,44,39,51,1.0,50,Saturday Night Fever,37.0,37,-1,-6,-5,1,down,1978-01-07
8510,Chic,1978-01-07,Chic - Chic,51,51,38,12.0,45,Chic,28.0,0,7,6,0,1,up,1978-01-07
8511,Chic,1978-01-14,Chic - Chic,45,51,30,12.0,38,Chic,28.0,1,8,7,6,1,up,1978-01-07
8512,Chic,1978-01-21,Chic - Chic,38,45,19,12.0,30,Chic,28.0,2,11,8,7,1,up,1978-01-07
8513,Chic,1978-01-28,Chic - Chic,30,38,14,12.0,19,Chic,28.0,3,5,11,8,1,up,1978-01-07
8514,Chic,1978-02-04,Chic - Chic,19,30,12,12.0,14,Chic,28.0,4,2,5,11,1,up,1978-01-07
8515,Chic,1978-02-11,Chic - Chic,14,19,12,12.0,12,Chic,28.0,5,0,2,5,0,stay,1978-01-07
8516,Chic,1978-02-18,Chic - Chic,12,14,19,12.0,12,Chic,28.0,6,-7,0,2,1,down,1978-01-07
8517,Chic,1978-02-25,Chic - Chic,12,12,19,12.0,19,Chic,28.0,7,0,-7,0,0,stay,1978-01-07
8518,Chic,1978-03-04,Chic - Chic,19,12,16,12.0,19,Chic,28.0,8,3,0,-7,1,up,1978-01-07
8519,Chic,1978-03-11,Chic - Chic,19,19,17,12.0,16,Chic,28.0,9,-1,3,0,1,down,1978-01-07
8520,Chic,1978-03-18,Chic - Chic,16,19,17,12.0,17,Chic,28.0,10,0,-1,3,0,stay,1978-01-07
8521,Chic,1978-03-25,Chic - Chic,17,16,24,12.0,17,Chic,28.0,11,-7,0,-1,1,down,1978-01-07
8522,Chic,1978-04-01,Chic - Chic,17,17,24,12.0,24,Chic,28.0,12,0,-7,0,0,stay,1978-01-07
8523,Chic,1978-04-08,Chic - Chic,24,17,25,12.0,24,Chic,28.0,13,-1,0,-7,1,down,1978-01-07
8524,Chic,1978-04-15,Chic - Chic,24,24,23,12.0,25,Chic,28.0,14,2,-1,0,1,up,1978-01-07
8525,Chic,1978-04-22,Chic - Chic,25,24,38,12.0,23,Chic,28.0,15,-15,2,-1,1,down,1978-01-07
8526,Chic,1978-04-29,Chic - Chic,23,25,38,12.0,38,Chic,28.0,16,0,-15,2,0,stay,1978-01-07
8527,Chic,1978-05-06,Chic - Chic,38,23,43,12.0,38,Chic,28.0,17,-5,0,-15,1,down,1978-01-07
8528,Chic,1978-05-13,Chic - Chic,38,38,43,12.0,43,Chic,28.0,18,0,-5,0,0,stay,1978-01-07
8529,Chic,1978-05-20,Chic - Chic,43,38,37,12.0,43,Chic,28.0,19,6,0,-5,1,up,1978-01-07
8530,Chic,1978-05-27,Chic - Chic,43,43,33,12.0,37,Chic,28.0,20,4,6,0,1,up,1978-01-07
8531,Chic,1978-06-03,Chic - Chic,37,43,33,12.0,33,Chic,28.0,21,0,4,6,0,stay,1978-01-07
8532,Chic,1978-06-10,Chic - Chic,33,37,32,12.0,33,Chic,28.0,22,1,0,4,1,up,1978-01-07
8533,Chic,1978-06-17,Chic - Chic,33,33,42,12.0,32,Chic,28.0,23,-10,1,0,1,down,1978-01-07
8534,Chic,1978-06-24,Chic - Chic,32,33,42,12.0,42,Chic,28.0,24,0,-10,1,0,stay,1978-01-07
8535,Chic,1978-07-01,Chic - Chic,42,32,43,12.0,42,Chic,28.0,25,-1,0,-10,1,down,1978-01-07
8536,Chic,1978-07-08,Chic - Chic,42,42,44,12.0,43,Chic,28.0,26,-1,-1,0,1,down,1978-01-07
8537,Chic,1978-07-15,Chic - Chic,43,42,45,12.0,44,Chic,28.0,27,-1,-1,-1,1,down,1978-01-07
8538,Chic,1978-07-22,Chic - Chic,44,43,51,12.0,45,Chic,28.0,28,-6,-1,-1,1,down,1978-01-07
8539,Denise LaSalle,1978-01-07,Denise LaSalle - The Bitch Is Bad,51,51,49,47.0,49,The Bitch Is Bad,8.0,0,0,2,0,0,stay,1978-01-07
8540,Denise LaSalle,1978-01-14,Denise LaSalle - The Bitch Is Bad,49,51,49,47.0,49,The Bitch Is Bad,8.0,1,0,0,2,0,stay,1978-01-07
8541,Denise LaSalle,1978-01-21,Denise LaSalle - The Bitch Is Bad,49,49,48,47.0,49,The Bitch Is Bad,8.0,2,1,0,0,1,up,1978-01-07
8542,Denise LaSalle,1978-02-25,Denise LaSalle - The Bitch Is Bad,49,49,47,47.0,48,The Bitch Is Bad,8.0,3,1,1,0,1,up,1978-01-07
8543,Denise LaSalle,1978-03-04,Denise LaSalle - The Bitch Is Bad,48,49,48,47.0,47,The Bitch Is Bad,8.0,4,-1,1,1,1,down,1978-01-07
8544,Denise LaSalle,1978-03-11,Denise LaSalle - The Bitch Is Bad,47,48,48,47.0,48,The Bitch Is Bad,8.0,5,0,-1,1,0,stay,1978-01-07
8545,Denise LaSalle,1978-03-18,Denise LaSalle - The Bitch Is Bad,48,47,47,47.0,48,The Bitch Is Bad,8.0,6,1,0,-1,1,up,1978-01-07
8546,Denise LaSalle,1978-03-25,Denise LaSalle - The Bitch Is Bad,48,48,47,47.0,47,The Bitch Is Bad,8.0,7,0,1,0,0,stay,1978-01-07
8547,Denise LaSalle,1978-04-01,Denise LaSalle - The Bitch Is Bad,47,48,51,47.0,47,The Bitch Is Bad,8.0,8,-4,0,1,1,down,1978-01-07
8548,Billy Paul,1978-01-14,Billy Paul - Only The Strong Survive,51,51,36,36.0,36,Only The Strong Survive,1.0,0,0,15,0,0,stay,1978-01-14
8549,Billy Paul,1978-01-21,Billy Paul - Only The Strong Survive,36,51,51,36.0,36,Only The Strong Survive,1.0,1,-15,0,15,1,down,1978-01-14
8550,Most Requested Rythmn Band,1978-01-14,Most Requested Rythmn Band - Got To Give It Up,51,51,51,50.0,50,Got To Give It Up,0.0,0,-1,1,0,1,down,1978-01-14
8551,Kool & The Gang,1978-01-21,Kool & The Gang - The Force,51,51,33,33.0,43,The Force,5.0,0,10,8,0,1,up,1978-01-21
8552,Kool & The Gang,1978-01-28,Kool & The Gang - The Force,43,51,33,33.0,33,The Force,5.0,1,0,10,8,0,stay,1978-01-21
8553,Kool & The Gang,1978-02-04,Kool & The Gang - The Force,33,43,44,33.0,33,The Force,5.0,2,-11,0,10,1,down,1978-01-21
8554,Kool & The Gang,1978-02-11,Kool & The Gang - The Force,33,33,44,33.0,44,The Force,5.0,3,0,-11,0,0,stay,1978-01-21
8555,Kool & The Gang,1978-02-18,Kool & The Gang - The Force,44,33,40,33.0,44,The Force,5.0,4,4,0,-11,1,up,1978-01-21
8556,Kool & The Gang,1978-02-25,Kool & The Gang - The Force,44,44,51,33.0,40,The Force,5.0,5,-11,4,0,1,down,1978-01-21
8557,Meco,1978-01-21,Meco - Encounters Of Everykind,51,51,35,35.0,45,Encounters Of Everykind,3.0,0,10,6,0,1,up,1978-01-21
8558,Meco,1978-01-28,Meco - Encounters Of Everykind,45,51,35,35.0,35,Encounters Of Everykind,3.0,1,0,10,6,0,stay,1978-01-21
8559,Meco,1978-02-04,Meco - Encounters Of Everykind,35,45,41,35.0,35,Encounters Of Everykind,3.0,2,-6,0,10,1,down,1978-01-21
8560,Meco,1978-02-11,Meco - Encounters Of Everykind,35,35,51,35.0,41,Encounters Of Everykind,3.0,3,-10,-6,0,1,down,1978-01-21
8561,"Grover Washington, Jr.",1978-01-21,"Grover Washington, Jr. - Live At The Bijou",51,51,37,4.0,47,Live At The Bijou,23.0,0,10,4,0,1,up,1978-01-21
8562,"Grover Washington, Jr.",1978-01-28,"Grover Washington, Jr. - Live At The Bijou",47,51,22,4.0,37,Live At The Bijou,23.0,1,15,10,4,1,up,1978-01-21
8563,"Grover Washington, Jr.",1978-02-04,"Grover Washington, Jr. - Live At The Bijou",37,47,4,4.0,22,Live At The Bijou,23.0,2,18,15,10,1,up,1978-01-21
8564,"Grover Washington, Jr.",1978-02-11,"Grover Washington, Jr. - Live At The Bijou",22,37,4,4.0,4,Live At The Bijou,23.0,3,0,18,15,0,stay,1978-01-21
8565,"Grover Washington, Jr.",1978-02-18,"Grover Washington, Jr. - Live At The Bijou",4,22,4,4.0,4,Live At The Bijou,23.0,4,0,0,18,0,stay,1978-01-21
8566,"Grover Washington, Jr.",1978-02-25,"Grover Washington, Jr. - Live At The Bijou",4,4,10,4.0,4,Live At The Bijou,23.0,5,-6,0,0,1,down,1978-01-21
8567,"Grover Washington, Jr.",1978-03-04,"Grover Washington, Jr. - Live At The Bijou",4,4,10,4.0,10,Live At The Bijou,23.0,6,0,-6,0,0,stay,1978-01-21
8568,"Grover Washington, Jr.",1978-03-11,"Grover Washington, Jr. - Live At The Bijou",10,4,10,4.0,10,Live At The Bijou,23.0,7,0,0,-6,0,stay,1978-01-21
8569,"Grover Washington, Jr.",1978-03-18,"Grover Washington, Jr. - Live At The Bijou",10,10,10,4.0,10,Live At The Bijou,23.0,8,0,0,0,0,stay,1978-01-21
8570,"Grover Washington, Jr.",1978-03-25,"Grover Washington, Jr. - Live At The Bijou",10,10,10,4.0,10,Live At The Bijou,23.0,9,0,0,0,0,stay,1978-01-21
8571,"Grover Washington, Jr.",1978-04-01,"Grover Washington, Jr. - Live At The Bijou",10,10,11,4.0,10,Live At The Bijou,23.0,10,-1,0,0,1,down,1978-01-21
8572,"Grover Washington, Jr.",1978-04-08,"Grover Washington, Jr. - Live At The Bijou",10,10,10,4.0,11,Live At The Bijou,23.0,11,1,-1,0,1,up,1978-01-21
8573,"Grover Washington, Jr.",1978-04-15,"Grover Washington, Jr. - Live At The Bijou",11,10,18,4.0,10,Live At The Bijou,23.0,12,-8,1,-1,1,down,1978-01-21
8574,"Grover Washington, Jr.",1978-04-22,"Grover Washington, Jr. - Live At The Bijou",10,11,18,4.0,18,Live At The Bijou,23.0,13,0,-8,1,0,stay,1978-01-21
8575,"Grover Washington, Jr.",1978-04-29,"Grover Washington, Jr. - Live At The Bijou",18,10,21,4.0,18,Live At The Bijou,23.0,14,-3,0,-8,1,down,1978-01-21
8576,"Grover Washington, Jr.",1978-05-06,"Grover Washington, Jr. - Live At The Bijou",18,18,21,4.0,21,Live At The Bijou,23.0,15,0,-3,0,0,stay,1978-01-21
8577,"Grover Washington, Jr.",1978-05-13,"Grover Washington, Jr. - Live At The Bijou",21,18,22,4.0,21,Live At The Bijou,23.0,16,-1,0,-3,1,down,1978-01-21
8578,"Grover Washington, Jr.",1978-05-20,"Grover Washington, Jr. - Live At The Bijou",21,21,22,4.0,22,Live At The Bijou,23.0,17,0,-1,0,0,stay,1978-01-21
8579,"Grover Washington, Jr.",1978-05-27,"Grover Washington, Jr. - Live At The Bijou",22,21,23,4.0,22,Live At The Bijou,23.0,18,-1,0,-1,1,down,1978-01-21
8580,"Grover Washington, Jr.",1978-06-03,"Grover Washington, Jr. - Live At The Bijou",22,22,29,4.0,23,Live At The Bijou,23.0,19,-6,-1,0,1,down,1978-01-21
8581,"Grover Washington, Jr.",1978-06-10,"Grover Washington, Jr. - Live At The Bijou",23,22,36,4.0,29,Live At The Bijou,23.0,20,-7,-6,-1,1,down,1978-01-21
8582,"Grover Washington, Jr.",1978-06-17,"Grover Washington, Jr. - Live At The Bijou",29,23,44,4.0,36,Live At The Bijou,23.0,21,-8,-7,-6,1,down,1978-01-21
8583,"Grover Washington, Jr.",1978-06-24,"Grover Washington, Jr. - Live At The Bijou",36,29,45,4.0,44,Live At The Bijou,23.0,22,-1,-8,-7,1,down,1978-01-21
8584,"Grover Washington, Jr.",1978-07-01,"Grover Washington, Jr. - Live At The Bijou",44,36,51,4.0,45,Live At The Bijou,23.0,23,-6,-1,-8,1,down,1978-01-21
8585,The Dells,1978-01-21,The Dells - Love Connection,51,51,45,45.0,48,Love Connection,3.0,0,3,3,0,1,up,1978-01-21
8586,The Dells,1978-01-28,The Dells - Love Connection,48,51,45,45.0,45,Love Connection,3.0,1,0,3,3,0,stay,1978-01-21
8587,The Dells,1978-02-04,The Dells - Love Connection,45,48,48,45.0,45,Love Connection,3.0,2,-3,0,3,1,down,1978-01-21
8588,The Dells,1978-02-11,The Dells - Love Connection,45,45,51,45.0,48,Love Connection,3.0,3,-3,-3,0,1,down,1978-01-21
8589,Enchantment,1978-01-28,Enchantment - Once Upon A Dream,51,51,25,8.0,38,Once Upon A Dream,18.0,0,13,13,0,1,up,1978-01-28
8590,Enchantment,1978-02-04,Enchantment - Once Upon A Dream,38,51,17,8.0,25,Once Upon A Dream,18.0,1,8,13,13,1,up,1978-01-28
8591,Enchantment,1978-02-11,Enchantment - Once Upon A Dream,25,38,13,8.0,17,Once Upon A Dream,18.0,2,4,8,13,1,up,1978-01-28
8592,Enchantment,1978-02-18,Enchantment - Once Upon A Dream,17,25,9,8.0,13,Once Upon A Dream,18.0,3,4,4,8,1,up,1978-01-28
8593,Enchantment,1978-02-25,Enchantment - Once Upon A Dream,13,17,8,8.0,9,Once Upon A Dream,18.0,4,1,4,4,1,up,1978-01-28
8594,Enchantment,1978-03-04,Enchantment - Once Upon A Dream,9,13,8,8.0,8,Once Upon A Dream,18.0,5,0,1,4,0,stay,1978-01-28
8595,Enchantment,1978-03-11,Enchantment - Once Upon A Dream,8,9,11,8.0,8,Once Upon A Dream,18.0,6,-3,0,1,1,down,1978-01-28
8596,Enchantment,1978-03-18,Enchantment - Once Upon A Dream,8,8,11,8.0,11,Once Upon A Dream,18.0,7,0,-3,0,0,stay,1978-01-28
8597,Enchantment,1978-03-25,Enchantment - Once Upon A Dream,11,8,14,8.0,11,Once Upon A Dream,18.0,8,-3,0,-3,1,down,1978-01-28
8598,Enchantment,1978-04-01,Enchantment - Once Upon A Dream,11,11,13,8.0,14,Once Upon A Dream,18.0,9,1,-3,0,1,up,1978-01-28
8599,Enchantment,1978-04-08,Enchantment - Once Upon A Dream,14,11,11,8.0,13,Once Upon A Dream,18.0,10,2,1,-3,1,up,1978-01-28
8600,Enchantment,1978-04-15,Enchantment - Once Upon A Dream,13,14,11,8.0,11,Once Upon A Dream,18.0,11,0,2,1,0,stay,1978-01-28
8601,Enchantment,1978-04-22,Enchantment - Once Upon A Dream,11,13,13,8.0,11,Once Upon A Dream,18.0,12,-2,0,2,1,down,1978-01-28
8602,Enchantment,1978-04-29,Enchantment - Once Upon A Dream,11,11,19,8.0,13,Once Upon A Dream,18.0,13,-6,-2,0,1,down,1978-01-28
8603,Enchantment,1978-05-06,Enchantment - Once Upon A Dream,13,11,19,8.0,19,Once Upon A Dream,18.0,14,0,-6,-2,0,stay,1978-01-28
8604,Enchantment,1978-05-13,Enchantment - Once Upon A Dream,19,13,25,8.0,19,Once Upon A Dream,18.0,15,-6,0,-6,1,down,1978-01-28
8605,Enchantment,1978-05-20,Enchantment - Once Upon A Dream,19,19,26,8.0,25,Once Upon A Dream,18.0,16,-1,-6,0,1,down,1978-01-28
8606,Enchantment,1978-05-27,Enchantment - Once Upon A Dream,25,19,42,8.0,26,Once Upon A Dream,18.0,17,-16,-1,-6,1,down,1978-01-28
8607,Enchantment,1978-06-03,Enchantment - Once Upon A Dream,26,25,51,8.0,42,Once Upon A Dream,18.0,18,-9,-16,-1,1,down,1978-01-28
8608,Peter Brown,1978-01-28,Peter Brown - Fantasy Love Affair,51,51,32,9.0,40,Fantasy Love Affair,36.0,0,8,11,0,1,up,1978-01-28
8609,Peter Brown,1978-02-04,Peter Brown - Fantasy Love Affair,40,51,26,9.0,32,Fantasy Love Affair,36.0,1,6,8,11,1,up,1978-01-28
8610,Peter Brown,1978-02-11,Peter Brown - Fantasy Love Affair,32,40,20,9.0,26,Fantasy Love Affair,36.0,2,6,6,8,1,up,1978-01-28
8611,Peter Brown,1978-02-18,Peter Brown - Fantasy Love Affair,26,32,20,9.0,20,Fantasy Love Affair,36.0,3,0,6,6,0,stay,1978-01-28
8612,Peter Brown,1978-02-25,Peter Brown - Fantasy Love Affair,20,26,22,9.0,20,Fantasy Love Affair,36.0,4,-2,0,6,1,down,1978-01-28
8613,Peter Brown,1978-03-04,Peter Brown - Fantasy Love Affair,20,20,22,9.0,22,Fantasy Love Affair,36.0,5,0,-2,0,0,stay,1978-01-28
8614,Peter Brown,1978-03-11,Peter Brown - Fantasy Love Affair,22,20,16,9.0,22,Fantasy Love Affair,36.0,6,6,0,-2,1,up,1978-01-28
8615,Peter Brown,1978-03-18,Peter Brown - Fantasy Love Affair,22,22,13,9.0,16,Fantasy Love Affair,36.0,7,3,6,0,1,up,1978-01-28
8616,Peter Brown,1978-03-25,Peter Brown - Fantasy Love Affair,16,22,13,9.0,13,Fantasy Love Affair,36.0,8,0,3,6,0,stay,1978-01-28
8617,Peter Brown,1978-04-01,Peter Brown - Fantasy Love Affair,13,16,12,9.0,13,Fantasy Love Affair,36.0,9,1,0,3,1,up,1978-01-28
8618,Peter Brown,1978-04-08,Peter Brown - Fantasy Love Affair,13,13,12,9.0,12,Fantasy Love Affair,36.0,10,0,1,0,0,stay,1978-01-28
8619,Peter Brown,1978-04-15,Peter Brown - Fantasy Love Affair,12,13,10,9.0,12,Fantasy Love Affair,36.0,11,2,0,1,1,up,1978-01-28
8620,Peter Brown,1978-04-22,Peter Brown - Fantasy Love Affair,12,12,10,9.0,10,Fantasy Love Affair,36.0,12,0,2,0,0,stay,1978-01-28
8621,Peter Brown,1978-04-29,Peter Brown - Fantasy Love Affair,10,12,13,9.0,10,Fantasy Love Affair,36.0,13,-3,0,2,1,down,1978-01-28
8622,Peter Brown,1978-05-06,Peter Brown - Fantasy Love Affair,10,10,13,9.0,13,Fantasy Love Affair,36.0,14,0,-3,0,0,stay,1978-01-28
8623,Peter Brown,1978-05-13,Peter Brown - Fantasy Love Affair,13,10,12,9.0,13,Fantasy Love Affair,36.0,15,1,0,-3,1,up,1978-01-28
8624,Peter Brown,1978-05-20,Peter Brown - Fantasy Love Affair,13,13,9,9.0,12,Fantasy Love Affair,36.0,16,3,1,0,1,up,1978-01-28
8625,Peter Brown,1978-05-27,Peter Brown - Fantasy Love Affair,12,13,15,9.0,9,Fantasy Love Affair,36.0,17,-6,3,1,1,down,1978-01-28
8626,Peter Brown,1978-06-03,Peter Brown - Fantasy Love Affair,9,12,18,9.0,15,Fantasy Love Affair,36.0,18,-3,-6,3,1,down,1978-01-28
8627,Peter Brown,1978-06-10,Peter Brown - Fantasy Love Affair,15,9,16,9.0,18,Fantasy Love Affair,36.0,19,2,-3,-6,1,up,1978-01-28
8628,Peter Brown,1978-06-17,Peter Brown - Fantasy Love Affair,18,15,14,9.0,16,Fantasy Love Affair,36.0,20,2,2,-3,1,up,1978-01-28
8629,Peter Brown,1978-06-24,Peter Brown - Fantasy Love Affair,16,18,16,9.0,14,Fantasy Love Affair,36.0,21,-2,2,2,1,down,1978-01-28
8630,Peter Brown,1978-07-01,Peter Brown - Fantasy Love Affair,14,16,23,9.0,16,Fantasy Love Affair,36.0,22,-7,-2,2,1,down,1978-01-28
8631,Peter Brown,1978-07-08,Peter Brown - Fantasy Love Affair,16,14,23,9.0,23,Fantasy Love Affair,36.0,23,0,-7,-2,0,stay,1978-01-28
8632,Peter Brown,1978-07-15,Peter Brown - Fantasy Love Affair,23,16,21,9.0,23,Fantasy Love Affair,36.0,24,2,0,-7,1,up,1978-01-28
8633,Peter Brown,1978-07-22,Peter Brown - Fantasy Love Affair,23,23,20,9.0,21,Fantasy Love Affair,36.0,25,1,2,0,1,up,1978-01-28
8634,Peter Brown,1978-07-29,Peter Brown - Fantasy Love Affair,21,23,20,9.0,20,Fantasy Love Affair,36.0,26,0,1,2,0,stay,1978-01-28
8635,Peter Brown,1978-08-05,Peter Brown - Fantasy Love Affair,20,21,25,9.0,20,Fantasy Love Affair,36.0,27,-5,0,1,1,down,1978-01-28
8636,Peter Brown,1978-08-12,Peter Brown - Fantasy Love Affair,20,20,22,9.0,25,Fantasy Love Affair,36.0,28,3,-5,0,1,up,1978-01-28
8637,Peter Brown,1978-08-19,Peter Brown - Fantasy Love Affair,25,20,26,9.0,22,Fantasy Love Affair,36.0,29,-4,3,-5,1,down,1978-01-28
8638,Peter Brown,1978-08-26,Peter Brown - Fantasy Love Affair,22,25,30,9.0,26,Fantasy Love Affair,36.0,30,-4,-4,3,1,down,1978-01-28
8639,Peter Brown,1978-09-02,Peter Brown - Fantasy Love Affair,26,22,31,9.0,30,Fantasy Love Affair,36.0,31,-1,-4,-4,1,down,1978-01-28
8640,Peter Brown,1978-09-09,Peter Brown - Fantasy Love Affair,30,26,43,9.0,31,Fantasy Love Affair,36.0,32,-12,-1,-4,1,down,1978-01-28
8641,Peter Brown,1978-09-16,Peter Brown - Fantasy Love Affair,31,30,43,9.0,43,Fantasy Love Affair,36.0,33,0,-12,-1,0,stay,1978-01-28
8642,Peter Brown,1978-09-23,Peter Brown - Fantasy Love Affair,43,31,46,9.0,43,Fantasy Love Affair,36.0,34,-3,0,-12,1,down,1978-01-28
8643,Peter Brown,1978-09-30,Peter Brown - Fantasy Love Affair,43,43,47,9.0,46,Fantasy Love Affair,36.0,35,-1,-3,0,1,down,1978-01-28
8644,Peter Brown,1978-10-07,Peter Brown - Fantasy Love Affair,46,43,51,9.0,47,Fantasy Love Affair,36.0,36,-4,-1,-3,1,down,1978-01-28
8645,T-Connection,1978-02-04,T-Connection - On Fire,51,51,40,40.0,50,On Fire,3.0,0,10,1,0,1,up,1978-02-04
8646,T-Connection,1978-02-11,T-Connection - On Fire,50,51,40,40.0,40,On Fire,3.0,1,0,10,1,0,stay,1978-02-04
8647,T-Connection,1978-02-18,T-Connection - On Fire,40,50,44,40.0,40,On Fire,3.0,2,-4,0,10,1,down,1978-02-04
8648,T-Connection,1978-02-25,T-Connection - On Fire,40,40,51,40.0,44,On Fire,3.0,3,-7,-4,0,1,down,1978-02-04
8649,Maze Featuring Frankie Beverly,1978-02-11,Maze Featuring Frankie Beverly - Golden Time Of Day,51,51,16,9.0,22,Golden Time Of Day,22.0,0,6,29,0,1,up,1978-02-11
8650,Maze Featuring Frankie Beverly,1978-02-18,Maze Featuring Frankie Beverly - Golden Time Of Day,22,51,10,9.0,16,Golden Time Of Day,22.0,1,6,6,29,1,up,1978-02-11
8651,Maze Featuring Frankie Beverly,1978-02-25,Maze Featuring Frankie Beverly - Golden Time Of Day,16,22,9,9.0,10,Golden Time Of Day,22.0,2,1,6,6,1,up,1978-02-11
8652,Maze Featuring Frankie Beverly,1978-03-04,Maze Featuring Frankie Beverly - Golden Time Of Day,10,16,9,9.0,9,Golden Time Of Day,22.0,3,0,1,6,0,stay,1978-02-11
8653,Maze Featuring Frankie Beverly,1978-03-11,Maze Featuring Frankie Beverly - Golden Time Of Day,9,10,9,9.0,9,Golden Time Of Day,22.0,4,0,0,1,0,stay,1978-02-11
8654,Maze Featuring Frankie Beverly,1978-03-18,Maze Featuring Frankie Beverly - Golden Time Of Day,9,9,9,9.0,9,Golden Time Of Day,22.0,5,0,0,0,0,stay,1978-02-11
8655,Maze Featuring Frankie Beverly,1978-03-25,Maze Featuring Frankie Beverly - Golden Time Of Day,9,9,9,9.0,9,Golden Time Of Day,22.0,6,0,0,0,0,stay,1978-02-11
8656,Maze Featuring Frankie Beverly,1978-04-01,Maze Featuring Frankie Beverly - Golden Time Of Day,9,9,9,9.0,9,Golden Time Of Day,22.0,7,0,0,0,0,stay,1978-02-11
8657,Maze Featuring Frankie Beverly,1978-04-08,Maze Featuring Frankie Beverly - Golden Time Of Day,9,9,13,9.0,9,Golden Time Of Day,22.0,8,-4,0,0,1,down,1978-02-11
8658,Maze Featuring Frankie Beverly,1978-04-15,Maze Featuring Frankie Beverly - Golden Time Of Day,9,9,13,9.0,13,Golden Time Of Day,22.0,9,0,-4,0,0,stay,1978-02-11
8659,Maze Featuring Frankie Beverly,1978-04-22,Maze Featuring Frankie Beverly - Golden Time Of Day,13,9,16,9.0,13,Golden Time Of Day,22.0,10,-3,0,-4,1,down,1978-02-11
8660,Maze Featuring Frankie Beverly,1978-04-29,Maze Featuring Frankie Beverly - Golden Time Of Day,13,13,22,9.0,16,Golden Time Of Day,22.0,11,-6,-3,0,1,down,1978-02-11
8661,Maze Featuring Frankie Beverly,1978-05-06,Maze Featuring Frankie Beverly - Golden Time Of Day,16,13,22,9.0,22,Golden Time Of Day,22.0,12,0,-6,-3,0,stay,1978-02-11
8662,Maze Featuring Frankie Beverly,1978-05-13,Maze Featuring Frankie Beverly - Golden Time Of Day,22,16,18,9.0,22,Golden Time Of Day,22.0,13,4,0,-6,1,up,1978-02-11
8663,Maze Featuring Frankie Beverly,1978-05-20,Maze Featuring Frankie Beverly - Golden Time Of Day,22,22,19,9.0,18,Golden Time Of Day,22.0,14,-1,4,0,1,down,1978-02-11
8664,Maze Featuring Frankie Beverly,1978-05-27,Maze Featuring Frankie Beverly - Golden Time Of Day,18,22,19,9.0,19,Golden Time Of Day,22.0,15,0,-1,4,0,stay,1978-02-11
8665,Maze Featuring Frankie Beverly,1978-06-03,Maze Featuring Frankie Beverly - Golden Time Of Day,19,18,21,9.0,19,Golden Time Of Day,22.0,16,-2,0,-1,1,down,1978-02-11
8666,Maze Featuring Frankie Beverly,1978-06-10,Maze Featuring Frankie Beverly - Golden Time Of Day,19,19,21,9.0,21,Golden Time Of Day,22.0,17,0,-2,0,0,stay,1978-02-11
8667,Maze Featuring Frankie Beverly,1978-06-17,Maze Featuring Frankie Beverly - Golden Time Of Day,21,19,27,9.0,21,Golden Time Of Day,22.0,18,-6,0,-2,1,down,1978-02-11
8668,Maze Featuring Frankie Beverly,1978-06-24,Maze Featuring Frankie Beverly - Golden Time Of Day,21,21,40,9.0,27,Golden Time Of Day,22.0,19,-13,-6,0,1,down,1978-02-11
8669,Maze Featuring Frankie Beverly,1978-07-01,Maze Featuring Frankie Beverly - Golden Time Of Day,27,21,41,9.0,40,Golden Time Of Day,22.0,20,-1,-13,-6,1,down,1978-02-11
8670,Maze Featuring Frankie Beverly,1978-07-08,Maze Featuring Frankie Beverly - Golden Time Of Day,40,27,46,9.0,41,Golden Time Of Day,22.0,21,-5,-1,-13,1,down,1978-02-11
8671,Maze Featuring Frankie Beverly,1978-07-15,Maze Featuring Frankie Beverly - Golden Time Of Day,41,40,51,9.0,46,Golden Time Of Day,22.0,22,-5,-5,-1,1,down,1978-02-11
8672,George Benson,1978-02-11,George Benson - Weekend In L.a.,51,51,15,1.0,30,Weekend In L.a.,28.0,0,15,21,0,1,up,1978-02-11
8673,George Benson,1978-02-18,George Benson - Weekend In L.a.,30,51,7,1.0,15,Weekend In L.a.,28.0,1,8,15,21,1,up,1978-02-11
8674,George Benson,1978-02-25,George Benson - Weekend In L.a.,15,30,4,1.0,7,Weekend In L.a.,28.0,2,3,8,15,1,up,1978-02-11
8675,George Benson,1978-03-04,George Benson - Weekend In L.a.,7,15,4,1.0,4,Weekend In L.a.,28.0,3,0,3,8,0,stay,1978-02-11
8676,George Benson,1978-03-11,George Benson - Weekend In L.a.,4,7,4,1.0,4,Weekend In L.a.,28.0,4,0,0,3,0,stay,1978-02-11
8677,George Benson,1978-03-18,George Benson - Weekend In L.a.,4,4,3,1.0,4,Weekend In L.a.,28.0,5,1,0,0,1,up,1978-02-11
8678,George Benson,1978-03-25,George Benson - Weekend In L.a.,4,4,3,1.0,3,Weekend In L.a.,28.0,6,0,1,0,0,stay,1978-02-11
8679,George Benson,1978-04-01,George Benson - Weekend In L.a.,3,4,6,1.0,3,Weekend In L.a.,28.0,7,-3,0,1,1,down,1978-02-11
8680,George Benson,1978-04-08,George Benson - Weekend In L.a.,3,3,4,1.0,6,Weekend In L.a.,28.0,8,2,-3,0,1,up,1978-02-11
8681,George Benson,1978-04-15,George Benson - Weekend In L.a.,6,3,2,1.0,4,Weekend In L.a.,28.0,9,2,2,-3,1,up,1978-02-11
8682,George Benson,1978-04-22,George Benson - Weekend In L.a.,4,6,1,1.0,2,Weekend In L.a.,28.0,10,1,2,2,1,up,1978-02-11
8683,George Benson,1978-04-29,George Benson - Weekend In L.a.,2,4,1,1.0,1,Weekend In L.a.,28.0,11,0,1,2,0,stay,1978-02-11
8684,George Benson,1978-05-06,George Benson - Weekend In L.a.,1,2,4,1.0,1,Weekend In L.a.,28.0,12,-3,0,1,1,down,1978-02-11
8685,George Benson,1978-05-13,George Benson - Weekend In L.a.,1,1,4,1.0,4,Weekend In L.a.,28.0,13,0,-3,0,0,stay,1978-02-11
8686,George Benson,1978-05-20,George Benson - Weekend In L.a.,4,1,4,1.0,4,Weekend In L.a.,28.0,14,0,0,-3,0,stay,1978-02-11
8687,George Benson,1978-05-27,George Benson - Weekend In L.a.,4,4,5,1.0,4,Weekend In L.a.,28.0,15,-1,0,0,1,down,1978-02-11
8688,George Benson,1978-06-03,George Benson - Weekend In L.a.,4,4,7,1.0,5,Weekend In L.a.,28.0,16,-2,-1,0,1,down,1978-02-11
8689,George Benson,1978-06-10,George Benson - Weekend In L.a.,5,4,10,1.0,7,Weekend In L.a.,28.0,17,-3,-2,-1,1,down,1978-02-11
8690,George Benson,1978-06-17,George Benson - Weekend In L.a.,7,5,10,1.0,10,Weekend In L.a.,28.0,18,0,-3,-2,0,stay,1978-02-11
8691,George Benson,1978-06-24,George Benson - Weekend In L.a.,10,7,15,1.0,10,Weekend In L.a.,28.0,19,-5,0,-3,1,down,1978-02-11
8692,George Benson,1978-07-01,George Benson - Weekend In L.a.,10,10,20,1.0,15,Weekend In L.a.,28.0,20,-5,-5,0,1,down,1978-02-11
8693,George Benson,1978-07-08,George Benson - Weekend In L.a.,15,10,20,1.0,20,Weekend In L.a.,28.0,21,0,-5,-5,0,stay,1978-02-11
8694,George Benson,1978-07-15,George Benson - Weekend In L.a.,20,15,28,1.0,20,Weekend In L.a.,28.0,22,-8,0,-5,1,down,1978-02-11
8695,George Benson,1978-07-22,George Benson - Weekend In L.a.,20,20,28,1.0,28,Weekend In L.a.,28.0,23,0,-8,0,0,stay,1978-02-11
8696,George Benson,1978-07-29,George Benson - Weekend In L.a.,28,20,29,1.0,28,Weekend In L.a.,28.0,24,-1,0,-8,1,down,1978-02-11
8697,George Benson,1978-08-05,George Benson - Weekend In L.a.,28,28,30,1.0,29,Weekend In L.a.,28.0,25,-1,-1,0,1,down,1978-02-11
8698,George Benson,1978-08-12,George Benson - Weekend In L.a.,29,28,35,1.0,30,Weekend In L.a.,28.0,26,-5,-1,-1,1,down,1978-02-11
8699,George Benson,1978-08-19,George Benson - Weekend In L.a.,30,29,44,1.0,35,Weekend In L.a.,28.0,27,-9,-5,-1,1,down,1978-02-11
8700,George Benson,1978-08-26,George Benson - Weekend In L.a.,35,30,51,1.0,44,Weekend In L.a.,28.0,28,-7,-9,-5,1,down,1978-02-11
8701,Player,1978-02-11,Player - Player,51,51,33,32.0,37,Player,6.0,0,4,14,0,1,up,1978-02-11
8702,Player,1978-02-18,Player - Player,37,51,32,32.0,33,Player,6.0,1,1,4,14,1,up,1978-02-11
8703,Player,1978-02-25,Player - Player,33,37,32,32.0,32,Player,6.0,2,0,1,4,0,stay,1978-02-11
8704,Player,1978-03-04,Player - Player,32,33,39,32.0,32,Player,6.0,3,-7,0,1,1,down,1978-02-11
8705,Player,1978-03-11,Player - Player,32,32,44,32.0,39,Player,6.0,4,-5,-7,0,1,down,1978-02-11
8706,Player,1978-03-18,Player - Player,39,32,44,32.0,44,Player,6.0,5,0,-5,-7,0,stay,1978-02-11
8707,Player,1978-03-25,Player - Player,44,39,51,32.0,44,Player,6.0,6,-7,0,-5,1,down,1978-02-11
8708,Cameo,1978-02-11,Cameo - We All Know Who We Are,51,51,41,15.0,49,We All Know Who We Are,20.0,0,8,2,0,1,up,1978-02-11
8709,Cameo,1978-02-18,Cameo - We All Know Who We Are,49,51,31,15.0,41,We All Know Who We Are,20.0,1,10,8,2,1,up,1978-02-11
8710,Cameo,1978-02-25,Cameo - We All Know Who We Are,41,49,21,15.0,31,We All Know Who We Are,20.0,2,10,10,8,1,up,1978-02-11
8711,Cameo,1978-03-04,Cameo - We All Know Who We Are,31,41,20,15.0,21,We All Know Who We Are,20.0,3,1,10,10,1,up,1978-02-11
8712,Cameo,1978-03-11,Cameo - We All Know Who We Are,21,31,18,15.0,20,We All Know Who We Are,20.0,4,2,1,10,1,up,1978-02-11
8713,Cameo,1978-03-18,Cameo - We All Know Who We Are,20,21,18,15.0,18,We All Know Who We Are,20.0,5,0,2,1,0,stay,1978-02-11
8714,Cameo,1978-03-25,Cameo - We All Know Who We Are,18,20,22,15.0,18,We All Know Who We Are,20.0,6,-4,0,2,1,down,1978-02-11
8715,Cameo,1978-04-01,Cameo - We All Know Who We Are,18,18,25,15.0,22,We All Know Who We Are,20.0,7,-3,-4,0,1,down,1978-02-11
8716,Cameo,1978-04-08,Cameo - We All Know Who We Are,22,18,20,15.0,25,We All Know Who We Are,20.0,8,5,-3,-4,1,up,1978-02-11
8717,Cameo,1978-04-15,Cameo - We All Know Who We Are,25,22,19,15.0,20,We All Know Who We Are,20.0,9,1,5,-3,1,up,1978-02-11
8718,Cameo,1978-04-22,Cameo - We All Know Who We Are,20,25,17,15.0,19,We All Know Who We Are,20.0,10,2,1,5,1,up,1978-02-11
8719,Cameo,1978-04-29,Cameo - We All Know Who We Are,19,20,17,15.0,17,We All Know Who We Are,20.0,11,0,2,1,0,stay,1978-02-11
8720,Cameo,1978-05-06,Cameo - We All Know Who We Are,17,19,15,15.0,17,We All Know Who We Are,20.0,12,2,0,2,1,up,1978-02-11
8721,Cameo,1978-05-13,Cameo - We All Know Who We Are,17,17,16,15.0,15,We All Know Who We Are,20.0,13,-1,2,0,1,down,1978-02-11
8722,Cameo,1978-05-20,Cameo - We All Know Who We Are,15,17,17,15.0,16,We All Know Who We Are,20.0,14,-1,-1,2,1,down,1978-02-11
8723,Cameo,1978-05-27,Cameo - We All Know Who We Are,16,15,20,15.0,17,We All Know Who We Are,20.0,15,-3,-1,-1,1,down,1978-02-11
8724,Cameo,1978-06-03,Cameo - We All Know Who We Are,17,16,20,15.0,20,We All Know Who We Are,20.0,16,0,-3,-1,0,stay,1978-02-11
8725,Cameo,1978-06-10,Cameo - We All Know Who We Are,20,17,30,15.0,20,We All Know Who We Are,20.0,17,-10,0,-3,1,down,1978-02-11
8726,Cameo,1978-06-17,Cameo - We All Know Who We Are,20,20,37,15.0,30,We All Know Who We Are,20.0,18,-7,-10,0,1,down,1978-02-11
8727,Cameo,1978-06-24,Cameo - We All Know Who We Are,30,20,37,15.0,37,We All Know Who We Are,20.0,19,0,-7,-10,0,stay,1978-02-11
8728,Cameo,1978-07-01,Cameo - We All Know Who We Are,37,30,51,15.0,37,We All Know Who We Are,20.0,20,-14,0,-7,1,down,1978-02-11
8729,Peabo Bryson,1978-02-11,Peabo Bryson - Reaching For The Sky,51,51,39,11.0,50,Reaching For The Sky,35.0,0,11,1,0,1,up,1978-02-11
8730,Peabo Bryson,1978-02-18,Peabo Bryson - Reaching For The Sky,50,51,33,11.0,39,Reaching For The Sky,35.0,1,6,11,1,1,up,1978-02-11
8731,Peabo Bryson,1978-02-25,Peabo Bryson - Reaching For The Sky,39,50,25,11.0,33,Reaching For The Sky,35.0,2,8,6,11,1,up,1978-02-11
8732,Peabo Bryson,1978-03-04,Peabo Bryson - Reaching For The Sky,33,39,24,11.0,25,Reaching For The Sky,35.0,3,1,8,6,1,up,1978-02-11
8733,Peabo Bryson,1978-03-11,Peabo Bryson - Reaching For The Sky,25,33,24,11.0,24,Reaching For The Sky,35.0,4,0,1,8,0,stay,1978-02-11
8734,Peabo Bryson,1978-03-18,Peabo Bryson - Reaching For The Sky,24,25,20,11.0,24,Reaching For The Sky,35.0,5,4,0,1,1,up,1978-02-11
8735,Peabo Bryson,1978-03-25,Peabo Bryson - Reaching For The Sky,24,24,19,11.0,20,Reaching For The Sky,35.0,6,1,4,0,1,up,1978-02-11
8736,Peabo Bryson,1978-04-01,Peabo Bryson - Reaching For The Sky,20,24,14,11.0,19,Reaching For The Sky,35.0,7,5,1,4,1,up,1978-02-11
8737,Peabo Bryson,1978-04-08,Peabo Bryson - Reaching For The Sky,19,20,14,11.0,14,Reaching For The Sky,35.0,8,0,5,1,0,stay,1978-02-11
8738,Peabo Bryson,1978-04-15,Peabo Bryson - Reaching For The Sky,14,19,14,11.0,14,Reaching For The Sky,35.0,9,0,0,5,0,stay,1978-02-11
8739,Peabo Bryson,1978-04-22,Peabo Bryson - Reaching For The Sky,14,14,14,11.0,14,Reaching For The Sky,35.0,10,0,0,0,0,stay,1978-02-11
8740,Peabo Bryson,1978-04-29,Peabo Bryson - Reaching For The Sky,14,14,14,11.0,14,Reaching For The Sky,35.0,11,0,0,0,0,stay,1978-02-11
8741,Peabo Bryson,1978-05-06,Peabo Bryson - Reaching For The Sky,14,14,14,11.0,14,Reaching For The Sky,35.0,12,0,0,0,0,stay,1978-02-11
8742,Peabo Bryson,1978-05-13,Peabo Bryson - Reaching For The Sky,14,14,14,11.0,14,Reaching For The Sky,35.0,13,0,0,0,0,stay,1978-02-11
8743,Peabo Bryson,1978-05-20,Peabo Bryson - Reaching For The Sky,14,14,14,11.0,14,Reaching For The Sky,35.0,14,0,0,0,0,stay,1978-02-11
8744,Peabo Bryson,1978-05-27,Peabo Bryson - Reaching For The Sky,14,14,11,11.0,14,Reaching For The Sky,35.0,15,3,0,0,1,up,1978-02-11
8745,Peabo Bryson,1978-06-03,Peabo Bryson - Reaching For The Sky,14,14,14,11.0,11,Reaching For The Sky,35.0,16,-3,3,0,1,down,1978-02-11
8746,Peabo Bryson,1978-06-10,Peabo Bryson - Reaching For The Sky,11,14,14,11.0,14,Reaching For The Sky,35.0,17,0,-3,3,0,stay,1978-02-11
8747,Peabo Bryson,1978-06-17,Peabo Bryson - Reaching For The Sky,14,11,13,11.0,14,Reaching For The Sky,35.0,18,1,0,-3,1,up,1978-02-11
8748,Peabo Bryson,1978-06-24,Peabo Bryson - Reaching For The Sky,14,14,18,11.0,13,Reaching For The Sky,35.0,19,-5,1,0,1,down,1978-02-11
8749,Peabo Bryson,1978-07-01,Peabo Bryson - Reaching For The Sky,13,14,19,11.0,18,Reaching For The Sky,35.0,20,-1,-5,1,1,down,1978-02-11
8750,Peabo Bryson,1978-07-08,Peabo Bryson - Reaching For The Sky,18,13,19,11.0,19,Reaching For The Sky,35.0,21,0,-1,-5,0,stay,1978-02-11
8751,Peabo Bryson,1978-07-15,Peabo Bryson - Reaching For The Sky,19,18,17,11.0,19,Reaching For The Sky,35.0,22,2,0,-1,1,up,1978-02-11
8752,Peabo Bryson,1978-07-22,Peabo Bryson - Reaching For The Sky,19,19,14,11.0,17,Reaching For The Sky,35.0,23,3,2,0,1,up,1978-02-11
8753,Peabo Bryson,1978-07-29,Peabo Bryson - Reaching For The Sky,17,19,16,11.0,14,Reaching For The Sky,35.0,24,-2,3,2,1,down,1978-02-11
8754,Peabo Bryson,1978-08-05,Peabo Bryson - Reaching For The Sky,14,17,17,11.0,16,Reaching For The Sky,35.0,25,-1,-2,3,1,down,1978-02-11
8755,Peabo Bryson,1978-08-12,Peabo Bryson - Reaching For The Sky,16,14,20,11.0,17,Reaching For The Sky,35.0,26,-3,-1,-2,1,down,1978-02-11
8756,Peabo Bryson,1978-08-19,Peabo Bryson - Reaching For The Sky,17,16,22,11.0,20,Reaching For The Sky,35.0,27,-2,-3,-1,1,down,1978-02-11
8757,Peabo Bryson,1978-08-26,Peabo Bryson - Reaching For The Sky,20,17,24,11.0,22,Reaching For The Sky,35.0,28,-2,-2,-3,1,down,1978-02-11
8758,Peabo Bryson,1978-09-02,Peabo Bryson - Reaching For The Sky,22,20,34,11.0,24,Reaching For The Sky,35.0,29,-10,-2,-2,1,down,1978-02-11
8759,Peabo Bryson,1978-09-09,Peabo Bryson - Reaching For The Sky,24,22,38,11.0,34,Reaching For The Sky,35.0,30,-4,-10,-2,1,down,1978-02-11
8760,Peabo Bryson,1978-09-16,Peabo Bryson - Reaching For The Sky,34,24,39,11.0,38,Reaching For The Sky,35.0,31,-1,-4,-10,1,down,1978-02-11
8761,Peabo Bryson,1978-09-23,Peabo Bryson - Reaching For The Sky,38,34,39,11.0,39,Reaching For The Sky,35.0,32,0,-1,-4,0,stay,1978-02-11
8762,Peabo Bryson,1978-09-30,Peabo Bryson - Reaching For The Sky,39,38,40,11.0,39,Reaching For The Sky,35.0,33,-1,0,-1,1,down,1978-02-11
8763,Peabo Bryson,1978-10-07,Peabo Bryson - Reaching For The Sky,39,39,46,11.0,40,Reaching For The Sky,35.0,34,-6,-1,0,1,down,1978-02-11
8764,Peabo Bryson,1978-10-14,Peabo Bryson - Reaching For The Sky,40,39,51,11.0,46,Reaching For The Sky,35.0,35,-5,-6,-1,1,down,1978-02-11
8765,Rufus And Chaka Khan,1978-02-18,Rufus And Chaka Khan - Street Player,51,51,14,1.0,24,Street Player,24.0,0,10,27,0,1,up,1978-02-18
8766,Rufus And Chaka Khan,1978-02-25,Rufus And Chaka Khan - Street Player,24,51,7,1.0,14,Street Player,24.0,1,7,10,27,1,up,1978-02-18
8767,Rufus And Chaka Khan,1978-03-04,Rufus And Chaka Khan - Street Player,14,24,7,1.0,7,Street Player,24.0,2,0,7,10,0,stay,1978-02-18
8768,Rufus And Chaka Khan,1978-03-11,Rufus And Chaka Khan - Street Player,7,14,6,1.0,7,Street Player,24.0,3,1,0,7,1,up,1978-02-18
8769,Rufus And Chaka Khan,1978-03-18,Rufus And Chaka Khan - Street Player,7,7,6,1.0,6,Street Player,24.0,4,0,1,0,0,stay,1978-02-18
8770,Rufus And Chaka Khan,1978-03-25,Rufus And Chaka Khan - Street Player,6,7,5,1.0,6,Street Player,24.0,5,1,0,1,1,up,1978-02-18
8771,Rufus And Chaka Khan,1978-04-01,Rufus And Chaka Khan - Street Player,6,6,4,1.0,5,Street Player,24.0,6,1,1,0,1,up,1978-02-18
8772,Rufus And Chaka Khan,1978-04-08,Rufus And Chaka Khan - Street Player,5,6,1,1.0,4,Street Player,24.0,7,3,1,1,1,up,1978-02-18
8773,Rufus And Chaka Khan,1978-04-15,Rufus And Chaka Khan - Street Player,4,5,4,1.0,1,Street Player,24.0,8,-3,3,1,1,down,1978-02-18
8774,Rufus And Chaka Khan,1978-04-22,Rufus And Chaka Khan - Street Player,1,4,3,1.0,4,Street Player,24.0,9,1,-3,3,1,up,1978-02-18
8775,Rufus And Chaka Khan,1978-04-29,Rufus And Chaka Khan - Street Player,4,1,3,1.0,3,Street Player,24.0,10,0,1,-3,0,stay,1978-02-18
8776,Rufus And Chaka Khan,1978-05-06,Rufus And Chaka Khan - Street Player,3,4,5,1.0,3,Street Player,24.0,11,-2,0,1,1,down,1978-02-18
8777,Rufus And Chaka Khan,1978-05-13,Rufus And Chaka Khan - Street Player,3,3,5,1.0,5,Street Player,24.0,12,0,-2,0,0,stay,1978-02-18
8778,Rufus And Chaka Khan,1978-05-20,Rufus And Chaka Khan - Street Player,5,3,5,1.0,5,Street Player,24.0,13,0,0,-2,0,stay,1978-02-18
8779,Rufus And Chaka Khan,1978-05-27,Rufus And Chaka Khan - Street Player,5,5,8,1.0,5,Street Player,24.0,14,-3,0,0,1,down,1978-02-18
8780,Rufus And Chaka Khan,1978-06-03,Rufus And Chaka Khan - Street Player,5,5,10,1.0,8,Street Player,24.0,15,-2,-3,0,1,down,1978-02-18
8781,Rufus And Chaka Khan,1978-06-10,Rufus And Chaka Khan - Street Player,8,5,11,1.0,10,Street Player,24.0,16,-1,-2,-3,1,down,1978-02-18
8782,Rufus And Chaka Khan,1978-06-17,Rufus And Chaka Khan - Street Player,10,8,15,1.0,11,Street Player,24.0,17,-4,-1,-2,1,down,1978-02-18
8783,Rufus And Chaka Khan,1978-06-24,Rufus And Chaka Khan - Street Player,11,10,28,1.0,15,Street Player,24.0,18,-13,-4,-1,1,down,1978-02-18
8784,Rufus And Chaka Khan,1978-07-01,Rufus And Chaka Khan - Street Player,15,11,32,1.0,28,Street Player,24.0,19,-4,-13,-4,1,down,1978-02-18
8785,Rufus And Chaka Khan,1978-07-08,Rufus And Chaka Khan - Street Player,28,15,33,1.0,32,Street Player,24.0,20,-1,-4,-13,1,down,1978-02-18
8786,Rufus And Chaka Khan,1978-07-15,Rufus And Chaka Khan - Street Player,32,28,36,1.0,33,Street Player,24.0,21,-3,-1,-4,1,down,1978-02-18
8787,Rufus And Chaka Khan,1978-07-22,Rufus And Chaka Khan - Street Player,33,32,43,1.0,36,Street Player,24.0,22,-7,-3,-1,1,down,1978-02-18
8788,Rufus And Chaka Khan,1978-07-29,Rufus And Chaka Khan - Street Player,36,33,46,1.0,43,Street Player,24.0,23,-3,-7,-3,1,down,1978-02-18
8789,Rufus And Chaka Khan,1978-08-05,Rufus And Chaka Khan - Street Player,43,36,51,1.0,46,Street Player,24.0,24,-5,-3,-7,1,down,1978-02-18
8790,Bunny Sigler,1978-02-18,Bunny Sigler - Let Me Party With You,51,51,46,18.0,50,Let Me Party With You,12.0,0,4,1,0,1,up,1978-02-18
8791,Bunny Sigler,1978-02-25,Bunny Sigler - Let Me Party With You,50,51,45,18.0,46,Let Me Party With You,12.0,1,1,4,1,1,up,1978-02-18
8792,Bunny Sigler,1978-03-04,Bunny Sigler - Let Me Party With You,46,50,46,18.0,45,Let Me Party With You,12.0,2,-1,1,4,1,down,1978-02-18
8793,Bunny Sigler,1978-03-11,Bunny Sigler - Let Me Party With You,45,46,36,18.0,46,Let Me Party With You,12.0,3,10,-1,1,1,up,1978-02-18
8794,Bunny Sigler,1978-03-18,Bunny Sigler - Let Me Party With You,46,45,26,18.0,36,Let Me Party With You,12.0,4,10,10,-1,1,up,1978-02-18
8795,Bunny Sigler,1978-03-25,Bunny Sigler - Let Me Party With You,36,46,20,18.0,26,Let Me Party With You,12.0,5,6,10,10,1,up,1978-02-18
8796,Bunny Sigler,1978-04-01,Bunny Sigler - Let Me Party With You,26,36,19,18.0,20,Let Me Party With You,12.0,6,1,6,10,1,up,1978-02-18
8797,Bunny Sigler,1978-04-08,Bunny Sigler - Let Me Party With You,20,26,18,18.0,19,Let Me Party With You,12.0,7,1,1,6,1,up,1978-02-18
8798,Bunny Sigler,1978-04-15,Bunny Sigler - Let Me Party With You,19,20,26,18.0,18,Let Me Party With You,12.0,8,-8,1,1,1,down,1978-02-18
8799,Bunny Sigler,1978-04-22,Bunny Sigler - Let Me Party With You,18,19,36,18.0,26,Let Me Party With You,12.0,9,-10,-8,1,1,down,1978-02-18
8800,Bunny Sigler,1978-04-29,Bunny Sigler - Let Me Party With You,26,18,36,18.0,36,Let Me Party With You,12.0,10,0,-10,-8,0,stay,1978-02-18
8801,Bunny Sigler,1978-05-06,Bunny Sigler - Let Me Party With You,36,26,50,18.0,36,Let Me Party With You,12.0,11,-14,0,-10,1,down,1978-02-18
8802,Bunny Sigler,1978-05-13,Bunny Sigler - Let Me Party With You,36,36,51,18.0,50,Let Me Party With You,12.0,12,-1,-14,0,1,down,1978-02-18
8803,Le Pamplemousse,1978-02-25,Le Pamplemousse - Le Spank,51,51,50,47.0,47,Le Spank,1.0,0,-3,4,0,1,down,1978-02-25
8804,Le Pamplemousse,1978-03-04,Le Pamplemousse - Le Spank,47,51,51,47.0,50,Le Spank,1.0,1,-1,-3,4,1,down,1978-02-25
8805,B.T. Express,1978-02-25,B.T. Express - Shout!,51,51,35,16.0,50,Shout!,12.0,0,15,1,0,1,up,1978-02-25
8806,B.T. Express,1978-03-04,B.T. Express - Shout!,50,51,27,16.0,35,Shout!,12.0,1,8,15,1,1,up,1978-02-25
8807,B.T. Express,1978-03-11,B.T. Express - Shout!,35,50,19,16.0,27,Shout!,12.0,2,8,8,15,1,up,1978-02-25
8808,B.T. Express,1978-03-18,B.T. Express - Shout!,27,35,19,16.0,19,Shout!,12.0,3,0,8,8,0,stay,1978-02-25
8809,B.T. Express,1978-03-25,B.T. Express - Shout!,19,27,16,16.0,19,Shout!,12.0,4,3,0,8,1,up,1978-02-25
8810,B.T. Express,1978-04-01,B.T. Express - Shout!,19,19,16,16.0,16,Shout!,12.0,5,0,3,0,0,stay,1978-02-25
8811,B.T. Express,1978-04-08,B.T. Express - Shout!,16,19,19,16.0,16,Shout!,12.0,6,-3,0,3,1,down,1978-02-25
8812,B.T. Express,1978-04-15,B.T. Express - Shout!,16,16,17,16.0,19,Shout!,12.0,7,2,-3,0,1,up,1978-02-25
8813,B.T. Express,1978-04-22,B.T. Express - Shout!,19,16,27,16.0,17,Shout!,12.0,8,-10,2,-3,1,down,1978-02-25
8814,B.T. Express,1978-04-29,B.T. Express - Shout!,17,19,31,16.0,27,Shout!,12.0,9,-4,-10,2,1,down,1978-02-25
8815,B.T. Express,1978-05-06,B.T. Express - Shout!,27,17,41,16.0,31,Shout!,12.0,10,-10,-4,-10,1,down,1978-02-25
8816,B.T. Express,1978-05-13,B.T. Express - Shout!,31,27,41,16.0,41,Shout!,12.0,11,0,-10,-4,0,stay,1978-02-25
8817,B.T. Express,1978-05-20,B.T. Express - Shout!,41,31,51,16.0,41,Shout!,12.0,12,-10,0,-10,1,down,1978-02-25
8818,Bootsy's Rubber Band,1978-03-04,Bootsy's Rubber Band - Bootsy? Player Of The Year,51,51,11,1.0,15,Bootsy? Player Of The Year,22.0,0,4,36,0,1,up,1978-03-04
8819,Bootsy's Rubber Band,1978-03-11,Bootsy's Rubber Band - Bootsy? Player Of The Year,15,51,7,1.0,11,Bootsy? Player Of The Year,22.0,1,4,4,36,1,up,1978-03-04
8820,Bootsy's Rubber Band,1978-03-18,Bootsy's Rubber Band - Bootsy? Player Of The Year,11,15,1,1.0,7,Bootsy? Player Of The Year,22.0,2,6,4,4,1,up,1978-03-04
8821,Bootsy's Rubber Band,1978-03-25,Bootsy's Rubber Band - Bootsy? Player Of The Year,7,11,1,1.0,1,Bootsy? Player Of The Year,22.0,3,0,6,4,0,stay,1978-03-04
8822,Bootsy's Rubber Band,1978-04-01,Bootsy's Rubber Band - Bootsy? Player Of The Year,1,7,1,1.0,1,Bootsy? Player Of The Year,22.0,4,0,0,6,0,stay,1978-03-04
8823,Bootsy's Rubber Band,1978-04-08,Bootsy's Rubber Band - Bootsy? Player Of The Year,1,1,6,1.0,1,Bootsy? Player Of The Year,22.0,5,-5,0,0,1,down,1978-03-04
8824,Bootsy's Rubber Band,1978-04-15,Bootsy's Rubber Band - Bootsy? Player Of The Year,1,1,6,1.0,6,Bootsy? Player Of The Year,22.0,6,0,-5,0,0,stay,1978-03-04
8825,Bootsy's Rubber Band,1978-04-22,Bootsy's Rubber Band - Bootsy? Player Of The Year,6,1,6,1.0,6,Bootsy? Player Of The Year,22.0,7,0,0,-5,0,stay,1978-03-04
8826,Bootsy's Rubber Band,1978-04-29,Bootsy's Rubber Band - Bootsy? Player Of The Year,6,6,6,1.0,6,Bootsy? Player Of The Year,22.0,8,0,0,0,0,stay,1978-03-04
8827,Bootsy's Rubber Band,1978-05-06,Bootsy's Rubber Band - Bootsy? Player Of The Year,6,6,6,1.0,6,Bootsy? Player Of The Year,22.0,9,0,0,0,0,stay,1978-03-04
8828,Bootsy's Rubber Band,1978-05-13,Bootsy's Rubber Band - Bootsy? Player Of The Year,6,6,6,1.0,6,Bootsy? Player Of The Year,22.0,10,0,0,0,0,stay,1978-03-04
8829,Bootsy's Rubber Band,1978-05-20,Bootsy's Rubber Band - Bootsy? Player Of The Year,6,6,8,1.0,6,Bootsy? Player Of The Year,22.0,11,-2,0,0,1,down,1978-03-04
8830,Bootsy's Rubber Band,1978-05-27,Bootsy's Rubber Band - Bootsy? Player Of The Year,6,6,9,1.0,8,Bootsy? Player Of The Year,22.0,12,-1,-2,0,1,down,1978-03-04
8831,Bootsy's Rubber Band,1978-06-03,Bootsy's Rubber Band - Bootsy? Player Of The Year,8,6,15,1.0,9,Bootsy? Player Of The Year,22.0,13,-6,-1,-2,1,down,1978-03-04
8832,Bootsy's Rubber Band,1978-06-10,Bootsy's Rubber Band - Bootsy? Player Of The Year,9,8,15,1.0,15,Bootsy? Player Of The Year,22.0,14,0,-6,-1,0,stay,1978-03-04
8833,Bootsy's Rubber Band,1978-06-17,Bootsy's Rubber Band - Bootsy? Player Of The Year,15,9,17,1.0,15,Bootsy? Player Of The Year,22.0,15,-2,0,-6,1,down,1978-03-04
8834,Bootsy's Rubber Band,1978-06-24,Bootsy's Rubber Band - Bootsy? Player Of The Year,15,15,23,1.0,17,Bootsy? Player Of The Year,22.0,16,-6,-2,0,1,down,1978-03-04
8835,Bootsy's Rubber Band,1978-07-01,Bootsy's Rubber Band - Bootsy? Player Of The Year,17,15,25,1.0,23,Bootsy? Player Of The Year,22.0,17,-2,-6,-2,1,down,1978-03-04
8836,Bootsy's Rubber Band,1978-07-08,Bootsy's Rubber Band - Bootsy? Player Of The Year,23,17,25,1.0,25,Bootsy? Player Of The Year,22.0,18,0,-2,-6,0,stay,1978-03-04
8837,Bootsy's Rubber Band,1978-07-15,Bootsy's Rubber Band - Bootsy? Player Of The Year,25,23,35,1.0,25,Bootsy? Player Of The Year,22.0,19,-10,0,-2,1,down,1978-03-04
8838,Bootsy's Rubber Band,1978-07-22,Bootsy's Rubber Band - Bootsy? Player Of The Year,25,25,39,1.0,35,Bootsy? Player Of The Year,22.0,20,-4,-10,0,1,down,1978-03-04
8839,Bootsy's Rubber Band,1978-07-29,Bootsy's Rubber Band - Bootsy? Player Of The Year,35,25,43,1.0,39,Bootsy? Player Of The Year,22.0,21,-4,-4,-10,1,down,1978-03-04
8840,Bootsy's Rubber Band,1978-08-05,Bootsy's Rubber Band - Bootsy? Player Of The Year,39,35,51,1.0,43,Bootsy? Player Of The Year,22.0,22,-8,-4,-4,1,down,1978-03-04
8841,Dr. Buzzard's Original Savannah Band,1978-03-04,Dr. Buzzard's Original Savannah Band - Dr.buzzards Original Savannah Band Meets Kink Pene,51,51,23,23.0,29,Dr.buzzards Original Savannah Band Meets Kink Pene,5.0,0,6,22,0,1,up,1978-03-04
8842,Dr. Buzzard's Original Savannah Band,1978-03-11,Dr. Buzzard's Original Savannah Band - Dr.buzzards Original Savannah Band Meets Kink Pene,29,51,23,23.0,23,Dr.buzzards Original Savannah Band Meets Kink Pene,5.0,1,0,6,22,0,stay,1978-03-04
8843,Dr. Buzzard's Original Savannah Band,1978-03-18,Dr. Buzzard's Original Savannah Band - Dr.buzzards Original Savannah Band Meets Kink Pene,23,29,27,23.0,23,Dr.buzzards Original Savannah Band Meets Kink Pene,5.0,2,-4,0,6,1,down,1978-03-04
8844,Dr. Buzzard's Original Savannah Band,1978-03-25,Dr. Buzzard's Original Savannah Band - Dr.buzzards Original Savannah Band Meets Kink Pene,23,23,29,23.0,27,Dr.buzzards Original Savannah Band Meets Kink Pene,5.0,3,-2,-4,0,1,down,1978-03-04
8845,Dr. Buzzard's Original Savannah Band,1978-04-01,Dr. Buzzard's Original Savannah Band - Dr.buzzards Original Savannah Band Meets Kink Pene,27,23,48,23.0,29,Dr.buzzards Original Savannah Band Meets Kink Pene,5.0,4,-19,-2,-4,1,down,1978-03-04
8846,Dr. Buzzard's Original Savannah Band,1978-04-08,Dr. Buzzard's Original Savannah Band - Dr.buzzards Original Savannah Band Meets Kink Pene,29,27,51,23.0,48,Dr.buzzards Original Savannah Band Meets Kink Pene,5.0,5,-3,-19,-2,1,down,1978-03-04
8847,Raydio,1978-03-04,Raydio - Raydio,51,51,30,8.0,40,Raydio,21.0,0,10,11,0,1,up,1978-03-04
8848,Raydio,1978-03-11,Raydio - Raydio,40,51,20,8.0,30,Raydio,21.0,1,10,10,11,1,up,1978-03-04
8849,Raydio,1978-03-18,Raydio - Raydio,30,40,14,8.0,20,Raydio,21.0,2,6,10,10,1,up,1978-03-04
8850,Raydio,1978-03-25,Raydio - Raydio,20,30,11,8.0,14,Raydio,21.0,3,3,6,10,1,up,1978-03-04
8851,Raydio,1978-04-01,Raydio - Raydio,14,20,10,8.0,11,Raydio,21.0,4,1,3,6,1,up,1978-03-04
8852,Raydio,1978-04-08,Raydio - Raydio,11,14,9,8.0,10,Raydio,21.0,5,1,1,3,1,up,1978-03-04
8853,Raydio,1978-04-15,Raydio - Raydio,10,11,8,8.0,9,Raydio,21.0,6,1,1,1,1,up,1978-03-04
8854,Raydio,1978-04-22,Raydio - Raydio,9,10,8,8.0,8,Raydio,21.0,7,0,1,1,0,stay,1978-03-04
8855,Raydio,1978-04-29,Raydio - Raydio,8,9,10,8.0,8,Raydio,21.0,8,-2,0,1,1,down,1978-03-04
8856,Raydio,1978-05-06,Raydio - Raydio,8,8,10,8.0,10,Raydio,21.0,9,0,-2,0,0,stay,1978-03-04
8857,Raydio,1978-05-13,Raydio - Raydio,10,8,10,8.0,10,Raydio,21.0,10,0,0,-2,0,stay,1978-03-04
8858,Raydio,1978-05-20,Raydio - Raydio,10,10,11,8.0,10,Raydio,21.0,11,-1,0,0,1,down,1978-03-04
8859,Raydio,1978-05-27,Raydio - Raydio,10,10,18,8.0,11,Raydio,21.0,12,-7,-1,0,1,down,1978-03-04
8860,Raydio,1978-06-03,Raydio - Raydio,11,10,19,8.0,18,Raydio,21.0,13,-1,-7,-1,1,down,1978-03-04
8861,Raydio,1978-06-10,Raydio - Raydio,18,11,26,8.0,19,Raydio,21.0,14,-7,-1,-7,1,down,1978-03-04
8862,Raydio,1978-06-17,Raydio - Raydio,19,18,31,8.0,26,Raydio,21.0,15,-5,-7,-1,1,down,1978-03-04
8863,Raydio,1978-06-24,Raydio - Raydio,26,19,35,8.0,31,Raydio,21.0,16,-4,-5,-7,1,down,1978-03-04
8864,Raydio,1978-07-01,Raydio - Raydio,31,26,35,8.0,35,Raydio,21.0,17,0,-4,-5,0,stay,1978-03-04
8865,Raydio,1978-07-08,Raydio - Raydio,35,31,38,8.0,35,Raydio,21.0,18,-3,0,-4,1,down,1978-03-04
8866,Raydio,1978-07-15,Raydio - Raydio,35,35,38,8.0,38,Raydio,21.0,19,0,-3,0,0,stay,1978-03-04
8867,Raydio,1978-07-22,Raydio - Raydio,38,35,46,8.0,38,Raydio,21.0,20,-8,0,-3,1,down,1978-03-04
8868,Raydio,1978-07-29,Raydio - Raydio,38,38,51,8.0,46,Raydio,21.0,21,-5,-8,0,1,down,1978-03-04
8869,The Manhattans,1978-03-04,The Manhattans - There's No Good In Goodbye,51,51,34,18.0,44,There's No Good In Goodbye,14.0,0,10,7,0,1,up,1978-03-04
8870,The Manhattans,1978-03-11,The Manhattans - There's No Good In Goodbye,44,51,31,18.0,34,There's No Good In Goodbye,14.0,1,3,10,7,1,up,1978-03-04
8871,The Manhattans,1978-03-18,The Manhattans - There's No Good In Goodbye,34,44,22,18.0,31,There's No Good In Goodbye,14.0,2,9,3,10,1,up,1978-03-04
8872,The Manhattans,1978-03-25,The Manhattans - There's No Good In Goodbye,31,34,18,18.0,22,There's No Good In Goodbye,14.0,3,4,9,3,1,up,1978-03-04
8873,The Manhattans,1978-04-01,The Manhattans - There's No Good In Goodbye,22,31,18,18.0,18,There's No Good In Goodbye,14.0,4,0,4,9,0,stay,1978-03-04
8874,The Manhattans,1978-04-08,The Manhattans - There's No Good In Goodbye,18,22,24,18.0,18,There's No Good In Goodbye,14.0,5,-6,0,4,1,down,1978-03-04
8875,The Manhattans,1978-04-15,The Manhattans - There's No Good In Goodbye,18,18,22,18.0,24,There's No Good In Goodbye,14.0,6,2,-6,0,1,up,1978-03-04
8876,The Manhattans,1978-04-22,The Manhattans - There's No Good In Goodbye,24,18,28,18.0,22,There's No Good In Goodbye,14.0,7,-6,2,-6,1,down,1978-03-04
8877,The Manhattans,1978-04-29,The Manhattans - There's No Good In Goodbye,22,24,28,18.0,28,There's No Good In Goodbye,14.0,8,0,-6,2,0,stay,1978-03-04
8878,The Manhattans,1978-05-06,The Manhattans - There's No Good In Goodbye,28,22,29,18.0,28,There's No Good In Goodbye,14.0,9,-1,0,-6,1,down,1978-03-04
8879,The Manhattans,1978-05-13,The Manhattans - There's No Good In Goodbye,28,28,32,18.0,29,There's No Good In Goodbye,14.0,10,-3,-1,0,1,down,1978-03-04
8880,The Manhattans,1978-05-20,The Manhattans - There's No Good In Goodbye,29,28,33,18.0,32,There's No Good In Goodbye,14.0,11,-1,-3,-1,1,down,1978-03-04
8881,The Manhattans,1978-05-27,The Manhattans - There's No Good In Goodbye,32,29,37,18.0,33,There's No Good In Goodbye,14.0,12,-4,-1,-3,1,down,1978-03-04
8882,The Manhattans,1978-06-03,The Manhattans - There's No Good In Goodbye,33,32,50,18.0,37,There's No Good In Goodbye,14.0,13,-13,-4,-1,1,down,1978-03-04
8883,The Manhattans,1978-06-10,The Manhattans - There's No Good In Goodbye,37,33,51,18.0,50,There's No Good In Goodbye,14.0,14,-1,-13,-4,1,down,1978-03-04
8884,Faze-O,1978-03-04,Faze-O - Riding High,51,51,45,19.0,46,Riding High,17.0,0,1,5,0,1,up,1978-03-04
8885,Faze-O,1978-03-11,Faze-O - Riding High,46,51,38,19.0,45,Riding High,17.0,1,7,1,5,1,up,1978-03-04
8886,Faze-O,1978-03-18,Faze-O - Riding High,45,46,30,19.0,38,Riding High,17.0,2,8,7,1,1,up,1978-03-04
8887,Faze-O,1978-03-25,Faze-O - Riding High,38,45,30,19.0,30,Riding High,17.0,3,0,8,7,0,stay,1978-03-04
8888,Faze-O,1978-04-01,Faze-O - Riding High,30,38,28,19.0,30,Riding High,17.0,4,2,0,8,1,up,1978-03-04
8889,Faze-O,1978-04-08,Faze-O - Riding High,30,30,26,19.0,28,Riding High,17.0,5,2,2,0,1,up,1978-03-04
8890,Faze-O,1978-04-15,Faze-O - Riding High,28,30,34,19.0,26,Riding High,17.0,6,-8,2,2,1,down,1978-03-04
8891,Faze-O,1978-04-22,Faze-O - Riding High,26,28,26,19.0,34,Riding High,17.0,7,8,-8,2,1,up,1978-03-04
8892,Faze-O,1978-04-29,Faze-O - Riding High,34,26,20,19.0,26,Riding High,17.0,8,6,8,-8,1,up,1978-03-04
8893,Faze-O,1978-05-06,Faze-O - Riding High,26,34,20,19.0,20,Riding High,17.0,9,0,6,8,0,stay,1978-03-04
8894,Faze-O,1978-05-13,Faze-O - Riding High,20,26,19,19.0,20,Riding High,17.0,10,1,0,6,1,up,1978-03-04
8895,Faze-O,1978-05-20,Faze-O - Riding High,20,20,20,19.0,19,Riding High,17.0,11,-1,1,0,1,down,1978-03-04
8896,Faze-O,1978-05-27,Faze-O - Riding High,19,20,27,19.0,20,Riding High,17.0,12,-7,-1,1,1,down,1978-03-04
8897,Faze-O,1978-06-03,Faze-O - Riding High,20,19,27,19.0,27,Riding High,17.0,13,0,-7,-1,0,stay,1978-03-04
8898,Faze-O,1978-06-10,Faze-O - Riding High,27,20,34,19.0,27,Riding High,17.0,14,-7,0,-7,1,down,1978-03-04
8899,Faze-O,1978-06-17,Faze-O - Riding High,27,27,48,19.0,34,Riding High,17.0,15,-14,-7,0,1,down,1978-03-04
8900,Faze-O,1978-06-24,Faze-O - Riding High,34,27,48,19.0,48,Riding High,17.0,16,0,-14,-7,0,stay,1978-03-04
8901,Faze-O,1978-07-01,Faze-O - Riding High,48,34,51,19.0,48,Riding High,17.0,17,-3,0,-14,1,down,1978-03-04
8902,Stargard,1978-03-11,Stargard - Stargard,51,51,14,12.0,42,Stargard,11.0,0,28,9,0,1,up,1978-03-11
8903,Stargard,1978-03-18,Stargard - Stargard,42,51,12,12.0,14,Stargard,11.0,1,2,28,9,1,up,1978-03-11
8904,Stargard,1978-03-25,Stargard - Stargard,14,42,12,12.0,12,Stargard,11.0,2,0,2,28,0,stay,1978-03-11
8905,Stargard,1978-04-01,Stargard - Stargard,12,14,15,12.0,12,Stargard,11.0,3,-3,0,2,1,down,1978-03-11
8906,Stargard,1978-04-08,Stargard - Stargard,12,12,15,12.0,15,Stargard,11.0,4,0,-3,0,0,stay,1978-03-11
8907,Stargard,1978-04-15,Stargard - Stargard,15,12,15,12.0,15,Stargard,11.0,5,0,0,-3,0,stay,1978-03-11
8908,Stargard,1978-04-22,Stargard - Stargard,15,15,20,12.0,15,Stargard,11.0,6,-5,0,0,1,down,1978-03-11
8909,Stargard,1978-04-29,Stargard - Stargard,15,15,35,12.0,20,Stargard,11.0,7,-15,-5,0,1,down,1978-03-11
8910,Stargard,1978-05-06,Stargard - Stargard,20,15,36,12.0,35,Stargard,11.0,8,-1,-15,-5,1,down,1978-03-11
8911,Stargard,1978-05-13,Stargard - Stargard,35,20,40,12.0,36,Stargard,11.0,9,-4,-1,-15,1,down,1978-03-11
8912,Stargard,1978-05-20,Stargard - Stargard,36,35,46,12.0,40,Stargard,11.0,10,-6,-4,-1,1,down,1978-03-11
8913,Stargard,1978-05-27,Stargard - Stargard,40,36,51,12.0,46,Stargard,11.0,11,-5,-6,-4,1,down,1978-03-11
8914,Eloise Laws,1978-03-11,Eloise Laws - Eloise,51,51,51,49.0,49,Eloise,0.0,0,-2,2,0,1,down,1978-03-11
8915,Eddie Kendricks,1978-03-11,Eddie Kendricks - At His Best,51,51,50,48.0,50,At His Best,3.0,0,0,1,0,0,stay,1978-03-11
8916,Eddie Kendricks,1978-03-18,Eddie Kendricks - At His Best,50,51,48,48.0,50,At His Best,3.0,1,2,0,1,1,up,1978-03-11
8917,Eddie Kendricks,1978-03-25,Eddie Kendricks - At His Best,50,50,48,48.0,48,At His Best,3.0,2,0,2,0,0,stay,1978-03-11
8918,Eddie Kendricks,1978-04-01,Eddie Kendricks - At His Best,48,50,51,48.0,48,At His Best,3.0,3,-3,0,2,1,down,1978-03-11
8919,Roy Ayers Ubiquity,1978-03-18,Roy Ayers Ubiquity - Let's Do It,51,51,29,15.0,39,Let's Do It,12.0,0,10,12,0,1,up,1978-03-18
8920,Roy Ayers Ubiquity,1978-03-25,Roy Ayers Ubiquity - Let's Do It,39,51,23,15.0,29,Let's Do It,12.0,1,6,10,12,1,up,1978-03-18
8921,Roy Ayers Ubiquity,1978-04-01,Roy Ayers Ubiquity - Let's Do It,29,39,21,15.0,23,Let's Do It,12.0,2,2,6,10,1,up,1978-03-18
8922,Roy Ayers Ubiquity,1978-04-08,Roy Ayers Ubiquity - Let's Do It,23,29,17,15.0,21,Let's Do It,12.0,3,4,2,6,1,up,1978-03-18
8923,Roy Ayers Ubiquity,1978-04-15,Roy Ayers Ubiquity - Let's Do It,21,23,16,15.0,17,Let's Do It,12.0,4,1,4,2,1,up,1978-03-18
8924,Roy Ayers Ubiquity,1978-04-22,Roy Ayers Ubiquity - Let's Do It,17,21,15,15.0,16,Let's Do It,12.0,5,1,1,4,1,up,1978-03-18
8925,Roy Ayers Ubiquity,1978-04-29,Roy Ayers Ubiquity - Let's Do It,16,17,18,15.0,15,Let's Do It,12.0,6,-3,1,1,1,down,1978-03-18
8926,Roy Ayers Ubiquity,1978-05-06,Roy Ayers Ubiquity - Let's Do It,15,16,23,15.0,18,Let's Do It,12.0,7,-5,-3,1,1,down,1978-03-18
8927,Roy Ayers Ubiquity,1978-05-13,Roy Ayers Ubiquity - Let's Do It,18,15,29,15.0,23,Let's Do It,12.0,8,-6,-5,-3,1,down,1978-03-18
8928,Roy Ayers Ubiquity,1978-05-20,Roy Ayers Ubiquity - Let's Do It,23,18,29,15.0,29,Let's Do It,12.0,9,0,-6,-5,0,stay,1978-03-18
8929,Roy Ayers Ubiquity,1978-05-27,Roy Ayers Ubiquity - Let's Do It,29,23,40,15.0,29,Let's Do It,12.0,10,-11,0,-6,1,down,1978-03-18
8930,Roy Ayers Ubiquity,1978-06-03,Roy Ayers Ubiquity - Let's Do It,29,29,42,15.0,40,Let's Do It,12.0,11,-2,-11,0,1,down,1978-03-18
8931,Roy Ayers Ubiquity,1978-06-10,Roy Ayers Ubiquity - Let's Do It,40,29,51,15.0,42,Let's Do It,12.0,12,-9,-2,-11,1,down,1978-03-18
8932,Harvey Mason,1978-03-25,Harvey Mason - Funk In A Mason Jar,51,51,37,37.0,41,Funk In A Mason Jar,9.0,0,4,10,0,1,up,1978-03-25
8933,Harvey Mason,1978-04-01,Harvey Mason - Funk In A Mason Jar,41,51,45,37.0,37,Funk In A Mason Jar,9.0,1,-8,4,10,1,down,1978-03-25
8934,Harvey Mason,1978-04-08,Harvey Mason - Funk In A Mason Jar,37,41,43,37.0,45,Funk In A Mason Jar,9.0,2,2,-8,4,1,up,1978-03-25
8935,Harvey Mason,1978-04-15,Harvey Mason - Funk In A Mason Jar,45,37,38,37.0,43,Funk In A Mason Jar,9.0,3,5,2,-8,1,up,1978-03-25
8936,Harvey Mason,1978-04-22,Harvey Mason - Funk In A Mason Jar,43,45,42,37.0,38,Funk In A Mason Jar,9.0,4,-4,5,2,1,down,1978-03-25
8937,Harvey Mason,1978-04-29,Harvey Mason - Funk In A Mason Jar,38,43,42,37.0,42,Funk In A Mason Jar,9.0,5,0,-4,5,0,stay,1978-03-25
8938,Harvey Mason,1978-05-06,Harvey Mason - Funk In A Mason Jar,42,38,47,37.0,42,Funk In A Mason Jar,9.0,6,-5,0,-4,1,down,1978-03-25
8939,Harvey Mason,1978-05-13,Harvey Mason - Funk In A Mason Jar,42,42,47,37.0,47,Funk In A Mason Jar,9.0,7,0,-5,0,0,stay,1978-03-25
8940,Harvey Mason,1978-05-20,Harvey Mason - Funk In A Mason Jar,47,42,48,37.0,47,Funk In A Mason Jar,9.0,8,-1,0,-5,1,down,1978-03-25
8941,Harvey Mason,1978-05-27,Harvey Mason - Funk In A Mason Jar,47,47,51,37.0,48,Funk In A Mason Jar,9.0,9,-3,-1,0,1,down,1978-03-25
8942,Smokey Robinson,1978-03-25,Smokey Robinson - Love Breeze,51,51,39,19.0,49,Love Breeze,19.0,0,10,2,0,1,up,1978-03-25
8943,Smokey Robinson,1978-04-01,Smokey Robinson - Love Breeze,49,51,31,19.0,39,Love Breeze,19.0,1,8,10,2,1,up,1978-03-25
8944,Smokey Robinson,1978-04-08,Smokey Robinson - Love Breeze,39,49,31,19.0,31,Love Breeze,19.0,2,0,8,10,0,stay,1978-03-25
8945,Smokey Robinson,1978-04-15,Smokey Robinson - Love Breeze,31,39,33,19.0,31,Love Breeze,19.0,3,-2,0,8,1,down,1978-03-25
8946,Smokey Robinson,1978-04-22,Smokey Robinson - Love Breeze,31,31,30,19.0,33,Love Breeze,19.0,4,3,-2,0,1,up,1978-03-25
8947,Smokey Robinson,1978-04-29,Smokey Robinson - Love Breeze,33,31,26,19.0,30,Love Breeze,19.0,5,4,3,-2,1,up,1978-03-25
8948,Smokey Robinson,1978-05-06,Smokey Robinson - Love Breeze,30,33,24,19.0,26,Love Breeze,19.0,6,2,4,3,1,up,1978-03-25
8949,Smokey Robinson,1978-05-13,Smokey Robinson - Love Breeze,26,30,23,19.0,24,Love Breeze,19.0,7,1,2,4,1,up,1978-03-25
8950,Smokey Robinson,1978-05-20,Smokey Robinson - Love Breeze,24,26,24,19.0,23,Love Breeze,19.0,8,-1,1,2,1,down,1978-03-25
8951,Smokey Robinson,1978-05-27,Smokey Robinson - Love Breeze,23,24,24,19.0,24,Love Breeze,19.0,9,0,-1,1,0,stay,1978-03-25
8952,Smokey Robinson,1978-06-03,Smokey Robinson - Love Breeze,24,23,23,19.0,24,Love Breeze,19.0,10,1,0,-1,1,up,1978-03-25
8953,Smokey Robinson,1978-06-10,Smokey Robinson - Love Breeze,24,24,19,19.0,23,Love Breeze,19.0,11,4,1,0,1,up,1978-03-25
8954,Smokey Robinson,1978-06-17,Smokey Robinson - Love Breeze,23,24,25,19.0,19,Love Breeze,19.0,12,-6,4,1,1,down,1978-03-25
8955,Smokey Robinson,1978-06-24,Smokey Robinson - Love Breeze,19,23,27,19.0,25,Love Breeze,19.0,13,-2,-6,4,1,down,1978-03-25
8956,Smokey Robinson,1978-07-01,Smokey Robinson - Love Breeze,25,19,27,19.0,27,Love Breeze,19.0,14,0,-2,-6,0,stay,1978-03-25
8957,Smokey Robinson,1978-07-08,Smokey Robinson - Love Breeze,27,25,28,19.0,27,Love Breeze,19.0,15,-1,0,-2,1,down,1978-03-25
8958,Smokey Robinson,1978-07-15,Smokey Robinson - Love Breeze,27,27,33,19.0,28,Love Breeze,19.0,16,-5,-1,0,1,down,1978-03-25
8959,Smokey Robinson,1978-07-22,Smokey Robinson - Love Breeze,28,27,35,19.0,33,Love Breeze,19.0,17,-2,-5,-1,1,down,1978-03-25
8960,Smokey Robinson,1978-07-29,Smokey Robinson - Love Breeze,33,28,38,19.0,35,Love Breeze,19.0,18,-3,-2,-5,1,down,1978-03-25
8961,Smokey Robinson,1978-08-05,Smokey Robinson - Love Breeze,35,33,51,19.0,38,Love Breeze,19.0,19,-13,-3,-2,1,down,1978-03-25
8962,Eddie Kendricks,1978-03-25,Eddie Kendricks - Vintage 78',51,51,40,33.0,50,Vintage 78',19.0,0,10,1,0,1,up,1978-03-25
8963,Eddie Kendricks,1978-04-01,Eddie Kendricks - Vintage 78',50,51,40,33.0,40,Vintage 78',19.0,1,0,10,1,0,stay,1978-03-25
8964,Eddie Kendricks,1978-04-08,Eddie Kendricks - Vintage 78',40,50,40,33.0,40,Vintage 78',19.0,2,0,0,10,0,stay,1978-03-25
8965,Eddie Kendricks,1978-04-15,Eddie Kendricks - Vintage 78',40,40,40,33.0,40,Vintage 78',19.0,3,0,0,0,0,stay,1978-03-25
8966,Eddie Kendricks,1978-04-22,Eddie Kendricks - Vintage 78',40,40,39,33.0,40,Vintage 78',19.0,4,1,0,0,1,up,1978-03-25
8967,Eddie Kendricks,1978-04-29,Eddie Kendricks - Vintage 78',40,40,37,33.0,39,Vintage 78',19.0,5,2,1,0,1,up,1978-03-25
8968,Eddie Kendricks,1978-05-06,Eddie Kendricks - Vintage 78',39,40,34,33.0,37,Vintage 78',19.0,6,3,2,1,1,up,1978-03-25
8969,Eddie Kendricks,1978-05-13,Eddie Kendricks - Vintage 78',37,39,34,33.0,34,Vintage 78',19.0,7,0,3,2,0,stay,1978-03-25
8970,Eddie Kendricks,1978-05-20,Eddie Kendricks - Vintage 78',34,37,34,33.0,34,Vintage 78',19.0,8,0,0,3,0,stay,1978-03-25
8971,Eddie Kendricks,1978-05-27,Eddie Kendricks - Vintage 78',34,34,38,33.0,34,Vintage 78',19.0,9,-4,0,0,1,down,1978-03-25
8972,Eddie Kendricks,1978-06-03,Eddie Kendricks - Vintage 78',34,34,38,33.0,38,Vintage 78',19.0,10,0,-4,0,0,stay,1978-03-25
8973,Eddie Kendricks,1978-06-10,Eddie Kendricks - Vintage 78',38,34,37,33.0,38,Vintage 78',19.0,11,1,0,-4,1,up,1978-03-25
8974,Eddie Kendricks,1978-06-17,Eddie Kendricks - Vintage 78',38,38,33,33.0,37,Vintage 78',19.0,12,4,1,0,1,up,1978-03-25
8975,Eddie Kendricks,1978-06-24,Eddie Kendricks - Vintage 78',37,38,36,33.0,33,Vintage 78',19.0,13,-3,4,1,1,down,1978-03-25
8976,Eddie Kendricks,1978-07-01,Eddie Kendricks - Vintage 78',33,37,36,33.0,36,Vintage 78',19.0,14,0,-3,4,0,stay,1978-03-25
8977,Eddie Kendricks,1978-07-08,Eddie Kendricks - Vintage 78',36,33,39,33.0,36,Vintage 78',19.0,15,-3,0,-3,1,down,1978-03-25
8978,Eddie Kendricks,1978-07-15,Eddie Kendricks - Vintage 78',36,36,42,33.0,39,Vintage 78',19.0,16,-3,-3,0,1,down,1978-03-25
8979,Eddie Kendricks,1978-07-22,Eddie Kendricks - Vintage 78',39,36,45,33.0,42,Vintage 78',19.0,17,-3,-3,-3,1,down,1978-03-25
8980,Eddie Kendricks,1978-07-29,Eddie Kendricks - Vintage 78',42,39,47,33.0,45,Vintage 78',19.0,18,-2,-3,-3,1,down,1978-03-25
8981,Eddie Kendricks,1978-08-05,Eddie Kendricks - Vintage 78',45,42,51,33.0,47,Vintage 78',19.0,19,-4,-2,-3,1,down,1978-03-25
8982,Average White Band,1978-04-01,Average White Band - Warmer Communications,51,51,26,12.0,34,Warmer Communications,13.0,0,8,17,0,1,up,1978-04-01
8983,Average White Band,1978-04-08,Average White Band - Warmer Communications,34,51,16,12.0,26,Warmer Communications,13.0,1,10,8,17,1,up,1978-04-01
8984,Average White Band,1978-04-15,Average White Band - Warmer Communications,26,34,12,12.0,16,Warmer Communications,13.0,2,4,10,8,1,up,1978-04-01
8985,Average White Band,1978-04-22,Average White Band - Warmer Communications,16,26,12,12.0,12,Warmer Communications,13.0,3,0,4,10,0,stay,1978-04-01
8986,Average White Band,1978-04-29,Average White Band - Warmer Communications,12,16,12,12.0,12,Warmer Communications,13.0,4,0,0,4,0,stay,1978-04-01
8987,Average White Band,1978-05-06,Average White Band - Warmer Communications,12,12,17,12.0,12,Warmer Communications,13.0,5,-5,0,0,1,down,1978-04-01
8988,Average White Band,1978-05-13,Average White Band - Warmer Communications,12,12,17,12.0,17,Warmer Communications,13.0,6,0,-5,0,0,stay,1978-04-01
8989,Average White Band,1978-05-20,Average White Band - Warmer Communications,17,12,21,12.0,17,Warmer Communications,13.0,7,-4,0,-5,1,down,1978-04-01
8990,Average White Band,1978-05-27,Average White Band - Warmer Communications,17,17,26,12.0,21,Warmer Communications,13.0,8,-5,-4,0,1,down,1978-04-01
8991,Average White Band,1978-06-03,Average White Band - Warmer Communications,21,17,30,12.0,26,Warmer Communications,13.0,9,-4,-5,-4,1,down,1978-04-01
8992,Average White Band,1978-06-10,Average White Band - Warmer Communications,26,21,47,12.0,30,Warmer Communications,13.0,10,-17,-4,-5,1,down,1978-04-01
8993,Average White Band,1978-06-17,Average White Band - Warmer Communications,30,26,47,12.0,47,Warmer Communications,13.0,11,0,-17,-4,0,stay,1978-04-01
8994,Average White Band,1978-06-24,Average White Band - Warmer Communications,47,30,47,12.0,47,Warmer Communications,13.0,12,0,0,-17,0,stay,1978-04-01
8995,Average White Band,1978-07-01,Average White Band - Warmer Communications,47,47,51,12.0,47,Warmer Communications,13.0,13,-4,0,0,1,down,1978-04-01
8996,Village People,1978-04-01,Village People - Macho Man,51,51,36,31.0,46,Macho Man,26.0,0,10,5,0,1,up,1978-04-01
8997,Village People,1978-04-08,Village People - Macho Man,46,51,34,31.0,36,Macho Man,26.0,1,2,10,5,1,up,1978-04-01
8998,Village People,1978-04-15,Village People - Macho Man,36,46,32,31.0,34,Macho Man,26.0,2,2,2,10,1,up,1978-04-01
8999,Village People,1978-04-22,Village People - Macho Man,34,36,32,31.0,32,Macho Man,26.0,3,0,2,2,0,stay,1978-04-01
9000,Village People,1978-04-29,Village People - Macho Man,32,34,32,31.0,32,Macho Man,26.0,4,0,0,2,0,stay,1978-04-01
9001,Village People,1978-05-06,Village People - Macho Man,32,32,31,31.0,32,Macho Man,26.0,5,1,0,0,1,up,1978-04-01
9002,Village People,1978-05-13,Village People - Macho Man,32,32,39,31.0,31,Macho Man,26.0,6,-8,1,0,1,down,1978-04-01
9003,Village People,1978-05-20,Village People - Macho Man,31,32,44,31.0,39,Macho Man,26.0,7,-5,-8,1,1,down,1978-04-01
9004,Village People,1978-05-27,Village People - Macho Man,39,31,44,31.0,44,Macho Man,26.0,8,0,-5,-8,0,stay,1978-04-01
9005,Village People,1978-06-03,Village People - Macho Man,44,39,36,31.0,44,Macho Man,26.0,9,8,0,-5,1,up,1978-04-01
9006,Village People,1978-06-10,Village People - Macho Man,44,44,39,31.0,36,Macho Man,26.0,10,-3,8,0,1,down,1978-04-01
9007,Village People,1978-06-17,Village People - Macho Man,36,44,49,31.0,39,Macho Man,26.0,11,-10,-3,8,1,down,1978-04-01
9008,Village People,1978-06-24,Village People - Macho Man,39,36,49,31.0,49,Macho Man,26.0,12,0,-10,-3,0,stay,1978-04-01
9009,Village People,1978-07-01,Village People - Macho Man,49,39,46,31.0,49,Macho Man,26.0,13,3,0,-10,1,up,1978-04-01
9010,Village People,1978-07-08,Village People - Macho Man,49,49,43,31.0,46,Macho Man,26.0,14,3,3,0,1,up,1978-04-01
9011,Village People,1978-07-15,Village People - Macho Man,46,49,40,31.0,43,Macho Man,26.0,15,3,3,3,1,up,1978-04-01
9012,Village People,1978-07-22,Village People - Macho Man,43,46,37,31.0,40,Macho Man,26.0,16,3,3,3,1,up,1978-04-01
9013,Village People,1978-07-29,Village People - Macho Man,40,43,37,31.0,37,Macho Man,26.0,17,0,3,3,0,stay,1978-04-01
9014,Village People,1978-08-05,Village People - Macho Man,37,40,38,31.0,37,Macho Man,26.0,18,-1,0,3,1,down,1978-04-01
9015,Village People,1978-08-12,Village People - Macho Man,37,37,47,31.0,38,Macho Man,26.0,19,-9,-1,0,1,down,1978-04-01
9016,Village People,1978-09-02,Village People - Macho Man,38,37,37,31.0,47,Macho Man,26.0,20,10,-9,-1,1,up,1978-04-01
9017,Village People,1978-09-09,Village People - Macho Man,47,38,37,31.0,37,Macho Man,26.0,21,0,10,-9,0,stay,1978-04-01
9018,Village People,1978-09-16,Village People - Macho Man,37,47,41,31.0,37,Macho Man,26.0,22,-4,0,10,1,down,1978-04-01
9019,Village People,1978-09-23,Village People - Macho Man,37,37,41,31.0,41,Macho Man,26.0,23,0,-4,0,0,stay,1978-04-01
9020,Village People,1978-09-30,Village People - Macho Man,41,37,42,31.0,41,Macho Man,26.0,24,-1,0,-4,1,down,1978-04-01
9021,Village People,1978-10-07,Village People - Macho Man,41,41,42,31.0,42,Macho Man,26.0,25,0,-1,0,0,stay,1978-04-01
9022,Village People,1978-10-14,Village People - Macho Man,42,41,51,31.0,42,Macho Man,26.0,26,-9,0,-1,1,down,1978-04-01
9023,John Handy,1978-04-08,John Handy - Where Go The Boats,51,51,28,28.0,34,Where Go The Boats,3.0,0,6,17,0,1,up,1978-04-08
9024,John Handy,1978-04-15,John Handy - Where Go The Boats,34,51,28,28.0,28,Where Go The Boats,3.0,1,0,6,17,0,stay,1978-04-08
9025,John Handy,1978-04-22,John Handy - Where Go The Boats,28,34,46,28.0,28,Where Go The Boats,3.0,2,-18,0,6,1,down,1978-04-08
9026,John Handy,1978-04-29,John Handy - Where Go The Boats,28,28,51,28.0,46,Where Go The Boats,3.0,3,-5,-18,0,1,down,1978-04-08
9027,Dexter Wansel,1978-04-08,Dexter Wansel - Voyager,51,51,37,37.0,37,Voyager,4.0,0,0,14,0,0,stay,1978-04-08
9028,Dexter Wansel,1978-04-15,Dexter Wansel - Voyager,37,51,37,37.0,37,Voyager,4.0,1,0,0,14,0,stay,1978-04-08
9029,Dexter Wansel,1978-04-22,Dexter Wansel - Voyager,37,37,44,37.0,37,Voyager,4.0,2,-7,0,0,1,down,1978-04-08
9030,Dexter Wansel,1978-04-29,Dexter Wansel - Voyager,37,37,43,37.0,44,Voyager,4.0,3,1,-7,0,1,up,1978-04-08
9031,Dexter Wansel,1978-05-06,Dexter Wansel - Voyager,44,37,51,37.0,43,Voyager,4.0,4,-8,1,-7,1,down,1978-04-08
9032,Tyrone Davis,1978-04-08,Tyrone Davis - I Can't Go On This Way,51,51,30,18.0,38,I Can't Go On This Way,8.0,0,8,13,0,1,up,1978-04-08
9033,Tyrone Davis,1978-04-15,Tyrone Davis - I Can't Go On This Way,38,51,24,18.0,30,I Can't Go On This Way,8.0,1,6,8,13,1,up,1978-04-08
9034,Tyrone Davis,1978-04-22,Tyrone Davis - I Can't Go On This Way,30,38,23,18.0,24,I Can't Go On This Way,8.0,2,1,6,8,1,up,1978-04-08
9035,Tyrone Davis,1978-04-29,Tyrone Davis - I Can't Go On This Way,24,30,23,18.0,23,I Can't Go On This Way,8.0,3,0,1,6,0,stay,1978-04-08
9036,Tyrone Davis,1978-05-06,Tyrone Davis - I Can't Go On This Way,23,24,18,18.0,23,I Can't Go On This Way,8.0,4,5,0,1,1,up,1978-04-08
9037,Tyrone Davis,1978-05-13,Tyrone Davis - I Can't Go On This Way,23,23,28,18.0,18,I Can't Go On This Way,8.0,5,-10,5,0,1,down,1978-04-08
9038,Tyrone Davis,1978-05-20,Tyrone Davis - I Can't Go On This Way,18,23,32,18.0,28,I Can't Go On This Way,8.0,6,-4,-10,5,1,down,1978-04-08
9039,Tyrone Davis,1978-05-27,Tyrone Davis - I Can't Go On This Way,28,18,35,18.0,32,I Can't Go On This Way,8.0,7,-3,-4,-10,1,down,1978-04-08
9040,Tyrone Davis,1978-06-03,Tyrone Davis - I Can't Go On This Way,32,28,51,18.0,35,I Can't Go On This Way,8.0,8,-16,-3,-4,1,down,1978-04-08
9041,Watsonian Institute,1978-04-08,Watsonian Institute - Master Funk,51,51,39,39.0,39,Master Funk,4.0,0,0,12,0,0,stay,1978-04-08
9042,Watsonian Institute,1978-04-15,Watsonian Institute - Master Funk,39,51,41,39.0,39,Master Funk,4.0,1,-2,0,12,1,down,1978-04-08
9043,Watsonian Institute,1978-04-22,Watsonian Institute - Master Funk,39,39,43,39.0,41,Master Funk,4.0,2,-2,-2,0,1,down,1978-04-08
9044,Watsonian Institute,1978-04-29,Watsonian Institute - Master Funk,41,39,46,39.0,43,Master Funk,4.0,3,-3,-2,-2,1,down,1978-04-08
9045,Watsonian Institute,1978-05-06,Watsonian Institute - Master Funk,43,41,51,39.0,46,Master Funk,4.0,4,-5,-3,-2,1,down,1978-04-08
9046,Johnny Mathis,1978-04-15,Johnny Mathis - You Light Up My Life,51,51,27,4.0,38,You Light Up My Life,16.0,0,11,13,0,1,up,1978-04-15
9047,Johnny Mathis,1978-04-22,Johnny Mathis - You Light Up My Life,38,51,21,4.0,27,You Light Up My Life,16.0,1,6,11,13,1,up,1978-04-15
9048,Johnny Mathis,1978-04-29,Johnny Mathis - You Light Up My Life,27,38,15,4.0,21,You Light Up My Life,16.0,2,6,6,11,1,up,1978-04-15
9049,Johnny Mathis,1978-05-06,Johnny Mathis - You Light Up My Life,21,27,11,4.0,15,You Light Up My Life,16.0,3,4,6,6,1,up,1978-04-15
9050,Johnny Mathis,1978-05-13,Johnny Mathis - You Light Up My Life,15,21,8,4.0,11,You Light Up My Life,16.0,4,3,4,6,1,up,1978-04-15
9051,Johnny Mathis,1978-05-20,Johnny Mathis - You Light Up My Life,11,15,6,4.0,8,You Light Up My Life,16.0,5,2,3,4,1,up,1978-04-15
9052,Johnny Mathis,1978-05-27,Johnny Mathis - You Light Up My Life,8,11,4,4.0,6,You Light Up My Life,16.0,6,2,2,3,1,up,1978-04-15
9053,Johnny Mathis,1978-06-03,Johnny Mathis - You Light Up My Life,6,8,4,4.0,4,You Light Up My Life,16.0,7,0,2,2,0,stay,1978-04-15
9054,Johnny Mathis,1978-06-10,Johnny Mathis - You Light Up My Life,4,6,5,4.0,4,You Light Up My Life,16.0,8,-1,0,2,1,down,1978-04-15
9055,Johnny Mathis,1978-06-17,Johnny Mathis - You Light Up My Life,4,4,6,4.0,5,You Light Up My Life,16.0,9,-1,-1,0,1,down,1978-04-15
9056,Johnny Mathis,1978-06-24,Johnny Mathis - You Light Up My Life,5,4,12,4.0,6,You Light Up My Life,16.0,10,-6,-1,-1,1,down,1978-04-15
9057,Johnny Mathis,1978-07-01,Johnny Mathis - You Light Up My Life,6,5,16,4.0,12,You Light Up My Life,16.0,11,-4,-6,-1,1,down,1978-04-15
9058,Johnny Mathis,1978-07-08,Johnny Mathis - You Light Up My Life,12,6,22,4.0,16,You Light Up My Life,16.0,12,-6,-4,-6,1,down,1978-04-15
9059,Johnny Mathis,1978-07-15,Johnny Mathis - You Light Up My Life,16,12,34,4.0,22,You Light Up My Life,16.0,13,-12,-6,-4,1,down,1978-04-15
9060,Johnny Mathis,1978-07-22,Johnny Mathis - You Light Up My Life,22,16,34,4.0,34,You Light Up My Life,16.0,14,0,-12,-6,0,stay,1978-04-15
9061,Johnny Mathis,1978-07-29,Johnny Mathis - You Light Up My Life,34,22,35,4.0,34,You Light Up My Life,16.0,15,-1,0,-12,1,down,1978-04-15
9062,Johnny Mathis,1978-08-05,Johnny Mathis - You Light Up My Life,34,34,51,4.0,35,You Light Up My Life,16.0,16,-16,-1,0,1,down,1978-04-15
9063,James Brown,1978-04-15,James Brown - Jam 1980's,51,51,36,30.0,46,Jam 1980's,17.0,0,10,5,0,1,up,1978-04-15
9064,James Brown,1978-04-22,James Brown - Jam 1980's,46,51,33,30.0,36,Jam 1980's,17.0,1,3,10,5,1,up,1978-04-15
9065,James Brown,1978-04-29,James Brown - Jam 1980's,36,46,30,30.0,33,Jam 1980's,17.0,2,3,3,10,1,up,1978-04-15
9066,James Brown,1978-05-06,James Brown - Jam 1980's,33,36,30,30.0,30,Jam 1980's,17.0,3,0,3,3,0,stay,1978-04-15
9067,James Brown,1978-05-13,James Brown - Jam 1980's,30,33,31,30.0,30,Jam 1980's,17.0,4,-1,0,3,1,down,1978-04-15
9068,James Brown,1978-05-20,James Brown - Jam 1980's,30,30,31,30.0,31,Jam 1980's,17.0,5,0,-1,0,0,stay,1978-04-15
9069,James Brown,1978-05-27,James Brown - Jam 1980's,31,30,34,30.0,31,Jam 1980's,17.0,6,-3,0,-1,1,down,1978-04-15
9070,James Brown,1978-06-03,James Brown - Jam 1980's,31,31,34,30.0,34,Jam 1980's,17.0,7,0,-3,0,0,stay,1978-04-15
9071,James Brown,1978-06-10,James Brown - Jam 1980's,34,31,38,30.0,34,Jam 1980's,17.0,8,-4,0,-3,1,down,1978-04-15
9072,James Brown,1978-06-17,James Brown - Jam 1980's,34,34,50,30.0,38,Jam 1980's,17.0,9,-12,-4,0,1,down,1978-04-15
9073,James Brown,1978-06-24,James Brown - Jam 1980's,38,34,50,30.0,50,Jam 1980's,17.0,10,0,-12,-4,0,stay,1978-04-15
9074,James Brown,1978-07-01,James Brown - Jam 1980's,50,38,45,30.0,50,Jam 1980's,17.0,11,5,0,-12,1,up,1978-04-15
9075,James Brown,1978-07-08,James Brown - Jam 1980's,50,50,35,30.0,45,Jam 1980's,17.0,12,10,5,0,1,up,1978-04-15
9076,James Brown,1978-07-15,James Brown - Jam 1980's,45,50,32,30.0,35,Jam 1980's,17.0,13,3,10,5,1,up,1978-04-15
9077,James Brown,1978-07-22,James Brown - Jam 1980's,35,45,33,30.0,32,Jam 1980's,17.0,14,-1,3,10,1,down,1978-04-15
9078,James Brown,1978-07-29,James Brown - Jam 1980's,32,35,39,30.0,33,Jam 1980's,17.0,15,-6,-1,3,1,down,1978-04-15
9079,James Brown,1978-08-05,James Brown - Jam 1980's,33,32,40,30.0,39,Jam 1980's,17.0,16,-1,-6,-1,1,down,1978-04-15
9080,James Brown,1978-08-12,James Brown - Jam 1980's,39,33,51,30.0,40,Jam 1980's,17.0,17,-11,-1,-6,1,down,1978-04-15
9081,Tower Of Power,1978-04-22,Tower Of Power - We Came To Play,51,51,34,33.0,39,We Came To Play,3.0,0,5,12,0,1,up,1978-04-22
9082,Tower Of Power,1978-04-29,Tower Of Power - We Came To Play,39,51,33,33.0,34,We Came To Play,3.0,1,1,5,12,1,up,1978-04-22
9083,Tower Of Power,1978-05-06,Tower Of Power - We Came To Play,34,39,39,33.0,33,We Came To Play,3.0,2,-6,1,5,1,down,1978-04-22
9084,Tower Of Power,1978-05-13,Tower Of Power - We Came To Play,33,34,51,33.0,39,We Came To Play,3.0,3,-12,-6,1,1,down,1978-04-22
9085,The Sundays,1978-04-22,The Sundays - Sunburn,51,51,41,21.0,43,Sunburn,25.0,0,2,8,0,1,up,1978-04-22
9086,The Sundays,1978-04-29,The Sundays - Sunburn,43,51,39,21.0,41,Sunburn,25.0,1,2,2,8,1,up,1978-04-22
9087,The Sundays,1978-05-06,The Sundays - Sunburn,41,43,46,21.0,39,Sunburn,25.0,2,-7,2,2,1,down,1978-04-22
9088,The Sundays,1978-05-13,The Sundays - Sunburn,39,41,36,21.0,46,Sunburn,25.0,3,10,-7,2,1,up,1978-04-22
9089,The Sundays,1978-05-20,The Sundays - Sunburn,46,39,28,21.0,36,Sunburn,25.0,4,8,10,-7,1,up,1978-04-22
9090,The Sundays,1978-05-27,The Sundays - Sunburn,36,46,22,21.0,28,Sunburn,25.0,5,6,8,10,1,up,1978-04-22
9091,The Sundays,1978-06-03,The Sundays - Sunburn,28,36,22,21.0,22,Sunburn,25.0,6,0,6,8,0,stay,1978-04-22
9092,The Sundays,1978-06-10,The Sundays - Sunburn,22,28,23,21.0,22,Sunburn,25.0,7,-1,0,6,1,down,1978-04-22
9093,The Sundays,1978-06-17,The Sundays - Sunburn,22,22,22,21.0,23,Sunburn,25.0,8,1,-1,0,1,up,1978-04-22
9094,The Sundays,1978-06-24,The Sundays - Sunburn,23,22,29,21.0,22,Sunburn,25.0,9,-7,1,-1,1,down,1978-04-22
9095,The Sundays,1978-07-01,The Sundays - Sunburn,22,23,30,21.0,29,Sunburn,25.0,10,-1,-7,1,1,down,1978-04-22
9096,The Sundays,1978-07-08,The Sundays - Sunburn,29,22,30,21.0,30,Sunburn,25.0,11,0,-1,-7,0,stay,1978-04-22
9097,The Sundays,1978-07-15,The Sundays - Sunburn,30,29,27,21.0,30,Sunburn,25.0,12,3,0,-1,1,up,1978-04-22
9098,The Sundays,1978-07-22,The Sundays - Sunburn,30,30,31,21.0,27,Sunburn,25.0,13,-4,3,0,1,down,1978-04-22
9099,The Sundays,1978-07-29,The Sundays - Sunburn,27,30,31,21.0,31,Sunburn,25.0,14,0,-4,3,0,stay,1978-04-22
9100,The Sundays,1978-08-05,The Sundays - Sunburn,31,27,33,21.0,31,Sunburn,25.0,15,-2,0,-4,1,down,1978-04-22
9101,The Sundays,1978-08-12,The Sundays - Sunburn,31,31,33,21.0,33,Sunburn,25.0,16,0,-2,0,0,stay,1978-04-22
9102,The Sundays,1978-08-19,The Sundays - Sunburn,33,31,24,21.0,33,Sunburn,25.0,17,9,0,-2,1,up,1978-04-22
9103,The Sundays,1978-08-26,The Sundays - Sunburn,33,33,21,21.0,24,Sunburn,25.0,18,3,9,0,1,up,1978-04-22
9104,The Sundays,1978-09-02,The Sundays - Sunburn,24,33,21,21.0,21,Sunburn,25.0,19,0,3,9,0,stay,1978-04-22
9105,The Sundays,1978-09-09,The Sundays - Sunburn,21,24,29,21.0,21,Sunburn,25.0,20,-8,0,3,1,down,1978-04-22
9106,The Sundays,1978-09-16,The Sundays - Sunburn,21,21,31,21.0,29,Sunburn,25.0,21,-2,-8,0,1,down,1978-04-22
9107,The Sundays,1978-09-23,The Sundays - Sunburn,29,21,32,21.0,31,Sunburn,25.0,22,-1,-2,-8,1,down,1978-04-22
9108,The Sundays,1978-09-30,The Sundays - Sunburn,31,29,41,21.0,32,Sunburn,25.0,23,-9,-1,-2,1,down,1978-04-22
9109,The Sundays,1978-10-07,The Sundays - Sunburn,32,31,45,21.0,41,Sunburn,25.0,24,-4,-9,-1,1,down,1978-04-22
9110,The Sundays,1978-10-14,The Sundays - Sunburn,41,32,51,21.0,45,Sunburn,25.0,25,-6,-4,-9,1,down,1978-04-22
9111,The Floaters,1978-04-22,The Floaters - Magic,51,51,35,27.0,45,Magic,7.0,0,10,6,0,1,up,1978-04-22
9112,The Floaters,1978-04-29,The Floaters - Magic,45,51,27,27.0,35,Magic,7.0,1,8,10,6,1,up,1978-04-22
9113,The Floaters,1978-05-06,The Floaters - Magic,35,45,27,27.0,27,Magic,7.0,2,0,8,10,0,stay,1978-04-22
9114,The Floaters,1978-05-13,The Floaters - Magic,27,35,30,27.0,27,Magic,7.0,3,-3,0,8,1,down,1978-04-22
9115,The Floaters,1978-05-20,The Floaters - Magic,27,27,30,27.0,30,Magic,7.0,4,0,-3,0,0,stay,1978-04-22
9116,The Floaters,1978-05-27,The Floaters - Magic,30,27,39,27.0,30,Magic,7.0,5,-9,0,-3,1,down,1978-04-22
9117,The Floaters,1978-06-03,The Floaters - Magic,30,30,47,27.0,39,Magic,7.0,6,-8,-9,0,1,down,1978-04-22
9118,The Floaters,1978-06-10,The Floaters - Magic,39,30,51,27.0,47,Magic,7.0,7,-4,-8,-9,1,down,1978-04-22
9119,Pharoah Sanders,1978-04-22,Pharoah Sanders - Love Will Find A Way,51,51,45,41.0,49,Love Will Find A Way,5.0,0,4,2,0,1,up,1978-04-22
9120,Pharoah Sanders,1978-04-29,Pharoah Sanders - Love Will Find A Way,49,51,41,41.0,45,Love Will Find A Way,5.0,1,4,4,2,1,up,1978-04-22
9121,Pharoah Sanders,1978-05-06,Pharoah Sanders - Love Will Find A Way,45,49,48,41.0,41,Love Will Find A Way,5.0,2,-7,4,4,1,down,1978-04-22
9122,Pharoah Sanders,1978-05-13,Pharoah Sanders - Love Will Find A Way,41,45,49,41.0,48,Love Will Find A Way,5.0,3,-1,-7,4,1,down,1978-04-22
9123,Pharoah Sanders,1978-05-20,Pharoah Sanders - Love Will Find A Way,48,41,50,41.0,49,Love Will Find A Way,5.0,4,-1,-1,-7,1,down,1978-04-22
9124,Pharoah Sanders,1978-05-27,Pharoah Sanders - Love Will Find A Way,49,48,51,41.0,50,Love Will Find A Way,5.0,5,-1,-1,-1,1,down,1978-04-22
9125,The Isley Brothers,1978-04-29,The Isley Brothers - Showdown,51,51,2,1.0,11,Showdown,23.0,0,9,40,0,1,up,1978-04-29
9126,The Isley Brothers,1978-05-06,The Isley Brothers - Showdown,11,51,1,1.0,2,Showdown,23.0,1,1,9,40,1,up,1978-04-29
9127,The Isley Brothers,1978-05-13,The Isley Brothers - Showdown,2,11,1,1.0,1,Showdown,23.0,2,0,1,9,0,stay,1978-04-29
9128,The Isley Brothers,1978-05-20,The Isley Brothers - Showdown,1,2,1,1.0,1,Showdown,23.0,3,0,0,1,0,stay,1978-04-29
9129,The Isley Brothers,1978-05-27,The Isley Brothers - Showdown,1,1,3,1.0,1,Showdown,23.0,4,-2,0,0,1,down,1978-04-29
9130,The Isley Brothers,1978-06-03,The Isley Brothers - Showdown,1,1,2,1.0,3,Showdown,23.0,5,1,-2,0,1,up,1978-04-29
9131,The Isley Brothers,1978-06-10,The Isley Brothers - Showdown,3,1,2,1.0,2,Showdown,23.0,6,0,1,-2,0,stay,1978-04-29
9132,The Isley Brothers,1978-06-17,The Isley Brothers - Showdown,2,3,3,1.0,2,Showdown,23.0,7,-1,0,1,1,down,1978-04-29
9133,The Isley Brothers,1978-06-24,The Isley Brothers - Showdown,2,2,3,1.0,3,Showdown,23.0,8,0,-1,0,0,stay,1978-04-29
9134,The Isley Brothers,1978-07-01,The Isley Brothers - Showdown,3,2,5,1.0,3,Showdown,23.0,9,-2,0,-1,1,down,1978-04-29
9135,The Isley Brothers,1978-07-08,The Isley Brothers - Showdown,3,3,10,1.0,5,Showdown,23.0,10,-5,-2,0,1,down,1978-04-29
9136,The Isley Brothers,1978-07-15,The Isley Brothers - Showdown,5,3,11,1.0,10,Showdown,23.0,11,-1,-5,-2,1,down,1978-04-29
9137,The Isley Brothers,1978-07-22,The Isley Brothers - Showdown,10,5,10,1.0,11,Showdown,23.0,12,1,-1,-5,1,up,1978-04-29
9138,The Isley Brothers,1978-07-29,The Isley Brothers - Showdown,11,10,9,1.0,10,Showdown,23.0,13,1,1,-1,1,up,1978-04-29
9139,The Isley Brothers,1978-08-05,The Isley Brothers - Showdown,10,11,8,1.0,9,Showdown,23.0,14,1,1,1,1,up,1978-04-29
9140,The Isley Brothers,1978-08-12,The Isley Brothers - Showdown,9,10,17,1.0,8,Showdown,23.0,15,-9,1,1,1,down,1978-04-29
9141,The Isley Brothers,1978-08-19,The Isley Brothers - Showdown,8,9,17,1.0,17,Showdown,23.0,16,0,-9,1,0,stay,1978-04-29
9142,The Isley Brothers,1978-08-26,The Isley Brothers - Showdown,17,8,23,1.0,17,Showdown,23.0,17,-6,0,-9,1,down,1978-04-29
9143,The Isley Brothers,1978-09-02,The Isley Brothers - Showdown,17,17,29,1.0,23,Showdown,23.0,18,-6,-6,0,1,down,1978-04-29
9144,The Isley Brothers,1978-09-09,The Isley Brothers - Showdown,23,17,36,1.0,29,Showdown,23.0,19,-7,-6,-6,1,down,1978-04-29
9145,The Isley Brothers,1978-09-16,The Isley Brothers - Showdown,29,23,37,1.0,36,Showdown,23.0,20,-1,-7,-6,1,down,1978-04-29
9146,The Isley Brothers,1978-09-23,The Isley Brothers - Showdown,36,29,38,1.0,37,Showdown,23.0,21,-1,-1,-7,1,down,1978-04-29
9147,The Isley Brothers,1978-09-30,The Isley Brothers - Showdown,37,36,46,1.0,38,Showdown,23.0,22,-8,-1,-1,1,down,1978-04-29
9148,The Isley Brothers,1978-10-07,The Isley Brothers - Showdown,38,37,51,1.0,46,Showdown,23.0,23,-5,-8,-1,1,down,1978-04-29
9149,Heatwave,1978-04-29,Heatwave - Central Heating,51,51,4,2.0,19,Central Heating,26.0,0,15,32,0,1,up,1978-04-29
9150,Heatwave,1978-05-06,Heatwave - Central Heating,19,51,2,2.0,4,Central Heating,26.0,1,2,15,32,1,up,1978-04-29
9151,Heatwave,1978-05-13,Heatwave - Central Heating,4,19,2,2.0,2,Central Heating,26.0,2,0,2,15,0,stay,1978-04-29
9152,Heatwave,1978-05-20,Heatwave - Central Heating,2,4,2,2.0,2,Central Heating,26.0,3,0,0,2,0,stay,1978-04-29
9153,Heatwave,1978-05-27,Heatwave - Central Heating,2,2,2,2.0,2,Central Heating,26.0,4,0,0,0,0,stay,1978-04-29
9154,Heatwave,1978-06-03,Heatwave - Central Heating,2,2,3,2.0,2,Central Heating,26.0,5,-1,0,0,1,down,1978-04-29
9155,Heatwave,1978-06-10,Heatwave - Central Heating,2,2,4,2.0,3,Central Heating,26.0,6,-1,-1,0,1,down,1978-04-29
9156,Heatwave,1978-06-17,Heatwave - Central Heating,3,2,4,2.0,4,Central Heating,26.0,7,0,-1,-1,0,stay,1978-04-29
9157,Heatwave,1978-06-24,Heatwave - Central Heating,4,3,4,2.0,4,Central Heating,26.0,8,0,0,-1,0,stay,1978-04-29
9158,Heatwave,1978-07-01,Heatwave - Central Heating,4,4,4,2.0,4,Central Heating,26.0,9,0,0,0,0,stay,1978-04-29
9159,Heatwave,1978-07-08,Heatwave - Central Heating,4,4,7,2.0,4,Central Heating,26.0,10,-3,0,0,1,down,1978-04-29
9160,Heatwave,1978-07-15,Heatwave - Central Heating,4,4,9,2.0,7,Central Heating,26.0,11,-2,-3,0,1,down,1978-04-29
9161,Heatwave,1978-07-22,Heatwave - Central Heating,7,4,9,2.0,9,Central Heating,26.0,12,0,-2,-3,0,stay,1978-04-29
9162,Heatwave,1978-07-29,Heatwave - Central Heating,9,7,8,2.0,9,Central Heating,26.0,13,1,0,-2,1,up,1978-04-29
9163,Heatwave,1978-08-05,Heatwave - Central Heating,9,9,11,2.0,8,Central Heating,26.0,14,-3,1,0,1,down,1978-04-29
9164,Heatwave,1978-08-12,Heatwave - Central Heating,8,9,19,2.0,11,Central Heating,26.0,15,-8,-3,1,1,down,1978-04-29
9165,Heatwave,1978-08-19,Heatwave - Central Heating,11,8,25,2.0,19,Central Heating,26.0,16,-6,-8,-3,1,down,1978-04-29
9166,Heatwave,1978-08-26,Heatwave - Central Heating,19,11,26,2.0,25,Central Heating,26.0,17,-1,-6,-8,1,down,1978-04-29
9167,Heatwave,1978-09-02,Heatwave - Central Heating,25,19,27,2.0,26,Central Heating,26.0,18,-1,-1,-6,1,down,1978-04-29
9168,Heatwave,1978-09-09,Heatwave - Central Heating,26,25,35,2.0,27,Central Heating,26.0,19,-8,-1,-1,1,down,1978-04-29
9169,Heatwave,1978-09-16,Heatwave - Central Heating,27,26,35,2.0,35,Central Heating,26.0,20,0,-8,-1,0,stay,1978-04-29
9170,Heatwave,1978-09-23,Heatwave - Central Heating,35,27,35,2.0,35,Central Heating,26.0,21,0,0,-8,0,stay,1978-04-29
9171,Heatwave,1978-09-30,Heatwave - Central Heating,35,35,38,2.0,35,Central Heating,26.0,22,-3,0,0,1,down,1978-04-29
9172,Heatwave,1978-10-07,Heatwave - Central Heating,35,35,40,2.0,38,Central Heating,26.0,23,-2,-3,0,1,down,1978-04-29
9173,Heatwave,1978-10-14,Heatwave - Central Heating,38,35,38,2.0,40,Central Heating,26.0,24,2,-2,-3,1,up,1978-04-29
9174,Heatwave,1978-10-21,Heatwave - Central Heating,40,38,47,2.0,38,Central Heating,26.0,25,-9,2,-2,1,down,1978-04-29
9175,Heatwave,1978-10-28,Heatwave - Central Heating,38,40,51,2.0,47,Central Heating,26.0,26,-4,-9,2,1,down,1978-04-29
9176,The O'Jays,1978-04-29,The O'Jays - So Full Of Love,51,51,9,1.0,25,So Full Of Love,27.0,0,16,26,0,1,up,1978-04-29
9177,The O'Jays,1978-05-06,The O'Jays - So Full Of Love,25,51,3,1.0,9,So Full Of Love,27.0,1,6,16,26,1,up,1978-04-29
9178,The O'Jays,1978-05-13,The O'Jays - So Full Of Love,9,25,3,1.0,3,So Full Of Love,27.0,2,0,6,16,0,stay,1978-04-29
9179,The O'Jays,1978-05-20,The O'Jays - So Full Of Love,3,9,3,1.0,3,So Full Of Love,27.0,3,0,0,6,0,stay,1978-04-29
9180,The O'Jays,1978-05-27,The O'Jays - So Full Of Love,3,3,1,1.0,3,So Full Of Love,27.0,4,2,0,0,1,up,1978-04-29
9181,The O'Jays,1978-06-03,The O'Jays - So Full Of Love,3,3,1,1.0,1,So Full Of Love,27.0,5,0,2,0,0,stay,1978-04-29
9182,The O'Jays,1978-06-10,The O'Jays - So Full Of Love,1,3,1,1.0,1,So Full Of Love,27.0,6,0,0,2,0,stay,1978-04-29
9183,The O'Jays,1978-06-17,The O'Jays - So Full Of Love,1,1,2,1.0,1,So Full Of Love,27.0,7,-1,0,0,1,down,1978-04-29
9184,The O'Jays,1978-06-24,The O'Jays - So Full Of Love,1,1,2,1.0,2,So Full Of Love,27.0,8,0,-1,0,0,stay,1978-04-29
9185,The O'Jays,1978-07-01,The O'Jays - So Full Of Love,2,1,2,1.0,2,So Full Of Love,27.0,9,0,0,-1,0,stay,1978-04-29
9186,The O'Jays,1978-07-08,The O'Jays - So Full Of Love,2,2,3,1.0,2,So Full Of Love,27.0,10,-1,0,0,1,down,1978-04-29
9187,The O'Jays,1978-07-15,The O'Jays - So Full Of Love,2,2,6,1.0,3,So Full Of Love,27.0,11,-3,-1,0,1,down,1978-04-29
9188,The O'Jays,1978-07-22,The O'Jays - So Full Of Love,3,2,7,1.0,6,So Full Of Love,27.0,12,-1,-3,-1,1,down,1978-04-29
9189,The O'Jays,1978-07-29,The O'Jays - So Full Of Love,6,3,7,1.0,7,So Full Of Love,27.0,13,0,-1,-3,0,stay,1978-04-29
9190,The O'Jays,1978-08-05,The O'Jays - So Full Of Love,7,6,7,1.0,7,So Full Of Love,27.0,14,0,0,-1,0,stay,1978-04-29
9191,The O'Jays,1978-08-12,The O'Jays - So Full Of Love,7,7,7,1.0,7,So Full Of Love,27.0,15,0,0,0,0,stay,1978-04-29
9192,The O'Jays,1978-08-19,The O'Jays - So Full Of Love,7,7,13,1.0,7,So Full Of Love,27.0,16,-6,0,0,1,down,1978-04-29
9193,The O'Jays,1978-08-26,The O'Jays - So Full Of Love,7,7,13,1.0,13,So Full Of Love,27.0,17,0,-6,0,0,stay,1978-04-29
9194,The O'Jays,1978-09-02,The O'Jays - So Full Of Love,13,7,15,1.0,13,So Full Of Love,27.0,18,-2,0,-6,1,down,1978-04-29
9195,The O'Jays,1978-09-09,The O'Jays - So Full Of Love,13,13,22,1.0,15,So Full Of Love,27.0,19,-7,-2,0,1,down,1978-04-29
9196,The O'Jays,1978-09-16,The O'Jays - So Full Of Love,15,13,22,1.0,22,So Full Of Love,27.0,20,0,-7,-2,0,stay,1978-04-29
9197,The O'Jays,1978-09-23,The O'Jays - So Full Of Love,22,15,24,1.0,22,So Full Of Love,27.0,21,-2,0,-7,1,down,1978-04-29
9198,The O'Jays,1978-09-30,The O'Jays - So Full Of Love,22,22,25,1.0,24,So Full Of Love,27.0,22,-1,-2,0,1,down,1978-04-29
9199,The O'Jays,1978-10-07,The O'Jays - So Full Of Love,24,22,26,1.0,25,So Full Of Love,27.0,23,-1,-1,-2,1,down,1978-04-29
9200,The O'Jays,1978-10-14,The O'Jays - So Full Of Love,25,24,34,1.0,26,So Full Of Love,27.0,24,-8,-1,-1,1,down,1978-04-29
9201,The O'Jays,1978-10-21,The O'Jays - So Full Of Love,26,25,36,1.0,34,So Full Of Love,27.0,25,-2,-8,-1,1,down,1978-04-29
9202,The O'Jays,1978-10-28,The O'Jays - So Full Of Love,34,26,46,1.0,36,So Full Of Love,27.0,26,-10,-2,-8,1,down,1978-04-29
9203,The O'Jays,1978-11-04,The O'Jays - So Full Of Love,36,34,51,1.0,46,So Full Of Love,27.0,27,-5,-10,-2,1,down,1978-04-29
9204,Eruption,1978-04-29,Eruption - Eruption,51,51,44,44.0,47,Eruption,2.0,0,3,4,0,1,up,1978-04-29
9205,Eruption,1978-05-06,Eruption - Eruption,47,51,44,44.0,44,Eruption,2.0,1,0,3,4,0,stay,1978-04-29
9206,Eruption,1978-05-13,Eruption - Eruption,44,47,51,44.0,44,Eruption,2.0,2,-7,0,3,1,down,1978-04-29
9207,Stanley Clarke,1978-05-06,Stanley Clarke - Modern Man,51,51,35,25.0,45,Modern Man,6.0,0,10,6,0,1,up,1978-05-06
9208,Stanley Clarke,1978-05-13,Stanley Clarke - Modern Man,45,51,27,25.0,35,Modern Man,6.0,1,8,10,6,1,up,1978-05-06
9209,Stanley Clarke,1978-05-20,Stanley Clarke - Modern Man,35,45,25,25.0,27,Modern Man,6.0,2,2,8,10,1,up,1978-05-06
9210,Stanley Clarke,1978-05-27,Stanley Clarke - Modern Man,27,35,36,25.0,25,Modern Man,6.0,3,-11,2,8,1,down,1978-05-06
9211,Stanley Clarke,1978-06-03,Stanley Clarke - Modern Man,25,27,40,25.0,36,Modern Man,6.0,4,-4,-11,2,1,down,1978-05-06
9212,Stanley Clarke,1978-06-10,Stanley Clarke - Modern Man,36,25,40,25.0,40,Modern Man,6.0,5,0,-4,-11,0,stay,1978-05-06
9213,Stanley Clarke,1978-06-17,Stanley Clarke - Modern Man,40,36,51,25.0,40,Modern Man,6.0,6,-11,0,-4,1,down,1978-05-06
9214,Lonnie Liston Smith,1978-05-06,Lonnie Liston Smith - Loveland,51,51,37,37.0,47,Loveland,6.0,0,10,4,0,1,up,1978-05-06
9215,Lonnie Liston Smith,1978-05-13,Lonnie Liston Smith - Loveland,47,51,37,37.0,37,Loveland,6.0,1,0,10,4,0,stay,1978-05-06
9216,Lonnie Liston Smith,1978-05-20,Lonnie Liston Smith - Loveland,37,47,43,37.0,37,Loveland,6.0,2,-6,0,10,1,down,1978-05-06
9217,Lonnie Liston Smith,1978-05-27,Lonnie Liston Smith - Loveland,37,37,43,37.0,43,Loveland,6.0,3,0,-6,0,0,stay,1978-05-06
9218,Lonnie Liston Smith,1978-06-03,Lonnie Liston Smith - Loveland,43,37,48,37.0,43,Loveland,6.0,4,-5,0,-6,1,down,1978-05-06
9219,Lonnie Liston Smith,1978-06-10,Lonnie Liston Smith - Loveland,43,43,48,37.0,48,Loveland,6.0,5,0,-5,0,0,stay,1978-05-06
9220,Lonnie Liston Smith,1978-06-17,Lonnie Liston Smith - Loveland,48,43,51,37.0,48,Loveland,6.0,6,-3,0,-5,1,down,1978-05-06
9221,Johnnie Taylor,1978-05-06,Johnnie Taylor - Ever Ready,51,51,40,35.0,49,Ever Ready,5.0,0,9,2,0,1,up,1978-05-06
9222,Johnnie Taylor,1978-05-13,Johnnie Taylor - Ever Ready,49,51,35,35.0,40,Ever Ready,5.0,1,5,9,2,1,up,1978-05-06
9223,Johnnie Taylor,1978-05-20,Johnnie Taylor - Ever Ready,40,49,45,35.0,35,Ever Ready,5.0,2,-10,5,9,1,down,1978-05-06
9224,Johnnie Taylor,1978-05-27,Johnnie Taylor - Ever Ready,35,40,45,35.0,45,Ever Ready,5.0,3,0,-10,5,0,stay,1978-05-06
9225,Johnnie Taylor,1978-06-03,Johnnie Taylor - Ever Ready,45,35,44,35.0,45,Ever Ready,5.0,4,1,0,-10,1,up,1978-05-06
9226,Johnnie Taylor,1978-06-10,Johnnie Taylor - Ever Ready,45,45,51,35.0,44,Ever Ready,5.0,5,-7,1,0,1,down,1978-05-06
9227,Aretha Franklin,1978-05-13,Aretha Franklin - Almighty Fire,51,51,20,12.0,26,Almighty Fire,10.0,0,6,25,0,1,up,1978-05-13
9228,Aretha Franklin,1978-05-20,Aretha Franklin - Almighty Fire,26,51,16,12.0,20,Almighty Fire,10.0,1,4,6,25,1,up,1978-05-13
9229,Aretha Franklin,1978-05-27,Aretha Franklin - Almighty Fire,20,26,12,12.0,16,Almighty Fire,10.0,2,4,4,6,1,up,1978-05-13
9230,Aretha Franklin,1978-06-03,Aretha Franklin - Almighty Fire,16,20,12,12.0,12,Almighty Fire,10.0,3,0,4,4,0,stay,1978-05-13
9231,Aretha Franklin,1978-06-10,Aretha Franklin - Almighty Fire,12,16,12,12.0,12,Almighty Fire,10.0,4,0,0,4,0,stay,1978-05-13
9232,Aretha Franklin,1978-06-17,Aretha Franklin - Almighty Fire,12,12,16,12.0,12,Almighty Fire,10.0,5,-4,0,0,1,down,1978-05-13
9233,Aretha Franklin,1978-06-24,Aretha Franklin - Almighty Fire,12,12,38,12.0,16,Almighty Fire,10.0,6,-22,-4,0,1,down,1978-05-13
9234,Aretha Franklin,1978-07-01,Aretha Franklin - Almighty Fire,16,12,38,12.0,38,Almighty Fire,10.0,7,0,-22,-4,0,stay,1978-05-13
9235,Aretha Franklin,1978-07-08,Aretha Franklin - Almighty Fire,38,16,40,12.0,38,Almighty Fire,10.0,8,-2,0,-22,1,down,1978-05-13
9236,Aretha Franklin,1978-07-15,Aretha Franklin - Almighty Fire,38,38,49,12.0,40,Almighty Fire,10.0,9,-9,-2,0,1,down,1978-05-13
9237,Aretha Franklin,1978-07-22,Aretha Franklin - Almighty Fire,40,38,51,12.0,49,Almighty Fire,10.0,10,-2,-9,-2,1,down,1978-05-13
9238,The Dramatics,1978-05-13,The Dramatics - Do What You Wanna Do,51,51,21,6.0,28,Do What You Wanna Do,21.0,0,7,23,0,1,up,1978-05-13
9239,The Dramatics,1978-05-20,The Dramatics - Do What You Wanna Do,28,51,15,6.0,21,Do What You Wanna Do,21.0,1,6,7,23,1,up,1978-05-13
9240,The Dramatics,1978-05-27,The Dramatics - Do What You Wanna Do,21,28,7,6.0,15,Do What You Wanna Do,21.0,2,8,6,7,1,up,1978-05-13
9241,The Dramatics,1978-06-03,The Dramatics - Do What You Wanna Do,15,21,6,6.0,7,Do What You Wanna Do,21.0,3,1,8,6,1,up,1978-05-13
9242,The Dramatics,1978-06-10,The Dramatics - Do What You Wanna Do,7,15,6,6.0,6,Do What You Wanna Do,21.0,4,0,1,8,0,stay,1978-05-13
9243,The Dramatics,1978-06-17,The Dramatics - Do What You Wanna Do,6,7,8,6.0,6,Do What You Wanna Do,21.0,5,-2,0,1,1,down,1978-05-13
9244,The Dramatics,1978-06-24,The Dramatics - Do What You Wanna Do,6,6,8,6.0,8,Do What You Wanna Do,21.0,6,0,-2,0,0,stay,1978-05-13
9245,The Dramatics,1978-07-01,The Dramatics - Do What You Wanna Do,8,6,14,6.0,8,Do What You Wanna Do,21.0,7,-6,0,-2,1,down,1978-05-13
9246,The Dramatics,1978-07-08,The Dramatics - Do What You Wanna Do,8,8,17,6.0,14,Do What You Wanna Do,21.0,8,-3,-6,0,1,down,1978-05-13
9247,The Dramatics,1978-07-15,The Dramatics - Do What You Wanna Do,14,8,18,6.0,17,Do What You Wanna Do,21.0,9,-1,-3,-6,1,down,1978-05-13
9248,The Dramatics,1978-07-22,The Dramatics - Do What You Wanna Do,17,14,22,6.0,18,Do What You Wanna Do,21.0,10,-4,-1,-3,1,down,1978-05-13
9249,The Dramatics,1978-07-29,The Dramatics - Do What You Wanna Do,18,17,25,6.0,22,Do What You Wanna Do,21.0,11,-3,-4,-1,1,down,1978-05-13
9250,The Dramatics,1978-08-05,The Dramatics - Do What You Wanna Do,22,18,26,6.0,25,Do What You Wanna Do,21.0,12,-1,-3,-4,1,down,1978-05-13
9251,The Dramatics,1978-08-12,The Dramatics - Do What You Wanna Do,25,22,32,6.0,26,Do What You Wanna Do,21.0,13,-6,-1,-3,1,down,1978-05-13
9252,The Dramatics,1978-08-19,The Dramatics - Do What You Wanna Do,26,25,33,6.0,32,Do What You Wanna Do,21.0,14,-1,-6,-1,1,down,1978-05-13
9253,The Dramatics,1978-08-26,The Dramatics - Do What You Wanna Do,32,26,37,6.0,33,Do What You Wanna Do,21.0,15,-4,-1,-6,1,down,1978-05-13
9254,The Dramatics,1978-09-02,The Dramatics - Do What You Wanna Do,33,32,38,6.0,37,Do What You Wanna Do,21.0,16,-1,-4,-1,1,down,1978-05-13
9255,The Dramatics,1978-09-09,The Dramatics - Do What You Wanna Do,37,33,42,6.0,38,Do What You Wanna Do,21.0,17,-4,-1,-4,1,down,1978-05-13
9256,The Dramatics,1978-09-16,The Dramatics - Do What You Wanna Do,38,37,47,6.0,42,Do What You Wanna Do,21.0,18,-5,-4,-1,1,down,1978-05-13
9257,The Dramatics,1978-09-23,The Dramatics - Do What You Wanna Do,42,38,47,6.0,47,Do What You Wanna Do,21.0,19,0,-5,-4,0,stay,1978-05-13
9258,The Dramatics,1978-09-30,The Dramatics - Do What You Wanna Do,47,42,48,6.0,47,Do What You Wanna Do,21.0,20,-1,0,-5,1,down,1978-05-13
9259,The Dramatics,1978-10-14,The Dramatics - Do What You Wanna Do,47,47,51,6.0,48,Do What You Wanna Do,21.0,21,-3,-1,0,1,down,1978-05-13
9260,Soundtrack,1978-05-13,Soundtrack - Thank God It's Friday,51,51,24,6.0,32,Thank God It's Friday,16.0,0,8,19,0,1,up,1978-05-13
9261,Soundtrack,1978-05-20,Soundtrack - Thank God It's Friday,32,51,18,6.0,24,Thank God It's Friday,16.0,1,6,8,19,1,up,1978-05-13
9262,Soundtrack,1978-05-27,Soundtrack - Thank God It's Friday,24,32,14,6.0,18,Thank God It's Friday,16.0,2,4,6,8,1,up,1978-05-13
9263,Soundtrack,1978-06-03,Soundtrack - Thank God It's Friday,18,24,11,6.0,14,Thank God It's Friday,16.0,3,3,4,6,1,up,1978-05-13
9264,Soundtrack,1978-06-10,Soundtrack - Thank God It's Friday,14,18,9,6.0,11,Thank God It's Friday,16.0,4,2,3,4,1,up,1978-05-13
9265,Soundtrack,1978-06-17,Soundtrack - Thank God It's Friday,11,14,7,6.0,9,Thank God It's Friday,16.0,5,2,2,3,1,up,1978-05-13
9266,Soundtrack,1978-06-24,Soundtrack - Thank God It's Friday,9,11,6,6.0,7,Thank God It's Friday,16.0,6,1,2,2,1,up,1978-05-13
9267,Soundtrack,1978-07-01,Soundtrack - Thank God It's Friday,7,9,12,6.0,6,Thank God It's Friday,16.0,7,-6,1,2,1,down,1978-05-13
9268,Soundtrack,1978-07-08,Soundtrack - Thank God It's Friday,6,7,12,6.0,12,Thank God It's Friday,16.0,8,0,-6,1,0,stay,1978-05-13
9269,Soundtrack,1978-07-15,Soundtrack - Thank God It's Friday,12,6,14,6.0,12,Thank God It's Friday,16.0,9,-2,0,-6,1,down,1978-05-13
9270,Soundtrack,1978-07-22,Soundtrack - Thank God It's Friday,12,12,16,6.0,14,Thank God It's Friday,16.0,10,-2,-2,0,1,down,1978-05-13
9271,Soundtrack,1978-07-29,Soundtrack - Thank God It's Friday,14,12,17,6.0,16,Thank God It's Friday,16.0,11,-1,-2,-2,1,down,1978-05-13
9272,Soundtrack,1978-08-05,Soundtrack - Thank God It's Friday,16,14,23,6.0,17,Thank God It's Friday,16.0,12,-6,-1,-2,1,down,1978-05-13
9273,Soundtrack,1978-08-12,Soundtrack - Thank God It's Friday,17,16,30,6.0,23,Thank God It's Friday,16.0,13,-7,-6,-1,1,down,1978-05-13
9274,Soundtrack,1978-08-19,Soundtrack - Thank God It's Friday,23,17,42,6.0,30,Thank God It's Friday,16.0,14,-12,-7,-6,1,down,1978-05-13
9275,Soundtrack,1978-08-26,Soundtrack - Thank God It's Friday,30,23,43,6.0,42,Thank God It's Friday,16.0,15,-1,-12,-7,1,down,1978-05-13
9276,Soundtrack,1978-09-02,Soundtrack - Thank God It's Friday,42,30,51,6.0,43,Thank God It's Friday,16.0,16,-8,-1,-12,1,down,1978-05-13
9277,Pleasure,1978-05-13,Pleasure - Get To The Feeling,51,51,42,42.0,45,Get To The Feeling,4.0,0,3,6,0,1,up,1978-05-13
9278,Pleasure,1978-05-20,Pleasure - Get To The Feeling,45,51,42,42.0,42,Get To The Feeling,4.0,1,0,3,6,0,stay,1978-05-13
9279,Pleasure,1978-05-27,Pleasure - Get To The Feeling,42,45,46,42.0,42,Get To The Feeling,4.0,2,-4,0,3,1,down,1978-05-13
9280,Pleasure,1978-06-03,Pleasure - Get To The Feeling,42,42,46,42.0,46,Get To The Feeling,4.0,3,0,-4,0,0,stay,1978-05-13
9281,Pleasure,1978-06-10,Pleasure - Get To The Feeling,46,42,51,42.0,46,Get To The Feeling,4.0,4,-5,0,-4,1,down,1978-05-13
9282,B.B. King,1978-05-13,B.B. King - Midnight Believer,51,51,45,27.0,49,Midnight Believer,22.0,0,4,2,0,1,up,1978-05-13
9283,B.B. King,1978-05-20,B.B. King - Midnight Believer,49,51,41,27.0,45,Midnight Believer,22.0,1,4,4,2,1,up,1978-05-13
9284,B.B. King,1978-05-27,B.B. King - Midnight Believer,45,49,31,27.0,41,Midnight Believer,22.0,2,10,4,4,1,up,1978-05-13
9285,B.B. King,1978-06-03,B.B. King - Midnight Believer,41,45,31,27.0,31,Midnight Believer,22.0,3,0,10,4,0,stay,1978-05-13
9286,B.B. King,1978-06-10,B.B. King - Midnight Believer,31,41,28,27.0,31,Midnight Believer,22.0,4,3,0,10,1,up,1978-05-13
9287,B.B. King,1978-06-17,B.B. King - Midnight Believer,31,31,28,27.0,28,Midnight Believer,22.0,5,0,3,0,0,stay,1978-05-13
9288,B.B. King,1978-06-24,B.B. King - Midnight Believer,28,31,31,27.0,28,Midnight Believer,22.0,6,-3,0,3,1,down,1978-05-13
9289,B.B. King,1978-07-01,B.B. King - Midnight Believer,28,28,31,27.0,31,Midnight Believer,22.0,7,0,-3,0,0,stay,1978-05-13
9290,B.B. King,1978-07-08,B.B. King - Midnight Believer,31,28,29,27.0,31,Midnight Believer,22.0,8,2,0,-3,1,up,1978-05-13
9291,B.B. King,1978-07-15,B.B. King - Midnight Believer,31,31,30,27.0,29,Midnight Believer,22.0,9,-1,2,0,1,down,1978-05-13
9292,B.B. King,1978-07-22,B.B. King - Midnight Believer,29,31,27,27.0,30,Midnight Believer,22.0,10,3,-1,2,1,up,1978-05-13
9293,B.B. King,1978-07-29,B.B. King - Midnight Believer,30,29,30,27.0,27,Midnight Believer,22.0,11,-3,3,-1,1,down,1978-05-13
9294,B.B. King,1978-08-05,B.B. King - Midnight Believer,27,30,36,27.0,30,Midnight Believer,22.0,12,-6,-3,3,1,down,1978-05-13
9295,B.B. King,1978-08-12,B.B. King - Midnight Believer,30,27,39,27.0,36,Midnight Believer,22.0,13,-3,-6,-3,1,down,1978-05-13
9296,B.B. King,1978-08-19,B.B. King - Midnight Believer,36,30,39,27.0,39,Midnight Believer,22.0,14,0,-3,-6,0,stay,1978-05-13
9297,B.B. King,1978-08-26,B.B. King - Midnight Believer,39,36,41,27.0,39,Midnight Believer,22.0,15,-2,0,-3,1,down,1978-05-13
9298,B.B. King,1978-09-02,B.B. King - Midnight Believer,39,39,41,27.0,41,Midnight Believer,22.0,16,0,-2,0,0,stay,1978-05-13
9299,B.B. King,1978-09-09,B.B. King - Midnight Believer,41,39,41,27.0,41,Midnight Believer,22.0,17,0,0,-2,0,stay,1978-05-13
9300,B.B. King,1978-09-16,B.B. King - Midnight Believer,41,41,42,27.0,41,Midnight Believer,22.0,18,-1,0,0,1,down,1978-05-13
9301,B.B. King,1978-09-23,B.B. King - Midnight Believer,41,41,42,27.0,42,Midnight Believer,22.0,19,0,-1,0,0,stay,1978-05-13
9302,B.B. King,1978-09-30,B.B. King - Midnight Believer,42,41,43,27.0,42,Midnight Believer,22.0,20,-1,0,-1,1,down,1978-05-13
9303,B.B. King,1978-10-07,B.B. King - Midnight Believer,42,42,43,27.0,43,Midnight Believer,22.0,21,0,-1,0,0,stay,1978-05-13
9304,B.B. King,1978-10-14,B.B. King - Midnight Believer,43,42,51,27.0,43,Midnight Believer,22.0,22,-8,0,-1,1,down,1978-05-13
9305,Linda Clifford,1978-05-20,Linda Clifford - If My Friends Could See Me Now,51,51,36,9.0,46,If My Friends Could See Me Now,19.0,0,10,5,0,1,up,1978-05-20
9306,Linda Clifford,1978-05-27,Linda Clifford - If My Friends Could See Me Now,46,51,28,9.0,36,If My Friends Could See Me Now,19.0,1,8,10,5,1,up,1978-05-20
9307,Linda Clifford,1978-06-03,Linda Clifford - If My Friends Could See Me Now,36,46,26,9.0,28,If My Friends Could See Me Now,19.0,2,2,8,10,1,up,1978-05-20
9308,Linda Clifford,1978-06-10,Linda Clifford - If My Friends Could See Me Now,28,36,20,9.0,26,If My Friends Could See Me Now,19.0,3,6,2,8,1,up,1978-05-20
9309,Linda Clifford,1978-06-17,Linda Clifford - If My Friends Could See Me Now,26,28,11,9.0,20,If My Friends Could See Me Now,19.0,4,9,6,2,1,up,1978-05-20
9310,Linda Clifford,1978-06-24,Linda Clifford - If My Friends Could See Me Now,20,26,9,9.0,11,If My Friends Could See Me Now,19.0,5,2,9,6,1,up,1978-05-20
9311,Linda Clifford,1978-07-01,Linda Clifford - If My Friends Could See Me Now,11,20,9,9.0,9,If My Friends Could See Me Now,19.0,6,0,2,9,0,stay,1978-05-20
9312,Linda Clifford,1978-07-08,Linda Clifford - If My Friends Could See Me Now,9,11,9,9.0,9,If My Friends Could See Me Now,19.0,7,0,0,2,0,stay,1978-05-20
9313,Linda Clifford,1978-07-15,Linda Clifford - If My Friends Could See Me Now,9,9,10,9.0,9,If My Friends Could See Me Now,19.0,8,-1,0,0,1,down,1978-05-20
9314,Linda Clifford,1978-07-22,Linda Clifford - If My Friends Could See Me Now,9,9,13,9.0,10,If My Friends Could See Me Now,19.0,9,-3,-1,0,1,down,1978-05-20
9315,Linda Clifford,1978-07-29,Linda Clifford - If My Friends Could See Me Now,10,9,13,9.0,13,If My Friends Could See Me Now,19.0,10,0,-3,-1,0,stay,1978-05-20
9316,Linda Clifford,1978-08-05,Linda Clifford - If My Friends Could See Me Now,13,10,13,9.0,13,If My Friends Could See Me Now,19.0,11,0,0,-3,0,stay,1978-05-20
9317,Linda Clifford,1978-08-12,Linda Clifford - If My Friends Could See Me Now,13,13,18,9.0,13,If My Friends Could See Me Now,19.0,12,-5,0,0,1,down,1978-05-20
9318,Linda Clifford,1978-08-19,Linda Clifford - If My Friends Could See Me Now,13,13,18,9.0,18,If My Friends Could See Me Now,19.0,13,0,-5,0,0,stay,1978-05-20
9319,Linda Clifford,1978-08-26,Linda Clifford - If My Friends Could See Me Now,18,13,27,9.0,18,If My Friends Could See Me Now,19.0,14,-9,0,-5,1,down,1978-05-20
9320,Linda Clifford,1978-09-02,Linda Clifford - If My Friends Could See Me Now,18,18,35,9.0,27,If My Friends Could See Me Now,19.0,15,-8,-9,0,1,down,1978-05-20
9321,Linda Clifford,1978-09-09,Linda Clifford - If My Friends Could See Me Now,27,18,45,9.0,35,If My Friends Could See Me Now,19.0,16,-10,-8,-9,1,down,1978-05-20
9322,Linda Clifford,1978-09-16,Linda Clifford - If My Friends Could See Me Now,35,27,46,9.0,45,If My Friends Could See Me Now,19.0,17,-1,-10,-8,1,down,1978-05-20
9323,Linda Clifford,1978-09-23,Linda Clifford - If My Friends Could See Me Now,45,35,48,9.0,46,If My Friends Could See Me Now,19.0,18,-2,-1,-10,1,down,1978-05-20
9324,Linda Clifford,1978-09-30,Linda Clifford - If My Friends Could See Me Now,46,45,51,9.0,48,If My Friends Could See Me Now,19.0,19,-3,-2,-1,1,down,1978-05-20
9325,Norman Connors,1978-05-20,Norman Connors - This Is Your Life,51,51,38,20.0,48,This Is Your Life,21.0,0,10,3,0,1,up,1978-05-20
9326,Norman Connors,1978-05-27,Norman Connors - This Is Your Life,48,51,30,20.0,38,This Is Your Life,21.0,1,8,10,3,1,up,1978-05-20
9327,Norman Connors,1978-06-03,Norman Connors - This Is Your Life,38,48,28,20.0,30,This Is Your Life,21.0,2,2,8,10,1,up,1978-05-20
9328,Norman Connors,1978-06-10,Norman Connors - This Is Your Life,30,38,24,20.0,28,This Is Your Life,21.0,3,4,2,8,1,up,1978-05-20
9329,Norman Connors,1978-06-17,Norman Connors - This Is Your Life,28,30,20,20.0,24,This Is Your Life,21.0,4,4,4,2,1,up,1978-05-20
9330,Norman Connors,1978-06-24,Norman Connors - This Is Your Life,24,28,21,20.0,20,This Is Your Life,21.0,5,-1,4,4,1,down,1978-05-20
9331,Norman Connors,1978-07-01,Norman Connors - This Is Your Life,20,24,24,20.0,21,This Is Your Life,21.0,6,-3,-1,4,1,down,1978-05-20
9332,Norman Connors,1978-07-08,Norman Connors - This Is Your Life,21,20,24,20.0,24,This Is Your Life,21.0,7,0,-3,-1,0,stay,1978-05-20
9333,Norman Connors,1978-07-15,Norman Connors - This Is Your Life,24,21,20,20.0,24,This Is Your Life,21.0,8,4,0,-3,1,up,1978-05-20
9334,Norman Connors,1978-07-22,Norman Connors - This Is Your Life,24,24,21,20.0,20,This Is Your Life,21.0,9,-1,4,0,1,down,1978-05-20
9335,Norman Connors,1978-07-29,Norman Connors - This Is Your Life,20,24,27,20.0,21,This Is Your Life,21.0,10,-6,-1,4,1,down,1978-05-20
9336,Norman Connors,1978-08-05,Norman Connors - This Is Your Life,21,20,29,20.0,27,This Is Your Life,21.0,11,-2,-6,-1,1,down,1978-05-20
9337,Norman Connors,1978-08-12,Norman Connors - This Is Your Life,27,21,29,20.0,29,This Is Your Life,21.0,12,0,-2,-6,0,stay,1978-05-20
9338,Norman Connors,1978-08-19,Norman Connors - This Is Your Life,29,27,32,20.0,29,This Is Your Life,21.0,13,-3,0,-2,1,down,1978-05-20
9339,Norman Connors,1978-08-26,Norman Connors - This Is Your Life,29,29,33,20.0,32,This Is Your Life,21.0,14,-1,-3,0,1,down,1978-05-20
9340,Norman Connors,1978-09-02,Norman Connors - This Is Your Life,32,29,33,20.0,33,This Is Your Life,21.0,15,0,-1,-3,0,stay,1978-05-20
9341,Norman Connors,1978-09-09,Norman Connors - This Is Your Life,33,32,34,20.0,33,This Is Your Life,21.0,16,-1,0,-1,1,down,1978-05-20
9342,Norman Connors,1978-09-16,Norman Connors - This Is Your Life,33,33,40,20.0,34,This Is Your Life,21.0,17,-6,-1,0,1,down,1978-05-20
9343,Norman Connors,1978-09-23,Norman Connors - This Is Your Life,34,33,43,20.0,40,This Is Your Life,21.0,18,-3,-6,-1,1,down,1978-05-20
9344,Norman Connors,1978-09-30,Norman Connors - This Is Your Life,40,34,45,20.0,43,This Is Your Life,21.0,19,-2,-3,-6,1,down,1978-05-20
9345,Norman Connors,1978-10-07,Norman Connors - This Is Your Life,43,40,47,20.0,45,This Is Your Life,21.0,20,-2,-2,-3,1,down,1978-05-20
9346,Norman Connors,1978-10-14,Norman Connors - This Is Your Life,45,43,51,20.0,47,This Is Your Life,21.0,21,-4,-2,-2,1,down,1978-05-20
9347,David Oliver,1978-05-20,David Oliver - David Oliver,51,51,40,18.0,50,David Oliver,9.0,0,10,1,0,1,up,1978-05-20
9348,David Oliver,1978-05-27,David Oliver - David Oliver,50,51,32,18.0,40,David Oliver,9.0,1,8,10,1,1,up,1978-05-20
9349,David Oliver,1978-06-03,David Oliver - David Oliver,40,50,24,18.0,32,David Oliver,9.0,2,8,8,10,1,up,1978-05-20
9350,David Oliver,1978-06-10,David Oliver - David Oliver,32,40,18,18.0,24,David Oliver,9.0,3,6,8,8,1,up,1978-05-20
9351,David Oliver,1978-06-17,David Oliver - David Oliver,24,32,18,18.0,18,David Oliver,9.0,4,0,6,8,0,stay,1978-05-20
9352,David Oliver,1978-06-24,David Oliver - David Oliver,18,24,24,18.0,18,David Oliver,9.0,5,-6,0,6,1,down,1978-05-20
9353,David Oliver,1978-07-01,David Oliver - David Oliver,18,18,28,18.0,24,David Oliver,9.0,6,-4,-6,0,1,down,1978-05-20
9354,David Oliver,1978-07-08,David Oliver - David Oliver,24,18,36,18.0,28,David Oliver,9.0,7,-8,-4,-6,1,down,1978-05-20
9355,David Oliver,1978-07-15,David Oliver - David Oliver,28,24,50,18.0,36,David Oliver,9.0,8,-14,-8,-4,1,down,1978-05-20
9356,David Oliver,1978-07-22,David Oliver - David Oliver,36,28,51,18.0,50,David Oliver,9.0,9,-1,-14,-8,1,down,1978-05-20
9357,Spyro Gyra,1978-05-27,Spyro Gyra - Spyro Gyra,51,51,48,48.0,49,Spyro Gyra,2.0,0,1,2,0,1,up,1978-05-27
9358,Spyro Gyra,1978-06-03,Spyro Gyra - Spyro Gyra,49,51,49,48.0,48,Spyro Gyra,2.0,1,-1,1,2,1,down,1978-05-27
9359,Spyro Gyra,1978-06-10,Spyro Gyra - Spyro Gyra,48,49,51,48.0,49,Spyro Gyra,2.0,2,-2,-1,1,1,down,1978-05-27
9360,Commodores,1978-06-03,Commodores - Natural High,51,51,5,1.0,13,Natural High,26.0,0,8,38,0,1,up,1978-06-03
9361,Commodores,1978-06-10,Commodores - Natural High,13,51,3,1.0,5,Natural High,26.0,1,2,8,38,1,up,1978-06-03
9362,Commodores,1978-06-17,Commodores - Natural High,5,13,1,1.0,3,Natural High,26.0,2,2,2,8,1,up,1978-06-03
9363,Commodores,1978-06-24,Commodores - Natural High,3,5,1,1.0,1,Natural High,26.0,3,0,2,2,0,stay,1978-06-03
9364,Commodores,1978-07-01,Commodores - Natural High,1,3,1,1.0,1,Natural High,26.0,4,0,0,2,0,stay,1978-06-03
9365,Commodores,1978-07-08,Commodores - Natural High,1,1,1,1.0,1,Natural High,26.0,5,0,0,0,0,stay,1978-06-03
9366,Commodores,1978-07-15,Commodores - Natural High,1,1,1,1.0,1,Natural High,26.0,6,0,0,0,0,stay,1978-06-03
9367,Commodores,1978-07-22,Commodores - Natural High,1,1,1,1.0,1,Natural High,26.0,7,0,0,0,0,stay,1978-06-03
9368,Commodores,1978-07-29,Commodores - Natural High,1,1,1,1.0,1,Natural High,26.0,8,0,0,0,0,stay,1978-06-03
9369,Commodores,1978-08-05,Commodores - Natural High,1,1,2,1.0,1,Natural High,26.0,9,-1,0,0,1,down,1978-06-03
9370,Commodores,1978-08-12,Commodores - Natural High,1,1,2,1.0,2,Natural High,26.0,10,0,-1,0,0,stay,1978-06-03
9371,Commodores,1978-08-19,Commodores - Natural High,2,1,1,1.0,2,Natural High,26.0,11,1,0,-1,1,up,1978-06-03
9372,Commodores,1978-08-26,Commodores - Natural High,2,2,4,1.0,1,Natural High,26.0,12,-3,1,0,1,down,1978-06-03
9373,Commodores,1978-09-02,Commodores - Natural High,1,2,3,1.0,4,Natural High,26.0,13,1,-3,1,1,up,1978-06-03
9374,Commodores,1978-09-09,Commodores - Natural High,4,1,2,1.0,3,Natural High,26.0,14,1,1,-3,1,up,1978-06-03
9375,Commodores,1978-09-16,Commodores - Natural High,3,4,5,1.0,2,Natural High,26.0,15,-3,1,1,1,down,1978-06-03
9376,Commodores,1978-09-23,Commodores - Natural High,2,3,9,1.0,5,Natural High,26.0,16,-4,-3,1,1,down,1978-06-03
9377,Commodores,1978-09-30,Commodores - Natural High,5,2,9,1.0,9,Natural High,26.0,17,0,-4,-3,0,stay,1978-06-03
9378,Commodores,1978-10-07,Commodores - Natural High,9,5,14,1.0,9,Natural High,26.0,18,-5,0,-4,1,down,1978-06-03
9379,Commodores,1978-10-14,Commodores - Natural High,9,9,16,1.0,14,Natural High,26.0,19,-2,-5,0,1,down,1978-06-03
9380,Commodores,1978-10-21,Commodores - Natural High,14,9,17,1.0,16,Natural High,26.0,20,-1,-2,-5,1,down,1978-06-03
9381,Commodores,1978-10-28,Commodores - Natural High,16,14,17,1.0,17,Natural High,26.0,21,0,-1,-2,0,stay,1978-06-03
9382,Commodores,1978-11-04,Commodores - Natural High,17,16,22,1.0,17,Natural High,26.0,22,-5,0,-1,1,down,1978-06-03
9383,Commodores,1978-11-11,Commodores - Natural High,17,17,25,1.0,22,Natural High,26.0,23,-3,-5,0,1,down,1978-06-03
9384,Commodores,1978-11-18,Commodores - Natural High,22,17,29,1.0,25,Natural High,26.0,24,-4,-3,-5,1,down,1978-06-03
9385,Commodores,1978-11-25,Commodores - Natural High,25,22,35,1.0,29,Natural High,26.0,25,-6,-4,-3,1,down,1978-06-03
9386,Commodores,1978-12-02,Commodores - Natural High,29,25,51,1.0,35,Natural High,26.0,26,-16,-6,-4,1,down,1978-06-03
9387,George Duke,1978-06-03,George Duke - Don't Let Go,51,51,9,5.0,21,Don't Let Go,15.0,0,12,30,0,1,up,1978-06-03
9388,George Duke,1978-06-10,George Duke - Don't Let Go,21,51,7,5.0,9,Don't Let Go,15.0,1,2,12,30,1,up,1978-06-03
9389,George Duke,1978-06-17,George Duke - Don't Let Go,9,21,5,5.0,7,Don't Let Go,15.0,2,2,2,12,1,up,1978-06-03
9390,George Duke,1978-06-24,George Duke - Don't Let Go,7,9,5,5.0,5,Don't Let Go,15.0,3,0,2,2,0,stay,1978-06-03
9391,George Duke,1978-07-01,George Duke - Don't Let Go,5,7,11,5.0,5,Don't Let Go,15.0,4,-6,0,2,1,down,1978-06-03
9392,George Duke,1978-07-08,George Duke - Don't Let Go,5,5,15,5.0,11,Don't Let Go,15.0,5,-4,-6,0,1,down,1978-06-03
9393,George Duke,1978-07-15,George Duke - Don't Let Go,11,5,16,5.0,15,Don't Let Go,15.0,6,-1,-4,-6,1,down,1978-06-03
9394,George Duke,1978-07-22,George Duke - Don't Let Go,15,11,19,5.0,16,Don't Let Go,15.0,7,-3,-1,-4,1,down,1978-06-03
9395,George Duke,1978-07-29,George Duke - Don't Let Go,16,15,19,5.0,19,Don't Let Go,15.0,8,0,-3,-1,0,stay,1978-06-03
9396,George Duke,1978-08-05,George Duke - Don't Let Go,19,16,21,5.0,19,Don't Let Go,15.0,9,-2,0,-3,1,down,1978-06-03
9397,George Duke,1978-08-12,George Duke - Don't Let Go,19,19,21,5.0,21,Don't Let Go,15.0,10,0,-2,0,0,stay,1978-06-03
9398,George Duke,1978-08-19,George Duke - Don't Let Go,21,19,27,5.0,21,Don't Let Go,15.0,11,-6,0,-2,1,down,1978-06-03
9399,George Duke,1978-08-26,George Duke - Don't Let Go,21,21,34,5.0,27,Don't Let Go,15.0,12,-7,-6,0,1,down,1978-06-03
9400,George Duke,1978-09-02,George Duke - Don't Let Go,27,21,43,5.0,34,Don't Let Go,15.0,13,-9,-7,-6,1,down,1978-06-03
9401,George Duke,1978-09-09,George Duke - Don't Let Go,34,27,47,5.0,43,Don't Let Go,15.0,14,-4,-9,-7,1,down,1978-06-03
9402,George Duke,1978-09-16,George Duke - Don't Let Go,43,34,51,5.0,47,Don't Let Go,15.0,15,-4,-4,-9,1,down,1978-06-03
9403,Jimmy 'Bo' Horne,1978-06-03,Jimmy 'Bo' Horne - Dance Across The Floor,51,51,37,23.0,47,Dance Across The Floor,13.0,0,10,4,0,1,up,1978-06-03
9404,Jimmy 'Bo' Horne,1978-06-10,Jimmy 'Bo' Horne - Dance Across The Floor,47,51,35,23.0,37,Dance Across The Floor,13.0,1,2,10,4,1,up,1978-06-03
9405,Jimmy 'Bo' Horne,1978-06-17,Jimmy 'Bo' Horne - Dance Across The Floor,37,47,32,23.0,35,Dance Across The Floor,13.0,2,3,2,10,1,up,1978-06-03
9406,Jimmy 'Bo' Horne,1978-06-24,Jimmy 'Bo' Horne - Dance Across The Floor,35,37,32,23.0,32,Dance Across The Floor,13.0,3,0,3,2,0,stay,1978-06-03
9407,Jimmy 'Bo' Horne,1978-07-01,Jimmy 'Bo' Horne - Dance Across The Floor,32,35,29,23.0,32,Dance Across The Floor,13.0,4,3,0,3,1,up,1978-06-03
9408,Jimmy 'Bo' Horne,1978-07-08,Jimmy 'Bo' Horne - Dance Across The Floor,32,32,27,23.0,29,Dance Across The Floor,13.0,5,2,3,0,1,up,1978-06-03
9409,Jimmy 'Bo' Horne,1978-07-15,Jimmy 'Bo' Horne - Dance Across The Floor,29,32,23,23.0,27,Dance Across The Floor,13.0,6,4,2,3,1,up,1978-06-03
9410,Jimmy 'Bo' Horne,1978-07-22,Jimmy 'Bo' Horne - Dance Across The Floor,27,29,26,23.0,23,Dance Across The Floor,13.0,7,-3,4,2,1,down,1978-06-03
9411,Jimmy 'Bo' Horne,1978-07-29,Jimmy 'Bo' Horne - Dance Across The Floor,23,27,32,23.0,26,Dance Across The Floor,13.0,8,-6,-3,4,1,down,1978-06-03
9412,Jimmy 'Bo' Horne,1978-08-05,Jimmy 'Bo' Horne - Dance Across The Floor,26,23,37,23.0,32,Dance Across The Floor,13.0,9,-5,-6,-3,1,down,1978-06-03
9413,Jimmy 'Bo' Horne,1978-08-12,Jimmy 'Bo' Horne - Dance Across The Floor,32,26,42,23.0,37,Dance Across The Floor,13.0,10,-5,-5,-6,1,down,1978-06-03
9414,Jimmy 'Bo' Horne,1978-08-19,Jimmy 'Bo' Horne - Dance Across The Floor,37,32,45,23.0,42,Dance Across The Floor,13.0,11,-3,-5,-5,1,down,1978-06-03
9415,Jimmy 'Bo' Horne,1978-08-26,Jimmy 'Bo' Horne - Dance Across The Floor,42,37,48,23.0,45,Dance Across The Floor,13.0,12,-3,-3,-5,1,down,1978-06-03
9416,Jimmy 'Bo' Horne,1978-09-02,Jimmy 'Bo' Horne - Dance Across The Floor,45,42,51,23.0,48,Dance Across The Floor,13.0,13,-3,-3,-3,1,down,1978-06-03
9417,"Evelyn ""Champagne"" King",1978-06-03,"Evelyn ""Champagne"" King - Smooth Talk",51,51,39,8.0,49,Smooth Talk,46.0,0,10,2,0,1,up,1978-06-03
9418,"Evelyn ""Champagne"" King",1978-06-10,"Evelyn ""Champagne"" King - Smooth Talk",49,51,31,8.0,39,Smooth Talk,46.0,1,8,10,2,1,up,1978-06-03
9419,"Evelyn ""Champagne"" King",1978-06-17,"Evelyn ""Champagne"" King - Smooth Talk",39,49,23,8.0,31,Smooth Talk,46.0,2,8,8,10,1,up,1978-06-03
9420,"Evelyn ""Champagne"" King",1978-06-24,"Evelyn ""Champagne"" King - Smooth Talk",31,39,17,8.0,23,Smooth Talk,46.0,3,6,8,8,1,up,1978-06-03
9421,"Evelyn ""Champagne"" King",1978-07-01,"Evelyn ""Champagne"" King - Smooth Talk",23,31,10,8.0,17,Smooth Talk,46.0,4,7,6,8,1,up,1978-06-03
9422,"Evelyn ""Champagne"" King",1978-07-08,"Evelyn ""Champagne"" King - Smooth Talk",17,23,8,8.0,10,Smooth Talk,46.0,5,2,7,6,1,up,1978-06-03
9423,"Evelyn ""Champagne"" King",1978-07-15,"Evelyn ""Champagne"" King - Smooth Talk",10,17,8,8.0,8,Smooth Talk,46.0,6,0,2,7,0,stay,1978-06-03
9424,"Evelyn ""Champagne"" King",1978-07-22,"Evelyn ""Champagne"" King - Smooth Talk",8,10,8,8.0,8,Smooth Talk,46.0,7,0,0,2,0,stay,1978-06-03
9425,"Evelyn ""Champagne"" King",1978-07-29,"Evelyn ""Champagne"" King - Smooth Talk",8,8,14,8.0,8,Smooth Talk,46.0,8,-6,0,0,1,down,1978-06-03
9426,"Evelyn ""Champagne"" King",1978-08-05,"Evelyn ""Champagne"" King - Smooth Talk",8,8,12,8.0,14,Smooth Talk,46.0,9,2,-6,0,1,up,1978-06-03
9427,"Evelyn ""Champagne"" King",1978-08-12,"Evelyn ""Champagne"" King - Smooth Talk",14,8,11,8.0,12,Smooth Talk,46.0,10,1,2,-6,1,up,1978-06-03
9428,"Evelyn ""Champagne"" King",1978-08-19,"Evelyn ""Champagne"" King - Smooth Talk",12,14,9,8.0,11,Smooth Talk,46.0,11,2,1,2,1,up,1978-06-03
9429,"Evelyn ""Champagne"" King",1978-08-26,"Evelyn ""Champagne"" King - Smooth Talk",11,12,9,8.0,9,Smooth Talk,46.0,12,0,2,1,0,stay,1978-06-03
9430,"Evelyn ""Champagne"" King",1978-09-02,"Evelyn ""Champagne"" King - Smooth Talk",9,11,9,8.0,9,Smooth Talk,46.0,13,0,0,2,0,stay,1978-06-03
9431,"Evelyn ""Champagne"" King",1978-09-09,"Evelyn ""Champagne"" King - Smooth Talk",9,9,14,8.0,9,Smooth Talk,46.0,14,-5,0,0,1,down,1978-06-03
9432,"Evelyn ""Champagne"" King",1978-09-16,"Evelyn ""Champagne"" King - Smooth Talk",9,9,14,8.0,14,Smooth Talk,46.0,15,0,-5,0,0,stay,1978-06-03
9433,"Evelyn ""Champagne"" King",1978-09-23,"Evelyn ""Champagne"" King - Smooth Talk",14,9,14,8.0,14,Smooth Talk,46.0,16,0,0,-5,0,stay,1978-06-03
9434,"Evelyn ""Champagne"" King",1978-09-30,"Evelyn ""Champagne"" King - Smooth Talk",14,14,15,8.0,14,Smooth Talk,46.0,17,-1,0,0,1,down,1978-06-03
9435,"Evelyn ""Champagne"" King",1978-10-07,"Evelyn ""Champagne"" King - Smooth Talk",14,14,17,8.0,15,Smooth Talk,46.0,18,-2,-1,0,1,down,1978-06-03
9436,"Evelyn ""Champagne"" King",1978-10-14,"Evelyn ""Champagne"" King - Smooth Talk",15,14,21,8.0,17,Smooth Talk,46.0,19,-4,-2,-1,1,down,1978-06-03
9437,"Evelyn ""Champagne"" King",1978-10-21,"Evelyn ""Champagne"" King - Smooth Talk",17,15,21,8.0,21,Smooth Talk,46.0,20,0,-4,-2,0,stay,1978-06-03
9438,"Evelyn ""Champagne"" King",1978-10-28,"Evelyn ""Champagne"" King - Smooth Talk",21,17,22,8.0,21,Smooth Talk,46.0,21,-1,0,-4,1,down,1978-06-03
9439,"Evelyn ""Champagne"" King",1978-11-04,"Evelyn ""Champagne"" King - Smooth Talk",21,21,27,8.0,22,Smooth Talk,46.0,22,-5,-1,0,1,down,1978-06-03
9440,"Evelyn ""Champagne"" King",1978-11-11,"Evelyn ""Champagne"" King - Smooth Talk",22,21,30,8.0,27,Smooth Talk,46.0,23,-3,-5,-1,1,down,1978-06-03
9441,"Evelyn ""Champagne"" King",1978-11-18,"Evelyn ""Champagne"" King - Smooth Talk",27,22,34,8.0,30,Smooth Talk,46.0,24,-4,-3,-5,1,down,1978-06-03
9442,"Evelyn ""Champagne"" King",1978-11-25,"Evelyn ""Champagne"" King - Smooth Talk",30,27,37,8.0,34,Smooth Talk,46.0,25,-3,-4,-3,1,down,1978-06-03
9443,"Evelyn ""Champagne"" King",1978-12-02,"Evelyn ""Champagne"" King - Smooth Talk",34,30,37,8.0,37,Smooth Talk,46.0,26,0,-3,-4,0,stay,1978-06-03
9444,"Evelyn ""Champagne"" King",1978-12-09,"Evelyn ""Champagne"" King - Smooth Talk",37,34,37,8.0,37,Smooth Talk,46.0,27,0,0,-3,0,stay,1978-06-03
9445,"Evelyn ""Champagne"" King",1978-12-16,"Evelyn ""Champagne"" King - Smooth Talk",37,37,37,8.0,37,Smooth Talk,46.0,28,0,0,0,0,stay,1978-06-03
9446,"Evelyn ""Champagne"" King",1978-12-23,"Evelyn ""Champagne"" King - Smooth Talk",37,37,37,8.0,37,Smooth Talk,46.0,29,0,0,0,0,stay,1978-06-03
9447,"Evelyn ""Champagne"" King",1978-12-30,"Evelyn ""Champagne"" King - Smooth Talk",37,37,27,8.0,37,Smooth Talk,46.0,30,10,0,0,1,up,1978-06-03
9448,"Evelyn ""Champagne"" King",1979-01-06,"Evelyn ""Champagne"" King - Smooth Talk",37,37,27,8.0,27,Smooth Talk,46.0,31,0,10,0,0,stay,1978-06-03
9449,"Evelyn ""Champagne"" King",1979-01-13,"Evelyn ""Champagne"" King - Smooth Talk",27,37,21,8.0,27,Smooth Talk,46.0,32,6,0,10,1,up,1978-06-03
9450,"Evelyn ""Champagne"" King",1979-01-20,"Evelyn ""Champagne"" King - Smooth Talk",27,27,16,8.0,21,Smooth Talk,46.0,33,5,6,0,1,up,1978-06-03
9451,"Evelyn ""Champagne"" King",1979-01-27,"Evelyn ""Champagne"" King - Smooth Talk",21,27,11,8.0,16,Smooth Talk,46.0,34,5,5,6,1,up,1978-06-03
9452,"Evelyn ""Champagne"" King",1979-02-03,"Evelyn ""Champagne"" King - Smooth Talk",16,21,11,8.0,11,Smooth Talk,46.0,35,0,5,5,0,stay,1978-06-03
9453,"Evelyn ""Champagne"" King",1979-02-10,"Evelyn ""Champagne"" King - Smooth Talk",11,16,17,8.0,11,Smooth Talk,46.0,36,-6,0,5,1,down,1978-06-03
9454,"Evelyn ""Champagne"" King",1979-02-17,"Evelyn ""Champagne"" King - Smooth Talk",11,11,25,8.0,17,Smooth Talk,46.0,37,-8,-6,0,1,down,1978-06-03
9455,"Evelyn ""Champagne"" King",1979-02-24,"Evelyn ""Champagne"" King - Smooth Talk",17,11,30,8.0,25,Smooth Talk,46.0,38,-5,-8,-6,1,down,1978-06-03
9456,"Evelyn ""Champagne"" King",1979-03-03,"Evelyn ""Champagne"" King - Smooth Talk",25,17,32,8.0,30,Smooth Talk,46.0,39,-2,-5,-8,1,down,1978-06-03
9457,"Evelyn ""Champagne"" King",1979-03-10,"Evelyn ""Champagne"" King - Smooth Talk",30,25,32,8.0,32,Smooth Talk,46.0,40,0,-2,-5,0,stay,1978-06-03
9458,"Evelyn ""Champagne"" King",1979-03-17,"Evelyn ""Champagne"" King - Smooth Talk",32,30,32,8.0,32,Smooth Talk,46.0,41,0,0,-2,0,stay,1978-06-03
9459,"Evelyn ""Champagne"" King",1979-03-24,"Evelyn ""Champagne"" King - Smooth Talk",32,32,29,8.0,32,Smooth Talk,46.0,42,3,0,0,1,up,1978-06-03
9460,"Evelyn ""Champagne"" King",1979-03-31,"Evelyn ""Champagne"" King - Smooth Talk",32,32,35,8.0,29,Smooth Talk,46.0,43,-6,3,0,1,down,1978-06-03
9461,"Evelyn ""Champagne"" King",1979-04-07,"Evelyn ""Champagne"" King - Smooth Talk",29,32,42,8.0,35,Smooth Talk,46.0,44,-7,-6,3,1,down,1978-06-03
9462,"Evelyn ""Champagne"" King",1979-04-14,"Evelyn ""Champagne"" King - Smooth Talk",35,29,42,8.0,42,Smooth Talk,46.0,45,0,-7,-6,0,stay,1978-06-03
9463,"Evelyn ""Champagne"" King",1979-04-21,"Evelyn ""Champagne"" King - Smooth Talk",42,35,51,8.0,42,Smooth Talk,46.0,46,-9,0,-7,1,down,1978-06-03
9464,Bob Marley And The Wailers,1978-06-03,Bob Marley And The Wailers - Kaya,51,51,51,50.0,50,Kaya,0.0,0,-1,1,0,1,down,1978-06-03
9465,Graham Central Station,1978-06-10,Graham Central Station - My Radio Sure Sounds Good To Me,51,51,27,18.0,35,My Radio Sure Sounds Good To Me,16.0,0,8,16,0,1,up,1978-06-10
9466,Graham Central Station,1978-06-17,Graham Central Station - My Radio Sure Sounds Good To Me,35,51,21,18.0,27,My Radio Sure Sounds Good To Me,16.0,1,6,8,16,1,up,1978-06-10
9467,Graham Central Station,1978-06-24,Graham Central Station - My Radio Sure Sounds Good To Me,27,35,19,18.0,21,My Radio Sure Sounds Good To Me,16.0,2,2,6,8,1,up,1978-06-10
9468,Graham Central Station,1978-07-01,Graham Central Station - My Radio Sure Sounds Good To Me,21,27,18,18.0,19,My Radio Sure Sounds Good To Me,16.0,3,1,2,6,1,up,1978-06-10
9469,Graham Central Station,1978-07-08,Graham Central Station - My Radio Sure Sounds Good To Me,19,21,18,18.0,18,My Radio Sure Sounds Good To Me,16.0,4,0,1,2,0,stay,1978-06-10
9470,Graham Central Station,1978-07-15,Graham Central Station - My Radio Sure Sounds Good To Me,18,19,25,18.0,18,My Radio Sure Sounds Good To Me,16.0,5,-7,0,1,1,down,1978-06-10
9471,Graham Central Station,1978-07-22,Graham Central Station - My Radio Sure Sounds Good To Me,18,18,25,18.0,25,My Radio Sure Sounds Good To Me,16.0,6,0,-7,0,0,stay,1978-06-10
9472,Graham Central Station,1978-07-29,Graham Central Station - My Radio Sure Sounds Good To Me,25,18,23,18.0,25,My Radio Sure Sounds Good To Me,16.0,7,2,0,-7,1,up,1978-06-10
9473,Graham Central Station,1978-08-05,Graham Central Station - My Radio Sure Sounds Good To Me,25,25,27,18.0,23,My Radio Sure Sounds Good To Me,16.0,8,-4,2,0,1,down,1978-06-10
9474,Graham Central Station,1978-08-12,Graham Central Station - My Radio Sure Sounds Good To Me,23,25,28,18.0,27,My Radio Sure Sounds Good To Me,16.0,9,-1,-4,2,1,down,1978-06-10
9475,Graham Central Station,1978-08-19,Graham Central Station - My Radio Sure Sounds Good To Me,27,23,29,18.0,28,My Radio Sure Sounds Good To Me,16.0,10,-1,-1,-4,1,down,1978-06-10
9476,Graham Central Station,1978-08-26,Graham Central Station - My Radio Sure Sounds Good To Me,28,27,29,18.0,29,My Radio Sure Sounds Good To Me,16.0,11,0,-1,-1,0,stay,1978-06-10
9477,Graham Central Station,1978-09-02,Graham Central Station - My Radio Sure Sounds Good To Me,29,28,36,18.0,29,My Radio Sure Sounds Good To Me,16.0,12,-7,0,-1,1,down,1978-06-10
9478,Graham Central Station,1978-09-09,Graham Central Station - My Radio Sure Sounds Good To Me,29,29,39,18.0,36,My Radio Sure Sounds Good To Me,16.0,13,-3,-7,0,1,down,1978-06-10
9479,Graham Central Station,1978-09-16,Graham Central Station - My Radio Sure Sounds Good To Me,36,29,44,18.0,39,My Radio Sure Sounds Good To Me,16.0,14,-5,-3,-7,1,down,1978-06-10
9480,Graham Central Station,1978-09-23,Graham Central Station - My Radio Sure Sounds Good To Me,39,36,45,18.0,44,My Radio Sure Sounds Good To Me,16.0,15,-1,-5,-3,1,down,1978-06-10
9481,Graham Central Station,1978-09-30,Graham Central Station - My Radio Sure Sounds Good To Me,44,39,51,18.0,45,My Radio Sure Sounds Good To Me,16.0,16,-6,-1,-5,1,down,1978-06-10
9482,Rick James,1978-06-10,Rick James - Come Get It,51,51,29,3.0,41,Come Get It,38.0,0,12,10,0,1,up,1978-06-10
9483,Rick James,1978-06-17,Rick James - Come Get It,41,51,19,3.0,29,Come Get It,38.0,1,10,12,10,1,up,1978-06-10
9484,Rick James,1978-06-24,Rick James - Come Get It,29,41,14,3.0,19,Come Get It,38.0,2,5,10,12,1,up,1978-06-10
9485,Rick James,1978-07-01,Rick James - Come Get It,19,29,7,3.0,14,Come Get It,38.0,3,7,5,10,1,up,1978-06-10
9486,Rick James,1978-07-08,Rick James - Come Get It,14,19,5,3.0,7,Come Get It,38.0,4,2,7,5,1,up,1978-06-10
9487,Rick James,1978-07-15,Rick James - Come Get It,7,14,3,3.0,5,Come Get It,38.0,5,2,2,7,1,up,1978-06-10
9488,Rick James,1978-07-22,Rick James - Come Get It,5,7,3,3.0,3,Come Get It,38.0,6,0,2,2,0,stay,1978-06-10
9489,Rick James,1978-07-29,Rick James - Come Get It,3,5,5,3.0,3,Come Get It,38.0,7,-2,0,2,1,down,1978-06-10
9490,Rick James,1978-08-05,Rick James - Come Get It,3,3,5,3.0,5,Come Get It,38.0,8,0,-2,0,0,stay,1978-06-10
9491,Rick James,1978-08-12,Rick James - Come Get It,5,3,5,3.0,5,Come Get It,38.0,9,0,0,-2,0,stay,1978-06-10
9492,Rick James,1978-08-19,Rick James - Come Get It,5,5,5,3.0,5,Come Get It,38.0,10,0,0,0,0,stay,1978-06-10
9493,Rick James,1978-08-26,Rick James - Come Get It,5,5,5,3.0,5,Come Get It,38.0,11,0,0,0,0,stay,1978-06-10
9494,Rick James,1978-09-02,Rick James - Come Get It,5,5,7,3.0,5,Come Get It,38.0,12,-2,0,0,1,down,1978-06-10
9495,Rick James,1978-09-09,Rick James - Come Get It,5,5,7,3.0,7,Come Get It,38.0,13,0,-2,0,0,stay,1978-06-10
9496,Rick James,1978-09-16,Rick James - Come Get It,7,5,6,3.0,7,Come Get It,38.0,14,1,0,-2,1,up,1978-06-10
9497,Rick James,1978-09-23,Rick James - Come Get It,7,7,8,3.0,6,Come Get It,38.0,15,-2,1,0,1,down,1978-06-10
9498,Rick James,1978-09-30,Rick James - Come Get It,6,7,7,3.0,8,Come Get It,38.0,16,1,-2,1,1,up,1978-06-10
9499,Rick James,1978-10-07,Rick James - Come Get It,8,6,16,3.0,7,Come Get It,38.0,17,-9,1,-2,1,down,1978-06-10
9500,Rick James,1978-10-14,Rick James - Come Get It,7,8,12,3.0,16,Come Get It,38.0,18,4,-9,1,1,up,1978-06-10
9501,Rick James,1978-10-21,Rick James - Come Get It,16,7,5,3.0,12,Come Get It,38.0,19,7,4,-9,1,up,1978-06-10
9502,Rick James,1978-10-28,Rick James - Come Get It,12,16,5,3.0,5,Come Get It,38.0,20,0,7,4,0,stay,1978-06-10
9503,Rick James,1978-11-04,Rick James - Come Get It,5,12,4,3.0,5,Come Get It,38.0,21,1,0,7,1,up,1978-06-10
9504,Rick James,1978-11-11,Rick James - Come Get It,5,5,4,3.0,4,Come Get It,38.0,22,0,1,0,0,stay,1978-06-10
9505,Rick James,1978-11-18,Rick James - Come Get It,4,5,9,3.0,4,Come Get It,38.0,23,-5,0,1,1,down,1978-06-10
9506,Rick James,1978-11-25,Rick James - Come Get It,4,4,9,3.0,9,Come Get It,38.0,24,0,-5,0,0,stay,1978-06-10
9507,Rick James,1978-12-02,Rick James - Come Get It,9,4,15,3.0,9,Come Get It,38.0,25,-6,0,-5,1,down,1978-06-10
9508,Rick James,1978-12-09,Rick James - Come Get It,9,9,22,3.0,15,Come Get It,38.0,26,-7,-6,0,1,down,1978-06-10
9509,Rick James,1978-12-16,Rick James - Come Get It,15,9,22,3.0,22,Come Get It,38.0,27,0,-7,-6,0,stay,1978-06-10
9510,Rick James,1978-12-23,Rick James - Come Get It,22,15,22,3.0,22,Come Get It,38.0,28,0,0,-7,0,stay,1978-06-10
9511,Rick James,1978-12-30,Rick James - Come Get It,22,22,31,3.0,22,Come Get It,38.0,29,-9,0,0,1,down,1978-06-10
9512,Rick James,1979-01-06,Rick James - Come Get It,22,22,30,3.0,31,Come Get It,38.0,30,1,-9,0,1,up,1978-06-10
9513,Rick James,1979-01-13,Rick James - Come Get It,31,22,30,3.0,30,Come Get It,38.0,31,0,1,-9,0,stay,1978-06-10
9514,Rick James,1979-01-20,Rick James - Come Get It,30,31,30,3.0,30,Come Get It,38.0,32,0,0,1,0,stay,1978-06-10
9515,Rick James,1979-01-27,Rick James - Come Get It,30,30,30,3.0,30,Come Get It,38.0,33,0,0,0,0,stay,1978-06-10
9516,Rick James,1979-02-03,Rick James - Come Get It,30,30,33,3.0,30,Come Get It,38.0,34,-3,0,0,1,down,1978-06-10
9517,Rick James,1979-02-10,Rick James - Come Get It,30,30,47,3.0,33,Come Get It,38.0,35,-14,-3,0,1,down,1978-06-10
9518,Rick James,1979-02-17,Rick James - Come Get It,33,30,48,3.0,47,Come Get It,38.0,36,-1,-14,-3,1,down,1978-06-10
9519,Rick James,1979-03-03,Rick James - Come Get It,47,33,48,3.0,48,Come Get It,38.0,37,0,-1,-14,0,stay,1978-06-10
9520,Rick James,1979-03-10,Rick James - Come Get It,48,47,51,3.0,48,Come Get It,38.0,38,-3,0,-1,1,down,1978-06-10
9521,The Whispers,1978-06-10,The Whispers - Headlights,51,51,33,22.0,43,Headlights,23.0,0,10,8,0,1,up,1978-06-10
9522,The Whispers,1978-06-17,The Whispers - Headlights,43,51,24,22.0,33,Headlights,23.0,1,9,10,8,1,up,1978-06-10
9523,The Whispers,1978-06-24,The Whispers - Headlights,33,43,22,22.0,24,Headlights,23.0,2,2,9,10,1,up,1978-06-10
9524,The Whispers,1978-07-01,The Whispers - Headlights,24,33,26,22.0,22,Headlights,23.0,3,-4,2,9,1,down,1978-06-10
9525,The Whispers,1978-07-08,The Whispers - Headlights,22,24,26,22.0,26,Headlights,23.0,4,0,-4,2,0,stay,1978-06-10
9526,The Whispers,1978-07-15,The Whispers - Headlights,26,22,22,22.0,26,Headlights,23.0,5,4,0,-4,1,up,1978-06-10
9527,The Whispers,1978-07-22,The Whispers - Headlights,26,26,24,22.0,22,Headlights,23.0,6,-2,4,0,1,down,1978-06-10
9528,The Whispers,1978-07-29,The Whispers - Headlights,22,26,28,22.0,24,Headlights,23.0,7,-4,-2,4,1,down,1978-06-10
9529,The Whispers,1978-08-05,The Whispers - Headlights,24,22,28,22.0,28,Headlights,23.0,8,0,-4,-2,0,stay,1978-06-10
9530,The Whispers,1978-08-12,The Whispers - Headlights,28,24,34,22.0,28,Headlights,23.0,9,-6,0,-4,1,down,1978-06-10
9531,The Whispers,1978-08-19,The Whispers - Headlights,28,28,37,22.0,34,Headlights,23.0,10,-3,-6,0,1,down,1978-06-10
9532,The Whispers,1978-08-26,The Whispers - Headlights,34,28,38,22.0,37,Headlights,23.0,11,-1,-3,-6,1,down,1978-06-10
9533,The Whispers,1978-09-02,The Whispers - Headlights,37,34,44,22.0,38,Headlights,23.0,12,-6,-1,-3,1,down,1978-06-10
9534,The Whispers,1978-09-09,The Whispers - Headlights,38,37,41,22.0,44,Headlights,23.0,13,3,-6,-1,1,up,1978-06-10
9535,The Whispers,1978-10-28,The Whispers - Headlights,44,38,31,22.0,41,Headlights,23.0,14,10,3,-6,1,up,1978-06-10
9536,The Whispers,1978-11-04,The Whispers - Headlights,41,44,23,22.0,31,Headlights,23.0,15,8,10,3,1,up,1978-06-10
9537,The Whispers,1978-11-11,The Whispers - Headlights,31,41,23,22.0,23,Headlights,23.0,16,0,8,10,0,stay,1978-06-10
9538,The Whispers,1978-11-18,The Whispers - Headlights,23,31,26,22.0,23,Headlights,23.0,17,-3,0,8,1,down,1978-06-10
9539,The Whispers,1978-11-25,The Whispers - Headlights,23,23,23,22.0,26,Headlights,23.0,18,3,-3,0,1,up,1978-06-10
9540,The Whispers,1978-12-02,The Whispers - Headlights,26,23,30,22.0,23,Headlights,23.0,19,-7,3,-3,1,down,1978-06-10
9541,The Whispers,1978-12-09,The Whispers - Headlights,23,26,30,22.0,30,Headlights,23.0,20,0,-7,3,0,stay,1978-06-10
9542,The Whispers,1978-12-16,The Whispers - Headlights,30,23,33,22.0,30,Headlights,23.0,21,-3,0,-7,1,down,1978-06-10
9543,The Whispers,1978-12-23,The Whispers - Headlights,30,30,33,22.0,33,Headlights,23.0,22,0,-3,0,0,stay,1978-06-10
9544,The Whispers,1978-12-30,The Whispers - Headlights,33,30,51,22.0,33,Headlights,23.0,23,-18,0,-3,1,down,1978-06-10
9545,Patti LaBelle,1978-06-17,Patti LaBelle - Tasty,51,51,39,39.0,42,Tasty,3.0,0,3,9,0,1,up,1978-06-17
9546,Patti LaBelle,1978-06-24,Patti LaBelle - Tasty,42,51,39,39.0,39,Tasty,3.0,1,0,3,9,0,stay,1978-06-17
9547,Patti LaBelle,1978-07-01,Patti LaBelle - Tasty,39,42,49,39.0,39,Tasty,3.0,2,-10,0,3,1,down,1978-06-17
9548,Patti LaBelle,1978-07-08,Patti LaBelle - Tasty,39,39,51,39.0,49,Tasty,3.0,3,-2,-10,0,1,down,1978-06-17
9549,LTD,1978-06-17,LTD - Togetherness,51,51,30,3.0,43,Togetherness,34.0,0,13,8,0,1,up,1978-06-17
9550,LTD,1978-06-24,LTD - Togetherness,43,51,13,3.0,30,Togetherness,34.0,1,17,13,8,1,up,1978-06-17
9551,LTD,1978-07-01,LTD - Togetherness,30,43,8,3.0,13,Togetherness,34.0,2,5,17,13,1,up,1978-06-17
9552,LTD,1978-07-08,LTD - Togetherness,13,30,6,3.0,8,Togetherness,34.0,3,2,5,17,1,up,1978-06-17
9553,LTD,1978-07-15,LTD - Togetherness,8,13,5,3.0,6,Togetherness,34.0,4,1,2,5,1,up,1978-06-17
9554,LTD,1978-07-22,LTD - Togetherness,6,8,4,3.0,5,Togetherness,34.0,5,1,1,2,1,up,1978-06-17
9555,LTD,1978-07-29,LTD - Togetherness,5,6,4,3.0,4,Togetherness,34.0,6,0,1,1,0,stay,1978-06-17
9556,LTD,1978-08-05,LTD - Togetherness,4,5,4,3.0,4,Togetherness,34.0,7,0,0,1,0,stay,1978-06-17
9557,LTD,1978-08-12,LTD - Togetherness,4,4,4,3.0,4,Togetherness,34.0,8,0,0,0,0,stay,1978-06-17
9558,LTD,1978-08-19,LTD - Togetherness,4,4,3,3.0,4,Togetherness,34.0,9,1,0,0,1,up,1978-06-17
9559,LTD,1978-08-26,LTD - Togetherness,4,4,3,3.0,3,Togetherness,34.0,10,0,1,0,0,stay,1978-06-17
9560,LTD,1978-09-02,LTD - Togetherness,3,4,5,3.0,3,Togetherness,34.0,11,-2,0,1,1,down,1978-06-17
9561,LTD,1978-09-09,LTD - Togetherness,3,3,5,3.0,5,Togetherness,34.0,12,0,-2,0,0,stay,1978-06-17
9562,LTD,1978-09-16,LTD - Togetherness,5,3,4,3.0,5,Togetherness,34.0,13,1,0,-2,1,up,1978-06-17
9563,LTD,1978-09-23,LTD - Togetherness,5,5,3,3.0,4,Togetherness,34.0,14,1,1,0,1,up,1978-06-17
9564,LTD,1978-09-30,LTD - Togetherness,4,5,3,3.0,3,Togetherness,34.0,15,0,1,1,0,stay,1978-06-17
9565,LTD,1978-10-07,LTD - Togetherness,3,4,4,3.0,3,Togetherness,34.0,16,-1,0,1,1,down,1978-06-17
9566,LTD,1978-10-14,LTD - Togetherness,3,3,4,3.0,4,Togetherness,34.0,17,0,-1,0,0,stay,1978-06-17
9567,LTD,1978-10-21,LTD - Togetherness,4,3,11,3.0,4,Togetherness,34.0,18,-7,0,-1,1,down,1978-06-17
9568,LTD,1978-10-28,LTD - Togetherness,4,4,11,3.0,11,Togetherness,34.0,19,0,-7,0,0,stay,1978-06-17
9569,LTD,1978-11-04,LTD - Togetherness,11,4,11,3.0,11,Togetherness,34.0,20,0,0,-7,0,stay,1978-06-17
9570,LTD,1978-11-11,LTD - Togetherness,11,11,15,3.0,11,Togetherness,34.0,21,-4,0,0,1,down,1978-06-17
9571,LTD,1978-11-18,LTD - Togetherness,11,11,18,3.0,15,Togetherness,34.0,22,-3,-4,0,1,down,1978-06-17
9572,LTD,1978-11-25,LTD - Togetherness,15,11,21,3.0,18,Togetherness,34.0,23,-3,-3,-4,1,down,1978-06-17
9573,LTD,1978-12-02,LTD - Togetherness,18,15,28,3.0,21,Togetherness,34.0,24,-7,-3,-3,1,down,1978-06-17
9574,LTD,1978-12-09,LTD - Togetherness,21,18,29,3.0,28,Togetherness,34.0,25,-1,-7,-3,1,down,1978-06-17
9575,LTD,1978-12-16,LTD - Togetherness,28,21,29,3.0,29,Togetherness,34.0,26,0,-1,-7,0,stay,1978-06-17
9576,LTD,1978-12-23,LTD - Togetherness,29,28,29,3.0,29,Togetherness,34.0,27,0,0,-1,0,stay,1978-06-17
9577,LTD,1978-12-30,LTD - Togetherness,29,29,34,3.0,29,Togetherness,34.0,28,-5,0,0,1,down,1978-06-17
9578,LTD,1979-01-06,LTD - Togetherness,29,29,34,3.0,34,Togetherness,34.0,29,0,-5,0,0,stay,1978-06-17
9579,LTD,1979-01-13,LTD - Togetherness,34,29,40,3.0,34,Togetherness,34.0,30,-6,0,-5,1,down,1978-06-17
9580,LTD,1979-01-20,LTD - Togetherness,34,34,36,3.0,40,Togetherness,34.0,31,4,-6,0,1,up,1978-06-17
9581,LTD,1979-01-27,LTD - Togetherness,40,34,43,3.0,36,Togetherness,34.0,32,-7,4,-6,1,down,1978-06-17
9582,LTD,1979-02-03,LTD - Togetherness,36,40,43,3.0,43,Togetherness,34.0,33,0,-7,4,0,stay,1978-06-17
9583,LTD,1979-02-10,LTD - Togetherness,43,36,51,3.0,43,Togetherness,34.0,34,-8,0,-7,1,down,1978-06-17
9584,Chocolate Milk,1978-06-17,Chocolate Milk - We're All In This Together,51,51,34,34.0,44,We're All In This Together,5.0,0,10,7,0,1,up,1978-06-17
9585,Chocolate Milk,1978-06-24,Chocolate Milk - We're All In This Together,44,51,34,34.0,34,We're All In This Together,5.0,1,0,10,7,0,stay,1978-06-17
9586,Chocolate Milk,1978-07-01,Chocolate Milk - We're All In This Together,34,44,34,34.0,34,We're All In This Together,5.0,2,0,0,10,0,stay,1978-06-17
9587,Chocolate Milk,1978-07-08,Chocolate Milk - We're All In This Together,34,34,41,34.0,34,We're All In This Together,5.0,3,-7,0,0,1,down,1978-06-17
9588,Chocolate Milk,1978-07-15,Chocolate Milk - We're All In This Together,34,34,47,34.0,41,We're All In This Together,5.0,4,-6,-7,0,1,down,1978-06-17
9589,Chocolate Milk,1978-07-22,Chocolate Milk - We're All In This Together,41,34,51,34.0,47,We're All In This Together,5.0,5,-4,-6,-7,1,down,1978-06-17
9590,Idris Muhammad,1978-06-17,Idris Muhammad - Boogie To The Top,51,51,45,45.0,45,Boogie To The Top,1.0,0,0,6,0,0,stay,1978-06-17
9591,Idris Muhammad,1978-06-24,Idris Muhammad - Boogie To The Top,45,51,51,45.0,45,Boogie To The Top,1.0,1,-6,0,6,1,down,1978-06-17
9592,A Taste Of Honey,1978-06-17,A Taste Of Honey - A Taste Of Honey,51,51,36,2.0,46,A Taste Of Honey,24.0,0,10,5,0,1,up,1978-06-17
9593,A Taste Of Honey,1978-06-24,A Taste Of Honey - A Taste Of Honey,46,51,26,2.0,36,A Taste Of Honey,24.0,1,10,10,5,1,up,1978-06-17
9594,A Taste Of Honey,1978-07-01,A Taste Of Honey - A Taste Of Honey,36,46,15,2.0,26,A Taste Of Honey,24.0,2,11,10,10,1,up,1978-06-17
9595,A Taste Of Honey,1978-07-08,A Taste Of Honey - A Taste Of Honey,26,36,11,2.0,15,A Taste Of Honey,24.0,3,4,11,10,1,up,1978-06-17
9596,A Taste Of Honey,1978-07-15,A Taste Of Honey - A Taste Of Honey,15,26,7,2.0,11,A Taste Of Honey,24.0,4,4,4,11,1,up,1978-06-17
9597,A Taste Of Honey,1978-07-22,A Taste Of Honey - A Taste Of Honey,11,15,5,2.0,7,A Taste Of Honey,24.0,5,2,4,4,1,up,1978-06-17
9598,A Taste Of Honey,1978-07-29,A Taste Of Honey - A Taste Of Honey,7,11,3,2.0,5,A Taste Of Honey,24.0,6,2,2,4,1,up,1978-06-17
9599,A Taste Of Honey,1978-08-05,A Taste Of Honey - A Taste Of Honey,5,7,3,2.0,3,A Taste Of Honey,24.0,7,0,2,2,0,stay,1978-06-17
9600,A Taste Of Honey,1978-08-12,A Taste Of Honey - A Taste Of Honey,3,5,3,2.0,3,A Taste Of Honey,24.0,8,0,0,2,0,stay,1978-06-17
9601,A Taste Of Honey,1978-08-19,A Taste Of Honey - A Taste Of Honey,3,3,2,2.0,3,A Taste Of Honey,24.0,9,1,0,0,1,up,1978-06-17
9602,A Taste Of Honey,1978-08-26,A Taste Of Honey - A Taste Of Honey,3,3,2,2.0,2,A Taste Of Honey,24.0,10,0,1,0,0,stay,1978-06-17
9603,A Taste Of Honey,1978-09-02,A Taste Of Honey - A Taste Of Honey,2,3,2,2.0,2,A Taste Of Honey,24.0,11,0,0,1,0,stay,1978-06-17
9604,A Taste Of Honey,1978-09-09,A Taste Of Honey - A Taste Of Honey,2,2,4,2.0,2,A Taste Of Honey,24.0,12,-2,0,0,1,down,1978-06-17
9605,A Taste Of Honey,1978-09-16,A Taste Of Honey - A Taste Of Honey,2,2,2,2.0,4,A Taste Of Honey,24.0,13,2,-2,0,1,up,1978-06-17
9606,A Taste Of Honey,1978-09-23,A Taste Of Honey - A Taste Of Honey,4,2,2,2.0,2,A Taste Of Honey,24.0,14,0,2,-2,0,stay,1978-06-17
9607,A Taste Of Honey,1978-09-30,A Taste Of Honey - A Taste Of Honey,2,4,2,2.0,2,A Taste Of Honey,24.0,15,0,0,2,0,stay,1978-06-17
9608,A Taste Of Honey,1978-10-07,A Taste Of Honey - A Taste Of Honey,2,2,6,2.0,2,A Taste Of Honey,24.0,16,-4,0,0,1,down,1978-06-17
9609,A Taste Of Honey,1978-10-14,A Taste Of Honey - A Taste Of Honey,2,2,13,2.0,6,A Taste Of Honey,24.0,17,-7,-4,0,1,down,1978-06-17
9610,A Taste Of Honey,1978-10-21,A Taste Of Honey - A Taste Of Honey,6,2,13,2.0,13,A Taste Of Honey,24.0,18,0,-7,-4,0,stay,1978-06-17
9611,A Taste Of Honey,1978-10-28,A Taste Of Honey - A Taste Of Honey,13,6,15,2.0,13,A Taste Of Honey,24.0,19,-2,0,-7,1,down,1978-06-17
9612,A Taste Of Honey,1978-11-04,A Taste Of Honey - A Taste Of Honey,13,13,16,2.0,15,A Taste Of Honey,24.0,20,-1,-2,0,1,down,1978-06-17
9613,A Taste Of Honey,1978-11-11,A Taste Of Honey - A Taste Of Honey,15,13,21,2.0,16,A Taste Of Honey,24.0,21,-5,-1,-2,1,down,1978-06-17
9614,A Taste Of Honey,1978-11-18,A Taste Of Honey - A Taste Of Honey,16,15,23,2.0,21,A Taste Of Honey,24.0,22,-2,-5,-1,1,down,1978-06-17
9615,A Taste Of Honey,1978-11-25,A Taste Of Honey - A Taste Of Honey,21,16,34,2.0,23,A Taste Of Honey,24.0,23,-11,-2,-5,1,down,1978-06-17
9616,A Taste Of Honey,1978-12-02,A Taste Of Honey - A Taste Of Honey,23,21,51,2.0,34,A Taste Of Honey,24.0,24,-17,-11,-2,1,down,1978-06-17
9617,Betty Wright,1978-06-17,Betty Wright - Betty Wright Live,51,51,40,6.0,50,Betty Wright Live,32.0,0,10,1,0,1,up,1978-06-17
9618,Betty Wright,1978-06-24,Betty Wright - Betty Wright Live,50,51,30,6.0,40,Betty Wright Live,32.0,1,10,10,1,1,up,1978-06-17
9619,Betty Wright,1978-07-01,Betty Wright - Betty Wright Live,40,50,22,6.0,30,Betty Wright Live,32.0,2,8,10,10,1,up,1978-06-17
9620,Betty Wright,1978-07-08,Betty Wright - Betty Wright Live,30,40,16,6.0,22,Betty Wright Live,32.0,3,6,8,10,1,up,1978-06-17
9621,Betty Wright,1978-07-15,Betty Wright - Betty Wright Live,22,30,12,6.0,16,Betty Wright Live,32.0,4,4,6,8,1,up,1978-06-17
9622,Betty Wright,1978-07-22,Betty Wright - Betty Wright Live,16,22,11,6.0,12,Betty Wright Live,32.0,5,1,4,6,1,up,1978-06-17
9623,Betty Wright,1978-07-29,Betty Wright - Betty Wright Live,12,16,10,6.0,11,Betty Wright Live,32.0,6,1,1,4,1,up,1978-06-17
9624,Betty Wright,1978-08-05,Betty Wright - Betty Wright Live,11,12,10,6.0,10,Betty Wright Live,32.0,7,0,1,1,0,stay,1978-06-17
9625,Betty Wright,1978-08-12,Betty Wright - Betty Wright Live,10,11,10,6.0,10,Betty Wright Live,32.0,8,0,0,1,0,stay,1978-06-17
9626,Betty Wright,1978-08-19,Betty Wright - Betty Wright Live,10,10,10,6.0,10,Betty Wright Live,32.0,9,0,0,0,0,stay,1978-06-17
9627,Betty Wright,1978-08-26,Betty Wright - Betty Wright Live,10,10,8,6.0,10,Betty Wright Live,32.0,10,2,0,0,1,up,1978-06-17
9628,Betty Wright,1978-09-02,Betty Wright - Betty Wright Live,10,10,8,6.0,8,Betty Wright Live,32.0,11,0,2,0,0,stay,1978-06-17
9629,Betty Wright,1978-09-09,Betty Wright - Betty Wright Live,8,10,9,6.0,8,Betty Wright Live,32.0,12,-1,0,2,1,down,1978-06-17
9630,Betty Wright,1978-09-16,Betty Wright - Betty Wright Live,8,8,11,6.0,9,Betty Wright Live,32.0,13,-2,-1,0,1,down,1978-06-17
9631,Betty Wright,1978-09-23,Betty Wright - Betty Wright Live,9,8,12,6.0,11,Betty Wright Live,32.0,14,-1,-2,-1,1,down,1978-06-17
9632,Betty Wright,1978-09-30,Betty Wright - Betty Wright Live,11,9,13,6.0,12,Betty Wright Live,32.0,15,-1,-1,-2,1,down,1978-06-17
9633,Betty Wright,1978-10-07,Betty Wright - Betty Wright Live,12,11,9,6.0,13,Betty Wright Live,32.0,16,4,-1,-1,1,up,1978-06-17
9634,Betty Wright,1978-10-14,Betty Wright - Betty Wright Live,13,12,6,6.0,9,Betty Wright Live,32.0,17,3,4,-1,1,up,1978-06-17
9635,Betty Wright,1978-10-21,Betty Wright - Betty Wright Live,9,13,6,6.0,6,Betty Wright Live,32.0,18,0,3,4,0,stay,1978-06-17
9636,Betty Wright,1978-10-28,Betty Wright - Betty Wright Live,6,9,7,6.0,6,Betty Wright Live,32.0,19,-1,0,3,1,down,1978-06-17
9637,Betty Wright,1978-11-04,Betty Wright - Betty Wright Live,6,6,7,6.0,7,Betty Wright Live,32.0,20,0,-1,0,0,stay,1978-06-17
9638,Betty Wright,1978-11-11,Betty Wright - Betty Wright Live,7,6,10,6.0,7,Betty Wright Live,32.0,21,-3,0,-1,1,down,1978-06-17
9639,Betty Wright,1978-11-18,Betty Wright - Betty Wright Live,7,7,10,6.0,10,Betty Wright Live,32.0,22,0,-3,0,0,stay,1978-06-17
9640,Betty Wright,1978-11-25,Betty Wright - Betty Wright Live,10,7,10,6.0,10,Betty Wright Live,32.0,23,0,0,-3,0,stay,1978-06-17
9641,Betty Wright,1978-12-02,Betty Wright - Betty Wright Live,10,10,14,6.0,10,Betty Wright Live,32.0,24,-4,0,0,1,down,1978-06-17
9642,Betty Wright,1978-12-09,Betty Wright - Betty Wright Live,10,10,17,6.0,14,Betty Wright Live,32.0,25,-3,-4,0,1,down,1978-06-17
9643,Betty Wright,1978-12-16,Betty Wright - Betty Wright Live,14,10,19,6.0,17,Betty Wright Live,32.0,26,-2,-3,-4,1,down,1978-06-17
9644,Betty Wright,1978-12-23,Betty Wright - Betty Wright Live,17,14,19,6.0,19,Betty Wright Live,32.0,27,0,-2,-3,0,stay,1978-06-17
9645,Betty Wright,1978-12-30,Betty Wright - Betty Wright Live,19,17,23,6.0,19,Betty Wright Live,32.0,28,-4,0,-2,1,down,1978-06-17
9646,Betty Wright,1979-01-06,Betty Wright - Betty Wright Live,19,19,40,6.0,23,Betty Wright Live,32.0,29,-17,-4,0,1,down,1978-06-17
9647,Betty Wright,1979-01-13,Betty Wright - Betty Wright Live,23,19,50,6.0,40,Betty Wright Live,32.0,30,-10,-17,-4,1,down,1978-06-17
9648,Betty Wright,1979-01-27,Betty Wright - Betty Wright Live,40,23,50,6.0,50,Betty Wright Live,32.0,31,0,-10,-17,0,stay,1978-06-17
9649,Betty Wright,1979-02-03,Betty Wright - Betty Wright Live,50,40,51,6.0,50,Betty Wright Live,32.0,32,-1,0,-10,1,down,1978-06-17
9650,Quincy Jones,1978-06-24,Quincy Jones - Sounds...And Stuff Like That!!,51,51,11,4.0,29,Sounds...And Stuff Like That!!,19.0,0,18,22,0,1,up,1978-06-24
9651,Quincy Jones,1978-07-01,Quincy Jones - Sounds...And Stuff Like That!!,29,51,6,4.0,11,Sounds...And Stuff Like That!!,19.0,1,5,18,22,1,up,1978-06-24
9652,Quincy Jones,1978-07-08,Quincy Jones - Sounds...And Stuff Like That!!,11,29,4,4.0,6,Sounds...And Stuff Like That!!,19.0,2,2,5,18,1,up,1978-06-24
9653,Quincy Jones,1978-07-15,Quincy Jones - Sounds...And Stuff Like That!!,6,11,4,4.0,4,Sounds...And Stuff Like That!!,19.0,3,0,2,5,0,stay,1978-06-24
9654,Quincy Jones,1978-07-22,Quincy Jones - Sounds...And Stuff Like That!!,4,6,6,4.0,4,Sounds...And Stuff Like That!!,19.0,4,-2,0,2,1,down,1978-06-24
9655,Quincy Jones,1978-07-29,Quincy Jones - Sounds...And Stuff Like That!!,4,4,6,4.0,6,Sounds...And Stuff Like That!!,19.0,5,0,-2,0,0,stay,1978-06-24
9656,Quincy Jones,1978-08-05,Quincy Jones - Sounds...And Stuff Like That!!,6,4,6,4.0,6,Sounds...And Stuff Like That!!,19.0,6,0,0,-2,0,stay,1978-06-24
9657,Quincy Jones,1978-08-12,Quincy Jones - Sounds...And Stuff Like That!!,6,6,8,4.0,6,Sounds...And Stuff Like That!!,19.0,7,-2,0,0,1,down,1978-06-24
9658,Quincy Jones,1978-08-19,Quincy Jones - Sounds...And Stuff Like That!!,6,6,7,4.0,8,Sounds...And Stuff Like That!!,19.0,8,1,-2,0,1,up,1978-06-24
9659,Quincy Jones,1978-08-26,Quincy Jones - Sounds...And Stuff Like That!!,8,6,10,4.0,7,Sounds...And Stuff Like That!!,19.0,9,-3,1,-2,1,down,1978-06-24
9660,Quincy Jones,1978-09-02,Quincy Jones - Sounds...And Stuff Like That!!,7,8,12,4.0,10,Sounds...And Stuff Like That!!,19.0,10,-2,-3,1,1,down,1978-06-24
9661,Quincy Jones,1978-09-09,Quincy Jones - Sounds...And Stuff Like That!!,10,7,17,4.0,12,Sounds...And Stuff Like That!!,19.0,11,-5,-2,-3,1,down,1978-06-24
9662,Quincy Jones,1978-09-16,Quincy Jones - Sounds...And Stuff Like That!!,12,10,20,4.0,17,Sounds...And Stuff Like That!!,19.0,12,-3,-5,-2,1,down,1978-06-24
9663,Quincy Jones,1978-09-23,Quincy Jones - Sounds...And Stuff Like That!!,17,12,20,4.0,20,Sounds...And Stuff Like That!!,19.0,13,0,-3,-5,0,stay,1978-06-24
9664,Quincy Jones,1978-09-30,Quincy Jones - Sounds...And Stuff Like That!!,20,17,21,4.0,20,Sounds...And Stuff Like That!!,19.0,14,-1,0,-3,1,down,1978-06-24
9665,Quincy Jones,1978-10-07,Quincy Jones - Sounds...And Stuff Like That!!,20,20,22,4.0,21,Sounds...And Stuff Like That!!,19.0,15,-1,-1,0,1,down,1978-06-24
9666,Quincy Jones,1978-10-14,Quincy Jones - Sounds...And Stuff Like That!!,21,20,29,4.0,22,Sounds...And Stuff Like That!!,19.0,16,-7,-1,-1,1,down,1978-06-24
9667,Quincy Jones,1978-10-21,Quincy Jones - Sounds...And Stuff Like That!!,22,21,29,4.0,29,Sounds...And Stuff Like That!!,19.0,17,0,-7,-1,0,stay,1978-06-24
9668,Quincy Jones,1978-10-28,Quincy Jones - Sounds...And Stuff Like That!!,29,22,45,4.0,29,Sounds...And Stuff Like That!!,19.0,18,-16,0,-7,1,down,1978-06-24
9669,Quincy Jones,1978-11-04,Quincy Jones - Sounds...And Stuff Like That!!,29,29,51,4.0,45,Sounds...And Stuff Like That!!,19.0,19,-6,-16,0,1,down,1978-06-24
9670,ConFunkShun,1978-06-24,ConFunkShun - Love Shine,51,51,25,10.0,35,Love Shine,20.0,0,10,16,0,1,up,1978-06-24
9671,ConFunkShun,1978-07-01,ConFunkShun - Love Shine,35,51,17,10.0,25,Love Shine,20.0,1,8,10,16,1,up,1978-06-24
9672,ConFunkShun,1978-07-08,ConFunkShun - Love Shine,25,35,13,10.0,17,Love Shine,20.0,2,4,8,10,1,up,1978-06-24
9673,ConFunkShun,1978-07-15,ConFunkShun - Love Shine,17,25,13,10.0,13,Love Shine,20.0,3,0,4,8,0,stay,1978-06-24
9674,ConFunkShun,1978-07-22,ConFunkShun - Love Shine,13,17,12,10.0,13,Love Shine,20.0,4,1,0,4,1,up,1978-06-24
9675,ConFunkShun,1978-07-29,ConFunkShun - Love Shine,13,13,12,10.0,12,Love Shine,20.0,5,0,1,0,0,stay,1978-06-24
9676,ConFunkShun,1978-08-05,ConFunkShun - Love Shine,12,13,15,10.0,12,Love Shine,20.0,6,-3,0,1,1,down,1978-06-24
9677,ConFunkShun,1978-08-12,ConFunkShun - Love Shine,12,12,12,10.0,15,Love Shine,20.0,7,3,-3,0,1,up,1978-06-24
9678,ConFunkShun,1978-08-19,ConFunkShun - Love Shine,15,12,12,10.0,12,Love Shine,20.0,8,0,3,-3,0,stay,1978-06-24
9679,ConFunkShun,1978-08-26,ConFunkShun - Love Shine,12,15,12,10.0,12,Love Shine,20.0,9,0,0,3,0,stay,1978-06-24
9680,ConFunkShun,1978-09-02,ConFunkShun - Love Shine,12,12,10,10.0,12,Love Shine,20.0,10,2,0,0,1,up,1978-06-24
9681,ConFunkShun,1978-09-09,ConFunkShun - Love Shine,12,12,10,10.0,10,Love Shine,20.0,11,0,2,0,0,stay,1978-06-24
9682,ConFunkShun,1978-09-16,ConFunkShun - Love Shine,10,12,12,10.0,10,Love Shine,20.0,12,-2,0,2,1,down,1978-06-24
9683,ConFunkShun,1978-09-23,ConFunkShun - Love Shine,10,10,15,10.0,12,Love Shine,20.0,13,-3,-2,0,1,down,1978-06-24
9684,ConFunkShun,1978-09-30,ConFunkShun - Love Shine,12,10,17,10.0,15,Love Shine,20.0,14,-2,-3,-2,1,down,1978-06-24
9685,ConFunkShun,1978-10-07,ConFunkShun - Love Shine,15,12,19,10.0,17,Love Shine,20.0,15,-2,-2,-3,1,down,1978-06-24
9686,ConFunkShun,1978-10-14,ConFunkShun - Love Shine,17,15,23,10.0,19,Love Shine,20.0,16,-4,-2,-2,1,down,1978-06-24
9687,ConFunkShun,1978-10-21,ConFunkShun - Love Shine,19,17,26,10.0,23,Love Shine,20.0,17,-3,-4,-2,1,down,1978-06-24
9688,ConFunkShun,1978-10-28,ConFunkShun - Love Shine,23,19,37,10.0,26,Love Shine,20.0,18,-11,-3,-4,1,down,1978-06-24
9689,ConFunkShun,1978-11-04,ConFunkShun - Love Shine,26,23,36,10.0,37,Love Shine,20.0,19,1,-11,-3,1,up,1978-06-24
9690,ConFunkShun,1978-11-11,ConFunkShun - Love Shine,37,26,51,10.0,36,Love Shine,20.0,20,-15,1,-11,1,down,1978-06-24
9691,Teddy Pendergrass,1978-06-24,Teddy Pendergrass - Life Is A Song Worth Singing,51,51,7,1.0,38,Life Is A Song Worth Singing,34.0,0,31,13,0,1,up,1978-06-24
9692,Teddy Pendergrass,1978-07-01,Teddy Pendergrass - Life Is A Song Worth Singing,38,51,3,1.0,7,Life Is A Song Worth Singing,34.0,1,4,31,13,1,up,1978-06-24
9693,Teddy Pendergrass,1978-07-08,Teddy Pendergrass - Life Is A Song Worth Singing,7,38,2,1.0,3,Life Is A Song Worth Singing,34.0,2,1,4,31,1,up,1978-06-24
9694,Teddy Pendergrass,1978-07-15,Teddy Pendergrass - Life Is A Song Worth Singing,3,7,2,1.0,2,Life Is A Song Worth Singing,34.0,3,0,1,4,0,stay,1978-06-24
9695,Teddy Pendergrass,1978-07-22,Teddy Pendergrass - Life Is A Song Worth Singing,2,3,2,1.0,2,Life Is A Song Worth Singing,34.0,4,0,0,1,0,stay,1978-06-24
9696,Teddy Pendergrass,1978-07-29,Teddy Pendergrass - Life Is A Song Worth Singing,2,2,2,1.0,2,Life Is A Song Worth Singing,34.0,5,0,0,0,0,stay,1978-06-24
9697,Teddy Pendergrass,1978-08-05,Teddy Pendergrass - Life Is A Song Worth Singing,2,2,1,1.0,2,Life Is A Song Worth Singing,34.0,6,1,0,0,1,up,1978-06-24
9698,Teddy Pendergrass,1978-08-12,Teddy Pendergrass - Life Is A Song Worth Singing,2,2,1,1.0,1,Life Is A Song Worth Singing,34.0,7,0,1,0,0,stay,1978-06-24
9699,Teddy Pendergrass,1978-08-19,Teddy Pendergrass - Life Is A Song Worth Singing,1,2,6,1.0,1,Life Is A Song Worth Singing,34.0,8,-5,0,1,1,down,1978-06-24
9700,Teddy Pendergrass,1978-08-26,Teddy Pendergrass - Life Is A Song Worth Singing,1,1,6,1.0,6,Life Is A Song Worth Singing,34.0,9,0,-5,0,0,stay,1978-06-24
9701,Teddy Pendergrass,1978-09-02,Teddy Pendergrass - Life Is A Song Worth Singing,6,1,6,1.0,6,Life Is A Song Worth Singing,34.0,10,0,0,-5,0,stay,1978-06-24
9702,Teddy Pendergrass,1978-09-09,Teddy Pendergrass - Life Is A Song Worth Singing,6,6,6,1.0,6,Life Is A Song Worth Singing,34.0,11,0,0,0,0,stay,1978-06-24
9703,Teddy Pendergrass,1978-09-16,Teddy Pendergrass - Life Is A Song Worth Singing,6,6,7,1.0,6,Life Is A Song Worth Singing,34.0,12,-1,0,0,1,down,1978-06-24
9704,Teddy Pendergrass,1978-09-23,Teddy Pendergrass - Life Is A Song Worth Singing,6,6,10,1.0,7,Life Is A Song Worth Singing,34.0,13,-3,-1,0,1,down,1978-06-24
9705,Teddy Pendergrass,1978-09-30,Teddy Pendergrass - Life Is A Song Worth Singing,7,6,11,1.0,10,Life Is A Song Worth Singing,34.0,14,-1,-3,-1,1,down,1978-06-24
9706,Teddy Pendergrass,1978-10-07,Teddy Pendergrass - Life Is A Song Worth Singing,10,7,11,1.0,11,Life Is A Song Worth Singing,34.0,15,0,-1,-3,0,stay,1978-06-24
9707,Teddy Pendergrass,1978-10-14,Teddy Pendergrass - Life Is A Song Worth Singing,11,10,9,1.0,11,Life Is A Song Worth Singing,34.0,16,2,0,-1,1,up,1978-06-24
9708,Teddy Pendergrass,1978-10-21,Teddy Pendergrass - Life Is A Song Worth Singing,11,11,9,1.0,9,Life Is A Song Worth Singing,34.0,17,0,2,0,0,stay,1978-06-24
9709,Teddy Pendergrass,1978-10-28,Teddy Pendergrass - Life Is A Song Worth Singing,9,11,9,1.0,9,Life Is A Song Worth Singing,34.0,18,0,0,2,0,stay,1978-06-24
9710,Teddy Pendergrass,1978-11-04,Teddy Pendergrass - Life Is A Song Worth Singing,9,9,10,1.0,9,Life Is A Song Worth Singing,34.0,19,-1,0,0,1,down,1978-06-24
9711,Teddy Pendergrass,1978-11-11,Teddy Pendergrass - Life Is A Song Worth Singing,9,9,13,1.0,10,Life Is A Song Worth Singing,34.0,20,-3,-1,0,1,down,1978-06-24
9712,Teddy Pendergrass,1978-11-18,Teddy Pendergrass - Life Is A Song Worth Singing,10,9,13,1.0,13,Life Is A Song Worth Singing,34.0,21,0,-3,-1,0,stay,1978-06-24
9713,Teddy Pendergrass,1978-11-25,Teddy Pendergrass - Life Is A Song Worth Singing,13,10,14,1.0,13,Life Is A Song Worth Singing,34.0,22,-1,0,-3,1,down,1978-06-24
9714,Teddy Pendergrass,1978-12-02,Teddy Pendergrass - Life Is A Song Worth Singing,13,13,31,1.0,14,Life Is A Song Worth Singing,34.0,23,-17,-1,0,1,down,1978-06-24
9715,Teddy Pendergrass,1978-12-09,Teddy Pendergrass - Life Is A Song Worth Singing,14,13,31,1.0,31,Life Is A Song Worth Singing,34.0,24,0,-17,-1,0,stay,1978-06-24
9716,Teddy Pendergrass,1978-12-16,Teddy Pendergrass - Life Is A Song Worth Singing,31,14,41,1.0,31,Life Is A Song Worth Singing,34.0,25,-10,0,-17,1,down,1978-06-24
9717,Teddy Pendergrass,1978-12-23,Teddy Pendergrass - Life Is A Song Worth Singing,31,31,41,1.0,41,Life Is A Song Worth Singing,34.0,26,0,-10,0,0,stay,1978-06-24
9718,Teddy Pendergrass,1978-12-30,Teddy Pendergrass - Life Is A Song Worth Singing,41,31,42,1.0,41,Life Is A Song Worth Singing,34.0,27,-1,0,-10,1,down,1978-06-24
9719,Teddy Pendergrass,1979-01-06,Teddy Pendergrass - Life Is A Song Worth Singing,41,41,31,1.0,42,Life Is A Song Worth Singing,34.0,28,11,-1,0,1,up,1978-06-24
9720,Teddy Pendergrass,1979-01-13,Teddy Pendergrass - Life Is A Song Worth Singing,42,41,29,1.0,31,Life Is A Song Worth Singing,34.0,29,2,11,-1,1,up,1978-06-24
9721,Teddy Pendergrass,1979-01-20,Teddy Pendergrass - Life Is A Song Worth Singing,31,42,29,1.0,29,Life Is A Song Worth Singing,34.0,30,0,2,11,0,stay,1978-06-24
9722,Teddy Pendergrass,1979-01-27,Teddy Pendergrass - Life Is A Song Worth Singing,29,31,31,1.0,29,Life Is A Song Worth Singing,34.0,31,-2,0,2,1,down,1978-06-24
9723,Teddy Pendergrass,1979-02-03,Teddy Pendergrass - Life Is A Song Worth Singing,29,29,41,1.0,31,Life Is A Song Worth Singing,34.0,32,-10,-2,0,1,down,1978-06-24
9724,Teddy Pendergrass,1979-02-10,Teddy Pendergrass - Life Is A Song Worth Singing,31,29,46,1.0,41,Life Is A Song Worth Singing,34.0,33,-5,-10,-2,1,down,1978-06-24
9725,Teddy Pendergrass,1979-02-17,Teddy Pendergrass - Life Is A Song Worth Singing,41,31,51,1.0,46,Life Is A Song Worth Singing,34.0,34,-5,-5,-10,1,down,1978-06-24
9726,Bobby Bland,1978-07-01,Bobby Bland - Come Fly With Me,51,51,40,31.0,43,Come Fly With Me,9.0,0,3,8,0,1,up,1978-07-01
9727,Bobby Bland,1978-07-08,Bobby Bland - Come Fly With Me,43,51,31,31.0,40,Come Fly With Me,9.0,1,9,3,8,1,up,1978-07-01
9728,Bobby Bland,1978-07-15,Bobby Bland - Come Fly With Me,40,43,31,31.0,31,Come Fly With Me,9.0,2,0,9,3,0,stay,1978-07-01
9729,Bobby Bland,1978-07-22,Bobby Bland - Come Fly With Me,31,40,32,31.0,31,Come Fly With Me,9.0,3,-1,0,9,1,down,1978-07-01
9730,Bobby Bland,1978-07-29,Bobby Bland - Come Fly With Me,31,31,33,31.0,32,Come Fly With Me,9.0,4,-1,-1,0,1,down,1978-07-01
9731,Bobby Bland,1978-08-05,Bobby Bland - Come Fly With Me,32,31,39,31.0,33,Come Fly With Me,9.0,5,-6,-1,-1,1,down,1978-07-01
9732,Bobby Bland,1978-08-12,Bobby Bland - Come Fly With Me,33,32,49,31.0,39,Come Fly With Me,9.0,6,-10,-6,-1,1,down,1978-07-01
9733,Bobby Bland,1978-09-16,Bobby Bland - Come Fly With Me,39,33,49,31.0,49,Come Fly With Me,9.0,7,0,-10,-6,0,stay,1978-07-01
9734,Bobby Bland,1978-09-23,Bobby Bland - Come Fly With Me,49,39,50,31.0,49,Come Fly With Me,9.0,8,-1,0,-10,1,down,1978-07-01
9735,Bobby Bland,1978-09-30,Bobby Bland - Come Fly With Me,49,49,51,31.0,50,Come Fly With Me,9.0,9,-1,-1,0,1,down,1978-07-01
9736,Bobby Humphrey,1978-07-08,Bobby Humphrey - Freestyle,51,51,34,34.0,37,Freestyle,5.0,0,3,14,0,1,up,1978-07-08
9737,Bobby Humphrey,1978-07-15,Bobby Humphrey - Freestyle,37,51,37,34.0,34,Freestyle,5.0,1,-3,3,14,1,down,1978-07-08
9738,Bobby Humphrey,1978-07-22,Bobby Humphrey - Freestyle,34,37,40,34.0,37,Freestyle,5.0,2,-3,-3,3,1,down,1978-07-08
9739,Bobby Humphrey,1978-07-29,Bobby Humphrey - Freestyle,37,34,42,34.0,40,Freestyle,5.0,3,-2,-3,-3,1,down,1978-07-08
9740,Bobby Humphrey,1978-08-05,Bobby Humphrey - Freestyle,40,37,42,34.0,42,Freestyle,5.0,4,0,-2,-3,0,stay,1978-07-08
9741,Bobby Humphrey,1978-08-12,Bobby Humphrey - Freestyle,42,40,51,34.0,42,Freestyle,5.0,5,-9,0,-2,1,down,1978-07-08
9742,Andy Gibb,1978-07-08,Andy Gibb - Shadow Dancing,51,51,32,18.0,42,Shadow Dancing,9.0,0,10,9,0,1,up,1978-07-08
9743,Andy Gibb,1978-07-15,Andy Gibb - Shadow Dancing,42,51,24,18.0,32,Shadow Dancing,9.0,1,8,10,9,1,up,1978-07-08
9744,Andy Gibb,1978-07-22,Andy Gibb - Shadow Dancing,32,42,18,18.0,24,Shadow Dancing,9.0,2,6,8,10,1,up,1978-07-08
9745,Andy Gibb,1978-07-29,Andy Gibb - Shadow Dancing,24,32,18,18.0,18,Shadow Dancing,9.0,3,0,6,8,0,stay,1978-07-08
9746,Andy Gibb,1978-08-05,Andy Gibb - Shadow Dancing,18,24,24,18.0,18,Shadow Dancing,9.0,4,-6,0,6,1,down,1978-07-08
9747,Andy Gibb,1978-08-12,Andy Gibb - Shadow Dancing,18,18,27,18.0,24,Shadow Dancing,9.0,5,-3,-6,0,1,down,1978-07-08
9748,Andy Gibb,1978-08-19,Andy Gibb - Shadow Dancing,24,18,31,18.0,27,Shadow Dancing,9.0,6,-4,-3,-6,1,down,1978-07-08
9749,Andy Gibb,1978-08-26,Andy Gibb - Shadow Dancing,27,24,39,18.0,31,Shadow Dancing,9.0,7,-8,-4,-3,1,down,1978-07-08
9750,Andy Gibb,1978-09-02,Andy Gibb - Shadow Dancing,31,27,45,18.0,39,Shadow Dancing,9.0,8,-6,-8,-4,1,down,1978-07-08
9751,Andy Gibb,1978-09-09,Andy Gibb - Shadow Dancing,39,31,51,18.0,45,Shadow Dancing,9.0,9,-6,-6,-8,1,down,1978-07-08
9752,Hamilton Bohannon,1978-07-08,Hamilton Bohannon - Summertime Groove,51,51,47,14.0,48,Summertime Groove,22.0,0,1,3,0,1,up,1978-07-08
9753,Hamilton Bohannon,1978-07-15,Hamilton Bohannon - Summertime Groove,48,51,41,14.0,47,Summertime Groove,22.0,1,6,1,3,1,up,1978-07-08
9754,Hamilton Bohannon,1978-07-22,Hamilton Bohannon - Summertime Groove,47,48,41,14.0,41,Summertime Groove,22.0,2,0,6,1,0,stay,1978-07-08
9755,Hamilton Bohannon,1978-07-29,Hamilton Bohannon - Summertime Groove,41,47,45,14.0,41,Summertime Groove,22.0,3,-4,0,6,1,down,1978-07-08
9756,Hamilton Bohannon,1978-08-05,Hamilton Bohannon - Summertime Groove,41,41,47,14.0,45,Summertime Groove,22.0,4,-2,-4,0,1,down,1978-07-08
9757,Hamilton Bohannon,1978-08-12,Hamilton Bohannon - Summertime Groove,45,41,37,14.0,47,Summertime Groove,22.0,5,10,-2,-4,1,up,1978-07-08
9758,Hamilton Bohannon,1978-08-19,Hamilton Bohannon - Summertime Groove,47,45,35,14.0,37,Summertime Groove,22.0,6,2,10,-2,1,up,1978-07-08
9759,Hamilton Bohannon,1978-08-26,Hamilton Bohannon - Summertime Groove,37,47,25,14.0,35,Summertime Groove,22.0,7,10,2,10,1,up,1978-07-08
9760,Hamilton Bohannon,1978-09-02,Hamilton Bohannon - Summertime Groove,35,37,22,14.0,25,Summertime Groove,22.0,8,3,10,2,1,up,1978-07-08
9761,Hamilton Bohannon,1978-09-09,Hamilton Bohannon - Summertime Groove,25,35,26,14.0,22,Summertime Groove,22.0,9,-4,3,10,1,down,1978-07-08
9762,Hamilton Bohannon,1978-09-16,Hamilton Bohannon - Summertime Groove,22,25,26,14.0,26,Summertime Groove,22.0,10,0,-4,3,0,stay,1978-07-08
9763,Hamilton Bohannon,1978-09-23,Hamilton Bohannon - Summertime Groove,26,22,23,14.0,26,Summertime Groove,22.0,11,3,0,-4,1,up,1978-07-08
9764,Hamilton Bohannon,1978-09-30,Hamilton Bohannon - Summertime Groove,26,26,18,14.0,23,Summertime Groove,22.0,12,5,3,0,1,up,1978-07-08
9765,Hamilton Bohannon,1978-10-07,Hamilton Bohannon - Summertime Groove,23,26,15,14.0,18,Summertime Groove,22.0,13,3,5,3,1,up,1978-07-08
9766,Hamilton Bohannon,1978-10-14,Hamilton Bohannon - Summertime Groove,18,23,14,14.0,15,Summertime Groove,22.0,14,1,3,5,1,up,1978-07-08
9767,Hamilton Bohannon,1978-10-21,Hamilton Bohannon - Summertime Groove,15,18,18,14.0,14,Summertime Groove,22.0,15,-4,1,3,1,down,1978-07-08
9768,Hamilton Bohannon,1978-10-28,Hamilton Bohannon - Summertime Groove,14,15,18,14.0,18,Summertime Groove,22.0,16,0,-4,1,0,stay,1978-07-08
9769,Hamilton Bohannon,1978-11-04,Hamilton Bohannon - Summertime Groove,18,14,19,14.0,18,Summertime Groove,22.0,17,-1,0,-4,1,down,1978-07-08
9770,Hamilton Bohannon,1978-11-11,Hamilton Bohannon - Summertime Groove,18,18,24,14.0,19,Summertime Groove,22.0,18,-5,-1,0,1,down,1978-07-08
9771,Hamilton Bohannon,1978-11-18,Hamilton Bohannon - Summertime Groove,19,18,25,14.0,24,Summertime Groove,22.0,19,-1,-5,-1,1,down,1978-07-08
9772,Hamilton Bohannon,1978-11-25,Hamilton Bohannon - Summertime Groove,24,19,31,14.0,25,Summertime Groove,22.0,20,-6,-1,-5,1,down,1978-07-08
9773,Hamilton Bohannon,1978-12-02,Hamilton Bohannon - Summertime Groove,25,24,41,14.0,31,Summertime Groove,22.0,21,-10,-6,-1,1,down,1978-07-08
9774,Hamilton Bohannon,1978-12-09,Hamilton Bohannon - Summertime Groove,31,25,51,14.0,41,Summertime Groove,22.0,22,-10,-10,-6,1,down,1978-07-08
9775,Memphis Horns,1978-07-08,Memphis Horns - Band Ii,51,51,48,48.0,50,Band Ii,1.0,0,2,1,0,1,up,1978-07-08
9776,Memphis Horns,1978-07-15,Memphis Horns - Band Ii,50,51,51,48.0,48,Band Ii,1.0,1,-3,2,1,1,down,1978-07-08
9777,Michael Henderson,1978-07-15,Michael Henderson - In The Night Time,51,51,39,5.0,49,In The Night Time,24.0,0,10,2,0,1,up,1978-07-15
9778,Michael Henderson,1978-07-22,Michael Henderson - In The Night Time,49,51,30,5.0,39,In The Night Time,24.0,1,9,10,2,1,up,1978-07-15
9779,Michael Henderson,1978-07-29,Michael Henderson - In The Night Time,39,49,24,5.0,30,In The Night Time,24.0,2,6,9,10,1,up,1978-07-15
9780,Michael Henderson,1978-08-05,Michael Henderson - In The Night Time,30,39,18,5.0,24,In The Night Time,24.0,3,6,6,9,1,up,1978-07-15
9781,Michael Henderson,1978-08-12,Michael Henderson - In The Night Time,24,30,15,5.0,18,In The Night Time,24.0,4,3,6,6,1,up,1978-07-15
9782,Michael Henderson,1978-08-19,Michael Henderson - In The Night Time,18,24,11,5.0,15,In The Night Time,24.0,5,4,3,6,1,up,1978-07-15
9783,Michael Henderson,1978-08-26,Michael Henderson - In The Night Time,15,18,11,5.0,11,In The Night Time,24.0,6,0,4,3,0,stay,1978-07-15
9784,Michael Henderson,1978-09-02,Michael Henderson - In The Night Time,11,15,14,5.0,11,In The Night Time,24.0,7,-3,0,4,1,down,1978-07-15
9785,Michael Henderson,1978-09-09,Michael Henderson - In The Night Time,11,11,8,5.0,14,In The Night Time,24.0,8,6,-3,0,1,up,1978-07-15
9786,Michael Henderson,1978-09-16,Michael Henderson - In The Night Time,14,11,8,5.0,8,In The Night Time,24.0,9,0,6,-3,0,stay,1978-07-15
9787,Michael Henderson,1978-09-23,Michael Henderson - In The Night Time,8,14,5,5.0,8,In The Night Time,24.0,10,3,0,6,1,up,1978-07-15
9788,Michael Henderson,1978-09-30,Michael Henderson - In The Night Time,8,8,5,5.0,5,In The Night Time,24.0,11,0,3,0,0,stay,1978-07-15
9789,Michael Henderson,1978-10-07,Michael Henderson - In The Night Time,5,8,7,5.0,5,In The Night Time,24.0,12,-2,0,3,1,down,1978-07-15
9790,Michael Henderson,1978-10-14,Michael Henderson - In The Night Time,5,5,11,5.0,7,In The Night Time,24.0,13,-4,-2,0,1,down,1978-07-15
9791,Michael Henderson,1978-10-21,Michael Henderson - In The Night Time,7,5,15,5.0,11,In The Night Time,24.0,14,-4,-4,-2,1,down,1978-07-15
9792,Michael Henderson,1978-10-28,Michael Henderson - In The Night Time,11,7,13,5.0,15,In The Night Time,24.0,15,2,-4,-4,1,up,1978-07-15
9793,Michael Henderson,1978-11-04,Michael Henderson - In The Night Time,15,11,13,5.0,13,In The Night Time,24.0,16,0,2,-4,0,stay,1978-07-15
9794,Michael Henderson,1978-11-11,Michael Henderson - In The Night Time,13,15,18,5.0,13,In The Night Time,24.0,17,-5,0,2,1,down,1978-07-15
9795,Michael Henderson,1978-11-18,Michael Henderson - In The Night Time,13,13,19,5.0,18,In The Night Time,24.0,18,-1,-5,0,1,down,1978-07-15
9796,Michael Henderson,1978-11-25,Michael Henderson - In The Night Time,18,13,19,5.0,19,In The Night Time,24.0,19,0,-1,-5,0,stay,1978-07-15
9797,Michael Henderson,1978-12-02,Michael Henderson - In The Night Time,19,18,29,5.0,19,In The Night Time,24.0,20,-10,0,-1,1,down,1978-07-15
9798,Michael Henderson,1978-12-09,Michael Henderson - In The Night Time,19,19,34,5.0,29,In The Night Time,24.0,21,-5,-10,0,1,down,1978-07-15
9799,Michael Henderson,1978-12-16,Michael Henderson - In The Night Time,29,19,34,5.0,34,In The Night Time,24.0,22,0,-5,-10,0,stay,1978-07-15
9800,Michael Henderson,1978-12-23,Michael Henderson - In The Night Time,34,29,34,5.0,34,In The Night Time,24.0,23,0,0,-5,0,stay,1978-07-15
9801,Michael Henderson,1978-12-30,Michael Henderson - In The Night Time,34,34,51,5.0,34,In The Night Time,24.0,24,-17,0,0,1,down,1978-07-15
9802,Mass Production,1978-07-15,Mass Production - Three Miles High,51,51,51,50.0,50,Three Miles High,0.0,0,-1,1,0,1,down,1978-07-15
9803,Natalie Cole,1978-07-22,Natalie Cole - Natalie Live,51,51,15,9.0,19,Natalie Live,14.0,0,4,32,0,1,up,1978-07-22
9804,Natalie Cole,1978-07-29,Natalie Cole - Natalie Live,19,51,11,9.0,15,Natalie Live,14.0,1,4,4,32,1,up,1978-07-22
9805,Natalie Cole,1978-08-05,Natalie Cole - Natalie Live,15,19,9,9.0,11,Natalie Live,14.0,2,2,4,4,1,up,1978-07-22
9806,Natalie Cole,1978-08-12,Natalie Cole - Natalie Live,11,15,9,9.0,9,Natalie Live,14.0,3,0,2,4,0,stay,1978-07-22
9807,Natalie Cole,1978-08-19,Natalie Cole - Natalie Live,9,11,14,9.0,9,Natalie Live,14.0,4,-5,0,2,1,down,1978-07-22
9808,Natalie Cole,1978-08-26,Natalie Cole - Natalie Live,9,9,16,9.0,14,Natalie Live,14.0,5,-2,-5,0,1,down,1978-07-22
9809,Natalie Cole,1978-09-02,Natalie Cole - Natalie Live,14,9,18,9.0,16,Natalie Live,14.0,6,-2,-2,-5,1,down,1978-07-22
9810,Natalie Cole,1978-09-09,Natalie Cole - Natalie Live,16,14,23,9.0,18,Natalie Live,14.0,7,-5,-2,-2,1,down,1978-07-22
9811,Natalie Cole,1978-09-16,Natalie Cole - Natalie Live,18,16,29,9.0,23,Natalie Live,14.0,8,-6,-5,-2,1,down,1978-07-22
9812,Natalie Cole,1978-09-23,Natalie Cole - Natalie Live,23,18,31,9.0,29,Natalie Live,14.0,9,-2,-6,-5,1,down,1978-07-22
9813,Natalie Cole,1978-09-30,Natalie Cole - Natalie Live,29,23,33,9.0,31,Natalie Live,14.0,10,-2,-2,-6,1,down,1978-07-22
9814,Natalie Cole,1978-10-07,Natalie Cole - Natalie Live,31,29,33,9.0,33,Natalie Live,14.0,11,0,-2,-2,0,stay,1978-07-22
9815,Natalie Cole,1978-10-14,Natalie Cole - Natalie Live,33,31,36,9.0,33,Natalie Live,14.0,12,-3,0,-2,1,down,1978-07-22
9816,Natalie Cole,1978-10-21,Natalie Cole - Natalie Live,33,33,49,9.0,36,Natalie Live,14.0,13,-13,-3,0,1,down,1978-07-22
9817,Natalie Cole,1978-10-28,Natalie Cole - Natalie Live,36,33,51,9.0,49,Natalie Live,14.0,14,-2,-13,-3,1,down,1978-07-22
9818,Millie Jackson,1978-07-22,Millie Jackson - Get It Outcha System,51,51,23,14.0,29,Get It Outcha System,15.0,0,6,22,0,1,up,1978-07-22
9819,Millie Jackson,1978-07-29,Millie Jackson - Get It Outcha System,29,51,15,14.0,23,Get It Outcha System,15.0,1,8,6,22,1,up,1978-07-22
9820,Millie Jackson,1978-08-05,Millie Jackson - Get It Outcha System,23,29,14,14.0,15,Get It Outcha System,15.0,2,1,8,6,1,up,1978-07-22
9821,Millie Jackson,1978-08-12,Millie Jackson - Get It Outcha System,15,23,16,14.0,14,Get It Outcha System,15.0,3,-2,1,8,1,down,1978-07-22
9822,Millie Jackson,1978-08-19,Millie Jackson - Get It Outcha System,14,15,16,14.0,16,Get It Outcha System,15.0,4,0,-2,1,0,stay,1978-07-22
9823,Millie Jackson,1978-08-26,Millie Jackson - Get It Outcha System,16,14,14,14.0,16,Get It Outcha System,15.0,5,2,0,-2,1,up,1978-07-22
9824,Millie Jackson,1978-09-02,Millie Jackson - Get It Outcha System,16,16,19,14.0,14,Get It Outcha System,15.0,6,-5,2,0,1,down,1978-07-22
9825,Millie Jackson,1978-09-09,Millie Jackson - Get It Outcha System,14,16,25,14.0,19,Get It Outcha System,15.0,7,-6,-5,2,1,down,1978-07-22
9826,Millie Jackson,1978-09-16,Millie Jackson - Get It Outcha System,19,14,25,14.0,25,Get It Outcha System,15.0,8,0,-6,-5,0,stay,1978-07-22
9827,Millie Jackson,1978-09-23,Millie Jackson - Get It Outcha System,25,19,26,14.0,25,Get It Outcha System,15.0,9,-1,0,-6,1,down,1978-07-22
9828,Millie Jackson,1978-09-30,Millie Jackson - Get It Outcha System,25,25,29,14.0,26,Get It Outcha System,15.0,10,-3,-1,0,1,down,1978-07-22
9829,Millie Jackson,1978-10-07,Millie Jackson - Get It Outcha System,26,25,29,14.0,29,Get It Outcha System,15.0,11,0,-3,-1,0,stay,1978-07-22
9830,Millie Jackson,1978-10-14,Millie Jackson - Get It Outcha System,29,26,27,14.0,29,Get It Outcha System,15.0,12,2,0,-3,1,up,1978-07-22
9831,Millie Jackson,1978-10-21,Millie Jackson - Get It Outcha System,29,29,34,14.0,27,Get It Outcha System,15.0,13,-7,2,0,1,down,1978-07-22
9832,Millie Jackson,1978-10-28,Millie Jackson - Get It Outcha System,27,29,41,14.0,34,Get It Outcha System,15.0,14,-7,-7,2,1,down,1978-07-22
9833,Millie Jackson,1978-11-04,Millie Jackson - Get It Outcha System,34,27,51,14.0,41,Get It Outcha System,15.0,15,-10,-7,-7,1,down,1978-07-22
9834,The Fatback Band,1978-07-22,The Fatback Band - Fired Up 'n' Kickin',51,51,42,17.0,44,Fired Up 'n' Kickin',15.0,0,2,7,0,1,up,1978-07-22
9835,The Fatback Band,1978-07-29,The Fatback Band - Fired Up 'n' Kickin',44,51,44,17.0,42,Fired Up 'n' Kickin',15.0,1,-2,2,7,1,down,1978-07-22
9836,The Fatback Band,1978-08-05,The Fatback Band - Fired Up 'n' Kickin',42,44,34,17.0,44,Fired Up 'n' Kickin',15.0,2,10,-2,2,1,up,1978-07-22
9837,The Fatback Band,1978-08-12,The Fatback Band - Fired Up 'n' Kickin',44,42,26,17.0,34,Fired Up 'n' Kickin',15.0,3,8,10,-2,1,up,1978-07-22
9838,The Fatback Band,1978-08-19,The Fatback Band - Fired Up 'n' Kickin',34,44,20,17.0,26,Fired Up 'n' Kickin',15.0,4,6,8,10,1,up,1978-07-22
9839,The Fatback Band,1978-08-26,The Fatback Band - Fired Up 'n' Kickin',26,34,19,17.0,20,Fired Up 'n' Kickin',15.0,5,1,6,8,1,up,1978-07-22
9840,The Fatback Band,1978-09-02,The Fatback Band - Fired Up 'n' Kickin',20,26,17,17.0,19,Fired Up 'n' Kickin',15.0,6,2,1,6,1,up,1978-07-22
9841,The Fatback Band,1978-09-09,The Fatback Band - Fired Up 'n' Kickin',19,20,19,17.0,17,Fired Up 'n' Kickin',15.0,7,-2,2,1,1,down,1978-07-22
9842,The Fatback Band,1978-09-16,The Fatback Band - Fired Up 'n' Kickin',17,19,19,17.0,19,Fired Up 'n' Kickin',15.0,8,0,-2,2,0,stay,1978-07-22
9843,The Fatback Band,1978-09-23,The Fatback Band - Fired Up 'n' Kickin',19,17,19,17.0,19,Fired Up 'n' Kickin',15.0,9,0,0,-2,0,stay,1978-07-22
9844,The Fatback Band,1978-09-30,The Fatback Band - Fired Up 'n' Kickin',19,19,20,17.0,19,Fired Up 'n' Kickin',15.0,10,-1,0,0,1,down,1978-07-22
9845,The Fatback Band,1978-10-07,The Fatback Band - Fired Up 'n' Kickin',19,19,20,17.0,20,Fired Up 'n' Kickin',15.0,11,0,-1,0,0,stay,1978-07-22
9846,The Fatback Band,1978-10-14,The Fatback Band - Fired Up 'n' Kickin',20,19,25,17.0,20,Fired Up 'n' Kickin',15.0,12,-5,0,-1,1,down,1978-07-22
9847,The Fatback Band,1978-10-21,The Fatback Band - Fired Up 'n' Kickin',20,20,27,17.0,25,Fired Up 'n' Kickin',15.0,13,-2,-5,0,1,down,1978-07-22
9848,The Fatback Band,1978-10-28,The Fatback Band - Fired Up 'n' Kickin',25,20,43,17.0,27,Fired Up 'n' Kickin',15.0,14,-16,-2,-5,1,down,1978-07-22
9849,The Fatback Band,1978-11-04,The Fatback Band - Fired Up 'n' Kickin',27,25,51,17.0,43,Fired Up 'n' Kickin',15.0,15,-8,-16,-2,1,down,1978-07-22
9850,Foxy,1978-07-22,Foxy - Get Off,51,51,36,3.0,46,Get Off,21.0,0,10,5,0,1,up,1978-07-22
9851,Foxy,1978-07-29,Foxy - Get Off,46,51,26,3.0,36,Get Off,21.0,1,10,10,5,1,up,1978-07-22
9852,Foxy,1978-08-05,Foxy - Get Off,36,46,20,3.0,26,Get Off,21.0,2,6,10,10,1,up,1978-07-22
9853,Foxy,1978-08-12,Foxy - Get Off,26,36,13,3.0,20,Get Off,21.0,3,7,6,10,1,up,1978-07-22
9854,Foxy,1978-08-19,Foxy - Get Off,20,26,8,3.0,13,Get Off,21.0,4,5,7,6,1,up,1978-07-22
9855,Foxy,1978-08-26,Foxy - Get Off,13,20,7,3.0,8,Get Off,21.0,5,1,5,7,1,up,1978-07-22
9856,Foxy,1978-09-02,Foxy - Get Off,8,13,4,3.0,7,Get Off,21.0,6,3,1,5,1,up,1978-07-22
9857,Foxy,1978-09-09,Foxy - Get Off,7,8,3,3.0,4,Get Off,21.0,7,1,3,1,1,up,1978-07-22
9858,Foxy,1978-09-16,Foxy - Get Off,4,7,3,3.0,3,Get Off,21.0,8,0,1,3,0,stay,1978-07-22
9859,Foxy,1978-09-23,Foxy - Get Off,3,4,4,3.0,3,Get Off,21.0,9,-1,0,1,1,down,1978-07-22
9860,Foxy,1978-09-30,Foxy - Get Off,3,3,8,3.0,4,Get Off,21.0,10,-4,-1,0,1,down,1978-07-22
9861,Foxy,1978-10-07,Foxy - Get Off,4,3,13,3.0,8,Get Off,21.0,11,-5,-4,-1,1,down,1978-07-22
9862,Foxy,1978-10-14,Foxy - Get Off,8,4,15,3.0,13,Get Off,21.0,12,-2,-5,-4,1,down,1978-07-22
9863,Foxy,1978-10-21,Foxy - Get Off,13,8,14,3.0,15,Get Off,21.0,13,1,-2,-5,1,up,1978-07-22
9864,Foxy,1978-10-28,Foxy - Get Off,15,13,14,3.0,14,Get Off,21.0,14,0,1,-2,0,stay,1978-07-22
9865,Foxy,1978-11-04,Foxy - Get Off,14,15,14,3.0,14,Get Off,21.0,15,0,0,1,0,stay,1978-07-22
9866,Foxy,1978-11-11,Foxy - Get Off,14,14,17,3.0,14,Get Off,21.0,16,-3,0,0,1,down,1978-07-22
9867,Foxy,1978-11-18,Foxy - Get Off,14,14,21,3.0,17,Get Off,21.0,17,-4,-3,0,1,down,1978-07-22
9868,Foxy,1978-11-25,Foxy - Get Off,17,14,25,3.0,21,Get Off,21.0,18,-4,-4,-3,1,down,1978-07-22
9869,Foxy,1978-12-02,Foxy - Get Off,21,17,35,3.0,25,Get Off,21.0,19,-10,-4,-4,1,down,1978-07-22
9870,Foxy,1978-12-09,Foxy - Get Off,25,21,41,3.0,35,Get Off,21.0,20,-6,-10,-4,1,down,1978-07-22
9871,Foxy,1978-12-16,Foxy - Get Off,35,25,51,3.0,41,Get Off,21.0,21,-10,-6,-10,1,down,1978-07-22
9872,Lenny Williams,1978-07-22,Lenny Williams - Spark Of Love,51,51,38,17.0,48,Spark Of Love,29.0,0,10,3,0,1,up,1978-07-22
9873,Lenny Williams,1978-07-29,Lenny Williams - Spark Of Love,48,51,36,17.0,38,Spark Of Love,29.0,1,2,10,3,1,up,1978-07-22
9874,Lenny Williams,1978-08-05,Lenny Williams - Spark Of Love,38,48,35,17.0,36,Spark Of Love,29.0,2,1,2,10,1,up,1978-07-22
9875,Lenny Williams,1978-08-12,Lenny Williams - Spark Of Love,36,38,42,17.0,35,Spark Of Love,29.0,3,-7,1,2,1,down,1978-07-22
9876,Lenny Williams,1978-09-02,Lenny Williams - Spark Of Love,35,36,32,17.0,42,Spark Of Love,29.0,4,10,-7,1,1,up,1978-07-22
9877,Lenny Williams,1978-09-09,Lenny Williams - Spark Of Love,42,35,24,17.0,32,Spark Of Love,29.0,5,8,10,-7,1,up,1978-07-22
9878,Lenny Williams,1978-09-16,Lenny Williams - Spark Of Love,32,42,18,17.0,24,Spark Of Love,29.0,6,6,8,10,1,up,1978-07-22
9879,Lenny Williams,1978-09-23,Lenny Williams - Spark Of Love,24,32,17,17.0,18,Spark Of Love,29.0,7,1,6,8,1,up,1978-07-22
9880,Lenny Williams,1978-09-30,Lenny Williams - Spark Of Love,18,24,23,17.0,17,Spark Of Love,29.0,8,-6,1,6,1,down,1978-07-22
9881,Lenny Williams,1978-10-07,Lenny Williams - Spark Of Love,17,18,23,17.0,23,Spark Of Love,29.0,9,0,-6,1,0,stay,1978-07-22
9882,Lenny Williams,1978-10-14,Lenny Williams - Spark Of Love,23,17,24,17.0,23,Spark Of Love,29.0,10,-1,0,-6,1,down,1978-07-22
9883,Lenny Williams,1978-10-21,Lenny Williams - Spark Of Love,23,23,24,17.0,24,Spark Of Love,29.0,11,0,-1,0,0,stay,1978-07-22
9884,Lenny Williams,1978-10-28,Lenny Williams - Spark Of Love,24,23,24,17.0,24,Spark Of Love,29.0,12,0,0,-1,0,stay,1978-07-22
9885,Lenny Williams,1978-11-04,Lenny Williams - Spark Of Love,24,24,29,17.0,24,Spark Of Love,29.0,13,-5,0,0,1,down,1978-07-22
9886,Lenny Williams,1978-11-11,Lenny Williams - Spark Of Love,24,24,29,17.0,29,Spark Of Love,29.0,14,0,-5,0,0,stay,1978-07-22
9887,Lenny Williams,1978-11-18,Lenny Williams - Spark Of Love,29,24,40,17.0,29,Spark Of Love,29.0,15,-11,0,-5,1,down,1978-07-22
9888,Lenny Williams,1978-11-25,Lenny Williams - Spark Of Love,29,29,40,17.0,40,Spark Of Love,29.0,16,0,-11,0,0,stay,1978-07-22
9889,Lenny Williams,1978-12-02,Lenny Williams - Spark Of Love,40,29,36,17.0,40,Spark Of Love,29.0,17,4,0,-11,1,up,1978-07-22
9890,Lenny Williams,1978-12-09,Lenny Williams - Spark Of Love,40,40,33,17.0,36,Spark Of Love,29.0,18,3,4,0,1,up,1978-07-22
9891,Lenny Williams,1978-12-16,Lenny Williams - Spark Of Love,36,40,26,17.0,33,Spark Of Love,29.0,19,7,3,4,1,up,1978-07-22
9892,Lenny Williams,1978-12-23,Lenny Williams - Spark Of Love,33,36,26,17.0,26,Spark Of Love,29.0,20,0,7,3,0,stay,1978-07-22
9893,Lenny Williams,1978-12-30,Lenny Williams - Spark Of Love,26,33,20,17.0,26,Spark Of Love,29.0,21,6,0,7,1,up,1978-07-22
9894,Lenny Williams,1979-01-06,Lenny Williams - Spark Of Love,26,26,20,17.0,20,Spark Of Love,29.0,22,0,6,0,0,stay,1978-07-22
9895,Lenny Williams,1979-01-13,Lenny Williams - Spark Of Love,20,26,19,17.0,20,Spark Of Love,29.0,23,1,0,6,1,up,1978-07-22
9896,Lenny Williams,1979-01-20,Lenny Williams - Spark Of Love,20,20,28,17.0,19,Spark Of Love,29.0,24,-9,1,0,1,down,1978-07-22
9897,Lenny Williams,1979-01-27,Lenny Williams - Spark Of Love,19,20,29,17.0,28,Spark Of Love,29.0,25,-1,-9,1,1,down,1978-07-22
9898,Lenny Williams,1979-02-03,Lenny Williams - Spark Of Love,28,19,40,17.0,29,Spark Of Love,29.0,26,-11,-1,-9,1,down,1978-07-22
9899,Lenny Williams,1979-02-10,Lenny Williams - Spark Of Love,29,28,44,17.0,40,Spark Of Love,29.0,27,-4,-11,-1,1,down,1978-07-22
9900,Lenny Williams,1979-02-17,Lenny Williams - Spark Of Love,40,29,45,17.0,44,Spark Of Love,29.0,28,-1,-4,-11,1,down,1978-07-22
9901,Lenny Williams,1979-02-24,Lenny Williams - Spark Of Love,44,40,51,17.0,45,Spark Of Love,29.0,29,-6,-1,-4,1,down,1978-07-22
9902,Johnny Mathis And Deniece Williams,1978-07-29,Johnny Mathis And Deniece Williams - That's What Friends Are For,51,51,22,14.0,44,That's What Friends Are For,10.0,0,22,7,0,1,up,1978-07-29
9903,Johnny Mathis And Deniece Williams,1978-08-05,Johnny Mathis And Deniece Williams - That's What Friends Are For,44,51,16,14.0,22,That's What Friends Are For,10.0,1,6,22,7,1,up,1978-07-29
9904,Johnny Mathis And Deniece Williams,1978-08-12,Johnny Mathis And Deniece Williams - That's What Friends Are For,22,44,14,14.0,16,That's What Friends Are For,10.0,2,2,6,22,1,up,1978-07-29
9905,Johnny Mathis And Deniece Williams,1978-08-19,Johnny Mathis And Deniece Williams - That's What Friends Are For,16,22,15,14.0,14,That's What Friends Are For,10.0,3,-1,2,6,1,down,1978-07-29
9906,Johnny Mathis And Deniece Williams,1978-08-26,Johnny Mathis And Deniece Williams - That's What Friends Are For,14,16,22,14.0,15,That's What Friends Are For,10.0,4,-7,-1,2,1,down,1978-07-29
9907,Johnny Mathis And Deniece Williams,1978-09-02,Johnny Mathis And Deniece Williams - That's What Friends Are For,15,14,26,14.0,22,That's What Friends Are For,10.0,5,-4,-7,-1,1,down,1978-07-29
9908,Johnny Mathis And Deniece Williams,1978-09-09,Johnny Mathis And Deniece Williams - That's What Friends Are For,22,15,30,14.0,26,That's What Friends Are For,10.0,6,-4,-4,-7,1,down,1978-07-29
9909,Johnny Mathis And Deniece Williams,1978-09-16,Johnny Mathis And Deniece Williams - That's What Friends Are For,26,22,34,14.0,30,That's What Friends Are For,10.0,7,-4,-4,-4,1,down,1978-07-29
9910,Johnny Mathis And Deniece Williams,1978-09-23,Johnny Mathis And Deniece Williams - That's What Friends Are For,30,26,37,14.0,34,That's What Friends Are For,10.0,8,-3,-4,-4,1,down,1978-07-29
9911,Johnny Mathis And Deniece Williams,1978-09-30,Johnny Mathis And Deniece Williams - That's What Friends Are For,34,30,37,14.0,37,That's What Friends Are For,10.0,9,0,-3,-4,0,stay,1978-07-29
9912,Johnny Mathis And Deniece Williams,1978-10-07,Johnny Mathis And Deniece Williams - That's What Friends Are For,37,34,51,14.0,37,That's What Friends Are For,10.0,10,-14,0,-3,1,down,1978-07-29
9913,High Inergy,1978-07-29,High Inergy - Steppin' Out,51,51,50,46.0,48,Steppin' Out,4.0,0,-2,3,0,1,down,1978-07-29
9914,High Inergy,1978-08-05,High Inergy - Steppin' Out,48,51,46,46.0,50,Steppin' Out,4.0,1,4,-2,3,1,up,1978-07-29
9915,High Inergy,1978-08-12,High Inergy - Steppin' Out,50,48,46,46.0,46,Steppin' Out,4.0,2,0,4,-2,0,stay,1978-07-29
9916,High Inergy,1978-08-19,High Inergy - Steppin' Out,46,50,49,46.0,46,Steppin' Out,4.0,3,-3,0,4,1,down,1978-07-29
9917,High Inergy,1978-08-26,High Inergy - Steppin' Out,46,46,51,46.0,49,Steppin' Out,4.0,4,-2,-3,0,1,down,1978-07-29
9918,Sweet Thunder,1978-07-29,Sweet Thunder - Sweet Thunder,51,51,48,43.0,49,Sweet Thunder,2.0,0,1,2,0,1,up,1978-07-29
9919,Sweet Thunder,1978-08-05,Sweet Thunder - Sweet Thunder,49,51,43,43.0,48,Sweet Thunder,2.0,1,5,1,2,1,up,1978-07-29
9920,Sweet Thunder,1978-08-12,Sweet Thunder - Sweet Thunder,48,49,51,43.0,43,Sweet Thunder,2.0,2,-8,5,1,1,down,1978-07-29
9921,Herbie Hancock,1978-07-29,Herbie Hancock - Sunlight,51,51,40,31.0,50,Sunlight,7.0,0,10,1,0,1,up,1978-07-29
9922,Herbie Hancock,1978-08-05,Herbie Hancock - Sunlight,50,51,32,31.0,40,Sunlight,7.0,1,8,10,1,1,up,1978-07-29
9923,Herbie Hancock,1978-08-12,Herbie Hancock - Sunlight,40,50,31,31.0,32,Sunlight,7.0,2,1,8,10,1,up,1978-07-29
9924,Herbie Hancock,1978-08-19,Herbie Hancock - Sunlight,32,40,43,31.0,31,Sunlight,7.0,3,-12,1,8,1,down,1978-07-29
9925,Herbie Hancock,1978-08-26,Herbie Hancock - Sunlight,31,32,45,31.0,43,Sunlight,7.0,4,-2,-12,1,1,down,1978-07-29
9926,Herbie Hancock,1978-09-02,Herbie Hancock - Sunlight,43,31,46,31.0,45,Sunlight,7.0,5,-1,-2,-12,1,down,1978-07-29
9927,Herbie Hancock,1978-09-09,Herbie Hancock - Sunlight,45,43,46,31.0,46,Sunlight,7.0,6,0,-1,-2,0,stay,1978-07-29
9928,Herbie Hancock,1978-09-16,Herbie Hancock - Sunlight,46,45,51,31.0,46,Sunlight,7.0,7,-5,0,-1,1,down,1978-07-29
9929,The Crusaders,1978-08-05,The Crusaders - Images,51,51,31,18.0,41,Images,13.0,0,10,10,0,1,up,1978-08-05
9930,The Crusaders,1978-08-12,The Crusaders - Images,41,51,23,18.0,31,Images,13.0,1,8,10,10,1,up,1978-08-05
9931,The Crusaders,1978-08-19,The Crusaders - Images,31,41,21,18.0,23,Images,13.0,2,2,8,10,1,up,1978-08-05
9932,The Crusaders,1978-08-26,The Crusaders - Images,23,31,18,18.0,21,Images,13.0,3,3,2,8,1,up,1978-08-05
9933,The Crusaders,1978-09-02,The Crusaders - Images,21,23,20,18.0,18,Images,13.0,4,-2,3,2,1,down,1978-08-05
9934,The Crusaders,1978-09-09,The Crusaders - Images,18,21,33,18.0,20,Images,13.0,5,-13,-2,3,1,down,1978-08-05
9935,The Crusaders,1978-09-16,The Crusaders - Images,20,18,33,18.0,33,Images,13.0,6,0,-13,-2,0,stay,1978-08-05
9936,The Crusaders,1978-09-23,The Crusaders - Images,33,20,34,18.0,33,Images,13.0,7,-1,0,-13,1,down,1978-08-05
9937,The Crusaders,1978-09-30,The Crusaders - Images,33,33,34,18.0,34,Images,13.0,8,0,-1,0,0,stay,1978-08-05
9938,The Crusaders,1978-10-07,The Crusaders - Images,34,33,31,18.0,34,Images,13.0,9,3,0,-1,1,up,1978-08-05
9939,The Crusaders,1978-10-14,The Crusaders - Images,34,34,32,18.0,31,Images,13.0,10,-1,3,0,1,down,1978-08-05
9940,The Crusaders,1978-10-21,The Crusaders - Images,31,34,32,18.0,32,Images,13.0,11,0,-1,3,0,stay,1978-08-05
9941,The Crusaders,1978-10-28,The Crusaders - Images,32,31,36,18.0,32,Images,13.0,12,-4,0,-1,1,down,1978-08-05
9942,The Crusaders,1978-11-04,The Crusaders - Images,32,32,51,18.0,36,Images,13.0,13,-15,-4,0,1,down,1978-08-05
9943,Prince,1978-08-05,Prince - For You,51,51,49,21.0,49,For You,12.0,0,0,2,0,0,stay,1978-08-05
9944,Prince,1978-08-12,Prince - For You,49,51,47,21.0,49,For You,12.0,1,2,0,2,1,up,1978-08-05
9945,Prince,1978-08-19,Prince - For You,49,49,48,21.0,47,For You,12.0,2,-1,2,0,1,down,1978-08-05
9946,Prince,1978-09-16,Prince - For You,47,49,38,21.0,48,For You,12.0,3,10,-1,2,1,up,1978-08-05
9947,Prince,1978-09-23,Prince - For You,48,47,30,21.0,38,For You,12.0,4,8,10,-1,1,up,1978-08-05
9948,Prince,1978-09-30,Prince - For You,38,48,27,21.0,30,For You,12.0,5,3,8,10,1,up,1978-08-05
9949,Prince,1978-10-07,Prince - For You,30,38,21,21.0,27,For You,12.0,6,6,3,8,1,up,1978-08-05
9950,Prince,1978-10-14,Prince - For You,27,30,28,21.0,21,For You,12.0,7,-7,6,3,1,down,1978-08-05
9951,Prince,1978-10-21,Prince - For You,21,27,28,21.0,28,For You,12.0,8,0,-7,6,0,stay,1978-08-05
9952,Prince,1978-10-28,Prince - For You,28,21,28,21.0,28,For You,12.0,9,0,0,-7,0,stay,1978-08-05
9953,Prince,1978-11-04,Prince - For You,28,28,30,21.0,28,For You,12.0,10,-2,0,0,1,down,1978-08-05
9954,Prince,1978-11-11,Prince - For You,28,28,47,21.0,30,For You,12.0,11,-17,-2,0,1,down,1978-08-05
9955,Prince,1978-12-02,Prince - For You,30,28,51,21.0,47,For You,12.0,12,-4,-17,-2,1,down,1978-08-05
9956,The Brothers Johnson,1978-08-12,The Brothers Johnson - Blam,51,51,6,1.0,19,Blam,22.0,0,13,32,0,1,up,1978-08-12
9957,The Brothers Johnson,1978-08-19,The Brothers Johnson - Blam,19,51,4,1.0,6,Blam,22.0,1,2,13,32,1,up,1978-08-12
9958,The Brothers Johnson,1978-08-26,The Brothers Johnson - Blam,6,19,1,1.0,4,Blam,22.0,2,3,2,13,1,up,1978-08-12
9959,The Brothers Johnson,1978-09-02,The Brothers Johnson - Blam,4,6,1,1.0,1,Blam,22.0,3,0,3,2,0,stay,1978-08-12
9960,The Brothers Johnson,1978-09-09,The Brothers Johnson - Blam,1,4,1,1.0,1,Blam,22.0,4,0,0,3,0,stay,1978-08-12
9961,The Brothers Johnson,1978-09-16,The Brothers Johnson - Blam,1,1,1,1.0,1,Blam,22.0,5,0,0,0,0,stay,1978-08-12
9962,The Brothers Johnson,1978-09-23,The Brothers Johnson - Blam,1,1,1,1.0,1,Blam,22.0,6,0,0,0,0,stay,1978-08-12
9963,The Brothers Johnson,1978-09-30,The Brothers Johnson - Blam,1,1,1,1.0,1,Blam,22.0,7,0,0,0,0,stay,1978-08-12
9964,The Brothers Johnson,1978-10-07,The Brothers Johnson - Blam,1,1,1,1.0,1,Blam,22.0,8,0,0,0,0,stay,1978-08-12
9965,The Brothers Johnson,1978-10-14,The Brothers Johnson - Blam,1,1,3,1.0,1,Blam,22.0,9,-2,0,0,1,down,1978-08-12
9966,The Brothers Johnson,1978-10-21,The Brothers Johnson - Blam,1,1,3,1.0,3,Blam,22.0,10,0,-2,0,0,stay,1978-08-12
9967,The Brothers Johnson,1978-10-28,The Brothers Johnson - Blam,3,1,8,1.0,3,Blam,22.0,11,-5,0,-2,1,down,1978-08-12
9968,The Brothers Johnson,1978-11-04,The Brothers Johnson - Blam,3,3,9,1.0,8,Blam,22.0,12,-1,-5,0,1,down,1978-08-12
9969,The Brothers Johnson,1978-11-11,The Brothers Johnson - Blam,8,3,11,1.0,9,Blam,22.0,13,-2,-1,-5,1,down,1978-08-12
9970,The Brothers Johnson,1978-11-18,The Brothers Johnson - Blam,9,8,11,1.0,11,Blam,22.0,14,0,-2,-1,0,stay,1978-08-12
9971,The Brothers Johnson,1978-11-25,The Brothers Johnson - Blam,11,9,15,1.0,11,Blam,22.0,15,-4,0,-2,1,down,1978-08-12
9972,The Brothers Johnson,1978-12-02,The Brothers Johnson - Blam,11,11,22,1.0,15,Blam,22.0,16,-7,-4,0,1,down,1978-08-12
9973,The Brothers Johnson,1978-12-09,The Brothers Johnson - Blam,15,11,26,1.0,22,Blam,22.0,17,-4,-7,-4,1,down,1978-08-12
9974,The Brothers Johnson,1978-12-16,The Brothers Johnson - Blam,22,15,30,1.0,26,Blam,22.0,18,-4,-4,-7,1,down,1978-08-12
9975,The Brothers Johnson,1978-12-23,The Brothers Johnson - Blam,26,22,30,1.0,30,Blam,22.0,19,0,-4,-4,0,stay,1978-08-12
9976,The Brothers Johnson,1978-12-30,The Brothers Johnson - Blam,30,26,35,1.0,30,Blam,22.0,20,-5,0,-4,1,down,1978-08-12
9977,The Brothers Johnson,1979-01-06,The Brothers Johnson - Blam,30,30,43,1.0,35,Blam,22.0,21,-8,-5,0,1,down,1978-08-12
9978,The Brothers Johnson,1979-01-13,The Brothers Johnson - Blam,35,30,51,1.0,43,Blam,22.0,22,-8,-8,-5,1,down,1978-08-12
9979,The Stylistics,1978-08-12,The Stylistics - In Fashion,51,51,43,43.0,44,In Fashion,3.0,0,1,7,0,1,up,1978-08-12
9980,The Stylistics,1978-08-19,The Stylistics - In Fashion,44,51,47,43.0,43,In Fashion,3.0,1,-4,1,7,1,down,1978-08-12
9981,The Stylistics,1978-08-26,The Stylistics - In Fashion,43,44,49,43.0,47,In Fashion,3.0,2,-2,-4,1,1,down,1978-08-12
9982,The Stylistics,1978-09-02,The Stylistics - In Fashion,47,43,51,43.0,49,In Fashion,3.0,3,-2,-2,-4,1,down,1978-08-12
9983,Sylvester,1978-08-12,Sylvester - Step II,51,51,44,7.0,45,Step II,32.0,0,1,6,0,1,up,1978-08-12
9984,Sylvester,1978-08-19,Sylvester - Step II,45,51,34,7.0,44,Step II,32.0,1,10,1,6,1,up,1978-08-12
9985,Sylvester,1978-08-26,Sylvester - Step II,44,45,32,7.0,34,Step II,32.0,2,2,10,1,1,up,1978-08-12
9986,Sylvester,1978-09-02,Sylvester - Step II,34,44,23,7.0,32,Step II,32.0,3,9,2,10,1,up,1978-08-12
9987,Sylvester,1978-09-09,Sylvester - Step II,32,34,20,7.0,23,Step II,32.0,4,3,9,2,1,up,1978-08-12
9988,Sylvester,1978-09-16,Sylvester - Step II,23,32,15,7.0,20,Step II,32.0,5,5,3,9,1,up,1978-08-12
9989,Sylvester,1978-09-23,Sylvester - Step II,20,23,11,7.0,15,Step II,32.0,6,4,5,3,1,up,1978-08-12
9990,Sylvester,1978-09-30,Sylvester - Step II,15,20,10,7.0,11,Step II,32.0,7,1,4,5,1,up,1978-08-12
9991,Sylvester,1978-10-07,Sylvester - Step II,11,15,8,7.0,10,Step II,32.0,8,2,1,4,1,up,1978-08-12
9992,Sylvester,1978-10-14,Sylvester - Step II,10,11,7,7.0,8,Step II,32.0,9,1,2,1,1,up,1978-08-12
9993,Sylvester,1978-10-21,Sylvester - Step II,8,10,12,7.0,7,Step II,32.0,10,-5,1,2,1,down,1978-08-12
9994,Sylvester,1978-10-28,Sylvester - Step II,7,8,12,7.0,12,Step II,32.0,11,0,-5,1,0,stay,1978-08-12
9995,Sylvester,1978-11-04,Sylvester - Step II,12,7,12,7.0,12,Step II,32.0,12,0,0,-5,0,stay,1978-08-12
9996,Sylvester,1978-11-11,Sylvester - Step II,12,12,12,7.0,12,Step II,32.0,13,0,0,0,0,stay,1978-08-12
9997,Sylvester,1978-11-18,Sylvester - Step II,12,12,12,7.0,12,Step II,32.0,14,0,0,0,0,stay,1978-08-12
9998,Sylvester,1978-11-25,Sylvester - Step II,12,12,12,7.0,12,Step II,32.0,15,0,0,0,0,stay,1978-08-12
9999,Sylvester,1978-12-02,Sylvester - Step II,12,12,23,7.0,12,Step II,32.0,16,-11,0,0,1,down,1978-08-12
10000,Sylvester,1978-12-09,Sylvester - Step II,12,12,24,7.0,23,Step II,32.0,17,-1,-11,0,1,down,1978-08-12
10001,Sylvester,1978-12-16,Sylvester - Step II,23,12,27,7.0,24,Step II,32.0,18,-3,-1,-11,1,down,1978-08-12
10002,Sylvester,1978-12-23,Sylvester - Step II,24,23,27,7.0,27,Step II,32.0,19,0,-3,-1,0,stay,1978-08-12
10003,Sylvester,1978-12-30,Sylvester - Step II,27,24,36,7.0,27,Step II,32.0,20,-9,0,-3,1,down,1978-08-12
10004,Sylvester,1979-01-06,Sylvester - Step II,27,27,39,7.0,36,Step II,32.0,21,-3,-9,0,1,down,1978-08-12
10005,Sylvester,1979-01-13,Sylvester - Step II,36,27,32,7.0,39,Step II,32.0,22,7,-3,-9,1,up,1978-08-12
10006,Sylvester,1979-01-20,Sylvester - Step II,39,36,31,7.0,32,Step II,32.0,23,1,7,-3,1,up,1978-08-12
10007,Sylvester,1979-01-27,Sylvester - Step II,32,39,23,7.0,31,Step II,32.0,24,8,1,7,1,up,1978-08-12
10008,Sylvester,1979-02-03,Sylvester - Step II,31,32,23,7.0,23,Step II,32.0,25,0,8,1,0,stay,1978-08-12
10009,Sylvester,1979-02-10,Sylvester - Step II,23,31,29,7.0,23,Step II,32.0,26,-6,0,8,1,down,1978-08-12
10010,Sylvester,1979-02-17,Sylvester - Step II,23,23,31,7.0,29,Step II,32.0,27,-2,-6,0,1,down,1978-08-12
10011,Sylvester,1979-02-24,Sylvester - Step II,29,23,39,7.0,31,Step II,32.0,28,-8,-2,-6,1,down,1978-08-12
10012,Sylvester,1979-03-03,Sylvester - Step II,31,29,41,7.0,39,Step II,32.0,29,-2,-8,-2,1,down,1978-08-12
10013,Sylvester,1979-03-10,Sylvester - Step II,39,31,41,7.0,41,Step II,32.0,30,0,-2,-8,0,stay,1978-08-12
10014,Sylvester,1979-03-17,Sylvester - Step II,41,39,48,7.0,41,Step II,32.0,31,-7,0,-2,1,down,1978-08-12
10015,Sylvester,1979-03-24,Sylvester - Step II,41,41,51,7.0,48,Step II,32.0,32,-3,-7,0,1,down,1978-08-12
10016,Candi Staton,1978-08-12,Candi Staton - House Of Love,51,51,41,19.0,48,House Of Love,15.0,0,7,3,0,1,up,1978-08-12
10017,Candi Staton,1978-08-19,Candi Staton - House Of Love,48,51,36,19.0,41,House Of Love,15.0,1,5,7,3,1,up,1978-08-12
10018,Candi Staton,1978-08-26,Candi Staton - House Of Love,41,48,36,19.0,36,House Of Love,15.0,2,0,5,7,0,stay,1978-08-12
10019,Candi Staton,1978-09-02,Candi Staton - House Of Love,36,41,28,19.0,36,House Of Love,15.0,3,8,0,5,1,up,1978-08-12
10020,Candi Staton,1978-09-09,Candi Staton - House Of Love,36,36,27,19.0,28,House Of Love,15.0,4,1,8,0,1,up,1978-08-12
10021,Candi Staton,1978-09-16,Candi Staton - House Of Love,28,36,28,19.0,27,House Of Love,15.0,5,-1,1,8,1,down,1978-08-12
10022,Candi Staton,1978-09-23,Candi Staton - House Of Love,27,28,29,19.0,28,House Of Love,15.0,6,-1,-1,1,1,down,1978-08-12
10023,Candi Staton,1978-09-30,Candi Staton - House Of Love,28,27,30,19.0,29,House Of Love,15.0,7,-1,-1,-1,1,down,1978-08-12
10024,Candi Staton,1978-10-07,Candi Staton - House Of Love,29,28,25,19.0,30,House Of Love,15.0,8,5,-1,-1,1,up,1978-08-12
10025,Candi Staton,1978-10-14,Candi Staton - House Of Love,30,29,19,19.0,25,House Of Love,15.0,9,6,5,-1,1,up,1978-08-12
10026,Candi Staton,1978-10-21,Candi Staton - House Of Love,25,30,19,19.0,19,House Of Love,15.0,10,0,6,5,0,stay,1978-08-12
10027,Candi Staton,1978-10-28,Candi Staton - House Of Love,19,25,20,19.0,19,House Of Love,15.0,11,-1,0,6,1,down,1978-08-12
10028,Candi Staton,1978-11-04,Candi Staton - House Of Love,19,19,47,19.0,20,House Of Love,15.0,12,-27,-1,0,1,down,1978-08-12
10029,Candi Staton,1978-11-25,Candi Staton - House Of Love,20,19,43,19.0,47,House Of Love,15.0,13,4,-27,-1,1,up,1978-08-12
10030,Candi Staton,1978-12-09,Candi Staton - House Of Love,47,20,43,19.0,43,House Of Love,15.0,14,0,4,-27,0,stay,1978-08-12
10031,Candi Staton,1978-12-16,Candi Staton - House Of Love,43,47,51,19.0,43,House Of Love,15.0,15,-8,0,4,1,down,1978-08-12
10032,War,1978-08-12,War - Youngblood,51,51,40,40.0,50,Youngblood,4.0,0,10,1,0,1,up,1978-08-12
10033,War,1978-08-19,War - Youngblood,50,51,40,40.0,40,Youngblood,4.0,1,0,10,1,0,stay,1978-08-12
10034,War,1978-08-26,War - Youngblood,40,50,44,40.0,40,Youngblood,4.0,2,-4,0,10,1,down,1978-08-12
10035,War,1978-09-02,War - Youngblood,40,40,48,40.0,44,Youngblood,4.0,3,-4,-4,0,1,down,1978-08-12
10036,War,1978-09-09,War - Youngblood,44,40,51,40.0,48,Youngblood,4.0,4,-3,-4,-4,1,down,1978-08-12
10037,Slave,1978-08-19,Slave - The Concept,51,51,19,11.0,25,The Concept,9.0,0,6,26,0,1,up,1978-08-19
10038,Slave,1978-08-26,Slave - The Concept,25,51,15,11.0,19,The Concept,9.0,1,4,6,26,1,up,1978-08-19
10039,Slave,1978-09-02,Slave - The Concept,19,25,11,11.0,15,The Concept,9.0,2,4,4,6,1,up,1978-08-19
10040,Slave,1978-09-09,Slave - The Concept,15,19,11,11.0,11,The Concept,9.0,3,0,4,4,0,stay,1978-08-19
10041,Slave,1978-09-16,Slave - The Concept,11,15,16,11.0,11,The Concept,9.0,4,-5,0,4,1,down,1978-08-19
10042,Slave,1978-09-23,Slave - The Concept,11,11,36,11.0,16,The Concept,9.0,5,-20,-5,0,1,down,1978-08-19
10043,Slave,1978-09-30,Slave - The Concept,16,11,36,11.0,36,The Concept,9.0,6,0,-20,-5,0,stay,1978-08-19
10044,Slave,1978-10-07,Slave - The Concept,36,16,39,11.0,36,The Concept,9.0,7,-3,0,-20,1,down,1978-08-19
10045,Slave,1978-10-14,Slave - The Concept,36,36,41,11.0,39,The Concept,9.0,8,-2,-3,0,1,down,1978-08-19
10046,Slave,1978-10-21,Slave - The Concept,39,36,51,11.0,41,The Concept,9.0,9,-10,-2,-3,1,down,1978-08-19
10047,The Emotions,1978-08-19,The Emotions - Sunbeam,51,51,23,12.0,36,Sunbeam,15.0,0,13,15,0,1,up,1978-08-19
10048,The Emotions,1978-08-26,The Emotions - Sunbeam,36,51,17,12.0,23,Sunbeam,15.0,1,6,13,15,1,up,1978-08-19
10049,The Emotions,1978-09-02,The Emotions - Sunbeam,23,36,13,12.0,17,Sunbeam,15.0,2,4,6,13,1,up,1978-08-19
10050,The Emotions,1978-09-09,The Emotions - Sunbeam,17,23,12,12.0,13,Sunbeam,15.0,3,1,4,6,1,up,1978-08-19
10051,The Emotions,1978-09-16,The Emotions - Sunbeam,13,17,13,12.0,12,Sunbeam,15.0,4,-1,1,4,1,down,1978-08-19
10052,The Emotions,1978-09-23,The Emotions - Sunbeam,12,13,13,12.0,13,Sunbeam,15.0,5,0,-1,1,0,stay,1978-08-19
10053,The Emotions,1978-09-30,The Emotions - Sunbeam,13,12,14,12.0,13,Sunbeam,15.0,6,-1,0,-1,1,down,1978-08-19
10054,The Emotions,1978-10-07,The Emotions - Sunbeam,13,13,18,12.0,14,Sunbeam,15.0,7,-4,-1,0,1,down,1978-08-19
10055,The Emotions,1978-10-14,The Emotions - Sunbeam,14,13,17,12.0,18,Sunbeam,15.0,8,1,-4,-1,1,up,1978-08-19
10056,The Emotions,1978-10-21,The Emotions - Sunbeam,18,14,25,12.0,17,Sunbeam,15.0,9,-8,1,-4,1,down,1978-08-19
10057,The Emotions,1978-10-28,The Emotions - Sunbeam,17,18,25,12.0,25,Sunbeam,15.0,10,0,-8,1,0,stay,1978-08-19
10058,The Emotions,1978-11-04,The Emotions - Sunbeam,25,17,26,12.0,25,Sunbeam,15.0,11,-1,0,-8,1,down,1978-08-19
10059,The Emotions,1978-11-11,The Emotions - Sunbeam,25,25,35,12.0,26,Sunbeam,15.0,12,-9,-1,0,1,down,1978-08-19
10060,The Emotions,1978-11-18,The Emotions - Sunbeam,26,25,35,12.0,35,Sunbeam,15.0,13,0,-9,-1,0,stay,1978-08-19
10061,The Emotions,1978-11-25,The Emotions - Sunbeam,35,26,41,12.0,35,Sunbeam,15.0,14,-6,0,-9,1,down,1978-08-19
10062,The Emotions,1978-12-02,The Emotions - Sunbeam,35,35,51,12.0,41,Sunbeam,15.0,15,-10,-6,0,1,down,1978-08-19
10063,Ohio Players,1978-08-19,Ohio Players - Jass-ay-lay-dee,51,51,30,15.0,38,Jass-ay-lay-dee,11.0,0,8,13,0,1,up,1978-08-19
10064,Ohio Players,1978-08-26,Ohio Players - Jass-ay-lay-dee,38,51,20,15.0,30,Jass-ay-lay-dee,11.0,1,10,8,13,1,up,1978-08-19
10065,Ohio Players,1978-09-02,Ohio Players - Jass-ay-lay-dee,30,38,16,15.0,20,Jass-ay-lay-dee,11.0,2,4,10,8,1,up,1978-08-19
10066,Ohio Players,1978-09-09,Ohio Players - Jass-ay-lay-dee,20,30,15,15.0,16,Jass-ay-lay-dee,11.0,3,1,4,10,1,up,1978-08-19
10067,Ohio Players,1978-09-16,Ohio Players - Jass-ay-lay-dee,16,20,21,15.0,15,Jass-ay-lay-dee,11.0,4,-6,1,4,1,down,1978-08-19
10068,Ohio Players,1978-09-23,Ohio Players - Jass-ay-lay-dee,15,16,21,15.0,21,Jass-ay-lay-dee,11.0,5,0,-6,1,0,stay,1978-08-19
10069,Ohio Players,1978-09-30,Ohio Players - Jass-ay-lay-dee,21,15,22,15.0,21,Jass-ay-lay-dee,11.0,6,-1,0,-6,1,down,1978-08-19
10070,Ohio Players,1978-10-07,Ohio Players - Jass-ay-lay-dee,21,21,27,15.0,22,Jass-ay-lay-dee,11.0,7,-5,-1,0,1,down,1978-08-19
10071,Ohio Players,1978-10-14,Ohio Players - Jass-ay-lay-dee,22,21,33,15.0,27,Jass-ay-lay-dee,11.0,8,-6,-5,-1,1,down,1978-08-19
10072,Ohio Players,1978-10-21,Ohio Players - Jass-ay-lay-dee,27,22,39,15.0,33,Jass-ay-lay-dee,11.0,9,-6,-6,-5,1,down,1978-08-19
10073,Ohio Players,1978-10-28,Ohio Players - Jass-ay-lay-dee,33,27,42,15.0,39,Jass-ay-lay-dee,11.0,10,-3,-6,-6,1,down,1978-08-19
10074,Ohio Players,1978-11-04,Ohio Players - Jass-ay-lay-dee,39,33,51,15.0,42,Jass-ay-lay-dee,11.0,11,-9,-3,-6,1,down,1978-08-19
10075,Roy Ayers,1978-08-19,Roy Ayers - You Send Me,51,51,38,16.0,48,You Send Me,23.0,0,10,3,0,1,up,1978-08-19
10076,Roy Ayers,1978-08-26,Roy Ayers - You Send Me,48,51,35,16.0,38,You Send Me,23.0,1,3,10,3,1,up,1978-08-19
10077,Roy Ayers,1978-09-02,Roy Ayers - You Send Me,38,48,25,16.0,35,You Send Me,23.0,2,10,3,10,1,up,1978-08-19
10078,Roy Ayers,1978-09-09,Roy Ayers - You Send Me,35,38,18,16.0,25,You Send Me,23.0,3,7,10,3,1,up,1978-08-19
10079,Roy Ayers,1978-09-16,Roy Ayers - You Send Me,25,35,17,16.0,18,You Send Me,23.0,4,1,7,10,1,up,1978-08-19
10080,Roy Ayers,1978-09-23,Roy Ayers - You Send Me,18,25,16,16.0,17,You Send Me,23.0,5,1,1,7,1,up,1978-08-19
10081,Roy Ayers,1978-09-30,Roy Ayers - You Send Me,17,18,19,16.0,16,You Send Me,23.0,6,-3,1,1,1,down,1978-08-19
10082,Roy Ayers,1978-10-07,Roy Ayers - You Send Me,16,17,34,16.0,19,You Send Me,23.0,7,-15,-3,1,1,down,1978-08-19
10083,Roy Ayers,1978-10-14,Roy Ayers - You Send Me,19,16,26,16.0,34,You Send Me,23.0,8,8,-15,-3,1,up,1978-08-19
10084,Roy Ayers,1978-10-21,Roy Ayers - You Send Me,34,19,20,16.0,26,You Send Me,23.0,9,6,8,-15,1,up,1978-08-19
10085,Roy Ayers,1978-10-28,Roy Ayers - You Send Me,26,34,19,16.0,20,You Send Me,23.0,10,1,6,8,1,up,1978-08-19
10086,Roy Ayers,1978-11-04,Roy Ayers - You Send Me,20,26,28,16.0,19,You Send Me,23.0,11,-9,1,6,1,down,1978-08-19
10087,Roy Ayers,1978-11-11,Roy Ayers - You Send Me,19,20,28,16.0,28,You Send Me,23.0,12,0,-9,1,0,stay,1978-08-19
10088,Roy Ayers,1978-11-18,Roy Ayers - You Send Me,28,19,39,16.0,28,You Send Me,23.0,13,-11,0,-9,1,down,1978-08-19
10089,Roy Ayers,1978-11-25,Roy Ayers - You Send Me,28,28,39,16.0,39,You Send Me,23.0,14,0,-11,0,0,stay,1978-08-19
10090,Roy Ayers,1978-12-02,Roy Ayers - You Send Me,39,28,47,16.0,39,You Send Me,23.0,15,-8,0,-11,1,down,1978-08-19
10091,Roy Ayers,1978-12-09,Roy Ayers - You Send Me,39,39,42,16.0,47,You Send Me,23.0,16,5,-8,0,1,up,1978-08-19
10092,Roy Ayers,1978-12-23,Roy Ayers - You Send Me,47,39,42,16.0,42,You Send Me,23.0,17,0,5,-8,0,stay,1978-08-19
10093,Roy Ayers,1978-12-30,Roy Ayers - You Send Me,42,47,32,16.0,42,You Send Me,23.0,18,10,0,5,1,up,1978-08-19
10094,Roy Ayers,1979-01-06,Roy Ayers - You Send Me,42,42,32,16.0,32,You Send Me,23.0,19,0,10,0,0,stay,1978-08-19
10095,Roy Ayers,1979-01-13,Roy Ayers - You Send Me,32,42,39,16.0,32,You Send Me,23.0,20,-7,0,10,1,down,1978-08-19
10096,Roy Ayers,1979-01-20,Roy Ayers - You Send Me,32,32,37,16.0,39,You Send Me,23.0,21,2,-7,0,1,up,1978-08-19
10097,Roy Ayers,1979-01-27,Roy Ayers - You Send Me,39,32,46,16.0,37,You Send Me,23.0,22,-9,2,-7,1,down,1978-08-19
10098,Roy Ayers,1979-02-03,Roy Ayers - You Send Me,37,39,51,16.0,46,You Send Me,23.0,23,-5,-9,2,1,down,1978-08-19
10099,The Rolling Stones,1978-08-19,The Rolling Stones - Some Girls,51,51,46,46.0,49,Some Girls,2.0,0,3,2,0,1,up,1978-08-19
10100,The Rolling Stones,1978-08-26,The Rolling Stones - Some Girls,49,51,46,46.0,46,Some Girls,2.0,1,0,3,2,0,stay,1978-08-19
10101,The Rolling Stones,1978-09-02,The Rolling Stones - Some Girls,46,49,51,46.0,46,Some Girls,2.0,2,-5,0,3,1,down,1978-08-19
10102,Atlantic Starr,1978-08-19,Atlantic Starr - Atlantic Starr,51,51,41,21.0,50,Atlantic Starr,16.0,0,9,1,0,1,up,1978-08-19
10103,Atlantic Starr,1978-08-26,Atlantic Starr - Atlantic Starr,50,51,31,21.0,41,Atlantic Starr,16.0,1,10,9,1,1,up,1978-08-19
10104,Atlantic Starr,1978-09-02,Atlantic Starr - Atlantic Starr,41,50,24,21.0,31,Atlantic Starr,16.0,2,7,10,9,1,up,1978-08-19
10105,Atlantic Starr,1978-09-09,Atlantic Starr - Atlantic Starr,31,41,21,21.0,24,Atlantic Starr,16.0,3,3,7,10,1,up,1978-08-19
10106,Atlantic Starr,1978-09-16,Atlantic Starr - Atlantic Starr,24,31,24,21.0,21,Atlantic Starr,16.0,4,-3,3,7,1,down,1978-08-19
10107,Atlantic Starr,1978-09-23,Atlantic Starr - Atlantic Starr,21,24,27,21.0,24,Atlantic Starr,16.0,5,-3,-3,3,1,down,1978-08-19
10108,Atlantic Starr,1978-09-30,Atlantic Starr - Atlantic Starr,24,21,28,21.0,27,Atlantic Starr,16.0,6,-1,-3,-3,1,down,1978-08-19
10109,Atlantic Starr,1978-10-07,Atlantic Starr - Atlantic Starr,27,24,30,21.0,28,Atlantic Starr,16.0,7,-2,-1,-3,1,down,1978-08-19
10110,Atlantic Starr,1978-10-14,Atlantic Starr - Atlantic Starr,28,27,31,21.0,30,Atlantic Starr,16.0,8,-1,-2,-1,1,down,1978-08-19
10111,Atlantic Starr,1978-10-21,Atlantic Starr - Atlantic Starr,30,28,23,21.0,31,Atlantic Starr,16.0,9,8,-1,-2,1,up,1978-08-19
10112,Atlantic Starr,1978-10-28,Atlantic Starr - Atlantic Starr,31,30,23,21.0,23,Atlantic Starr,16.0,10,0,8,-1,0,stay,1978-08-19
10113,Atlantic Starr,1978-11-04,Atlantic Starr - Atlantic Starr,23,31,31,21.0,23,Atlantic Starr,16.0,11,-8,0,8,1,down,1978-08-19
10114,Atlantic Starr,1978-11-11,Atlantic Starr - Atlantic Starr,23,23,46,21.0,31,Atlantic Starr,16.0,12,-15,-8,0,1,down,1978-08-19
10115,Atlantic Starr,1978-11-18,Atlantic Starr - Atlantic Starr,31,23,46,21.0,46,Atlantic Starr,16.0,13,0,-15,-8,0,stay,1978-08-19
10116,Atlantic Starr,1978-11-25,Atlantic Starr - Atlantic Starr,46,31,49,21.0,46,Atlantic Starr,16.0,14,-3,0,-15,1,down,1978-08-19
10117,Atlantic Starr,1978-12-02,Atlantic Starr - Atlantic Starr,46,46,49,21.0,49,Atlantic Starr,16.0,15,0,-3,0,0,stay,1978-08-19
10118,Atlantic Starr,1978-12-09,Atlantic Starr - Atlantic Starr,49,46,51,21.0,49,Atlantic Starr,16.0,16,-2,0,-3,1,down,1978-08-19
10119,KC And The Sunshine Band,1978-08-26,KC And The Sunshine Band - Who Do Ya Love,51,51,40,25.0,50,Who Do Ya Love,8.0,0,10,1,0,1,up,1978-08-26
10120,KC And The Sunshine Band,1978-09-02,KC And The Sunshine Band - Who Do Ya Love,50,51,30,25.0,40,Who Do Ya Love,8.0,1,10,10,1,1,up,1978-08-26
10121,KC And The Sunshine Band,1978-09-09,KC And The Sunshine Band - Who Do Ya Love,40,50,28,25.0,30,Who Do Ya Love,8.0,2,2,10,10,1,up,1978-08-26
10122,KC And The Sunshine Band,1978-09-16,KC And The Sunshine Band - Who Do Ya Love,30,40,27,25.0,28,Who Do Ya Love,8.0,3,1,2,10,1,up,1978-08-26
10123,KC And The Sunshine Band,1978-09-23,KC And The Sunshine Band - Who Do Ya Love,28,30,25,25.0,27,Who Do Ya Love,8.0,4,2,1,2,1,up,1978-08-26
10124,KC And The Sunshine Band,1978-09-30,KC And The Sunshine Band - Who Do Ya Love,27,28,31,25.0,25,Who Do Ya Love,8.0,5,-6,2,1,1,down,1978-08-26
10125,KC And The Sunshine Band,1978-10-07,KC And The Sunshine Band - Who Do Ya Love,25,27,44,25.0,31,Who Do Ya Love,8.0,6,-13,-6,2,1,down,1978-08-26
10126,KC And The Sunshine Band,1978-10-21,KC And The Sunshine Band - Who Do Ya Love,31,25,43,25.0,44,Who Do Ya Love,8.0,7,1,-13,-6,1,up,1978-08-26
10127,KC And The Sunshine Band,1978-10-28,KC And The Sunshine Band - Who Do Ya Love,44,31,51,25.0,43,Who Do Ya Love,8.0,8,-8,1,-13,1,down,1978-08-26
10128,Gladys Knight And The Pips,1978-09-02,Gladys Knight And The Pips - The One And Only,51,51,40,30.0,50,The One And Only,6.0,0,10,1,0,1,up,1978-09-02
10129,Gladys Knight And The Pips,1978-09-09,Gladys Knight And The Pips - The One And Only,50,51,32,30.0,40,The One And Only,6.0,1,8,10,1,1,up,1978-09-02
10130,Gladys Knight And The Pips,1978-09-16,Gladys Knight And The Pips - The One And Only,40,50,30,30.0,32,The One And Only,6.0,2,2,8,10,1,up,1978-09-02
10131,Gladys Knight And The Pips,1978-09-23,Gladys Knight And The Pips - The One And Only,32,40,33,30.0,30,The One And Only,6.0,3,-3,2,8,1,down,1978-09-02
10132,Gladys Knight And The Pips,1978-09-30,Gladys Knight And The Pips - The One And Only,30,32,35,30.0,33,The One And Only,6.0,4,-2,-3,2,1,down,1978-09-02
10133,Gladys Knight And The Pips,1978-10-07,Gladys Knight And The Pips - The One And Only,33,30,35,30.0,35,The One And Only,6.0,5,0,-2,-3,0,stay,1978-09-02
10134,Gladys Knight And The Pips,1978-10-14,Gladys Knight And The Pips - The One And Only,35,33,51,30.0,35,The One And Only,6.0,6,-16,0,-2,1,down,1978-09-02
10135,Switch,1978-09-09,Switch - Switch,51,51,31,6.0,42,Switch,29.0,0,11,9,0,1,up,1978-09-09
10136,Switch,1978-09-16,Switch - Switch,42,51,23,6.0,31,Switch,29.0,1,8,11,9,1,up,1978-09-09
10137,Switch,1978-09-23,Switch - Switch,31,42,18,6.0,23,Switch,29.0,2,5,8,11,1,up,1978-09-09
10138,Switch,1978-09-30,Switch - Switch,23,31,16,6.0,18,Switch,29.0,3,2,5,8,1,up,1978-09-09
10139,Switch,1978-10-07,Switch - Switch,18,23,12,6.0,16,Switch,29.0,4,4,2,5,1,up,1978-09-09
10140,Switch,1978-10-14,Switch - Switch,16,18,10,6.0,12,Switch,29.0,5,2,4,2,1,up,1978-09-09
10141,Switch,1978-10-21,Switch - Switch,12,16,10,6.0,10,Switch,29.0,6,0,2,4,0,stay,1978-09-09
10142,Switch,1978-10-28,Switch - Switch,10,12,10,6.0,10,Switch,29.0,7,0,0,2,0,stay,1978-09-09
10143,Switch,1978-11-04,Switch - Switch,10,10,8,6.0,10,Switch,29.0,8,2,0,0,1,up,1978-09-09
10144,Switch,1978-11-11,Switch - Switch,10,10,8,6.0,8,Switch,29.0,9,0,2,0,0,stay,1978-09-09
10145,Switch,1978-11-18,Switch - Switch,8,10,6,6.0,8,Switch,29.0,10,2,0,2,1,up,1978-09-09
10146,Switch,1978-11-25,Switch - Switch,8,8,6,6.0,6,Switch,29.0,11,0,2,0,0,stay,1978-09-09
10147,Switch,1978-12-02,Switch - Switch,6,8,6,6.0,6,Switch,29.0,12,0,0,2,0,stay,1978-09-09
10148,Switch,1978-12-09,Switch - Switch,6,6,6,6.0,6,Switch,29.0,13,0,0,0,0,stay,1978-09-09
10149,Switch,1978-12-16,Switch - Switch,6,6,10,6.0,6,Switch,29.0,14,-4,0,0,1,down,1978-09-09
10150,Switch,1978-12-23,Switch - Switch,6,6,10,6.0,10,Switch,29.0,15,0,-4,0,0,stay,1978-09-09
10151,Switch,1978-12-30,Switch - Switch,10,6,10,6.0,10,Switch,29.0,16,0,0,-4,0,stay,1978-09-09
10152,Switch,1979-01-06,Switch - Switch,10,10,11,6.0,10,Switch,29.0,17,-1,0,0,1,down,1978-09-09
10153,Switch,1979-01-13,Switch - Switch,10,10,26,6.0,11,Switch,29.0,18,-15,-1,0,1,down,1978-09-09
10154,Switch,1979-01-20,Switch - Switch,11,10,26,6.0,26,Switch,29.0,19,0,-15,-1,0,stay,1978-09-09
10155,Switch,1979-01-27,Switch - Switch,26,11,25,6.0,26,Switch,29.0,20,1,0,-15,1,up,1978-09-09
10156,Switch,1979-02-03,Switch - Switch,26,26,25,6.0,25,Switch,29.0,21,0,1,0,0,stay,1978-09-09
10157,Switch,1979-02-10,Switch - Switch,25,26,31,6.0,25,Switch,29.0,22,-6,0,1,1,down,1978-09-09
10158,Switch,1979-02-17,Switch - Switch,25,25,34,6.0,31,Switch,29.0,23,-3,-6,0,1,down,1978-09-09
10159,Switch,1979-02-24,Switch - Switch,31,25,38,6.0,34,Switch,29.0,24,-4,-3,-6,1,down,1978-09-09
10160,Switch,1979-03-03,Switch - Switch,34,31,42,6.0,38,Switch,29.0,25,-4,-4,-3,1,down,1978-09-09
10161,Switch,1979-03-10,Switch - Switch,38,34,43,6.0,42,Switch,29.0,26,-1,-4,-4,1,down,1978-09-09
10162,Switch,1979-03-17,Switch - Switch,42,38,46,6.0,43,Switch,29.0,27,-3,-1,-4,1,down,1978-09-09
10163,Switch,1979-03-24,Switch - Switch,43,42,46,6.0,46,Switch,29.0,28,0,-3,-1,0,stay,1978-09-09
10164,Switch,1979-03-31,Switch - Switch,46,43,51,6.0,46,Switch,29.0,29,-5,0,-3,1,down,1978-09-09
10165,Rose Royce,1978-09-09,Rose Royce - Rose Royce III/Strikes Again!,51,51,13,4.0,47,Rose Royce III/Strikes Again!,24.0,0,34,4,0,1,up,1978-09-09
10166,Rose Royce,1978-09-16,Rose Royce - Rose Royce III/Strikes Again!,47,51,10,4.0,13,Rose Royce III/Strikes Again!,24.0,1,3,34,4,1,up,1978-09-09
10167,Rose Royce,1978-09-23,Rose Royce - Rose Royce III/Strikes Again!,13,47,7,4.0,10,Rose Royce III/Strikes Again!,24.0,2,3,3,34,1,up,1978-09-09
10168,Rose Royce,1978-09-30,Rose Royce - Rose Royce III/Strikes Again!,10,13,6,4.0,7,Rose Royce III/Strikes Again!,24.0,3,1,3,3,1,up,1978-09-09
10169,Rose Royce,1978-10-07,Rose Royce - Rose Royce III/Strikes Again!,7,10,5,4.0,6,Rose Royce III/Strikes Again!,24.0,4,1,1,3,1,up,1978-09-09
10170,Rose Royce,1978-10-14,Rose Royce - Rose Royce III/Strikes Again!,6,7,5,4.0,5,Rose Royce III/Strikes Again!,24.0,5,0,1,1,0,stay,1978-09-09
10171,Rose Royce,1978-10-21,Rose Royce - Rose Royce III/Strikes Again!,5,6,4,4.0,5,Rose Royce III/Strikes Again!,24.0,6,1,0,1,1,up,1978-09-09
10172,Rose Royce,1978-10-28,Rose Royce - Rose Royce III/Strikes Again!,5,5,4,4.0,4,Rose Royce III/Strikes Again!,24.0,7,0,1,0,0,stay,1978-09-09
10173,Rose Royce,1978-11-04,Rose Royce - Rose Royce III/Strikes Again!,4,5,5,4.0,4,Rose Royce III/Strikes Again!,24.0,8,-1,0,1,1,down,1978-09-09
10174,Rose Royce,1978-11-11,Rose Royce - Rose Royce III/Strikes Again!,4,4,7,4.0,5,Rose Royce III/Strikes Again!,24.0,9,-2,-1,0,1,down,1978-09-09
10175,Rose Royce,1978-11-18,Rose Royce - Rose Royce III/Strikes Again!,5,4,8,4.0,7,Rose Royce III/Strikes Again!,24.0,10,-1,-2,-1,1,down,1978-09-09
10176,Rose Royce,1978-11-25,Rose Royce - Rose Royce III/Strikes Again!,7,5,8,4.0,8,Rose Royce III/Strikes Again!,24.0,11,0,-1,-2,0,stay,1978-09-09
10177,Rose Royce,1978-12-02,Rose Royce - Rose Royce III/Strikes Again!,8,7,7,4.0,8,Rose Royce III/Strikes Again!,24.0,12,1,0,-1,1,up,1978-09-09
10178,Rose Royce,1978-12-09,Rose Royce - Rose Royce III/Strikes Again!,8,8,5,4.0,7,Rose Royce III/Strikes Again!,24.0,13,2,1,0,1,up,1978-09-09
10179,Rose Royce,1978-12-16,Rose Royce - Rose Royce III/Strikes Again!,7,8,5,4.0,5,Rose Royce III/Strikes Again!,24.0,14,0,2,1,0,stay,1978-09-09
10180,Rose Royce,1978-12-23,Rose Royce - Rose Royce III/Strikes Again!,5,7,5,4.0,5,Rose Royce III/Strikes Again!,24.0,15,0,0,2,0,stay,1978-09-09
10181,Rose Royce,1978-12-30,Rose Royce - Rose Royce III/Strikes Again!,5,5,7,4.0,5,Rose Royce III/Strikes Again!,24.0,16,-2,0,0,1,down,1978-09-09
10182,Rose Royce,1979-01-06,Rose Royce - Rose Royce III/Strikes Again!,5,5,13,4.0,7,Rose Royce III/Strikes Again!,24.0,17,-6,-2,0,1,down,1978-09-09
10183,Rose Royce,1979-01-13,Rose Royce - Rose Royce III/Strikes Again!,7,5,18,4.0,13,Rose Royce III/Strikes Again!,24.0,18,-5,-6,-2,1,down,1978-09-09
10184,Rose Royce,1979-01-20,Rose Royce - Rose Royce III/Strikes Again!,13,7,17,4.0,18,Rose Royce III/Strikes Again!,24.0,19,1,-5,-6,1,up,1978-09-09
10185,Rose Royce,1979-01-27,Rose Royce - Rose Royce III/Strikes Again!,18,13,22,4.0,17,Rose Royce III/Strikes Again!,24.0,20,-5,1,-5,1,down,1978-09-09
10186,Rose Royce,1979-02-03,Rose Royce - Rose Royce III/Strikes Again!,17,18,27,4.0,22,Rose Royce III/Strikes Again!,24.0,21,-5,-5,1,1,down,1978-09-09
10187,Rose Royce,1979-02-10,Rose Royce - Rose Royce III/Strikes Again!,22,17,38,4.0,27,Rose Royce III/Strikes Again!,24.0,22,-11,-5,-5,1,down,1978-09-09
10188,Rose Royce,1979-02-17,Rose Royce - Rose Royce III/Strikes Again!,27,22,48,4.0,38,Rose Royce III/Strikes Again!,24.0,23,-10,-11,-5,1,down,1978-09-09
10189,Rose Royce,1979-02-24,Rose Royce - Rose Royce III/Strikes Again!,38,27,51,4.0,48,Rose Royce III/Strikes Again!,24.0,24,-3,-10,-11,1,down,1978-09-09
10190,Ashford & Simpson,1978-09-09,Ashford & Simpson - Is It Still Good To Ya,51,51,16,1.0,49,Is It Still Good To Ya,26.0,0,33,2,0,1,up,1978-09-09
10191,Ashford & Simpson,1978-09-16,Ashford & Simpson - Is It Still Good To Ya,49,51,9,1.0,16,Is It Still Good To Ya,26.0,1,7,33,2,1,up,1978-09-09
10192,Ashford & Simpson,1978-09-23,Ashford & Simpson - Is It Still Good To Ya,16,49,6,1.0,9,Is It Still Good To Ya,26.0,2,3,7,33,1,up,1978-09-09
10193,Ashford & Simpson,1978-09-30,Ashford & Simpson - Is It Still Good To Ya,9,16,4,1.0,6,Is It Still Good To Ya,26.0,3,2,3,7,1,up,1978-09-09
10194,Ashford & Simpson,1978-10-07,Ashford & Simpson - Is It Still Good To Ya,6,9,3,1.0,4,Is It Still Good To Ya,26.0,4,1,2,3,1,up,1978-09-09
10195,Ashford & Simpson,1978-10-14,Ashford & Simpson - Is It Still Good To Ya,4,6,1,1.0,3,Is It Still Good To Ya,26.0,5,2,1,2,1,up,1978-09-09
10196,Ashford & Simpson,1978-10-21,Ashford & Simpson - Is It Still Good To Ya,3,4,2,1.0,1,Is It Still Good To Ya,26.0,6,-1,2,1,1,down,1978-09-09
10197,Ashford & Simpson,1978-10-28,Ashford & Simpson - Is It Still Good To Ya,1,3,2,1.0,2,Is It Still Good To Ya,26.0,7,0,-1,2,0,stay,1978-09-09
10198,Ashford & Simpson,1978-11-04,Ashford & Simpson - Is It Still Good To Ya,2,1,2,1.0,2,Is It Still Good To Ya,26.0,8,0,0,-1,0,stay,1978-09-09
10199,Ashford & Simpson,1978-11-11,Ashford & Simpson - Is It Still Good To Ya,2,2,3,1.0,2,Is It Still Good To Ya,26.0,9,-1,0,0,1,down,1978-09-09
10200,Ashford & Simpson,1978-11-18,Ashford & Simpson - Is It Still Good To Ya,2,2,4,1.0,3,Is It Still Good To Ya,26.0,10,-1,-1,0,1,down,1978-09-09
10201,Ashford & Simpson,1978-11-25,Ashford & Simpson - Is It Still Good To Ya,3,2,5,1.0,4,Is It Still Good To Ya,26.0,11,-1,-1,-1,1,down,1978-09-09
10202,Ashford & Simpson,1978-12-02,Ashford & Simpson - Is It Still Good To Ya,4,3,8,1.0,5,Is It Still Good To Ya,26.0,12,-3,-1,-1,1,down,1978-09-09
10203,Ashford & Simpson,1978-12-09,Ashford & Simpson - Is It Still Good To Ya,5,4,8,1.0,8,Is It Still Good To Ya,26.0,13,0,-3,-1,0,stay,1978-09-09
10204,Ashford & Simpson,1978-12-16,Ashford & Simpson - Is It Still Good To Ya,8,5,7,1.0,8,Is It Still Good To Ya,26.0,14,1,0,-3,1,up,1978-09-09
10205,Ashford & Simpson,1978-12-23,Ashford & Simpson - Is It Still Good To Ya,8,8,7,1.0,7,Is It Still Good To Ya,26.0,15,0,1,0,0,stay,1978-09-09
10206,Ashford & Simpson,1978-12-30,Ashford & Simpson - Is It Still Good To Ya,7,8,8,1.0,7,Is It Still Good To Ya,26.0,16,-1,0,1,1,down,1978-09-09
10207,Ashford & Simpson,1979-01-06,Ashford & Simpson - Is It Still Good To Ya,7,7,8,1.0,8,Is It Still Good To Ya,26.0,17,0,-1,0,0,stay,1978-09-09
10208,Ashford & Simpson,1979-01-13,Ashford & Simpson - Is It Still Good To Ya,8,7,10,1.0,8,Is It Still Good To Ya,26.0,18,-2,0,-1,1,down,1978-09-09
10209,Ashford & Simpson,1979-01-20,Ashford & Simpson - Is It Still Good To Ya,8,8,12,1.0,10,Is It Still Good To Ya,26.0,19,-2,-2,0,1,down,1978-09-09
10210,Ashford & Simpson,1979-01-27,Ashford & Simpson - Is It Still Good To Ya,10,8,16,1.0,12,Is It Still Good To Ya,26.0,20,-4,-2,-2,1,down,1978-09-09
10211,Ashford & Simpson,1979-02-03,Ashford & Simpson - Is It Still Good To Ya,12,10,19,1.0,16,Is It Still Good To Ya,26.0,21,-3,-4,-2,1,down,1978-09-09
10212,Ashford & Simpson,1979-02-10,Ashford & Simpson - Is It Still Good To Ya,16,12,24,1.0,19,Is It Still Good To Ya,26.0,22,-5,-3,-4,1,down,1978-09-09
10213,Ashford & Simpson,1979-02-17,Ashford & Simpson - Is It Still Good To Ya,19,16,30,1.0,24,Is It Still Good To Ya,26.0,23,-6,-5,-3,1,down,1978-09-09
10214,Ashford & Simpson,1979-02-24,Ashford & Simpson - Is It Still Good To Ya,24,19,43,1.0,30,Is It Still Good To Ya,26.0,24,-13,-6,-5,1,down,1978-09-09
10215,Ashford & Simpson,1979-03-03,Ashford & Simpson - Is It Still Good To Ya,30,24,46,1.0,43,Is It Still Good To Ya,26.0,25,-3,-13,-6,1,down,1978-09-09
10216,Ashford & Simpson,1979-03-10,Ashford & Simpson - Is It Still Good To Ya,43,30,51,1.0,46,Is It Still Good To Ya,26.0,26,-5,-3,-13,1,down,1978-09-09
10217,Gil Scott-Heron,1978-09-09,Gil Scott-Heron - Secrets,51,51,40,10.0,50,Secrets,23.0,0,10,1,0,1,up,1978-09-09
10218,Gil Scott-Heron,1978-09-16,Gil Scott-Heron - Secrets,50,51,36,10.0,40,Secrets,23.0,1,4,10,1,1,up,1978-09-09
10219,Gil Scott-Heron,1978-09-23,Gil Scott-Heron - Secrets,40,50,28,10.0,36,Secrets,23.0,2,8,4,10,1,up,1978-09-09
10220,Gil Scott-Heron,1978-09-30,Gil Scott-Heron - Secrets,36,40,26,10.0,28,Secrets,23.0,3,2,8,4,1,up,1978-09-09
10221,Gil Scott-Heron,1978-10-07,Gil Scott-Heron - Secrets,28,36,24,10.0,26,Secrets,23.0,4,2,2,8,1,up,1978-09-09
10222,Gil Scott-Heron,1978-10-14,Gil Scott-Heron - Secrets,26,28,18,10.0,24,Secrets,23.0,5,6,2,2,1,up,1978-09-09
10223,Gil Scott-Heron,1978-10-21,Gil Scott-Heron - Secrets,24,26,16,10.0,18,Secrets,23.0,6,2,6,2,1,up,1978-09-09
10224,Gil Scott-Heron,1978-10-28,Gil Scott-Heron - Secrets,18,24,16,10.0,16,Secrets,23.0,7,0,2,6,0,stay,1978-09-09
10225,Gil Scott-Heron,1978-11-04,Gil Scott-Heron - Secrets,16,18,17,10.0,16,Secrets,23.0,8,-1,0,2,1,down,1978-09-09
10226,Gil Scott-Heron,1978-11-11,Gil Scott-Heron - Secrets,16,16,19,10.0,17,Secrets,23.0,9,-2,-1,0,1,down,1978-09-09
10227,Gil Scott-Heron,1978-11-18,Gil Scott-Heron - Secrets,17,16,15,10.0,19,Secrets,23.0,10,4,-2,-1,1,up,1978-09-09
10228,Gil Scott-Heron,1978-11-25,Gil Scott-Heron - Secrets,19,17,13,10.0,15,Secrets,23.0,11,2,4,-2,1,up,1978-09-09
10229,Gil Scott-Heron,1978-12-02,Gil Scott-Heron - Secrets,15,19,10,10.0,13,Secrets,23.0,12,3,2,4,1,up,1978-09-09
10230,Gil Scott-Heron,1978-12-09,Gil Scott-Heron - Secrets,13,15,10,10.0,10,Secrets,23.0,13,0,3,2,0,stay,1978-09-09
10231,Gil Scott-Heron,1978-12-16,Gil Scott-Heron - Secrets,10,13,15,10.0,10,Secrets,23.0,14,-5,0,3,1,down,1978-09-09
10232,Gil Scott-Heron,1978-12-23,Gil Scott-Heron - Secrets,10,10,15,10.0,15,Secrets,23.0,15,0,-5,0,0,stay,1978-09-09
10233,Gil Scott-Heron,1978-12-30,Gil Scott-Heron - Secrets,15,10,16,10.0,15,Secrets,23.0,16,-1,0,-5,1,down,1978-09-09
10234,Gil Scott-Heron,1979-01-06,Gil Scott-Heron - Secrets,15,15,18,10.0,16,Secrets,23.0,17,-2,-1,0,1,down,1978-09-09
10235,Gil Scott-Heron,1979-01-13,Gil Scott-Heron - Secrets,16,15,25,10.0,18,Secrets,23.0,18,-7,-2,-1,1,down,1978-09-09
10236,Gil Scott-Heron,1979-01-20,Gil Scott-Heron - Secrets,18,16,24,10.0,25,Secrets,23.0,19,1,-7,-2,1,up,1978-09-09
10237,Gil Scott-Heron,1979-01-27,Gil Scott-Heron - Secrets,25,18,26,10.0,24,Secrets,23.0,20,-2,1,-7,1,down,1978-09-09
10238,Gil Scott-Heron,1979-02-03,Gil Scott-Heron - Secrets,24,25,45,10.0,26,Secrets,23.0,21,-19,-2,1,1,down,1978-09-09
10239,Gil Scott-Heron,1979-02-10,Gil Scott-Heron - Secrets,26,24,45,10.0,45,Secrets,23.0,22,0,-19,-2,0,stay,1978-09-09
10240,Gil Scott-Heron,1979-02-17,Gil Scott-Heron - Secrets,45,26,51,10.0,45,Secrets,23.0,23,-6,0,-19,1,down,1978-09-09
10241,The Sylvers,1978-09-16,The Sylvers - Forever Yours,51,51,48,40.0,50,Forever Yours,5.0,0,2,1,0,1,up,1978-09-16
10242,The Sylvers,1978-09-23,The Sylvers - Forever Yours,50,51,44,40.0,48,Forever Yours,5.0,1,4,2,1,1,up,1978-09-16
10243,The Sylvers,1978-09-30,The Sylvers - Forever Yours,48,50,44,40.0,44,Forever Yours,5.0,2,0,4,2,0,stay,1978-09-16
10244,The Sylvers,1978-10-07,The Sylvers - Forever Yours,44,48,41,40.0,44,Forever Yours,5.0,3,3,0,4,1,up,1978-09-16
10245,The Sylvers,1978-10-14,The Sylvers - Forever Yours,44,44,40,40.0,41,Forever Yours,5.0,4,1,3,0,1,up,1978-09-16
10246,The Sylvers,1978-10-21,The Sylvers - Forever Yours,41,44,51,40.0,40,Forever Yours,5.0,5,-11,1,3,1,down,1978-09-16
10247,Donna Summer,1978-09-23,Donna Summer - Live And More,51,51,22,4.0,32,Live And More,36.0,0,10,19,0,1,up,1978-09-23
10248,Donna Summer,1978-09-30,Donna Summer - Live And More,32,51,12,4.0,22,Live And More,36.0,1,10,10,19,1,up,1978-09-23
10249,Donna Summer,1978-10-07,Donna Summer - Live And More,22,32,10,4.0,12,Live And More,36.0,2,2,10,10,1,up,1978-09-23
10250,Donna Summer,1978-10-14,Donna Summer - Live And More,12,22,8,4.0,10,Live And More,36.0,3,2,2,10,1,up,1978-09-23
10251,Donna Summer,1978-10-21,Donna Summer - Live And More,10,12,7,4.0,8,Live And More,36.0,4,1,2,2,1,up,1978-09-23
10252,Donna Summer,1978-10-28,Donna Summer - Live And More,8,10,6,4.0,7,Live And More,36.0,5,1,1,2,1,up,1978-09-23
10253,Donna Summer,1978-11-04,Donna Summer - Live And More,7,8,6,4.0,6,Live And More,36.0,6,0,1,1,0,stay,1978-09-23
10254,Donna Summer,1978-11-11,Donna Summer - Live And More,6,7,5,4.0,6,Live And More,36.0,7,1,0,1,1,up,1978-09-23
10255,Donna Summer,1978-11-18,Donna Summer - Live And More,6,6,5,4.0,5,Live And More,36.0,8,0,1,0,0,stay,1978-09-23
10256,Donna Summer,1978-11-25,Donna Summer - Live And More,5,6,4,4.0,5,Live And More,36.0,9,1,0,1,1,up,1978-09-23
10257,Donna Summer,1978-12-02,Donna Summer - Live And More,5,5,4,4.0,4,Live And More,36.0,10,0,1,0,0,stay,1978-09-23
10258,Donna Summer,1978-12-09,Donna Summer - Live And More,4,5,4,4.0,4,Live And More,36.0,11,0,0,1,0,stay,1978-09-23
10259,Donna Summer,1978-12-16,Donna Summer - Live And More,4,4,9,4.0,4,Live And More,36.0,12,-5,0,0,1,down,1978-09-23
10260,Donna Summer,1978-12-23,Donna Summer - Live And More,4,4,9,4.0,9,Live And More,36.0,13,0,-5,0,0,stay,1978-09-23
10261,Donna Summer,1978-12-30,Donna Summer - Live And More,9,4,9,4.0,9,Live And More,36.0,14,0,0,-5,0,stay,1978-09-23
10262,Donna Summer,1979-01-06,Donna Summer - Live And More,9,9,10,4.0,9,Live And More,36.0,15,-1,0,0,1,down,1978-09-23
10263,Donna Summer,1979-01-13,Donna Summer - Live And More,9,9,11,4.0,10,Live And More,36.0,16,-1,-1,0,1,down,1978-09-23
10264,Donna Summer,1979-01-20,Donna Summer - Live And More,10,9,13,4.0,11,Live And More,36.0,17,-2,-1,-1,1,down,1978-09-23
10265,Donna Summer,1979-01-27,Donna Summer - Live And More,11,10,13,4.0,13,Live And More,36.0,18,0,-2,-1,0,stay,1978-09-23
10266,Donna Summer,1979-02-03,Donna Summer - Live And More,13,11,13,4.0,13,Live And More,36.0,19,0,0,-2,0,stay,1978-09-23
10267,Donna Summer,1979-02-10,Donna Summer - Live And More,13,13,19,4.0,13,Live And More,36.0,20,-6,0,0,1,down,1978-09-23
10268,Donna Summer,1979-02-17,Donna Summer - Live And More,13,13,19,4.0,19,Live And More,36.0,21,0,-6,0,0,stay,1978-09-23
10269,Donna Summer,1979-02-24,Donna Summer - Live And More,19,13,24,4.0,19,Live And More,36.0,22,-5,0,-6,1,down,1978-09-23
10270,Donna Summer,1979-03-03,Donna Summer - Live And More,19,19,24,4.0,24,Live And More,36.0,23,0,-5,0,0,stay,1978-09-23
10271,Donna Summer,1979-03-10,Donna Summer - Live And More,24,19,26,4.0,24,Live And More,36.0,24,-2,0,-5,1,down,1978-09-23
10272,Donna Summer,1979-03-17,Donna Summer - Live And More,24,24,27,4.0,26,Live And More,36.0,25,-1,-2,0,1,down,1978-09-23
10273,Donna Summer,1979-03-24,Donna Summer - Live And More,26,24,27,4.0,27,Live And More,36.0,26,0,-1,-2,0,stay,1978-09-23
10274,Donna Summer,1979-03-31,Donna Summer - Live And More,27,26,29,4.0,27,Live And More,36.0,27,-2,0,-1,1,down,1978-09-23
10275,Donna Summer,1979-04-07,Donna Summer - Live And More,27,27,47,4.0,29,Live And More,36.0,28,-18,-2,0,1,down,1978-09-23
10276,Donna Summer,1979-04-14,Donna Summer - Live And More,29,27,48,4.0,47,Live And More,36.0,29,-1,-18,-2,1,down,1978-09-23
10277,Donna Summer,1979-04-21,Donna Summer - Live And More,47,29,48,4.0,48,Live And More,36.0,30,0,-1,-18,0,stay,1978-09-23
10278,Donna Summer,1979-04-28,Donna Summer - Live And More,48,47,50,4.0,48,Live And More,36.0,31,-2,0,-1,1,down,1978-09-23
10279,Donna Summer,1979-05-05,Donna Summer - Live And More,48,48,50,4.0,50,Live And More,36.0,32,0,-2,0,0,stay,1978-09-23
10280,Donna Summer,1979-05-12,Donna Summer - Live And More,50,48,44,4.0,50,Live And More,36.0,33,6,0,-2,1,up,1978-09-23
10281,Donna Summer,1979-06-02,Donna Summer - Live And More,50,50,44,4.0,44,Live And More,36.0,34,0,6,0,0,stay,1978-09-23
10282,Donna Summer,1979-06-09,Donna Summer - Live And More,44,50,45,4.0,44,Live And More,36.0,35,-1,0,6,1,down,1978-09-23
10283,Donna Summer,1979-06-16,Donna Summer - Live And More,44,44,51,4.0,45,Live And More,36.0,36,-6,-1,0,1,down,1978-09-23
10284,The Mc Crarys,1978-09-23,The Mc Crarys - Loving Is Living,51,51,40,32.0,45,Loving Is Living,3.0,0,5,6,0,1,up,1978-09-23
10285,The Mc Crarys,1978-09-30,The Mc Crarys - Loving Is Living,45,51,32,32.0,40,Loving Is Living,3.0,1,8,5,6,1,up,1978-09-23
10286,The Mc Crarys,1978-10-07,The Mc Crarys - Loving Is Living,40,45,32,32.0,32,Loving Is Living,3.0,2,0,8,5,0,stay,1978-09-23
10287,The Mc Crarys,1978-10-14,The Mc Crarys - Loving Is Living,32,40,51,32.0,32,Loving Is Living,3.0,3,-19,0,8,1,down,1978-09-23
10288,Roberta Flack,1978-09-30,Roberta Flack - Roberta Flack,51,51,39,37.0,49,Roberta Flack,6.0,0,10,2,0,1,up,1978-09-30
10289,Roberta Flack,1978-10-07,Roberta Flack - Roberta Flack,49,51,37,37.0,39,Roberta Flack,6.0,1,2,10,2,1,up,1978-09-30
10290,Roberta Flack,1978-10-14,Roberta Flack - Roberta Flack,39,49,37,37.0,37,Roberta Flack,6.0,2,0,2,10,0,stay,1978-09-30
10291,Roberta Flack,1978-10-21,Roberta Flack - Roberta Flack,37,39,38,37.0,37,Roberta Flack,6.0,3,-1,0,2,1,down,1978-09-30
10292,Roberta Flack,1978-10-28,Roberta Flack - Roberta Flack,37,37,38,37.0,38,Roberta Flack,6.0,4,0,-1,0,0,stay,1978-09-30
10293,Roberta Flack,1978-11-04,Roberta Flack - Roberta Flack,38,37,45,37.0,38,Roberta Flack,6.0,5,-7,0,-1,1,down,1978-09-30
10294,Roberta Flack,1978-11-11,Roberta Flack - Roberta Flack,38,38,51,37.0,45,Roberta Flack,6.0,6,-6,-7,0,1,down,1978-09-30
10295,Funkadelic,1978-10-07,Funkadelic - One Nation Under A Groove,51,51,2,1.0,24,One Nation Under A Groove,20.0,0,22,27,0,1,up,1978-10-07
10296,Funkadelic,1978-10-14,Funkadelic - One Nation Under A Groove,24,51,2,1.0,2,One Nation Under A Groove,20.0,1,0,22,27,0,stay,1978-10-07
10297,Funkadelic,1978-10-21,Funkadelic - One Nation Under A Groove,2,24,1,1.0,2,One Nation Under A Groove,20.0,2,1,0,22,1,up,1978-10-07
10298,Funkadelic,1978-10-28,Funkadelic - One Nation Under A Groove,2,2,1,1.0,1,One Nation Under A Groove,20.0,3,0,1,0,0,stay,1978-10-07
10299,Funkadelic,1978-11-04,Funkadelic - One Nation Under A Groove,1,2,1,1.0,1,One Nation Under A Groove,20.0,4,0,0,1,0,stay,1978-10-07
10300,Funkadelic,1978-11-11,Funkadelic - One Nation Under A Groove,1,1,1,1.0,1,One Nation Under A Groove,20.0,5,0,0,0,0,stay,1978-10-07
10301,Funkadelic,1978-11-18,Funkadelic - One Nation Under A Groove,1,1,3,1.0,1,One Nation Under A Groove,20.0,6,-2,0,0,1,down,1978-10-07
10302,Funkadelic,1978-11-25,Funkadelic - One Nation Under A Groove,1,1,3,1.0,3,One Nation Under A Groove,20.0,7,0,-2,0,0,stay,1978-10-07
10303,Funkadelic,1978-12-02,Funkadelic - One Nation Under A Groove,3,1,5,1.0,3,One Nation Under A Groove,20.0,8,-2,0,-2,1,down,1978-10-07
10304,Funkadelic,1978-12-09,Funkadelic - One Nation Under A Groove,3,3,11,1.0,5,One Nation Under A Groove,20.0,9,-6,-2,0,1,down,1978-10-07
10305,Funkadelic,1978-12-16,Funkadelic - One Nation Under A Groove,5,3,11,1.0,11,One Nation Under A Groove,20.0,10,0,-6,-2,0,stay,1978-10-07
10306,Funkadelic,1978-12-23,Funkadelic - One Nation Under A Groove,11,5,11,1.0,11,One Nation Under A Groove,20.0,11,0,0,-6,0,stay,1978-10-07
10307,Funkadelic,1978-12-30,Funkadelic - One Nation Under A Groove,11,11,14,1.0,11,One Nation Under A Groove,20.0,12,-3,0,0,1,down,1978-10-07
10308,Funkadelic,1979-01-06,Funkadelic - One Nation Under A Groove,11,11,14,1.0,14,One Nation Under A Groove,20.0,13,0,-3,0,0,stay,1978-10-07
10309,Funkadelic,1979-01-13,Funkadelic - One Nation Under A Groove,14,11,20,1.0,14,One Nation Under A Groove,20.0,14,-6,0,-3,1,down,1978-10-07
10310,Funkadelic,1979-01-20,Funkadelic - One Nation Under A Groove,14,14,18,1.0,20,One Nation Under A Groove,20.0,15,2,-6,0,1,up,1978-10-07
10311,Funkadelic,1979-01-27,Funkadelic - One Nation Under A Groove,20,14,21,1.0,18,One Nation Under A Groove,20.0,16,-3,2,-6,1,down,1978-10-07
10312,Funkadelic,1979-02-03,Funkadelic - One Nation Under A Groove,18,20,22,1.0,21,One Nation Under A Groove,20.0,17,-1,-3,2,1,down,1978-10-07
10313,Funkadelic,1979-02-10,Funkadelic - One Nation Under A Groove,21,18,41,1.0,22,One Nation Under A Groove,20.0,18,-19,-1,-3,1,down,1978-10-07
10314,Funkadelic,1979-02-17,Funkadelic - One Nation Under A Groove,22,21,47,1.0,41,One Nation Under A Groove,20.0,19,-6,-19,-1,1,down,1978-10-07
10315,Funkadelic,1979-02-24,Funkadelic - One Nation Under A Groove,41,22,51,1.0,47,One Nation Under A Groove,20.0,20,-4,-6,-19,1,down,1978-10-07
10316,Lee Oskar,1978-10-07,Lee Oskar - Before The Rain,51,51,38,29.0,48,Before The Rain,8.0,0,10,3,0,1,up,1978-10-07
10317,Lee Oskar,1978-10-14,Lee Oskar - Before The Rain,48,51,30,29.0,38,Before The Rain,8.0,1,8,10,3,1,up,1978-10-07
10318,Lee Oskar,1978-10-21,Lee Oskar - Before The Rain,38,48,30,29.0,30,Before The Rain,8.0,2,0,8,10,0,stay,1978-10-07
10319,Lee Oskar,1978-10-28,Lee Oskar - Before The Rain,30,38,29,29.0,30,Before The Rain,8.0,3,1,0,8,1,up,1978-10-07
10320,Lee Oskar,1978-11-04,Lee Oskar - Before The Rain,30,30,34,29.0,29,Before The Rain,8.0,4,-5,1,0,1,down,1978-10-07
10321,Lee Oskar,1978-11-11,Lee Oskar - Before The Rain,29,30,33,29.0,34,Before The Rain,8.0,5,1,-5,1,1,up,1978-10-07
10322,Lee Oskar,1978-11-18,Lee Oskar - Before The Rain,34,29,43,29.0,33,Before The Rain,8.0,6,-10,1,-5,1,down,1978-10-07
10323,Lee Oskar,1978-11-25,Lee Oskar - Before The Rain,33,34,43,29.0,43,Before The Rain,8.0,7,0,-10,1,0,stay,1978-10-07
10324,Lee Oskar,1978-12-02,Lee Oskar - Before The Rain,43,33,51,29.0,43,Before The Rain,8.0,8,-8,0,-10,1,down,1978-10-07
10325,Meco,1978-10-07,Meco - The Wizard Of Oz,51,51,49,49.0,49,The Wizard Of Oz,2.0,0,0,2,0,0,stay,1978-10-07
10326,Meco,1978-10-14,Meco - The Wizard Of Oz,49,51,49,49.0,49,The Wizard Of Oz,2.0,1,0,0,2,0,stay,1978-10-07
10327,Meco,1978-10-21,Meco - The Wizard Of Oz,49,49,51,49.0,49,The Wizard Of Oz,2.0,2,-2,0,0,1,down,1978-10-07
10328,Goody Goody,1978-10-07,Goody Goody - Goody Goody,51,51,50,50.0,50,Goody Goody,1.0,0,0,1,0,0,stay,1978-10-07
10329,Goody Goody,1978-10-14,Goody Goody - Goody Goody,50,51,51,50.0,50,Goody Goody,1.0,1,-1,0,1,1,down,1978-10-07
10330,Pockets,1978-10-14,Pockets - Take It On Up,51,51,22,22.0,28,Take It On Up,4.0,0,6,23,0,1,up,1978-10-14
10331,Pockets,1978-10-21,Pockets - Take It On Up,28,51,22,22.0,22,Take It On Up,4.0,1,0,6,23,0,stay,1978-10-14
10332,Pockets,1978-10-28,Pockets - Take It On Up,22,28,26,22.0,22,Take It On Up,4.0,2,-4,0,6,1,down,1978-10-14
10333,Pockets,1978-11-04,Pockets - Take It On Up,22,22,33,22.0,26,Take It On Up,4.0,3,-7,-4,0,1,down,1978-10-14
10334,Pockets,1978-11-11,Pockets - Take It On Up,26,22,51,22.0,33,Take It On Up,4.0,4,-18,-7,-4,1,down,1978-10-14
10335,Ray Charles,1978-10-14,Ray Charles - Love + Peace,51,51,35,35.0,36,Love + Peace,1.0,0,1,15,0,1,up,1978-10-14
10336,Ray Charles,1978-10-21,Ray Charles - Love + Peace,36,51,51,35.0,35,Love + Peace,1.0,1,-16,1,15,1,down,1978-10-14
10337,Alicia Bridges,1978-10-14,Alicia Bridges - Alicia Bridges,51,51,42,30.0,44,Alicia Bridges,12.0,0,2,7,0,1,up,1978-10-14
10338,Alicia Bridges,1978-10-21,Alicia Bridges - Alicia Bridges,44,51,44,30.0,42,Alicia Bridges,12.0,1,-2,2,7,1,down,1978-10-14
10339,Alicia Bridges,1978-10-28,Alicia Bridges - Alicia Bridges,42,44,44,30.0,44,Alicia Bridges,12.0,2,0,-2,2,0,stay,1978-10-14
10340,Alicia Bridges,1978-11-04,Alicia Bridges - Alicia Bridges,44,42,43,30.0,44,Alicia Bridges,12.0,3,1,0,-2,1,up,1978-10-14
10341,Alicia Bridges,1978-11-18,Alicia Bridges - Alicia Bridges,44,44,33,30.0,43,Alicia Bridges,12.0,4,10,1,0,1,up,1978-10-14
10342,Alicia Bridges,1978-11-25,Alicia Bridges - Alicia Bridges,43,44,30,30.0,33,Alicia Bridges,12.0,5,3,10,1,1,up,1978-10-14
10343,Alicia Bridges,1978-12-02,Alicia Bridges - Alicia Bridges,33,43,32,30.0,30,Alicia Bridges,12.0,6,-2,3,10,1,down,1978-10-14
10344,Alicia Bridges,1978-12-09,Alicia Bridges - Alicia Bridges,30,33,46,30.0,32,Alicia Bridges,12.0,7,-14,-2,3,1,down,1978-10-14
10345,Alicia Bridges,1978-12-16,Alicia Bridges - Alicia Bridges,32,30,49,30.0,46,Alicia Bridges,12.0,8,-3,-14,-2,1,down,1978-10-14
10346,Alicia Bridges,1978-12-23,Alicia Bridges - Alicia Bridges,46,32,49,30.0,49,Alicia Bridges,12.0,9,0,-3,-14,0,stay,1978-10-14
10347,Alicia Bridges,1978-12-30,Alicia Bridges - Alicia Bridges,49,46,49,30.0,49,Alicia Bridges,12.0,10,0,0,-3,0,stay,1978-10-14
10348,Alicia Bridges,1979-01-06,Alicia Bridges - Alicia Bridges,49,49,50,30.0,49,Alicia Bridges,12.0,11,-1,0,0,1,down,1978-10-14
10349,Alicia Bridges,1979-01-13,Alicia Bridges - Alicia Bridges,49,49,51,30.0,50,Alicia Bridges,12.0,12,-1,-1,0,1,down,1978-10-14
10350,Barry White,1978-10-21,Barry White - Barry White The Man,51,51,8,1.0,20,Barry White The Man,23.0,0,12,31,0,1,up,1978-10-21
10351,Barry White,1978-10-28,Barry White - Barry White The Man,20,51,3,1.0,8,Barry White The Man,23.0,1,5,12,31,1,up,1978-10-21
10352,Barry White,1978-11-04,Barry White - Barry White The Man,8,20,3,1.0,3,Barry White The Man,23.0,2,0,5,12,0,stay,1978-10-21
10353,Barry White,1978-11-11,Barry White - Barry White The Man,3,8,2,1.0,3,Barry White The Man,23.0,3,1,0,5,1,up,1978-10-21
10354,Barry White,1978-11-18,Barry White - Barry White The Man,3,3,1,1.0,2,Barry White The Man,23.0,4,1,1,0,1,up,1978-10-21
10355,Barry White,1978-11-25,Barry White - Barry White The Man,2,3,1,1.0,1,Barry White The Man,23.0,5,0,1,1,0,stay,1978-10-21
10356,Barry White,1978-12-02,Barry White - Barry White The Man,1,2,1,1.0,1,Barry White The Man,23.0,6,0,0,1,0,stay,1978-10-21
10357,Barry White,1978-12-09,Barry White - Barry White The Man,1,1,3,1.0,1,Barry White The Man,23.0,7,-2,0,0,1,down,1978-10-21
10358,Barry White,1978-12-16,Barry White - Barry White The Man,1,1,3,1.0,3,Barry White The Man,23.0,8,0,-2,0,0,stay,1978-10-21
10359,Barry White,1978-12-23,Barry White - Barry White The Man,3,1,3,1.0,3,Barry White The Man,23.0,9,0,0,-2,0,stay,1978-10-21
10360,Barry White,1978-12-30,Barry White - Barry White The Man,3,3,6,1.0,3,Barry White The Man,23.0,10,-3,0,0,1,down,1978-10-21
10361,Barry White,1979-01-06,Barry White - Barry White The Man,3,3,6,1.0,6,Barry White The Man,23.0,11,0,-3,0,0,stay,1978-10-21
10362,Barry White,1979-01-13,Barry White - Barry White The Man,6,3,4,1.0,6,Barry White The Man,23.0,12,2,0,-3,1,up,1978-10-21
10363,Barry White,1979-01-20,Barry White - Barry White The Man,6,6,4,1.0,4,Barry White The Man,23.0,13,0,2,0,0,stay,1978-10-21
10364,Barry White,1979-01-27,Barry White - Barry White The Man,4,6,9,1.0,4,Barry White The Man,23.0,14,-5,0,2,1,down,1978-10-21
10365,Barry White,1979-02-03,Barry White - Barry White The Man,4,4,9,1.0,9,Barry White The Man,23.0,15,0,-5,0,0,stay,1978-10-21
10366,Barry White,1979-02-10,Barry White - Barry White The Man,9,4,9,1.0,9,Barry White The Man,23.0,16,0,0,-5,0,stay,1978-10-21
10367,Barry White,1979-02-17,Barry White - Barry White The Man,9,9,13,1.0,9,Barry White The Man,23.0,17,-4,0,0,1,down,1978-10-21
10368,Barry White,1979-02-24,Barry White - Barry White The Man,9,9,14,1.0,13,Barry White The Man,23.0,18,-1,-4,0,1,down,1978-10-21
10369,Barry White,1979-03-03,Barry White - Barry White The Man,13,9,27,1.0,14,Barry White The Man,23.0,19,-13,-1,-4,1,down,1978-10-21
10370,Barry White,1979-03-10,Barry White - Barry White The Man,14,13,34,1.0,27,Barry White The Man,23.0,20,-7,-13,-1,1,down,1978-10-21
10371,Barry White,1979-03-17,Barry White - Barry White The Man,27,14,37,1.0,34,Barry White The Man,23.0,21,-3,-7,-13,1,down,1978-10-21
10372,Barry White,1979-03-24,Barry White - Barry White The Man,34,27,44,1.0,37,Barry White The Man,23.0,22,-7,-3,-7,1,down,1978-10-21
10373,Barry White,1979-03-31,Barry White - Barry White The Man,37,34,51,1.0,44,Barry White The Man,23.0,23,-7,-7,-3,1,down,1978-10-21
10374,"Grover Washington, Jr.",1978-10-21,"Grover Washington, Jr. - Reed Seed",51,51,31,7.0,39,Reed Seed,19.0,0,8,12,0,1,up,1978-10-21
10375,"Grover Washington, Jr.",1978-10-28,"Grover Washington, Jr. - Reed Seed",39,51,21,7.0,31,Reed Seed,19.0,1,10,8,12,1,up,1978-10-21
10376,"Grover Washington, Jr.",1978-11-04,"Grover Washington, Jr. - Reed Seed",31,39,15,7.0,21,Reed Seed,19.0,2,6,10,8,1,up,1978-10-21
10377,"Grover Washington, Jr.",1978-11-11,"Grover Washington, Jr. - Reed Seed",21,31,9,7.0,15,Reed Seed,19.0,3,6,6,10,1,up,1978-10-21
10378,"Grover Washington, Jr.",1978-11-18,"Grover Washington, Jr. - Reed Seed",15,21,7,7.0,9,Reed Seed,19.0,4,2,6,6,1,up,1978-10-21
10379,"Grover Washington, Jr.",1978-11-25,"Grover Washington, Jr. - Reed Seed",9,15,7,7.0,7,Reed Seed,19.0,5,0,2,6,0,stay,1978-10-21
10380,"Grover Washington, Jr.",1978-12-02,"Grover Washington, Jr. - Reed Seed",7,9,9,7.0,7,Reed Seed,19.0,6,-2,0,2,1,down,1978-10-21
10381,"Grover Washington, Jr.",1978-12-09,"Grover Washington, Jr. - Reed Seed",7,7,13,7.0,9,Reed Seed,19.0,7,-4,-2,0,1,down,1978-10-21
10382,"Grover Washington, Jr.",1978-12-16,"Grover Washington, Jr. - Reed Seed",9,7,13,7.0,13,Reed Seed,19.0,8,0,-4,-2,0,stay,1978-10-21
10383,"Grover Washington, Jr.",1978-12-23,"Grover Washington, Jr. - Reed Seed",13,9,13,7.0,13,Reed Seed,19.0,9,0,0,-4,0,stay,1978-10-21
10384,"Grover Washington, Jr.",1978-12-30,"Grover Washington, Jr. - Reed Seed",13,13,21,7.0,13,Reed Seed,19.0,10,-8,0,0,1,down,1978-10-21
10385,"Grover Washington, Jr.",1979-01-06,"Grover Washington, Jr. - Reed Seed",13,13,24,7.0,21,Reed Seed,19.0,11,-3,-8,0,1,down,1978-10-21
10386,"Grover Washington, Jr.",1979-01-13,"Grover Washington, Jr. - Reed Seed",21,13,23,7.0,24,Reed Seed,19.0,12,1,-3,-8,1,up,1978-10-21
10387,"Grover Washington, Jr.",1979-01-20,"Grover Washington, Jr. - Reed Seed",24,21,23,7.0,23,Reed Seed,19.0,13,0,1,-3,0,stay,1978-10-21
10388,"Grover Washington, Jr.",1979-01-27,"Grover Washington, Jr. - Reed Seed",23,24,28,7.0,23,Reed Seed,19.0,14,-5,0,1,1,down,1978-10-21
10389,"Grover Washington, Jr.",1979-02-03,"Grover Washington, Jr. - Reed Seed",23,23,28,7.0,28,Reed Seed,19.0,15,0,-5,0,0,stay,1978-10-21
10390,"Grover Washington, Jr.",1979-02-10,"Grover Washington, Jr. - Reed Seed",28,23,35,7.0,28,Reed Seed,19.0,16,-7,0,-5,1,down,1978-10-21
10391,"Grover Washington, Jr.",1979-02-17,"Grover Washington, Jr. - Reed Seed",28,28,41,7.0,35,Reed Seed,19.0,17,-6,-7,0,1,down,1978-10-21
10392,"Grover Washington, Jr.",1979-02-24,"Grover Washington, Jr. - Reed Seed",35,28,46,7.0,41,Reed Seed,19.0,18,-5,-6,-7,1,down,1978-10-21
10393,"Grover Washington, Jr.",1979-03-03,"Grover Washington, Jr. - Reed Seed",41,35,51,7.0,46,Reed Seed,19.0,19,-5,-5,-6,1,down,1978-10-21
10394,Soundtrack,1978-10-21,Soundtrack - The Wiz,51,51,33,33.0,43,The Wiz,5.0,0,10,8,0,1,up,1978-10-21
10395,Soundtrack,1978-10-28,Soundtrack - The Wiz,43,51,33,33.0,33,The Wiz,5.0,1,0,10,8,0,stay,1978-10-21
10396,Soundtrack,1978-11-04,Soundtrack - The Wiz,33,43,35,33.0,33,The Wiz,5.0,2,-2,0,10,1,down,1978-10-21
10397,Soundtrack,1978-11-11,Soundtrack - The Wiz,33,33,37,33.0,35,The Wiz,5.0,3,-2,-2,0,1,down,1978-10-21
10398,Soundtrack,1978-11-18,Soundtrack - The Wiz,35,33,41,33.0,37,The Wiz,5.0,4,-4,-2,-2,1,down,1978-10-21
10399,Soundtrack,1978-11-25,Soundtrack - The Wiz,37,35,51,33.0,41,The Wiz,5.0,5,-10,-4,-2,1,down,1978-10-21
10400,Johnny Guitar Watson,1978-10-21,Johnny Guitar Watson - Giant,51,51,35,20.0,45,Giant,7.0,0,10,6,0,1,up,1978-10-21
10401,Johnny Guitar Watson,1978-10-28,Johnny Guitar Watson - Giant,45,51,27,20.0,35,Giant,7.0,1,8,10,6,1,up,1978-10-21
10402,Johnny Guitar Watson,1978-11-04,Johnny Guitar Watson - Giant,35,45,21,20.0,27,Giant,7.0,2,6,8,10,1,up,1978-10-21
10403,Johnny Guitar Watson,1978-11-11,Johnny Guitar Watson - Giant,27,35,20,20.0,21,Giant,7.0,3,1,6,8,1,up,1978-10-21
10404,Johnny Guitar Watson,1978-11-18,Johnny Guitar Watson - Giant,21,27,22,20.0,20,Giant,7.0,4,-2,1,6,1,down,1978-10-21
10405,Johnny Guitar Watson,1978-11-25,Johnny Guitar Watson - Giant,20,21,32,20.0,22,Giant,7.0,5,-10,-2,1,1,down,1978-10-21
10406,Johnny Guitar Watson,1978-12-02,Johnny Guitar Watson - Giant,22,20,33,20.0,32,Giant,7.0,6,-1,-10,-2,1,down,1978-10-21
10407,Johnny Guitar Watson,1978-12-09,Johnny Guitar Watson - Giant,32,22,51,20.0,33,Giant,7.0,7,-18,-1,-10,1,down,1978-10-21
10408,The Temptations,1978-10-21,The Temptations - Bare Back,51,51,46,46.0,46,Bare Back,1.0,0,0,5,0,0,stay,1978-10-21
10409,The Temptations,1978-10-28,The Temptations - Bare Back,46,51,51,46.0,46,Bare Back,1.0,1,-5,0,5,1,down,1978-10-21
10410,Diana Ross,1978-10-21,Diana Ross - Ross,51,51,37,32.0,47,Ross,4.0,0,10,4,0,1,up,1978-10-21
10411,Diana Ross,1978-10-28,Diana Ross - Ross,47,51,34,32.0,37,Ross,4.0,1,3,10,4,1,up,1978-10-21
10412,Diana Ross,1978-11-04,Diana Ross - Ross,37,47,32,32.0,34,Ross,4.0,2,2,3,10,1,up,1978-10-21
10413,Diana Ross,1978-11-11,Diana Ross - Ross,34,37,34,32.0,32,Ross,4.0,3,-2,2,3,1,down,1978-10-21
10414,Diana Ross,1978-11-18,Diana Ross - Ross,32,34,51,32.0,34,Ross,4.0,4,-17,-2,2,1,down,1978-10-21
10415,Mother's Finest,1978-10-21,Mother's Finest - Mother Factor,51,51,48,22.0,48,Mother Factor,17.0,0,0,3,0,0,stay,1978-10-21
10416,Mother's Finest,1978-10-28,Mother's Finest - Mother Factor,48,51,39,22.0,48,Mother Factor,17.0,1,9,0,3,1,up,1978-10-21
10417,Mother's Finest,1978-11-04,Mother's Finest - Mother Factor,48,48,39,22.0,39,Mother Factor,17.0,2,0,9,0,0,stay,1978-10-21
10418,Mother's Finest,1978-11-11,Mother's Finest - Mother Factor,39,48,48,22.0,39,Mother Factor,17.0,3,-9,0,9,1,down,1978-10-21
10419,Mother's Finest,1978-12-16,Mother's Finest - Mother Factor,39,39,48,22.0,48,Mother Factor,17.0,4,0,-9,0,0,stay,1978-10-21
10420,Mother's Finest,1978-12-23,Mother's Finest - Mother Factor,48,39,48,22.0,48,Mother Factor,17.0,5,0,0,-9,0,stay,1978-10-21
10421,Mother's Finest,1978-12-30,Mother's Finest - Mother Factor,48,48,38,22.0,48,Mother Factor,17.0,6,10,0,0,1,up,1978-10-21
10422,Mother's Finest,1979-01-06,Mother's Finest - Mother Factor,48,48,28,22.0,38,Mother Factor,17.0,7,10,10,0,1,up,1978-10-21
10423,Mother's Finest,1979-01-13,Mother's Finest - Mother Factor,38,48,22,22.0,28,Mother Factor,17.0,8,6,10,10,1,up,1978-10-21
10424,Mother's Finest,1979-01-20,Mother's Finest - Mother Factor,28,38,22,22.0,22,Mother Factor,17.0,9,0,6,10,0,stay,1978-10-21
10425,Mother's Finest,1979-01-27,Mother's Finest - Mother Factor,22,28,24,22.0,22,Mother Factor,17.0,10,-2,0,6,1,down,1978-10-21
10426,Mother's Finest,1979-02-03,Mother's Finest - Mother Factor,22,22,26,22.0,24,Mother Factor,17.0,11,-2,-2,0,1,down,1978-10-21
10427,Mother's Finest,1979-02-10,Mother's Finest - Mother Factor,24,22,30,22.0,26,Mother Factor,17.0,12,-4,-2,-2,1,down,1978-10-21
10428,Mother's Finest,1979-02-17,Mother's Finest - Mother Factor,26,24,37,22.0,30,Mother Factor,17.0,13,-7,-4,-2,1,down,1978-10-21
10429,Mother's Finest,1979-02-24,Mother's Finest - Mother Factor,30,26,45,22.0,37,Mother Factor,17.0,14,-8,-7,-4,1,down,1978-10-21
10430,Mother's Finest,1979-03-03,Mother's Finest - Mother Factor,37,30,45,22.0,45,Mother Factor,17.0,15,0,-8,-7,0,stay,1978-10-21
10431,Mother's Finest,1979-03-10,Mother's Finest - Mother Factor,45,37,48,22.0,45,Mother Factor,17.0,16,-3,0,-8,1,down,1978-10-21
10432,Mother's Finest,1979-03-17,Mother's Finest - Mother Factor,45,45,51,22.0,48,Mother Factor,17.0,17,-3,-3,0,1,down,1978-10-21
10433,Cameo,1978-10-21,Cameo - Ugly Ego,51,51,40,16.0,50,Ugly Ego,15.0,0,10,1,0,1,up,1978-10-21
10434,Cameo,1978-10-28,Cameo - Ugly Ego,50,51,32,16.0,40,Ugly Ego,15.0,1,8,10,1,1,up,1978-10-21
10435,Cameo,1978-11-04,Cameo - Ugly Ego,40,50,20,16.0,32,Ugly Ego,15.0,2,12,8,10,1,up,1978-10-21
10436,Cameo,1978-11-11,Cameo - Ugly Ego,32,40,16,16.0,20,Ugly Ego,15.0,3,4,12,8,1,up,1978-10-21
10437,Cameo,1978-11-18,Cameo - Ugly Ego,20,32,16,16.0,16,Ugly Ego,15.0,4,0,4,12,0,stay,1978-10-21
10438,Cameo,1978-11-25,Cameo - Ugly Ego,16,20,26,16.0,16,Ugly Ego,15.0,5,-10,0,4,1,down,1978-10-21
10439,Cameo,1978-12-02,Cameo - Ugly Ego,16,16,19,16.0,26,Ugly Ego,15.0,6,7,-10,0,1,up,1978-10-21
10440,Cameo,1978-12-09,Cameo - Ugly Ego,26,16,19,16.0,19,Ugly Ego,15.0,7,0,7,-10,0,stay,1978-10-21
10441,Cameo,1978-12-16,Cameo - Ugly Ego,19,26,28,16.0,19,Ugly Ego,15.0,8,-9,0,7,1,down,1978-10-21
10442,Cameo,1978-12-23,Cameo - Ugly Ego,19,19,28,16.0,28,Ugly Ego,15.0,9,0,-9,0,0,stay,1978-10-21
10443,Cameo,1978-12-30,Cameo - Ugly Ego,28,19,39,16.0,28,Ugly Ego,15.0,10,-11,0,-9,1,down,1978-10-21
10444,Cameo,1979-01-06,Cameo - Ugly Ego,28,28,36,16.0,39,Ugly Ego,15.0,11,3,-11,0,1,up,1978-10-21
10445,Cameo,1979-01-13,Cameo - Ugly Ego,39,28,37,16.0,36,Ugly Ego,15.0,12,-1,3,-11,1,down,1978-10-21
10446,Cameo,1979-01-20,Cameo - Ugly Ego,36,39,40,16.0,37,Ugly Ego,15.0,13,-3,-1,3,1,down,1978-10-21
10447,Cameo,1979-01-27,Cameo - Ugly Ego,37,36,47,16.0,40,Ugly Ego,15.0,14,-7,-3,-1,1,down,1978-10-21
10448,Cameo,1979-02-03,Cameo - Ugly Ego,40,37,51,16.0,47,Ugly Ego,15.0,15,-4,-7,-3,1,down,1978-10-21
10449,Village People,1978-10-28,Village People - Cruisin',51,51,30,5.0,42,Cruisin',28.0,0,12,9,0,1,up,1978-10-28
10450,Village People,1978-11-04,Village People - Cruisin',42,51,24,5.0,30,Cruisin',28.0,1,6,12,9,1,up,1978-10-28
10451,Village People,1978-11-11,Village People - Cruisin',30,42,14,5.0,24,Cruisin',28.0,2,10,6,12,1,up,1978-10-28
10452,Village People,1978-11-18,Village People - Cruisin',24,30,14,5.0,14,Cruisin',28.0,3,0,10,6,0,stay,1978-10-28
10453,Village People,1978-11-25,Village People - Cruisin',14,24,11,5.0,14,Cruisin',28.0,4,3,0,10,1,up,1978-10-28
10454,Village People,1978-12-02,Village People - Cruisin',14,14,11,5.0,11,Cruisin',28.0,5,0,3,0,0,stay,1978-10-28
10455,Village People,1978-12-09,Village People - Cruisin',11,14,15,5.0,11,Cruisin',28.0,6,-4,0,3,1,down,1978-10-28
10456,Village People,1978-12-16,Village People - Cruisin',11,11,17,5.0,15,Cruisin',28.0,7,-2,-4,0,1,down,1978-10-28
10457,Village People,1978-12-23,Village People - Cruisin',15,11,17,5.0,17,Cruisin',28.0,8,0,-2,-4,0,stay,1978-10-28
10458,Village People,1978-12-30,Village People - Cruisin',17,15,17,5.0,17,Cruisin',28.0,9,0,0,-2,0,stay,1978-10-28
10459,Village People,1979-01-06,Village People - Cruisin',17,17,17,5.0,17,Cruisin',28.0,10,0,0,0,0,stay,1978-10-28
10460,Village People,1979-01-13,Village People - Cruisin',17,17,17,5.0,17,Cruisin',28.0,11,0,0,0,0,stay,1978-10-28
10461,Village People,1979-01-20,Village People - Cruisin',17,17,20,5.0,17,Cruisin',28.0,12,-3,0,0,1,down,1978-10-28
10462,Village People,1979-01-27,Village People - Cruisin',17,17,19,5.0,20,Cruisin',28.0,13,1,-3,0,1,up,1978-10-28
10463,Village People,1979-02-03,Village People - Cruisin',20,17,14,5.0,19,Cruisin',28.0,14,5,1,-3,1,up,1978-10-28
10464,Village People,1979-02-10,Village People - Cruisin',19,20,13,5.0,14,Cruisin',28.0,15,1,5,1,1,up,1978-10-28
10465,Village People,1979-02-17,Village People - Cruisin',14,19,9,5.0,13,Cruisin',28.0,16,4,1,5,1,up,1978-10-28
10466,Village People,1979-02-24,Village People - Cruisin',13,14,9,5.0,9,Cruisin',28.0,17,0,4,1,0,stay,1978-10-28
10467,Village People,1979-03-03,Village People - Cruisin',9,13,5,5.0,9,Cruisin',28.0,18,4,0,4,1,up,1978-10-28
10468,Village People,1979-03-10,Village People - Cruisin',9,9,5,5.0,5,Cruisin',28.0,19,0,4,0,0,stay,1978-10-28
10469,Village People,1979-03-17,Village People - Cruisin',5,9,12,5.0,5,Cruisin',28.0,20,-7,0,4,1,down,1978-10-28
10470,Village People,1979-03-24,Village People - Cruisin',5,5,20,5.0,12,Cruisin',28.0,21,-8,-7,0,1,down,1978-10-28
10471,Village People,1979-03-31,Village People - Cruisin',12,5,20,5.0,20,Cruisin',28.0,22,0,-8,-7,0,stay,1978-10-28
10472,Village People,1979-04-07,Village People - Cruisin',20,12,34,5.0,20,Cruisin',28.0,23,-14,0,-8,1,down,1978-10-28
10473,Village People,1979-04-14,Village People - Cruisin',20,20,34,5.0,34,Cruisin',28.0,24,0,-14,0,0,stay,1978-10-28
10474,Village People,1979-04-21,Village People - Cruisin',34,20,35,5.0,34,Cruisin',28.0,25,-1,0,-14,1,down,1978-10-28
10475,Village People,1979-04-28,Village People - Cruisin',34,34,39,5.0,35,Cruisin',28.0,26,-4,-1,0,1,down,1978-10-28
10476,Village People,1979-05-05,Village People - Cruisin',35,34,41,5.0,39,Cruisin',28.0,27,-2,-4,-1,1,down,1978-10-28
10477,Village People,1979-05-12,Village People - Cruisin',39,35,51,5.0,41,Cruisin',28.0,28,-10,-2,-4,1,down,1978-10-28
10478,Brides Of Funkenstein,1978-10-28,Brides Of Funkenstein - Funk Or Walk,51,51,35,17.0,45,Funk Or Walk,10.0,0,10,6,0,1,up,1978-10-28
10479,Brides Of Funkenstein,1978-11-04,Brides Of Funkenstein - Funk Or Walk,45,51,25,17.0,35,Funk Or Walk,10.0,1,10,10,6,1,up,1978-10-28
10480,Brides Of Funkenstein,1978-11-11,Brides Of Funkenstein - Funk Or Walk,35,45,22,17.0,25,Funk Or Walk,10.0,2,3,10,10,1,up,1978-10-28
10481,Brides Of Funkenstein,1978-11-18,Brides Of Funkenstein - Funk Or Walk,25,35,17,17.0,22,Funk Or Walk,10.0,3,5,3,10,1,up,1978-10-28
10482,Brides Of Funkenstein,1978-11-25,Brides Of Funkenstein - Funk Or Walk,22,25,17,17.0,17,Funk Or Walk,10.0,4,0,5,3,0,stay,1978-10-28
10483,Brides Of Funkenstein,1978-12-02,Brides Of Funkenstein - Funk Or Walk,17,22,18,17.0,17,Funk Or Walk,10.0,5,-1,0,5,1,down,1978-10-28
10484,Brides Of Funkenstein,1978-12-09,Brides Of Funkenstein - Funk Or Walk,17,17,36,17.0,18,Funk Or Walk,10.0,6,-18,-1,0,1,down,1978-10-28
10485,Brides Of Funkenstein,1978-12-16,Brides Of Funkenstein - Funk Or Walk,18,17,36,17.0,36,Funk Or Walk,10.0,7,0,-18,-1,0,stay,1978-10-28
10486,Brides Of Funkenstein,1978-12-23,Brides Of Funkenstein - Funk Or Walk,36,18,36,17.0,36,Funk Or Walk,10.0,8,0,0,-18,0,stay,1978-10-28
10487,Brides Of Funkenstein,1978-12-30,Brides Of Funkenstein - Funk Or Walk,36,36,40,17.0,36,Funk Or Walk,10.0,9,-4,0,0,1,down,1978-10-28
10488,Brides Of Funkenstein,1979-01-06,Brides Of Funkenstein - Funk Or Walk,36,36,51,17.0,40,Funk Or Walk,10.0,10,-11,-4,0,1,down,1978-10-28
10489,Chuck Mangione,1978-10-28,Chuck Mangione - Children Of Sanchez,51,51,40,37.0,50,Children Of Sanchez,5.0,0,10,1,0,1,up,1978-10-28
10490,Chuck Mangione,1978-11-04,Chuck Mangione - Children Of Sanchez,50,51,37,37.0,40,Children Of Sanchez,5.0,1,3,10,1,1,up,1978-10-28
10491,Chuck Mangione,1978-11-11,Chuck Mangione - Children Of Sanchez,40,50,44,37.0,37,Children Of Sanchez,5.0,2,-7,3,10,1,down,1978-10-28
10492,Chuck Mangione,1978-11-18,Chuck Mangione - Children Of Sanchez,37,40,44,37.0,44,Children Of Sanchez,5.0,3,0,-7,3,0,stay,1978-10-28
10493,Chuck Mangione,1978-11-25,Chuck Mangione - Children Of Sanchez,44,37,45,37.0,44,Children Of Sanchez,5.0,4,-1,0,-7,1,down,1978-10-28
10494,Chuck Mangione,1978-12-02,Chuck Mangione - Children Of Sanchez,44,44,51,37.0,45,Children Of Sanchez,5.0,5,-6,-1,0,1,down,1978-10-28
10495,Loleatta Holloway,1978-11-04,Loleatta Holloway - Queen Of The Night,51,51,47,47.0,47,Queen Of The Night,1.0,0,0,4,0,0,stay,1978-11-04
10496,Loleatta Holloway,1978-11-11,Loleatta Holloway - Queen Of The Night,47,51,51,47.0,47,Queen Of The Night,1.0,1,-4,0,4,1,down,1978-11-04
10497,Faze-O,1978-11-04,Faze-O - Good Thang,51,51,40,40.0,49,Good Thang,2.0,0,9,2,0,1,up,1978-11-04
10498,Faze-O,1978-11-11,Faze-O - Good Thang,49,51,40,40.0,40,Good Thang,2.0,1,0,9,2,0,stay,1978-11-04
10499,Faze-O,1978-11-18,Faze-O - Good Thang,40,49,51,40.0,40,Good Thang,2.0,2,-11,0,9,1,down,1978-11-04
10500,Jarreau,1978-11-04,Jarreau - All Fly Home,51,51,38,27.0,50,All Fly Home,11.0,0,12,1,0,1,up,1978-11-04
10501,Jarreau,1978-11-11,Jarreau - All Fly Home,50,51,27,27.0,38,All Fly Home,11.0,1,11,12,1,1,up,1978-11-04
10502,Jarreau,1978-11-18,Jarreau - All Fly Home,38,50,27,27.0,27,All Fly Home,11.0,2,0,11,12,0,stay,1978-11-04
10503,Jarreau,1978-11-25,Jarreau - All Fly Home,27,38,28,27.0,27,All Fly Home,11.0,3,-1,0,11,1,down,1978-11-04
10504,Jarreau,1978-12-02,Jarreau - All Fly Home,27,27,39,27.0,28,All Fly Home,11.0,4,-11,-1,0,1,down,1978-11-04
10505,Jarreau,1978-12-09,Jarreau - All Fly Home,28,27,45,27.0,39,All Fly Home,11.0,5,-6,-11,-1,1,down,1978-11-04
10506,Jarreau,1978-12-16,Jarreau - All Fly Home,39,28,45,27.0,45,All Fly Home,11.0,6,0,-6,-11,0,stay,1978-11-04
10507,Jarreau,1978-12-23,Jarreau - All Fly Home,45,39,45,27.0,45,All Fly Home,11.0,7,0,0,-6,0,stay,1978-11-04
10508,Jarreau,1978-12-30,Jarreau - All Fly Home,45,45,41,27.0,45,All Fly Home,11.0,8,4,0,0,1,up,1978-11-04
10509,Jarreau,1979-01-06,Jarreau - All Fly Home,45,45,37,27.0,41,All Fly Home,11.0,9,4,4,0,1,up,1978-11-04
10510,Jarreau,1979-01-13,Jarreau - All Fly Home,41,45,44,27.0,37,All Fly Home,11.0,10,-7,4,4,1,down,1978-11-04
10511,Jarreau,1979-01-20,Jarreau - All Fly Home,37,41,51,27.0,44,All Fly Home,11.0,11,-7,-7,4,1,down,1978-11-04
10512,Chaka Khan,1978-11-11,Chaka Khan - Chaka,51,51,6,2.0,18,Chaka,17.0,0,12,33,0,1,up,1978-11-11
10513,Chaka Khan,1978-11-18,Chaka Khan - Chaka,18,51,2,2.0,6,Chaka,17.0,1,4,12,33,1,up,1978-11-11
10514,Chaka Khan,1978-11-25,Chaka Khan - Chaka,6,18,2,2.0,2,Chaka,17.0,2,0,4,12,0,stay,1978-11-11
10515,Chaka Khan,1978-12-02,Chaka Khan - Chaka,2,6,2,2.0,2,Chaka,17.0,3,0,0,4,0,stay,1978-11-11
10516,Chaka Khan,1978-12-09,Chaka Khan - Chaka,2,2,2,2.0,2,Chaka,17.0,4,0,0,0,0,stay,1978-11-11
10517,Chaka Khan,1978-12-16,Chaka Khan - Chaka,2,2,2,2.0,2,Chaka,17.0,5,0,0,0,0,stay,1978-11-11
10518,Chaka Khan,1978-12-23,Chaka Khan - Chaka,2,2,2,2.0,2,Chaka,17.0,6,0,0,0,0,stay,1978-11-11
10519,Chaka Khan,1978-12-30,Chaka Khan - Chaka,2,2,4,2.0,2,Chaka,17.0,7,-2,0,0,1,down,1978-11-11
10520,Chaka Khan,1979-01-06,Chaka Khan - Chaka,2,2,4,2.0,4,Chaka,17.0,8,0,-2,0,0,stay,1978-11-11
10521,Chaka Khan,1979-01-13,Chaka Khan - Chaka,4,2,5,2.0,4,Chaka,17.0,9,-1,0,-2,1,down,1978-11-11
10522,Chaka Khan,1979-01-20,Chaka Khan - Chaka,4,4,11,2.0,5,Chaka,17.0,10,-6,-1,0,1,down,1978-11-11
10523,Chaka Khan,1979-01-27,Chaka Khan - Chaka,5,4,12,2.0,11,Chaka,17.0,11,-1,-6,-1,1,down,1978-11-11
10524,Chaka Khan,1979-02-03,Chaka Khan - Chaka,11,5,20,2.0,12,Chaka,17.0,12,-8,-1,-6,1,down,1978-11-11
10525,Chaka Khan,1979-02-10,Chaka Khan - Chaka,12,11,36,2.0,20,Chaka,17.0,13,-16,-8,-1,1,down,1978-11-11
10526,Chaka Khan,1979-02-17,Chaka Khan - Chaka,20,12,36,2.0,36,Chaka,17.0,14,0,-16,-8,0,stay,1978-11-11
10527,Chaka Khan,1979-02-24,Chaka Khan - Chaka,36,20,42,2.0,36,Chaka,17.0,15,-6,0,-16,1,down,1978-11-11
10528,Chaka Khan,1979-03-03,Chaka Khan - Chaka,36,36,43,2.0,42,Chaka,17.0,16,-1,-6,0,1,down,1978-11-11
10529,Chaka Khan,1979-03-10,Chaka Khan - Chaka,42,36,51,2.0,43,Chaka,17.0,17,-8,-1,-6,1,down,1978-11-11
10530,Chanson,1978-11-11,Chanson - Chanson,51,51,31,23.0,41,Chanson,12.0,0,10,10,0,1,up,1978-11-11
10531,Chanson,1978-11-18,Chanson - Chanson,41,51,28,23.0,31,Chanson,12.0,1,3,10,10,1,up,1978-11-11
10532,Chanson,1978-11-25,Chanson - Chanson,31,41,33,23.0,28,Chanson,12.0,2,-5,3,10,1,down,1978-11-11
10533,Chanson,1978-12-02,Chanson - Chanson,28,31,25,23.0,33,Chanson,12.0,3,8,-5,3,1,up,1978-11-11
10534,Chanson,1978-12-09,Chanson - Chanson,33,28,25,23.0,25,Chanson,12.0,4,0,8,-5,0,stay,1978-11-11
10535,Chanson,1978-12-16,Chanson - Chanson,25,33,23,23.0,25,Chanson,12.0,5,2,0,8,1,up,1978-11-11
10536,Chanson,1978-12-23,Chanson - Chanson,25,25,23,23.0,23,Chanson,12.0,6,0,2,0,0,stay,1978-11-11
10537,Chanson,1978-12-30,Chanson - Chanson,23,25,25,23.0,23,Chanson,12.0,7,-2,0,2,1,down,1978-11-11
10538,Chanson,1979-01-06,Chanson - Chanson,23,23,25,23.0,25,Chanson,12.0,8,0,-2,0,0,stay,1978-11-11
10539,Chanson,1979-01-13,Chanson - Chanson,25,23,38,23.0,25,Chanson,12.0,9,-13,0,-2,1,down,1978-11-11
10540,Chanson,1979-01-20,Chanson - Chanson,25,25,48,23.0,38,Chanson,12.0,10,-10,-13,0,1,down,1978-11-11
10541,Chanson,1979-01-27,Chanson - Chanson,38,25,48,23.0,48,Chanson,12.0,11,0,-10,-13,0,stay,1978-11-11
10542,Chanson,1979-02-03,Chanson - Chanson,48,38,51,23.0,48,Chanson,12.0,12,-3,0,-10,1,down,1978-11-11
10543,Cheryl Lynn,1978-11-11,Cheryl Lynn - Cheryl Lynn,51,51,32,5.0,42,Cheryl Lynn,24.0,0,10,9,0,1,up,1978-11-11
10544,Cheryl Lynn,1978-11-18,Cheryl Lynn - Cheryl Lynn,42,51,24,5.0,32,Cheryl Lynn,24.0,1,8,10,9,1,up,1978-11-11
10545,Cheryl Lynn,1978-11-25,Cheryl Lynn - Cheryl Lynn,32,42,16,5.0,24,Cheryl Lynn,24.0,2,8,8,10,1,up,1978-11-11
10546,Cheryl Lynn,1978-12-02,Cheryl Lynn - Cheryl Lynn,24,32,12,5.0,16,Cheryl Lynn,24.0,3,4,8,8,1,up,1978-11-11
10547,Cheryl Lynn,1978-12-09,Cheryl Lynn - Cheryl Lynn,16,24,9,5.0,12,Cheryl Lynn,24.0,4,3,4,8,1,up,1978-11-11
10548,Cheryl Lynn,1978-12-16,Cheryl Lynn - Cheryl Lynn,12,16,6,5.0,9,Cheryl Lynn,24.0,5,3,3,4,1,up,1978-11-11
10549,Cheryl Lynn,1978-12-23,Cheryl Lynn - Cheryl Lynn,9,12,6,5.0,6,Cheryl Lynn,24.0,6,0,3,3,0,stay,1978-11-11
10550,Cheryl Lynn,1978-12-30,Cheryl Lynn - Cheryl Lynn,6,9,5,5.0,6,Cheryl Lynn,24.0,7,1,0,3,1,up,1978-11-11
10551,Cheryl Lynn,1979-01-06,Cheryl Lynn - Cheryl Lynn,6,6,5,5.0,5,Cheryl Lynn,24.0,8,0,1,0,0,stay,1978-11-11
10552,Cheryl Lynn,1979-01-13,Cheryl Lynn - Cheryl Lynn,5,6,8,5.0,5,Cheryl Lynn,24.0,9,-3,0,1,1,down,1978-11-11
10553,Cheryl Lynn,1979-01-20,Cheryl Lynn - Cheryl Lynn,5,5,6,5.0,8,Cheryl Lynn,24.0,10,2,-3,0,1,up,1978-11-11
10554,Cheryl Lynn,1979-01-27,Cheryl Lynn - Cheryl Lynn,8,5,6,5.0,6,Cheryl Lynn,24.0,11,0,2,-3,0,stay,1978-11-11
10555,Cheryl Lynn,1979-02-03,Cheryl Lynn - Cheryl Lynn,6,8,8,5.0,6,Cheryl Lynn,24.0,12,-2,0,2,1,down,1978-11-11
10556,Cheryl Lynn,1979-02-10,Cheryl Lynn - Cheryl Lynn,6,6,8,5.0,8,Cheryl Lynn,24.0,13,0,-2,0,0,stay,1978-11-11
10557,Cheryl Lynn,1979-02-17,Cheryl Lynn - Cheryl Lynn,8,6,12,5.0,8,Cheryl Lynn,24.0,14,-4,0,-2,1,down,1978-11-11
10558,Cheryl Lynn,1979-02-24,Cheryl Lynn - Cheryl Lynn,8,8,19,5.0,12,Cheryl Lynn,24.0,15,-7,-4,0,1,down,1978-11-11
10559,Cheryl Lynn,1979-03-03,Cheryl Lynn - Cheryl Lynn,12,8,28,5.0,19,Cheryl Lynn,24.0,16,-9,-7,-4,1,down,1978-11-11
10560,Cheryl Lynn,1979-03-10,Cheryl Lynn - Cheryl Lynn,19,12,33,5.0,28,Cheryl Lynn,24.0,17,-5,-9,-7,1,down,1978-11-11
10561,Cheryl Lynn,1979-03-17,Cheryl Lynn - Cheryl Lynn,28,19,33,5.0,33,Cheryl Lynn,24.0,18,0,-5,-9,0,stay,1978-11-11
10562,Cheryl Lynn,1979-03-24,Cheryl Lynn - Cheryl Lynn,33,28,36,5.0,33,Cheryl Lynn,24.0,19,-3,0,-5,1,down,1978-11-11
10563,Cheryl Lynn,1979-03-31,Cheryl Lynn - Cheryl Lynn,33,33,45,5.0,36,Cheryl Lynn,24.0,20,-9,-3,0,1,down,1978-11-11
10564,Cheryl Lynn,1979-04-07,Cheryl Lynn - Cheryl Lynn,36,33,45,5.0,45,Cheryl Lynn,24.0,21,0,-9,-3,0,stay,1978-11-11
10565,Cheryl Lynn,1979-04-14,Cheryl Lynn - Cheryl Lynn,45,36,45,5.0,45,Cheryl Lynn,24.0,22,0,0,-9,0,stay,1978-11-11
10566,Cheryl Lynn,1979-04-21,Cheryl Lynn - Cheryl Lynn,45,45,45,5.0,45,Cheryl Lynn,24.0,23,0,0,0,0,stay,1978-11-11
10567,Cheryl Lynn,1979-04-28,Cheryl Lynn - Cheryl Lynn,45,45,51,5.0,45,Cheryl Lynn,24.0,24,-6,0,0,1,down,1978-11-11
10568,Staples,1978-11-11,Staples - Unlock Your Mind,51,51,41,34.0,43,Unlock Your Mind,7.0,0,2,8,0,1,up,1978-11-11
10569,Staples,1978-11-18,Staples - Unlock Your Mind,43,51,42,34.0,41,Unlock Your Mind,7.0,1,-1,2,8,1,down,1978-11-11
10570,Staples,1978-11-25,Staples - Unlock Your Mind,41,43,38,34.0,42,Unlock Your Mind,7.0,2,4,-1,2,1,up,1978-11-11
10571,Staples,1978-12-02,Staples - Unlock Your Mind,42,41,34,34.0,38,Unlock Your Mind,7.0,3,4,4,-1,1,up,1978-11-11
10572,Staples,1978-12-09,Staples - Unlock Your Mind,38,42,47,34.0,34,Unlock Your Mind,7.0,4,-13,4,4,1,down,1978-11-11
10573,Staples,1978-12-16,Staples - Unlock Your Mind,34,38,50,34.0,47,Unlock Your Mind,7.0,5,-3,-13,4,1,down,1978-11-11
10574,Staples,1978-12-23,Staples - Unlock Your Mind,47,34,50,34.0,50,Unlock Your Mind,7.0,6,0,-3,-13,0,stay,1978-11-11
10575,Staples,1978-12-30,Staples - Unlock Your Mind,50,47,51,34.0,50,Unlock Your Mind,7.0,7,-1,0,-3,1,down,1978-11-11
10576,Ronnie Laws,1978-11-11,Ronnie Laws - Flame,51,51,26,16.0,44,Flame,17.0,0,18,7,0,1,up,1978-11-11
10577,Ronnie Laws,1978-11-18,Ronnie Laws - Flame,44,51,20,16.0,26,Flame,17.0,1,6,18,7,1,up,1978-11-11
10578,Ronnie Laws,1978-11-25,Ronnie Laws - Flame,26,44,18,16.0,20,Flame,17.0,2,2,6,18,1,up,1978-11-11
10579,Ronnie Laws,1978-12-02,Ronnie Laws - Flame,20,26,17,16.0,18,Flame,17.0,3,1,2,6,1,up,1978-11-11
10580,Ronnie Laws,1978-12-09,Ronnie Laws - Flame,18,20,16,16.0,17,Flame,17.0,4,1,1,2,1,up,1978-11-11
10581,Ronnie Laws,1978-12-16,Ronnie Laws - Flame,17,18,16,16.0,16,Flame,17.0,5,0,1,1,0,stay,1978-11-11
10582,Ronnie Laws,1978-12-23,Ronnie Laws - Flame,16,17,16,16.0,16,Flame,17.0,6,0,0,1,0,stay,1978-11-11
10583,Ronnie Laws,1978-12-30,Ronnie Laws - Flame,16,16,18,16.0,16,Flame,17.0,7,-2,0,0,1,down,1978-11-11
10584,Ronnie Laws,1979-01-06,Ronnie Laws - Flame,16,16,22,16.0,18,Flame,17.0,8,-4,-2,0,1,down,1978-11-11
10585,Ronnie Laws,1979-01-13,Ronnie Laws - Flame,18,16,35,16.0,22,Flame,17.0,9,-13,-4,-2,1,down,1978-11-11
10586,Ronnie Laws,1979-01-20,Ronnie Laws - Flame,22,18,35,16.0,35,Flame,17.0,10,0,-13,-4,0,stay,1978-11-11
10587,Ronnie Laws,1979-01-27,Ronnie Laws - Flame,35,22,33,16.0,35,Flame,17.0,11,2,0,-13,1,up,1978-11-11
10588,Ronnie Laws,1979-02-03,Ronnie Laws - Flame,35,35,30,16.0,33,Flame,17.0,12,3,2,0,1,up,1978-11-11
10589,Ronnie Laws,1979-02-10,Ronnie Laws - Flame,33,35,33,16.0,30,Flame,17.0,13,-3,3,2,1,down,1978-11-11
10590,Ronnie Laws,1979-02-17,Ronnie Laws - Flame,30,33,40,16.0,33,Flame,17.0,14,-7,-3,3,1,down,1978-11-11
10591,Ronnie Laws,1979-02-24,Ronnie Laws - Flame,33,30,41,16.0,40,Flame,17.0,15,-1,-7,-3,1,down,1978-11-11
10592,Ronnie Laws,1979-03-03,Ronnie Laws - Flame,40,33,47,16.0,41,Flame,17.0,16,-6,-1,-7,1,down,1978-11-11
10593,Ronnie Laws,1979-03-10,Ronnie Laws - Flame,41,40,51,16.0,47,Flame,17.0,17,-4,-6,-1,1,down,1978-11-11
10594,Santana,1978-11-11,Santana - Inner Secrets,51,51,36,36.0,46,Inner Secrets,3.0,0,10,5,0,1,up,1978-11-11
10595,Santana,1978-11-18,Santana - Inner Secrets,46,51,36,36.0,36,Inner Secrets,3.0,1,0,10,5,0,stay,1978-11-11
10596,Santana,1978-11-25,Santana - Inner Secrets,36,46,44,36.0,36,Inner Secrets,3.0,2,-8,0,10,1,down,1978-11-11
10597,Santana,1978-12-02,Santana - Inner Secrets,36,36,51,36.0,44,Inner Secrets,3.0,3,-7,-8,0,1,down,1978-11-11
10598,Gino Vannelli,1978-11-11,Gino Vannelli - Brother To Brother,51,51,39,12.0,49,Brother To Brother,10.0,0,10,2,0,1,up,1978-11-11
10599,Gino Vannelli,1978-11-18,Gino Vannelli - Brother To Brother,49,51,31,12.0,39,Brother To Brother,10.0,1,8,10,2,1,up,1978-11-11
10600,Gino Vannelli,1978-11-25,Gino Vannelli - Brother To Brother,39,49,20,12.0,31,Brother To Brother,10.0,2,11,8,10,1,up,1978-11-11
10601,Gino Vannelli,1978-12-02,Gino Vannelli - Brother To Brother,31,39,16,12.0,20,Brother To Brother,10.0,3,4,11,8,1,up,1978-11-11
10602,Gino Vannelli,1978-12-09,Gino Vannelli - Brother To Brother,20,31,12,12.0,16,Brother To Brother,10.0,4,4,4,11,1,up,1978-11-11
10603,Gino Vannelli,1978-12-16,Gino Vannelli - Brother To Brother,16,20,12,12.0,12,Brother To Brother,10.0,5,0,4,4,0,stay,1978-11-11
10604,Gino Vannelli,1978-12-23,Gino Vannelli - Brother To Brother,12,16,12,12.0,12,Brother To Brother,10.0,6,0,0,4,0,stay,1978-11-11
10605,Gino Vannelli,1978-12-30,Gino Vannelli - Brother To Brother,12,12,22,12.0,12,Brother To Brother,10.0,7,-10,0,0,1,down,1978-11-11
10606,Gino Vannelli,1979-01-06,Gino Vannelli - Brother To Brother,12,12,23,12.0,22,Brother To Brother,10.0,8,-1,-10,0,1,down,1978-11-11
10607,Gino Vannelli,1979-01-13,Gino Vannelli - Brother To Brother,22,12,43,12.0,23,Brother To Brother,10.0,9,-20,-1,-10,1,down,1978-11-11
10608,Gino Vannelli,1979-01-20,Gino Vannelli - Brother To Brother,23,22,51,12.0,43,Brother To Brother,10.0,10,-8,-20,-1,1,down,1978-11-11
10609,Isaac Hayes,1978-11-11,Isaac Hayes - For The Sake Of Love,51,51,38,15.0,50,For The Sake Of Love,17.0,0,12,1,0,1,up,1978-11-11
10610,Isaac Hayes,1978-11-18,Isaac Hayes - For The Sake Of Love,50,51,30,15.0,38,For The Sake Of Love,17.0,1,8,12,1,1,up,1978-11-11
10611,Isaac Hayes,1978-11-25,Isaac Hayes - For The Sake Of Love,38,50,22,15.0,30,For The Sake Of Love,17.0,2,8,8,12,1,up,1978-11-11
10612,Isaac Hayes,1978-12-02,Isaac Hayes - For The Sake Of Love,30,38,20,15.0,22,For The Sake Of Love,17.0,3,2,8,8,1,up,1978-11-11
10613,Isaac Hayes,1978-12-09,Isaac Hayes - For The Sake Of Love,22,30,18,15.0,20,For The Sake Of Love,17.0,4,2,2,8,1,up,1978-11-11
10614,Isaac Hayes,1978-12-16,Isaac Hayes - For The Sake Of Love,20,22,20,15.0,18,For The Sake Of Love,17.0,5,-2,2,2,1,down,1978-11-11
10615,Isaac Hayes,1978-12-23,Isaac Hayes - For The Sake Of Love,18,20,20,15.0,20,For The Sake Of Love,17.0,6,0,-2,2,0,stay,1978-11-11
10616,Isaac Hayes,1978-12-30,Isaac Hayes - For The Sake Of Love,20,18,15,15.0,20,For The Sake Of Love,17.0,7,5,0,-2,1,up,1978-11-11
10617,Isaac Hayes,1979-01-06,Isaac Hayes - For The Sake Of Love,20,20,15,15.0,15,For The Sake Of Love,17.0,8,0,5,0,0,stay,1978-11-11
10618,Isaac Hayes,1979-01-13,Isaac Hayes - For The Sake Of Love,15,20,31,15.0,15,For The Sake Of Love,17.0,9,-16,0,5,1,down,1978-11-11
10619,Isaac Hayes,1979-01-20,Isaac Hayes - For The Sake Of Love,15,15,32,15.0,31,For The Sake Of Love,17.0,10,-1,-16,0,1,down,1978-11-11
10620,Isaac Hayes,1979-01-27,Isaac Hayes - For The Sake Of Love,31,15,34,15.0,32,For The Sake Of Love,17.0,11,-2,-1,-16,1,down,1978-11-11
10621,Isaac Hayes,1979-02-03,Isaac Hayes - For The Sake Of Love,32,31,35,15.0,34,For The Sake Of Love,17.0,12,-1,-2,-1,1,down,1978-11-11
10622,Isaac Hayes,1979-02-10,Isaac Hayes - For The Sake Of Love,34,32,40,15.0,35,For The Sake Of Love,17.0,13,-5,-1,-2,1,down,1978-11-11
10623,Isaac Hayes,1979-02-17,Isaac Hayes - For The Sake Of Love,35,34,46,15.0,40,For The Sake Of Love,17.0,14,-6,-5,-1,1,down,1978-11-11
10624,Isaac Hayes,1979-02-24,Isaac Hayes - For The Sake Of Love,40,35,47,15.0,46,For The Sake Of Love,17.0,15,-1,-6,-5,1,down,1978-11-11
10625,Isaac Hayes,1979-03-03,Isaac Hayes - For The Sake Of Love,46,40,49,15.0,47,For The Sake Of Love,17.0,16,-2,-1,-6,1,down,1978-11-11
10626,Isaac Hayes,1979-03-10,Isaac Hayes - For The Sake Of Love,47,46,51,15.0,49,For The Sake Of Love,17.0,17,-2,-2,-1,1,down,1978-11-11
10627,Commodores,1978-11-18,Commodores - Commodores' Greatest Hits,51,51,32,24.0,42,Commodores' Greatest Hits,11.0,0,10,9,0,1,up,1978-11-18
10628,Commodores,1978-11-25,Commodores - Commodores' Greatest Hits,42,51,24,24.0,32,Commodores' Greatest Hits,11.0,1,8,10,9,1,up,1978-11-18
10629,Commodores,1978-12-02,Commodores - Commodores' Greatest Hits,32,42,24,24.0,24,Commodores' Greatest Hits,11.0,2,0,8,10,0,stay,1978-11-18
10630,Commodores,1978-12-09,Commodores - Commodores' Greatest Hits,24,32,27,24.0,24,Commodores' Greatest Hits,11.0,3,-3,0,8,1,down,1978-11-18
10631,Commodores,1978-12-16,Commodores - Commodores' Greatest Hits,24,24,31,24.0,27,Commodores' Greatest Hits,11.0,4,-4,-3,0,1,down,1978-11-18
10632,Commodores,1978-12-23,Commodores - Commodores' Greatest Hits,27,24,31,24.0,31,Commodores' Greatest Hits,11.0,5,0,-4,-3,0,stay,1978-11-18
10633,Commodores,1978-12-30,Commodores - Commodores' Greatest Hits,31,27,48,24.0,31,Commodores' Greatest Hits,11.0,6,-17,0,-4,1,down,1978-11-18
10634,Commodores,1979-01-06,Commodores - Commodores' Greatest Hits,31,31,38,24.0,48,Commodores' Greatest Hits,11.0,7,10,-17,0,1,up,1978-11-18
10635,Commodores,1979-01-13,Commodores - Commodores' Greatest Hits,48,31,36,24.0,38,Commodores' Greatest Hits,11.0,8,2,10,-17,1,up,1978-11-18
10636,Commodores,1979-01-20,Commodores - Commodores' Greatest Hits,38,48,39,24.0,36,Commodores' Greatest Hits,11.0,9,-3,2,10,1,down,1978-11-18
10637,Commodores,1979-01-27,Commodores - Commodores' Greatest Hits,36,38,40,24.0,39,Commodores' Greatest Hits,11.0,10,-1,-3,2,1,down,1978-11-18
10638,Commodores,1979-02-03,Commodores - Commodores' Greatest Hits,39,36,51,24.0,40,Commodores' Greatest Hits,11.0,11,-11,-1,-3,1,down,1978-11-18
10639,Quazar,1978-11-18,Quazar - Quazar,51,51,37,21.0,47,Quazar,6.0,0,10,4,0,1,up,1978-11-18
10640,Quazar,1978-11-25,Quazar - Quazar,47,51,27,21.0,37,Quazar,6.0,1,10,10,4,1,up,1978-11-18
10641,Quazar,1978-12-02,Quazar - Quazar,37,47,21,21.0,27,Quazar,6.0,2,6,10,10,1,up,1978-11-18
10642,Quazar,1978-12-09,Quazar - Quazar,27,37,21,21.0,21,Quazar,6.0,3,0,6,10,0,stay,1978-11-18
10643,Quazar,1978-12-16,Quazar - Quazar,21,27,35,21.0,21,Quazar,6.0,4,-14,0,6,1,down,1978-11-18
10644,Quazar,1978-12-23,Quazar - Quazar,21,21,35,21.0,35,Quazar,6.0,5,0,-14,0,0,stay,1978-11-18
10645,Quazar,1978-12-30,Quazar - Quazar,35,21,51,21.0,35,Quazar,6.0,6,-16,0,-14,1,down,1978-11-18
10646,Barkays,1978-11-18,Barkays - Money Talks,51,51,38,21.0,48,Money Talks,18.0,0,10,3,0,1,up,1978-11-18
10647,Barkays,1978-11-25,Barkays - Money Talks,48,51,29,21.0,38,Money Talks,18.0,1,9,10,3,1,up,1978-11-18
10648,Barkays,1978-12-02,Barkays - Money Talks,38,48,27,21.0,29,Money Talks,18.0,2,2,9,10,1,up,1978-11-18
10649,Barkays,1978-12-09,Barkays - Money Talks,29,38,23,21.0,27,Money Talks,18.0,3,4,2,9,1,up,1978-11-18
10650,Barkays,1978-12-16,Barkays - Money Talks,27,29,21,21.0,23,Money Talks,18.0,4,2,4,2,1,up,1978-11-18
10651,Barkays,1978-12-23,Barkays - Money Talks,23,27,21,21.0,21,Money Talks,18.0,5,0,2,4,0,stay,1978-11-18
10652,Barkays,1978-12-30,Barkays - Money Talks,21,23,28,21.0,21,Money Talks,18.0,6,-7,0,2,1,down,1978-11-18
10653,Barkays,1979-01-06,Barkays - Money Talks,21,21,41,21.0,28,Money Talks,18.0,7,-13,-7,0,1,down,1978-11-18
10654,Barkays,1979-01-13,Barkays - Money Talks,28,21,42,21.0,41,Money Talks,18.0,8,-1,-13,-7,1,down,1978-11-18
10655,Barkays,1979-01-20,Barkays - Money Talks,41,28,41,21.0,42,Money Talks,18.0,9,1,-1,-13,1,up,1978-11-18
10656,Barkays,1979-01-27,Barkays - Money Talks,42,41,37,21.0,41,Money Talks,18.0,10,4,1,-1,1,up,1978-11-18
10657,Barkays,1979-02-03,Barkays - Money Talks,41,42,37,21.0,37,Money Talks,18.0,11,0,4,1,0,stay,1978-11-18
10658,Barkays,1979-02-10,Barkays - Money Talks,37,41,39,21.0,37,Money Talks,18.0,12,-2,0,4,1,down,1978-11-18
10659,Barkays,1979-02-17,Barkays - Money Talks,37,37,44,21.0,39,Money Talks,18.0,13,-5,-2,0,1,down,1978-11-18
10660,Barkays,1979-02-24,Barkays - Money Talks,39,37,44,21.0,44,Money Talks,18.0,14,0,-5,-2,0,stay,1978-11-18
10661,Barkays,1979-03-03,Barkays - Money Talks,44,39,44,21.0,44,Money Talks,18.0,15,0,0,-5,0,stay,1978-11-18
10662,Barkays,1979-03-10,Barkays - Money Talks,44,44,45,21.0,44,Money Talks,18.0,16,-1,0,0,1,down,1978-11-18
10663,Barkays,1979-03-17,Barkays - Money Talks,44,44,45,21.0,45,Money Talks,18.0,17,0,-1,0,0,stay,1978-11-18
10664,Barkays,1979-03-24,Barkays - Money Talks,45,44,51,21.0,45,Money Talks,18.0,18,-6,0,-1,1,down,1978-11-18
10665,Cerrone,1978-11-18,Cerrone - Cerrone IV - The Golden Touch,51,51,49,49.0,49,Cerrone IV - The Golden Touch,1.0,0,0,2,0,0,stay,1978-11-18
10666,Cerrone,1978-11-25,Cerrone - Cerrone IV - The Golden Touch,49,51,51,49.0,49,Cerrone IV - The Golden Touch,1.0,1,-2,0,2,1,down,1978-11-18
10667,Stargard,1978-11-18,Stargard - What You Waitin For,51,51,50,50.0,50,What You Waitin For,1.0,0,0,1,0,0,stay,1978-11-18
10668,Stargard,1978-11-25,Stargard - What You Waitin For,50,51,51,50.0,50,What You Waitin For,1.0,1,-1,0,1,1,down,1978-11-18
10669,Lou Rawls,1978-11-25,Lou Rawls - Lou Rawls Live,51,51,42,42.0,45,Lou Rawls Live,1.0,0,3,6,0,1,up,1978-11-25
10670,Lou Rawls,1978-12-02,Lou Rawls - Lou Rawls Live,45,51,51,42.0,42,Lou Rawls Live,1.0,1,-9,3,6,1,down,1978-11-25
10671,Gene Chandler,1978-11-25,Gene Chandler - Get Down,51,51,36,12.0,48,Get Down,17.0,0,12,3,0,1,up,1978-11-25
10672,Gene Chandler,1978-12-02,Gene Chandler - Get Down,48,51,26,12.0,36,Get Down,17.0,1,10,12,3,1,up,1978-11-25
10673,Gene Chandler,1978-12-09,Gene Chandler - Get Down,36,48,20,12.0,26,Get Down,17.0,2,6,10,12,1,up,1978-11-25
10674,Gene Chandler,1978-12-16,Gene Chandler - Get Down,26,36,14,12.0,20,Get Down,17.0,3,6,6,10,1,up,1978-11-25
10675,Gene Chandler,1978-12-23,Gene Chandler - Get Down,20,26,14,12.0,14,Get Down,17.0,4,0,6,6,0,stay,1978-11-25
10676,Gene Chandler,1978-12-30,Gene Chandler - Get Down,14,20,13,12.0,14,Get Down,17.0,5,1,0,6,1,up,1978-11-25
10677,Gene Chandler,1979-01-06,Gene Chandler - Get Down,14,14,12,12.0,13,Get Down,17.0,6,1,1,0,1,up,1978-11-25
10678,Gene Chandler,1979-01-13,Gene Chandler - Get Down,13,14,14,12.0,12,Get Down,17.0,7,-2,1,1,1,down,1978-11-25
10679,Gene Chandler,1979-01-20,Gene Chandler - Get Down,12,13,14,12.0,14,Get Down,17.0,8,0,-2,1,0,stay,1978-11-25
10680,Gene Chandler,1979-01-27,Gene Chandler - Get Down,14,12,15,12.0,14,Get Down,17.0,9,-1,0,-2,1,down,1978-11-25
10681,Gene Chandler,1979-02-03,Gene Chandler - Get Down,14,14,15,12.0,15,Get Down,17.0,10,0,-1,0,0,stay,1978-11-25
10682,Gene Chandler,1979-02-10,Gene Chandler - Get Down,15,14,21,12.0,15,Get Down,17.0,11,-6,0,-1,1,down,1978-11-25
10683,Gene Chandler,1979-02-17,Gene Chandler - Get Down,15,15,27,12.0,21,Get Down,17.0,12,-6,-6,0,1,down,1978-11-25
10684,Gene Chandler,1979-02-24,Gene Chandler - Get Down,21,15,32,12.0,27,Get Down,17.0,13,-5,-6,-6,1,down,1978-11-25
10685,Gene Chandler,1979-03-03,Gene Chandler - Get Down,27,21,34,12.0,32,Get Down,17.0,14,-2,-5,-6,1,down,1978-11-25
10686,Gene Chandler,1979-03-10,Gene Chandler - Get Down,32,27,38,12.0,34,Get Down,17.0,15,-4,-2,-5,1,down,1978-11-25
10687,Gene Chandler,1979-03-17,Gene Chandler - Get Down,34,32,38,12.0,38,Get Down,17.0,16,0,-4,-2,0,stay,1978-11-25
10688,Gene Chandler,1979-03-24,Gene Chandler - Get Down,38,34,51,12.0,38,Get Down,17.0,17,-13,0,-4,1,down,1978-11-25
10689,Jerry Butler,1978-12-02,Jerry Butler - Nothing Says I Love You Like I Love You,51,51,45,42.0,46,Nothing Says I Love You Like I Love You,5.0,0,1,5,0,1,up,1978-12-02
10690,Jerry Butler,1978-12-09,Jerry Butler - Nothing Says I Love You Like I Love You,46,51,42,42.0,45,Nothing Says I Love You Like I Love You,5.0,1,3,1,5,1,up,1978-12-02
10691,Jerry Butler,1978-12-16,Jerry Butler - Nothing Says I Love You Like I Love You,45,46,44,42.0,42,Nothing Says I Love You Like I Love You,5.0,2,-2,3,1,1,down,1978-12-02
10692,Jerry Butler,1978-12-23,Jerry Butler - Nothing Says I Love You Like I Love You,42,45,44,42.0,44,Nothing Says I Love You Like I Love You,5.0,3,0,-2,3,0,stay,1978-12-02
10693,Jerry Butler,1978-12-30,Jerry Butler - Nothing Says I Love You Like I Love You,44,42,48,42.0,44,Nothing Says I Love You Like I Love You,5.0,4,-4,0,-2,1,down,1978-12-02
10694,Jerry Butler,1979-01-20,Jerry Butler - Nothing Says I Love You Like I Love You,44,44,51,42.0,48,Nothing Says I Love You Like I Love You,5.0,5,-3,-4,0,1,down,1978-12-02
10695,Bobby Caldwell,1978-12-02,Bobby Caldwell - Bobby Caldwell,51,51,38,7.0,48,Bobby Caldwell,23.0,0,10,3,0,1,up,1978-12-02
10696,Bobby Caldwell,1978-12-09,Bobby Caldwell - Bobby Caldwell,48,51,28,7.0,38,Bobby Caldwell,23.0,1,10,10,3,1,up,1978-12-02
10697,Bobby Caldwell,1978-12-16,Bobby Caldwell - Bobby Caldwell,38,48,18,7.0,28,Bobby Caldwell,23.0,2,10,10,10,1,up,1978-12-02
10698,Bobby Caldwell,1978-12-23,Bobby Caldwell - Bobby Caldwell,28,38,18,7.0,18,Bobby Caldwell,23.0,3,0,10,10,0,stay,1978-12-02
10699,Bobby Caldwell,1978-12-30,Bobby Caldwell - Bobby Caldwell,18,28,12,7.0,18,Bobby Caldwell,23.0,4,6,0,10,1,up,1978-12-02
10700,Bobby Caldwell,1979-01-06,Bobby Caldwell - Bobby Caldwell,18,18,9,7.0,12,Bobby Caldwell,23.0,5,3,6,0,1,up,1978-12-02
10701,Bobby Caldwell,1979-01-13,Bobby Caldwell - Bobby Caldwell,12,18,7,7.0,9,Bobby Caldwell,23.0,6,2,3,6,1,up,1978-12-02
10702,Bobby Caldwell,1979-01-20,Bobby Caldwell - Bobby Caldwell,9,12,7,7.0,7,Bobby Caldwell,23.0,7,0,2,3,0,stay,1978-12-02
10703,Bobby Caldwell,1979-01-27,Bobby Caldwell - Bobby Caldwell,7,9,7,7.0,7,Bobby Caldwell,23.0,8,0,0,2,0,stay,1978-12-02
10704,Bobby Caldwell,1979-02-03,Bobby Caldwell - Bobby Caldwell,7,7,7,7.0,7,Bobby Caldwell,23.0,9,0,0,0,0,stay,1978-12-02
10705,Bobby Caldwell,1979-02-10,Bobby Caldwell - Bobby Caldwell,7,7,11,7.0,7,Bobby Caldwell,23.0,10,-4,0,0,1,down,1978-12-02
10706,Bobby Caldwell,1979-02-17,Bobby Caldwell - Bobby Caldwell,7,7,16,7.0,11,Bobby Caldwell,23.0,11,-5,-4,0,1,down,1978-12-02
10707,Bobby Caldwell,1979-02-24,Bobby Caldwell - Bobby Caldwell,11,7,15,7.0,16,Bobby Caldwell,23.0,12,1,-5,-4,1,up,1978-12-02
10708,Bobby Caldwell,1979-03-03,Bobby Caldwell - Bobby Caldwell,16,11,19,7.0,15,Bobby Caldwell,23.0,13,-4,1,-5,1,down,1978-12-02
10709,Bobby Caldwell,1979-03-10,Bobby Caldwell - Bobby Caldwell,15,16,23,7.0,19,Bobby Caldwell,23.0,14,-4,-4,1,1,down,1978-12-02
10710,Bobby Caldwell,1979-03-17,Bobby Caldwell - Bobby Caldwell,19,15,24,7.0,23,Bobby Caldwell,23.0,15,-1,-4,-4,1,down,1978-12-02
10711,Bobby Caldwell,1979-03-24,Bobby Caldwell - Bobby Caldwell,23,19,25,7.0,24,Bobby Caldwell,23.0,16,-1,-1,-4,1,down,1978-12-02
10712,Bobby Caldwell,1979-03-31,Bobby Caldwell - Bobby Caldwell,24,23,21,7.0,25,Bobby Caldwell,23.0,17,4,-1,-1,1,up,1978-12-02
10713,Bobby Caldwell,1979-04-07,Bobby Caldwell - Bobby Caldwell,25,24,24,7.0,21,Bobby Caldwell,23.0,18,-3,4,-1,1,down,1978-12-02
10714,Bobby Caldwell,1979-04-14,Bobby Caldwell - Bobby Caldwell,21,25,24,7.0,24,Bobby Caldwell,23.0,19,0,-3,4,0,stay,1978-12-02
10715,Bobby Caldwell,1979-04-21,Bobby Caldwell - Bobby Caldwell,24,21,25,7.0,24,Bobby Caldwell,23.0,20,-1,0,-3,1,down,1978-12-02
10716,Bobby Caldwell,1979-04-28,Bobby Caldwell - Bobby Caldwell,24,24,38,7.0,25,Bobby Caldwell,23.0,21,-13,-1,0,1,down,1978-12-02
10717,Bobby Caldwell,1979-05-05,Bobby Caldwell - Bobby Caldwell,25,24,46,7.0,38,Bobby Caldwell,23.0,22,-8,-13,-1,1,down,1978-12-02
10718,Bobby Caldwell,1979-05-12,Bobby Caldwell - Bobby Caldwell,38,25,51,7.0,46,Bobby Caldwell,23.0,23,-5,-8,-13,1,down,1978-12-02
10719,Brass Construction,1978-12-02,Brass Construction - Brass Construction Iv,51,51,40,24.0,50,Brass Construction Iv,5.0,0,10,1,0,1,up,1978-12-02
10720,Brass Construction,1978-12-09,Brass Construction - Brass Construction Iv,50,51,32,24.0,40,Brass Construction Iv,5.0,1,8,10,1,1,up,1978-12-02
10721,Brass Construction,1978-12-16,Brass Construction - Brass Construction Iv,40,50,24,24.0,32,Brass Construction Iv,5.0,2,8,8,10,1,up,1978-12-02
10722,Brass Construction,1978-12-23,Brass Construction - Brass Construction Iv,32,40,24,24.0,24,Brass Construction Iv,5.0,3,0,8,8,0,stay,1978-12-02
10723,Brass Construction,1978-12-30,Brass Construction - Brass Construction Iv,24,32,24,24.0,24,Brass Construction Iv,5.0,4,0,0,8,0,stay,1978-12-02
10724,Brass Construction,1979-01-06,Brass Construction - Brass Construction Iv,24,24,51,24.0,24,Brass Construction Iv,5.0,5,-27,0,0,1,down,1978-12-02
10725,Chic,1978-12-09,Chic - C'est Chic,51,51,1,1.0,3,C'est Chic,24.0,0,2,48,0,1,up,1978-12-09
10726,Chic,1978-12-16,Chic - C'est Chic,3,51,1,1.0,1,C'est Chic,24.0,1,0,2,48,0,stay,1978-12-09
10727,Chic,1978-12-23,Chic - C'est Chic,1,3,1,1.0,1,C'est Chic,24.0,2,0,0,2,0,stay,1978-12-09
10728,Chic,1978-12-30,Chic - C'est Chic,1,1,1,1.0,1,C'est Chic,24.0,3,0,0,0,0,stay,1978-12-09
10729,Chic,1979-01-06,Chic - C'est Chic,1,1,1,1.0,1,C'est Chic,24.0,4,0,0,0,0,stay,1978-12-09
10730,Chic,1979-01-13,Chic - C'est Chic,1,1,1,1.0,1,C'est Chic,24.0,5,0,0,0,0,stay,1978-12-09
10731,Chic,1979-01-20,Chic - C'est Chic,1,1,1,1.0,1,C'est Chic,24.0,6,0,0,0,0,stay,1978-12-09
10732,Chic,1979-01-27,Chic - C'est Chic,1,1,1,1.0,1,C'est Chic,24.0,7,0,0,0,0,stay,1978-12-09
10733,Chic,1979-02-03,Chic - C'est Chic,1,1,1,1.0,1,C'est Chic,24.0,8,0,0,0,0,stay,1978-12-09
10734,Chic,1979-02-10,Chic - C'est Chic,1,1,1,1.0,1,C'est Chic,24.0,9,0,0,0,0,stay,1978-12-09
10735,Chic,1979-02-17,Chic - C'est Chic,1,1,1,1.0,1,C'est Chic,24.0,10,0,0,0,0,stay,1978-12-09
10736,Chic,1979-02-24,Chic - C'est Chic,1,1,2,1.0,1,C'est Chic,24.0,11,-1,0,0,1,down,1978-12-09
10737,Chic,1979-03-03,Chic - C'est Chic,1,1,3,1.0,2,C'est Chic,24.0,12,-1,-1,0,1,down,1978-12-09
10738,Chic,1979-03-10,Chic - C'est Chic,2,1,6,1.0,3,C'est Chic,24.0,13,-3,-1,-1,1,down,1978-12-09
10739,Chic,1979-03-17,Chic - C'est Chic,3,2,6,1.0,6,C'est Chic,24.0,14,0,-3,-1,0,stay,1978-12-09
10740,Chic,1979-03-24,Chic - C'est Chic,6,3,8,1.0,6,C'est Chic,24.0,15,-2,0,-3,1,down,1978-12-09
10741,Chic,1979-03-31,Chic - C'est Chic,6,6,8,1.0,8,C'est Chic,24.0,16,0,-2,0,0,stay,1978-12-09
10742,Chic,1979-04-07,Chic - C'est Chic,8,6,8,1.0,8,C'est Chic,24.0,17,0,0,-2,0,stay,1978-12-09
10743,Chic,1979-04-14,Chic - C'est Chic,8,8,10,1.0,8,C'est Chic,24.0,18,-2,0,0,1,down,1978-12-09
10744,Chic,1979-04-21,Chic - C'est Chic,8,8,11,1.0,10,C'est Chic,24.0,19,-1,-2,0,1,down,1978-12-09
10745,Chic,1979-04-28,Chic - C'est Chic,10,8,21,1.0,11,C'est Chic,24.0,20,-10,-1,-2,1,down,1978-12-09
10746,Chic,1979-05-05,Chic - C'est Chic,11,10,22,1.0,21,C'est Chic,24.0,21,-1,-10,-1,1,down,1978-12-09
10747,Chic,1979-05-12,Chic - C'est Chic,21,11,22,1.0,22,C'est Chic,24.0,22,0,-1,-10,0,stay,1978-12-09
10748,Chic,1979-05-19,Chic - C'est Chic,22,21,49,1.0,22,C'est Chic,24.0,23,-27,0,-1,1,down,1978-12-09
10749,Chic,1979-05-26,Chic - C'est Chic,22,22,51,1.0,49,C'est Chic,24.0,24,-2,-27,0,1,down,1978-12-09
10750,"Earth, Wind & Fire",1978-12-09,"Earth, Wind & Fire - The Best Of Earth,wind+ Fire",51,51,7,3.0,13,"The Best Of Earth,wind+ Fire",17.0,0,6,38,0,1,up,1978-12-09
10751,"Earth, Wind & Fire",1978-12-16,"Earth, Wind & Fire - The Best Of Earth,wind+ Fire",13,51,4,3.0,7,"The Best Of Earth,wind+ Fire",17.0,1,3,6,38,1,up,1978-12-09
10752,"Earth, Wind & Fire",1978-12-23,"Earth, Wind & Fire - The Best Of Earth,wind+ Fire",7,13,4,3.0,4,"The Best Of Earth,wind+ Fire",17.0,2,0,3,6,0,stay,1978-12-09
10753,"Earth, Wind & Fire",1978-12-30,"Earth, Wind & Fire - The Best Of Earth,wind+ Fire",4,7,3,3.0,4,"The Best Of Earth,wind+ Fire",17.0,3,1,0,3,1,up,1978-12-09
10754,"Earth, Wind & Fire",1979-01-06,"Earth, Wind & Fire - The Best Of Earth,wind+ Fire",4,4,3,3.0,3,"The Best Of Earth,wind+ Fire",17.0,4,0,1,0,0,stay,1978-12-09
10755,"Earth, Wind & Fire",1979-01-13,"Earth, Wind & Fire - The Best Of Earth,wind+ Fire",3,4,3,3.0,3,"The Best Of Earth,wind+ Fire",17.0,5,0,0,1,0,stay,1978-12-09
10756,"Earth, Wind & Fire",1979-01-20,"Earth, Wind & Fire - The Best Of Earth,wind+ Fire",3,3,3,3.0,3,"The Best Of Earth,wind+ Fire",17.0,6,0,0,0,0,stay,1978-12-09
10757,"Earth, Wind & Fire",1979-01-27,"Earth, Wind & Fire - The Best Of Earth,wind+ Fire",3,3,3,3.0,3,"The Best Of Earth,wind+ Fire",17.0,7,0,0,0,0,stay,1978-12-09
10758,"Earth, Wind & Fire",1979-02-03,"Earth, Wind & Fire - The Best Of Earth,wind+ Fire",3,3,5,3.0,3,"The Best Of Earth,wind+ Fire",17.0,8,-2,0,0,1,down,1978-12-09
10759,"Earth, Wind & Fire",1979-02-10,"Earth, Wind & Fire - The Best Of Earth,wind+ Fire",3,3,7,3.0,5,"The Best Of Earth,wind+ Fire",17.0,9,-2,-2,0,1,down,1978-12-09
10760,"Earth, Wind & Fire",1979-02-17,"Earth, Wind & Fire - The Best Of Earth,wind+ Fire",5,3,8,3.0,7,"The Best Of Earth,wind+ Fire",17.0,10,-1,-2,-2,1,down,1978-12-09
10761,"Earth, Wind & Fire",1979-02-24,"Earth, Wind & Fire - The Best Of Earth,wind+ Fire",7,5,12,3.0,8,"The Best Of Earth,wind+ Fire",17.0,11,-4,-1,-2,1,down,1978-12-09
10762,"Earth, Wind & Fire",1979-03-03,"Earth, Wind & Fire - The Best Of Earth,wind+ Fire",8,7,12,3.0,12,"The Best Of Earth,wind+ Fire",17.0,12,0,-4,-1,0,stay,1978-12-09
10763,"Earth, Wind & Fire",1979-03-10,"Earth, Wind & Fire - The Best Of Earth,wind+ Fire",12,8,18,3.0,12,"The Best Of Earth,wind+ Fire",17.0,13,-6,0,-4,1,down,1978-12-09
10764,"Earth, Wind & Fire",1979-03-17,"Earth, Wind & Fire - The Best Of Earth,wind+ Fire",12,12,18,3.0,18,"The Best Of Earth,wind+ Fire",17.0,14,0,-6,0,0,stay,1978-12-09
10765,"Earth, Wind & Fire",1979-03-24,"Earth, Wind & Fire - The Best Of Earth,wind+ Fire",18,12,26,3.0,18,"The Best Of Earth,wind+ Fire",17.0,15,-8,0,-6,1,down,1978-12-09
10766,"Earth, Wind & Fire",1979-03-31,"Earth, Wind & Fire - The Best Of Earth,wind+ Fire",18,18,42,3.0,26,"The Best Of Earth,wind+ Fire",17.0,16,-16,-8,0,1,down,1978-12-09
10767,"Earth, Wind & Fire",1979-04-07,"Earth, Wind & Fire - The Best Of Earth,wind+ Fire",26,18,51,3.0,42,"The Best Of Earth,wind+ Fire",17.0,17,-9,-16,-8,1,down,1978-12-09
10768,The Jacksons,1978-12-09,The Jacksons - Destiny,51,51,38,3.0,42,Destiny,43.0,0,4,9,0,1,up,1978-12-09
10769,The Jacksons,1978-12-16,The Jacksons - Destiny,42,51,38,3.0,38,Destiny,43.0,1,0,4,9,0,stay,1978-12-09
10770,The Jacksons,1978-12-23,The Jacksons - Destiny,38,42,38,3.0,38,Destiny,43.0,2,0,0,4,0,stay,1978-12-09
10771,The Jacksons,1978-12-30,The Jacksons - Destiny,38,38,37,3.0,38,Destiny,43.0,3,1,0,0,1,up,1978-12-09
10772,The Jacksons,1979-01-06,The Jacksons - Destiny,38,38,26,3.0,37,Destiny,43.0,4,11,1,0,1,up,1978-12-09
10773,The Jacksons,1979-01-13,The Jacksons - Destiny,37,38,24,3.0,26,Destiny,43.0,5,2,11,1,1,up,1978-12-09
10774,The Jacksons,1979-01-20,The Jacksons - Destiny,26,37,27,3.0,24,Destiny,43.0,6,-3,2,11,1,down,1978-12-09
10775,The Jacksons,1979-01-27,The Jacksons - Destiny,24,26,20,3.0,27,Destiny,43.0,7,7,-3,2,1,up,1978-12-09
10776,The Jacksons,1979-02-03,The Jacksons - Destiny,27,24,17,3.0,20,Destiny,43.0,8,3,7,-3,1,up,1978-12-09
10777,The Jacksons,1979-02-10,The Jacksons - Destiny,20,27,16,3.0,17,Destiny,43.0,9,1,3,7,1,up,1978-12-09
10778,The Jacksons,1979-02-17,The Jacksons - Destiny,17,20,28,3.0,16,Destiny,43.0,10,-12,1,3,1,down,1978-12-09
10779,The Jacksons,1979-02-24,The Jacksons - Destiny,16,17,21,3.0,28,Destiny,43.0,11,7,-12,1,1,up,1978-12-09
10780,The Jacksons,1979-03-03,The Jacksons - Destiny,28,16,7,3.0,21,Destiny,43.0,12,14,7,-12,1,up,1978-12-09
10781,The Jacksons,1979-03-10,The Jacksons - Destiny,21,28,3,3.0,7,Destiny,43.0,13,4,14,7,1,up,1978-12-09
10782,The Jacksons,1979-03-17,The Jacksons - Destiny,7,21,3,3.0,3,Destiny,43.0,14,0,4,14,0,stay,1978-12-09
10783,The Jacksons,1979-03-24,The Jacksons - Destiny,3,7,3,3.0,3,Destiny,43.0,15,0,0,4,0,stay,1978-12-09
10784,The Jacksons,1979-03-31,The Jacksons - Destiny,3,3,6,3.0,3,Destiny,43.0,16,-3,0,0,1,down,1978-12-09
10785,The Jacksons,1979-04-07,The Jacksons - Destiny,3,3,7,3.0,6,Destiny,43.0,17,-1,-3,0,1,down,1978-12-09
10786,The Jacksons,1979-04-14,The Jacksons - Destiny,6,3,6,3.0,7,Destiny,43.0,18,1,-1,-3,1,up,1978-12-09
10787,The Jacksons,1979-04-21,The Jacksons - Destiny,7,6,4,3.0,6,Destiny,43.0,19,2,1,-1,1,up,1978-12-09
10788,The Jacksons,1979-04-28,The Jacksons - Destiny,6,7,4,3.0,4,Destiny,43.0,20,0,2,1,0,stay,1978-12-09
10789,The Jacksons,1979-05-05,The Jacksons - Destiny,4,6,5,3.0,4,Destiny,43.0,21,-1,0,2,1,down,1978-12-09
10790,The Jacksons,1979-05-12,The Jacksons - Destiny,4,4,7,3.0,5,Destiny,43.0,22,-2,-1,0,1,down,1978-12-09
10791,The Jacksons,1979-05-19,The Jacksons - Destiny,5,4,7,3.0,7,Destiny,43.0,23,0,-2,-1,0,stay,1978-12-09
10792,The Jacksons,1979-05-26,The Jacksons - Destiny,7,5,8,3.0,7,Destiny,43.0,24,-1,0,-2,1,down,1978-12-09
10793,The Jacksons,1979-06-02,The Jacksons - Destiny,7,7,10,3.0,8,Destiny,43.0,25,-2,-1,0,1,down,1978-12-09
10794,The Jacksons,1979-06-09,The Jacksons - Destiny,8,7,15,3.0,10,Destiny,43.0,26,-5,-2,-1,1,down,1978-12-09
10795,The Jacksons,1979-06-16,The Jacksons - Destiny,10,8,16,3.0,15,Destiny,43.0,27,-1,-5,-2,1,down,1978-12-09
10796,The Jacksons,1979-06-23,The Jacksons - Destiny,15,10,19,3.0,16,Destiny,43.0,28,-3,-1,-5,1,down,1978-12-09
10797,The Jacksons,1979-06-30,The Jacksons - Destiny,16,15,22,3.0,19,Destiny,43.0,29,-3,-3,-1,1,down,1978-12-09
10798,The Jacksons,1979-07-07,The Jacksons - Destiny,19,16,25,3.0,22,Destiny,43.0,30,-3,-3,-3,1,down,1978-12-09
10799,The Jacksons,1979-07-14,The Jacksons - Destiny,22,19,26,3.0,25,Destiny,43.0,31,-1,-3,-3,1,down,1978-12-09
10800,The Jacksons,1979-07-21,The Jacksons - Destiny,25,22,31,3.0,26,Destiny,43.0,32,-5,-1,-3,1,down,1978-12-09
10801,The Jacksons,1979-07-28,The Jacksons - Destiny,26,25,32,3.0,31,Destiny,43.0,33,-1,-5,-1,1,down,1978-12-09
10802,The Jacksons,1979-08-04,The Jacksons - Destiny,31,26,31,3.0,32,Destiny,43.0,34,1,-1,-5,1,up,1978-12-09
10803,The Jacksons,1979-08-11,The Jacksons - Destiny,32,31,34,3.0,31,Destiny,43.0,35,-3,1,-1,1,down,1978-12-09
10804,The Jacksons,1979-08-18,The Jacksons - Destiny,31,32,37,3.0,34,Destiny,43.0,36,-3,-3,1,1,down,1978-12-09
10805,The Jacksons,1979-08-25,The Jacksons - Destiny,34,31,41,3.0,37,Destiny,43.0,37,-4,-3,-3,1,down,1978-12-09
10806,The Jacksons,1979-09-01,The Jacksons - Destiny,37,34,41,3.0,41,Destiny,43.0,38,0,-4,-3,0,stay,1978-12-09
10807,The Jacksons,1979-09-08,The Jacksons - Destiny,41,37,46,3.0,41,Destiny,43.0,39,-5,0,-4,1,down,1978-12-09
10808,The Jacksons,1979-09-15,The Jacksons - Destiny,41,41,46,3.0,46,Destiny,43.0,40,0,-5,0,0,stay,1978-12-09
10809,The Jacksons,1979-09-22,The Jacksons - Destiny,46,41,48,3.0,46,Destiny,43.0,41,-2,0,-5,1,down,1978-12-09
10810,The Jacksons,1979-09-29,The Jacksons - Destiny,46,46,49,3.0,48,Destiny,43.0,42,-1,-2,0,1,down,1978-12-09
10811,The Jacksons,1979-10-06,The Jacksons - Destiny,48,46,51,3.0,49,Destiny,43.0,43,-2,-1,-2,1,down,1978-12-09
10812,Peaches & Herb,1978-12-09,Peaches & Herb - 2-hot,51,51,44,1.0,46,2-hot,36.0,0,2,5,0,1,up,1978-12-09
10813,Peaches & Herb,1978-12-16,Peaches & Herb - 2-hot,46,51,43,1.0,44,2-hot,36.0,1,1,2,5,1,up,1978-12-09
10814,Peaches & Herb,1978-12-23,Peaches & Herb - 2-hot,44,46,43,1.0,43,2-hot,36.0,2,0,1,2,0,stay,1978-12-09
10815,Peaches & Herb,1978-12-30,Peaches & Herb - 2-hot,43,44,33,1.0,43,2-hot,36.0,3,10,0,1,1,up,1978-12-09
10816,Peaches & Herb,1979-01-06,Peaches & Herb - 2-hot,43,43,19,1.0,33,2-hot,36.0,4,14,10,0,1,up,1978-12-09
10817,Peaches & Herb,1979-01-13,Peaches & Herb - 2-hot,33,43,13,1.0,19,2-hot,36.0,5,6,14,10,1,up,1978-12-09
10818,Peaches & Herb,1979-01-20,Peaches & Herb - 2-hot,19,33,10,1.0,13,2-hot,36.0,6,3,6,14,1,up,1978-12-09
10819,Peaches & Herb,1979-01-27,Peaches & Herb - 2-hot,13,19,10,1.0,10,2-hot,36.0,7,0,3,6,0,stay,1978-12-09
10820,Peaches & Herb,1979-02-03,Peaches & Herb - 2-hot,10,13,10,1.0,10,2-hot,36.0,8,0,0,3,0,stay,1978-12-09
10821,Peaches & Herb,1979-02-10,Peaches & Herb - 2-hot,10,10,5,1.0,10,2-hot,36.0,9,5,0,0,1,up,1978-12-09
10822,Peaches & Herb,1979-02-17,Peaches & Herb - 2-hot,10,10,2,1.0,5,2-hot,36.0,10,3,5,0,1,up,1978-12-09
10823,Peaches & Herb,1979-02-24,Peaches & Herb - 2-hot,5,10,1,1.0,2,2-hot,36.0,11,1,3,5,1,up,1978-12-09
10824,Peaches & Herb,1979-03-03,Peaches & Herb - 2-hot,2,5,1,1.0,1,2-hot,36.0,12,0,1,3,0,stay,1978-12-09
10825,Peaches & Herb,1979-03-10,Peaches & Herb - 2-hot,1,2,1,1.0,1,2-hot,36.0,13,0,0,1,0,stay,1978-12-09
10826,Peaches & Herb,1979-03-17,Peaches & Herb - 2-hot,1,1,1,1.0,1,2-hot,36.0,14,0,0,0,0,stay,1978-12-09
10827,Peaches & Herb,1979-03-24,Peaches & Herb - 2-hot,1,1,4,1.0,1,2-hot,36.0,15,-3,0,0,1,down,1978-12-09
10828,Peaches & Herb,1979-03-31,Peaches & Herb - 2-hot,1,1,3,1.0,4,2-hot,36.0,16,1,-3,0,1,up,1978-12-09
10829,Peaches & Herb,1979-04-07,Peaches & Herb - 2-hot,4,1,1,1.0,3,2-hot,36.0,17,2,1,-3,1,up,1978-12-09
10830,Peaches & Herb,1979-04-14,Peaches & Herb - 2-hot,3,4,1,1.0,1,2-hot,36.0,18,0,2,1,0,stay,1978-12-09
10831,Peaches & Herb,1979-04-21,Peaches & Herb - 2-hot,1,3,1,1.0,1,2-hot,36.0,19,0,0,2,0,stay,1978-12-09
10832,Peaches & Herb,1979-04-28,Peaches & Herb - 2-hot,1,1,1,1.0,1,2-hot,36.0,20,0,0,0,0,stay,1978-12-09
10833,Peaches & Herb,1979-05-05,Peaches & Herb - 2-hot,1,1,3,1.0,1,2-hot,36.0,21,-2,0,0,1,down,1978-12-09
10834,Peaches & Herb,1979-05-12,Peaches & Herb - 2-hot,1,1,3,1.0,3,2-hot,36.0,22,0,-2,0,0,stay,1978-12-09
10835,Peaches & Herb,1979-05-19,Peaches & Herb - 2-hot,3,1,3,1.0,3,2-hot,36.0,23,0,0,-2,0,stay,1978-12-09
10836,Peaches & Herb,1979-05-26,Peaches & Herb - 2-hot,3,3,6,1.0,3,2-hot,36.0,24,-3,0,0,1,down,1978-12-09
10837,Peaches & Herb,1979-06-02,Peaches & Herb - 2-hot,3,3,3,1.0,6,2-hot,36.0,25,3,-3,0,1,up,1978-12-09
10838,Peaches & Herb,1979-06-09,Peaches & Herb - 2-hot,6,3,3,1.0,3,2-hot,36.0,26,0,3,-3,0,stay,1978-12-09
10839,Peaches & Herb,1979-06-16,Peaches & Herb - 2-hot,3,6,6,1.0,3,2-hot,36.0,27,-3,0,3,1,down,1978-12-09
10840,Peaches & Herb,1979-06-23,Peaches & Herb - 2-hot,3,3,8,1.0,6,2-hot,36.0,28,-2,-3,0,1,down,1978-12-09
10841,Peaches & Herb,1979-06-30,Peaches & Herb - 2-hot,6,3,11,1.0,8,2-hot,36.0,29,-3,-2,-3,1,down,1978-12-09
10842,Peaches & Herb,1979-07-07,Peaches & Herb - 2-hot,8,6,24,1.0,11,2-hot,36.0,30,-13,-3,-2,1,down,1978-12-09
10843,Peaches & Herb,1979-07-14,Peaches & Herb - 2-hot,11,8,24,1.0,24,2-hot,36.0,31,0,-13,-3,0,stay,1978-12-09
10844,Peaches & Herb,1979-07-21,Peaches & Herb - 2-hot,24,11,33,1.0,24,2-hot,36.0,32,-9,0,-13,1,down,1978-12-09
10845,Peaches & Herb,1979-07-28,Peaches & Herb - 2-hot,24,24,36,1.0,33,2-hot,36.0,33,-3,-9,0,1,down,1978-12-09
10846,Peaches & Herb,1979-08-04,Peaches & Herb - 2-hot,33,24,35,1.0,36,2-hot,36.0,34,1,-3,-9,1,up,1978-12-09
10847,Peaches & Herb,1979-08-11,Peaches & Herb - 2-hot,36,33,38,1.0,35,2-hot,36.0,35,-3,1,-3,1,down,1978-12-09
10848,Peaches & Herb,1979-08-18,Peaches & Herb - 2-hot,35,36,51,1.0,38,2-hot,36.0,36,-13,-3,1,1,down,1978-12-09
10849,ADC Band,1978-12-09,ADC Band - Long Stroke,51,51,35,16.0,48,Long Stroke,9.0,0,13,3,0,1,up,1978-12-09
10850,ADC Band,1978-12-16,ADC Band - Long Stroke,48,51,25,16.0,35,Long Stroke,9.0,1,10,13,3,1,up,1978-12-09
10851,ADC Band,1978-12-23,ADC Band - Long Stroke,35,48,25,16.0,25,Long Stroke,9.0,2,0,10,13,0,stay,1978-12-09
10852,ADC Band,1978-12-30,ADC Band - Long Stroke,25,35,19,16.0,25,Long Stroke,9.0,3,6,0,10,1,up,1978-12-09
10853,ADC Band,1979-01-06,ADC Band - Long Stroke,25,25,16,16.0,19,Long Stroke,9.0,4,3,6,0,1,up,1978-12-09
10854,ADC Band,1979-01-13,ADC Band - Long Stroke,19,25,16,16.0,16,Long Stroke,9.0,5,0,3,6,0,stay,1978-12-09
10855,ADC Band,1979-01-20,ADC Band - Long Stroke,16,19,19,16.0,16,Long Stroke,9.0,6,-3,0,3,1,down,1978-12-09
10856,ADC Band,1979-01-27,ADC Band - Long Stroke,16,16,27,16.0,19,Long Stroke,9.0,7,-8,-3,0,1,down,1978-12-09
10857,ADC Band,1979-02-03,ADC Band - Long Stroke,19,16,50,16.0,27,Long Stroke,9.0,8,-23,-8,-3,1,down,1978-12-09
10858,ADC Band,1979-02-10,ADC Band - Long Stroke,27,19,51,16.0,50,Long Stroke,9.0,9,-1,-23,-8,1,down,1978-12-09
10859,Mandrill,1978-12-09,Mandrill - New Worlds,51,51,40,30.0,50,New Worlds,4.0,0,10,1,0,1,up,1978-12-09
10860,Mandrill,1978-12-16,Mandrill - New Worlds,50,51,32,30.0,40,New Worlds,4.0,1,8,10,1,1,up,1978-12-09
10861,Mandrill,1978-12-23,Mandrill - New Worlds,40,50,32,30.0,32,New Worlds,4.0,2,0,8,10,0,stay,1978-12-09
10862,Mandrill,1978-12-30,Mandrill - New Worlds,32,40,30,30.0,32,New Worlds,4.0,3,2,0,8,1,up,1978-12-09
10863,Mandrill,1979-01-06,Mandrill - New Worlds,32,32,51,30.0,30,New Worlds,4.0,4,-21,2,0,1,down,1978-12-09
10864,Parliament,1978-12-16,Parliament - Motor Booty Affair,51,51,8,2.0,14,Motor Booty Affair,19.0,0,6,37,0,1,up,1978-12-16
10865,Parliament,1978-12-23,Parliament - Motor Booty Affair,14,51,8,2.0,8,Motor Booty Affair,19.0,1,0,6,37,0,stay,1978-12-16
10866,Parliament,1978-12-30,Parliament - Motor Booty Affair,8,14,2,2.0,8,Motor Booty Affair,19.0,2,6,0,6,1,up,1978-12-16
10867,Parliament,1979-01-06,Parliament - Motor Booty Affair,8,8,2,2.0,2,Motor Booty Affair,19.0,3,0,6,0,0,stay,1978-12-16
10868,Parliament,1979-01-13,Parliament - Motor Booty Affair,2,8,2,2.0,2,Motor Booty Affair,19.0,4,0,0,6,0,stay,1978-12-16
10869,Parliament,1979-01-20,Parliament - Motor Booty Affair,2,2,2,2.0,2,Motor Booty Affair,19.0,5,0,0,0,0,stay,1978-12-16
10870,Parliament,1979-01-27,Parliament - Motor Booty Affair,2,2,2,2.0,2,Motor Booty Affair,19.0,6,0,0,0,0,stay,1978-12-16
10871,Parliament,1979-02-03,Parliament - Motor Booty Affair,2,2,2,2.0,2,Motor Booty Affair,19.0,7,0,0,0,0,stay,1978-12-16
10872,Parliament,1979-02-10,Parliament - Motor Booty Affair,2,2,2,2.0,2,Motor Booty Affair,19.0,8,0,0,0,0,stay,1978-12-16
10873,Parliament,1979-02-17,Parliament - Motor Booty Affair,2,2,5,2.0,2,Motor Booty Affair,19.0,9,-3,0,0,1,down,1978-12-16
10874,Parliament,1979-02-24,Parliament - Motor Booty Affair,2,2,5,2.0,5,Motor Booty Affair,19.0,10,0,-3,0,0,stay,1978-12-16
10875,Parliament,1979-03-03,Parliament - Motor Booty Affair,5,2,14,2.0,5,Motor Booty Affair,19.0,11,-9,0,-3,1,down,1978-12-16
10876,Parliament,1979-03-10,Parliament - Motor Booty Affair,5,5,12,2.0,14,Motor Booty Affair,19.0,12,2,-9,0,1,up,1978-12-16
10877,Parliament,1979-03-17,Parliament - Motor Booty Affair,14,5,14,2.0,12,Motor Booty Affair,19.0,13,-2,2,-9,1,down,1978-12-16
10878,Parliament,1979-03-24,Parliament - Motor Booty Affair,12,14,19,2.0,14,Motor Booty Affair,19.0,14,-5,-2,2,1,down,1978-12-16
10879,Parliament,1979-03-31,Parliament - Motor Booty Affair,14,12,19,2.0,19,Motor Booty Affair,19.0,15,0,-5,-2,0,stay,1978-12-16
10880,Parliament,1979-04-07,Parliament - Motor Booty Affair,19,14,26,2.0,19,Motor Booty Affair,19.0,16,-7,0,-5,1,down,1978-12-16
10881,Parliament,1979-04-14,Parliament - Motor Booty Affair,19,19,33,2.0,26,Motor Booty Affair,19.0,17,-7,-7,0,1,down,1978-12-16
10882,Parliament,1979-04-21,Parliament - Motor Booty Affair,26,19,49,2.0,33,Motor Booty Affair,19.0,18,-16,-7,-7,1,down,1978-12-16
10883,Parliament,1979-04-28,Parliament - Motor Booty Affair,33,26,51,2.0,49,Motor Booty Affair,19.0,19,-2,-16,-7,1,down,1978-12-16
10884,Lakeside,1978-12-16,Lakeside - Shot Of Love,51,51,39,10.0,49,Shot Of Love,19.0,0,10,2,0,1,up,1978-12-16
10885,Lakeside,1978-12-23,Lakeside - Shot Of Love,49,51,39,10.0,39,Shot Of Love,19.0,1,0,10,2,0,stay,1978-12-16
10886,Lakeside,1978-12-30,Lakeside - Shot Of Love,39,49,29,10.0,39,Shot Of Love,19.0,2,10,0,10,1,up,1978-12-16
10887,Lakeside,1979-01-06,Lakeside - Shot Of Love,39,39,29,10.0,29,Shot Of Love,19.0,3,0,10,0,0,stay,1978-12-16
10888,Lakeside,1979-01-13,Lakeside - Shot Of Love,29,39,28,10.0,29,Shot Of Love,19.0,4,1,0,10,1,up,1978-12-16
10889,Lakeside,1979-01-20,Lakeside - Shot Of Love,29,29,21,10.0,28,Shot Of Love,19.0,5,7,1,0,1,up,1978-12-16
10890,Lakeside,1979-01-27,Lakeside - Shot Of Love,28,29,14,10.0,21,Shot Of Love,19.0,6,7,7,1,1,up,1978-12-16
10891,Lakeside,1979-02-03,Lakeside - Shot Of Love,21,28,12,10.0,14,Shot Of Love,19.0,7,2,7,7,1,up,1978-12-16
10892,Lakeside,1979-02-10,Lakeside - Shot Of Love,14,21,10,10.0,12,Shot Of Love,19.0,8,2,2,7,1,up,1978-12-16
10893,Lakeside,1979-02-17,Lakeside - Shot Of Love,12,14,10,10.0,10,Shot Of Love,19.0,9,0,2,2,0,stay,1978-12-16
10894,Lakeside,1979-02-24,Lakeside - Shot Of Love,10,12,13,10.0,10,Shot Of Love,19.0,10,-3,0,2,1,down,1978-12-16
10895,Lakeside,1979-03-03,Lakeside - Shot Of Love,10,10,21,10.0,13,Shot Of Love,19.0,11,-8,-3,0,1,down,1978-12-16
10896,Lakeside,1979-03-10,Lakeside - Shot Of Love,13,10,21,10.0,21,Shot Of Love,19.0,12,0,-8,-3,0,stay,1978-12-16
10897,Lakeside,1979-03-17,Lakeside - Shot Of Love,21,13,22,10.0,21,Shot Of Love,19.0,13,-1,0,-8,1,down,1978-12-16
10898,Lakeside,1979-03-24,Lakeside - Shot Of Love,21,21,16,10.0,22,Shot Of Love,19.0,14,6,-1,0,1,up,1978-12-16
10899,Lakeside,1979-03-31,Lakeside - Shot Of Love,22,21,16,10.0,16,Shot Of Love,19.0,15,0,6,-1,0,stay,1978-12-16
10900,Lakeside,1979-04-07,Lakeside - Shot Of Love,16,22,20,10.0,16,Shot Of Love,19.0,16,-4,0,6,1,down,1978-12-16
10901,Lakeside,1979-04-14,Lakeside - Shot Of Love,16,16,32,10.0,20,Shot Of Love,19.0,17,-12,-4,0,1,down,1978-12-16
10902,Lakeside,1979-04-21,Lakeside - Shot Of Love,20,16,47,10.0,32,Shot Of Love,19.0,18,-15,-12,-4,1,down,1978-12-16
10903,Lakeside,1979-04-28,Lakeside - Shot Of Love,32,20,51,10.0,47,Shot Of Love,19.0,19,-4,-15,-12,1,down,1978-12-16
10904,Norman Connors,1978-12-16,Norman Connors - Best Of Norman Connors + Friends,51,51,47,44.0,50,Best Of Norman Connors + Friends,3.0,0,3,1,0,1,up,1978-12-16
10905,Norman Connors,1978-12-23,Norman Connors - Best Of Norman Connors + Friends,50,51,47,44.0,47,Best Of Norman Connors + Friends,3.0,1,0,3,1,0,stay,1978-12-16
10906,Norman Connors,1978-12-30,Norman Connors - Best Of Norman Connors + Friends,47,50,44,44.0,47,Best Of Norman Connors + Friends,3.0,2,3,0,3,1,up,1978-12-16
10907,Norman Connors,1979-01-06,Norman Connors - Best Of Norman Connors + Friends,47,47,51,44.0,44,Best Of Norman Connors + Friends,3.0,3,-7,3,0,1,down,1978-12-16
10908,Barkays,1978-12-23,Barkays - Light Of Life,51,51,46,15.0,46,Light Of Life,14.0,0,0,5,0,0,stay,1978-12-23
10909,Barkays,1978-12-30,Barkays - Light Of Life,46,51,26,15.0,46,Light Of Life,14.0,1,20,0,5,1,up,1978-12-23
10910,Barkays,1979-01-06,Barkays - Light Of Life,46,46,21,15.0,26,Light Of Life,14.0,2,5,20,0,1,up,1978-12-23
10911,Barkays,1979-01-13,Barkays - Light Of Life,26,46,15,15.0,21,Light Of Life,14.0,3,6,5,20,1,up,1978-12-23
10912,Barkays,1979-01-20,Barkays - Light Of Life,21,26,15,15.0,15,Light Of Life,14.0,4,0,6,5,0,stay,1978-12-23
10913,Barkays,1979-01-27,Barkays - Light Of Life,15,21,17,15.0,15,Light Of Life,14.0,5,-2,0,6,1,down,1978-12-23
10914,Barkays,1979-02-03,Barkays - Light Of Life,15,15,18,15.0,17,Light Of Life,14.0,6,-1,-2,0,1,down,1978-12-23
10915,Barkays,1979-02-10,Barkays - Light Of Life,17,15,26,15.0,18,Light Of Life,14.0,7,-8,-1,-2,1,down,1978-12-23
10916,Barkays,1979-02-17,Barkays - Light Of Life,18,17,33,15.0,26,Light Of Life,14.0,8,-7,-8,-1,1,down,1978-12-23
10917,Barkays,1979-02-24,Barkays - Light Of Life,26,18,35,15.0,33,Light Of Life,14.0,9,-2,-7,-8,1,down,1978-12-23
10918,Barkays,1979-03-03,Barkays - Light Of Life,33,26,35,15.0,35,Light Of Life,14.0,10,0,-2,-7,0,stay,1978-12-23
10919,Barkays,1979-03-10,Barkays - Light Of Life,35,33,47,15.0,35,Light Of Life,14.0,11,-12,0,-2,1,down,1978-12-23
10920,Barkays,1979-03-17,Barkays - Light Of Life,35,35,49,15.0,47,Light Of Life,14.0,12,-2,-12,0,1,down,1978-12-23
10921,Barkays,1979-03-24,Barkays - Light Of Life,47,35,48,15.0,49,Light Of Life,14.0,13,1,-2,-12,1,up,1978-12-23
10922,Barkays,1979-03-31,Barkays - Light Of Life,49,47,51,15.0,48,Light Of Life,14.0,14,-3,1,-2,1,down,1978-12-23
10923,Richard Pryor,1979-01-06,Richard Pryor - Wanted,51,51,7,4.0,11,Wanted,14.0,0,4,40,0,1,up,1979-01-06
10924,Richard Pryor,1979-01-13,Richard Pryor - Wanted,11,51,6,4.0,7,Wanted,14.0,1,1,4,40,1,up,1979-01-06
10925,Richard Pryor,1979-01-20,Richard Pryor - Wanted,7,11,5,4.0,6,Wanted,14.0,2,1,1,4,1,up,1979-01-06
10926,Richard Pryor,1979-01-27,Richard Pryor - Wanted,6,7,4,4.0,5,Wanted,14.0,3,1,1,1,1,up,1979-01-06
10927,Richard Pryor,1979-02-03,Richard Pryor - Wanted,5,6,6,4.0,4,Wanted,14.0,4,-2,1,1,1,down,1979-01-06
10928,Richard Pryor,1979-02-10,Richard Pryor - Wanted,4,5,6,4.0,6,Wanted,14.0,5,0,-2,1,0,stay,1979-01-06
10929,Richard Pryor,1979-02-17,Richard Pryor - Wanted,6,4,6,4.0,6,Wanted,14.0,6,0,0,-2,0,stay,1979-01-06
10930,Richard Pryor,1979-02-24,Richard Pryor - Wanted,6,6,7,4.0,6,Wanted,14.0,7,-1,0,0,1,down,1979-01-06
10931,Richard Pryor,1979-03-03,Richard Pryor - Wanted,6,6,13,4.0,7,Wanted,14.0,8,-6,-1,0,1,down,1979-01-06
10932,Richard Pryor,1979-03-10,Richard Pryor - Wanted,7,6,16,4.0,13,Wanted,14.0,9,-3,-6,-1,1,down,1979-01-06
10933,Richard Pryor,1979-03-17,Richard Pryor - Wanted,13,7,16,4.0,16,Wanted,14.0,10,0,-3,-6,0,stay,1979-01-06
10934,Richard Pryor,1979-03-24,Richard Pryor - Wanted,16,13,21,4.0,16,Wanted,14.0,11,-5,0,-3,1,down,1979-01-06
10935,Richard Pryor,1979-03-31,Richard Pryor - Wanted,16,16,30,4.0,21,Wanted,14.0,12,-9,-5,0,1,down,1979-01-06
10936,Richard Pryor,1979-04-07,Richard Pryor - Wanted,21,16,31,4.0,30,Wanted,14.0,13,-1,-9,-5,1,down,1979-01-06
10937,Richard Pryor,1979-04-14,Richard Pryor - Wanted,30,21,51,4.0,31,Wanted,14.0,14,-20,-1,-9,1,down,1979-01-06
10938,Third World,1979-01-06,Third World - Journey To Addis,51,51,33,14.0,43,Journey To Addis,12.0,0,10,8,0,1,up,1979-01-06
10939,Third World,1979-01-13,Third World - Journey To Addis,43,51,27,14.0,33,Journey To Addis,12.0,1,6,10,8,1,up,1979-01-06
10940,Third World,1979-01-20,Third World - Journey To Addis,33,43,25,14.0,27,Journey To Addis,12.0,2,2,6,10,1,up,1979-01-06
10941,Third World,1979-01-27,Third World - Journey To Addis,27,33,18,14.0,25,Journey To Addis,12.0,3,7,2,6,1,up,1979-01-06
10942,Third World,1979-02-03,Third World - Journey To Addis,25,27,16,14.0,18,Journey To Addis,12.0,4,2,7,2,1,up,1979-01-06
10943,Third World,1979-02-10,Third World - Journey To Addis,18,25,14,14.0,16,Journey To Addis,12.0,5,2,2,7,1,up,1979-01-06
10944,Third World,1979-02-17,Third World - Journey To Addis,16,18,14,14.0,14,Journey To Addis,12.0,6,0,2,2,0,stay,1979-01-06
10945,Third World,1979-02-24,Third World - Journey To Addis,14,16,26,14.0,14,Journey To Addis,12.0,7,-12,0,2,1,down,1979-01-06
10946,Third World,1979-03-03,Third World - Journey To Addis,14,14,33,14.0,26,Journey To Addis,12.0,8,-7,-12,0,1,down,1979-01-06
10947,Third World,1979-03-10,Third World - Journey To Addis,26,14,28,14.0,33,Journey To Addis,12.0,9,5,-7,-12,1,up,1979-01-06
10948,Third World,1979-03-17,Third World - Journey To Addis,33,26,26,14.0,28,Journey To Addis,12.0,10,2,5,-7,1,up,1979-01-06
10949,Third World,1979-03-24,Third World - Journey To Addis,28,33,31,14.0,26,Journey To Addis,12.0,11,-5,2,5,1,down,1979-01-06
10950,Third World,1979-03-31,Third World - Journey To Addis,26,28,51,14.0,31,Journey To Addis,12.0,12,-20,-5,2,1,down,1979-01-06
10951,Wilton Felder,1979-01-06,Wilton Felder - We All Have A Star,51,51,35,33.0,45,We All Have A Star,7.0,0,10,6,0,1,up,1979-01-06
10952,Wilton Felder,1979-01-13,Wilton Felder - We All Have A Star,45,51,33,33.0,35,We All Have A Star,7.0,1,2,10,6,1,up,1979-01-06
10953,Wilton Felder,1979-01-20,Wilton Felder - We All Have A Star,35,45,33,33.0,33,We All Have A Star,7.0,2,0,2,10,0,stay,1979-01-06
10954,Wilton Felder,1979-01-27,Wilton Felder - We All Have A Star,33,35,42,33.0,33,We All Have A Star,7.0,3,-9,0,2,1,down,1979-01-06
10955,Wilton Felder,1979-02-03,Wilton Felder - We All Have A Star,33,33,42,33.0,42,We All Have A Star,7.0,4,0,-9,0,0,stay,1979-01-06
10956,Wilton Felder,1979-02-10,Wilton Felder - We All Have A Star,42,33,42,33.0,42,We All Have A Star,7.0,5,0,0,-9,0,stay,1979-01-06
10957,Wilton Felder,1979-02-17,Wilton Felder - We All Have A Star,42,42,49,33.0,42,We All Have A Star,7.0,6,-7,0,0,1,down,1979-01-06
10958,Wilton Felder,1979-02-24,Wilton Felder - We All Have A Star,42,42,51,33.0,49,We All Have A Star,7.0,7,-2,-7,0,1,down,1979-01-06
10959,Randy Brown,1979-01-06,Randy Brown - Welcome To My Room,51,51,46,46.0,46,Welcome To My Room,1.0,0,0,5,0,0,stay,1979-01-06
10960,Randy Brown,1979-01-13,Randy Brown - Welcome To My Room,46,51,51,46.0,46,Welcome To My Room,1.0,1,-5,0,5,1,down,1979-01-06
10961,The Blackbyrds,1979-01-06,The Blackbyrds - Night Grooves,51,51,47,43.0,47,Night Grooves,4.0,0,0,4,0,0,stay,1979-01-06
10962,The Blackbyrds,1979-01-13,The Blackbyrds - Night Grooves,47,51,45,43.0,47,Night Grooves,4.0,1,2,0,4,1,up,1979-01-06
10963,The Blackbyrds,1979-01-20,The Blackbyrds - Night Grooves,47,47,43,43.0,45,Night Grooves,4.0,2,2,2,0,1,up,1979-01-06
10964,The Blackbyrds,1979-01-27,The Blackbyrds - Night Grooves,45,47,49,43.0,43,Night Grooves,4.0,3,-6,2,2,1,down,1979-01-06
10965,The Blackbyrds,1979-02-03,The Blackbyrds - Night Grooves,43,45,51,43.0,49,Night Grooves,4.0,4,-2,-6,2,1,down,1979-01-06
10966,Peabo Bryson,1979-01-06,Peabo Bryson - Crosswinds,51,51,45,3.0,50,Crosswinds,22.0,0,5,1,0,1,up,1979-01-06
10967,Peabo Bryson,1979-01-13,Peabo Bryson - Crosswinds,50,51,9,3.0,45,Crosswinds,22.0,1,36,5,1,1,up,1979-01-06
10968,Peabo Bryson,1979-01-20,Peabo Bryson - Crosswinds,45,50,8,3.0,9,Crosswinds,22.0,2,1,36,5,1,up,1979-01-06
10969,Peabo Bryson,1979-01-27,Peabo Bryson - Crosswinds,9,45,5,3.0,8,Crosswinds,22.0,3,3,1,36,1,up,1979-01-06
10970,Peabo Bryson,1979-02-03,Peabo Bryson - Crosswinds,8,9,3,3.0,5,Crosswinds,22.0,4,2,3,1,1,up,1979-01-06
10971,Peabo Bryson,1979-02-10,Peabo Bryson - Crosswinds,5,8,3,3.0,3,Crosswinds,22.0,5,0,2,3,0,stay,1979-01-06
10972,Peabo Bryson,1979-02-17,Peabo Bryson - Crosswinds,3,5,3,3.0,3,Crosswinds,22.0,6,0,0,2,0,stay,1979-01-06
10973,Peabo Bryson,1979-02-24,Peabo Bryson - Crosswinds,3,3,6,3.0,3,Crosswinds,22.0,7,-3,0,0,1,down,1979-01-06
10974,Peabo Bryson,1979-03-03,Peabo Bryson - Crosswinds,3,3,8,3.0,6,Crosswinds,22.0,8,-2,-3,0,1,down,1979-01-06
10975,Peabo Bryson,1979-03-10,Peabo Bryson - Crosswinds,6,3,11,3.0,8,Crosswinds,22.0,9,-3,-2,-3,1,down,1979-01-06
10976,Peabo Bryson,1979-03-17,Peabo Bryson - Crosswinds,8,6,11,3.0,11,Crosswinds,22.0,10,0,-3,-2,0,stay,1979-01-06
10977,Peabo Bryson,1979-03-24,Peabo Bryson - Crosswinds,11,8,11,3.0,11,Crosswinds,22.0,11,0,0,-3,0,stay,1979-01-06
10978,Peabo Bryson,1979-03-31,Peabo Bryson - Crosswinds,11,11,14,3.0,11,Crosswinds,22.0,12,-3,0,0,1,down,1979-01-06
10979,Peabo Bryson,1979-04-07,Peabo Bryson - Crosswinds,11,11,12,3.0,14,Crosswinds,22.0,13,2,-3,0,1,up,1979-01-06
10980,Peabo Bryson,1979-04-14,Peabo Bryson - Crosswinds,14,11,12,3.0,12,Crosswinds,22.0,14,0,2,-3,0,stay,1979-01-06
10981,Peabo Bryson,1979-04-21,Peabo Bryson - Crosswinds,12,14,12,3.0,12,Crosswinds,22.0,15,0,0,2,0,stay,1979-01-06
10982,Peabo Bryson,1979-04-28,Peabo Bryson - Crosswinds,12,12,13,3.0,12,Crosswinds,22.0,16,-1,0,0,1,down,1979-01-06
10983,Peabo Bryson,1979-05-05,Peabo Bryson - Crosswinds,12,12,15,3.0,13,Crosswinds,22.0,17,-2,-1,0,1,down,1979-01-06
10984,Peabo Bryson,1979-05-12,Peabo Bryson - Crosswinds,13,12,17,3.0,15,Crosswinds,22.0,18,-2,-2,-1,1,down,1979-01-06
10985,Peabo Bryson,1979-05-19,Peabo Bryson - Crosswinds,15,13,22,3.0,17,Crosswinds,22.0,19,-5,-2,-2,1,down,1979-01-06
10986,Peabo Bryson,1979-05-26,Peabo Bryson - Crosswinds,17,15,31,3.0,22,Crosswinds,22.0,20,-9,-5,-2,1,down,1979-01-06
10987,Peabo Bryson,1979-06-02,Peabo Bryson - Crosswinds,22,17,45,3.0,31,Crosswinds,22.0,21,-14,-9,-5,1,down,1979-01-06
10988,Peabo Bryson,1979-06-09,Peabo Bryson - Crosswinds,31,22,51,3.0,45,Crosswinds,22.0,22,-6,-14,-9,1,down,1979-01-06
10989,Bonnie Pointer,1979-01-13,Bonnie Pointer - Bonnie Pointer,51,51,34,34.0,42,Bonnie Pointer,5.0,0,8,9,0,1,up,1979-01-13
10990,Bonnie Pointer,1979-01-20,Bonnie Pointer - Bonnie Pointer,42,51,34,34.0,34,Bonnie Pointer,5.0,1,0,8,9,0,stay,1979-01-13
10991,Bonnie Pointer,1979-01-27,Bonnie Pointer - Bonnie Pointer,34,42,38,34.0,34,Bonnie Pointer,5.0,2,-4,0,8,1,down,1979-01-13
10992,Bonnie Pointer,1979-02-03,Bonnie Pointer - Bonnie Pointer,34,34,49,34.0,38,Bonnie Pointer,5.0,3,-11,-4,0,1,down,1979-01-13
10993,Bonnie Pointer,1979-02-10,Bonnie Pointer - Bonnie Pointer,38,34,50,34.0,49,Bonnie Pointer,5.0,4,-1,-11,-4,1,down,1979-01-13
10994,Bonnie Pointer,1979-02-17,Bonnie Pointer - Bonnie Pointer,49,38,51,34.0,50,Bonnie Pointer,5.0,5,-1,-1,-11,1,down,1979-01-13
10995,Al Green,1979-01-13,Al Green - Truth N' Time,51,51,46,44.0,48,Truth N' Time,3.0,0,2,3,0,1,up,1979-01-13
10996,Al Green,1979-01-20,Al Green - Truth N' Time,48,51,44,44.0,46,Truth N' Time,3.0,1,2,2,3,1,up,1979-01-13
10997,Al Green,1979-01-27,Al Green - Truth N' Time,46,48,44,44.0,44,Truth N' Time,3.0,2,0,2,2,0,stay,1979-01-13
10998,Al Green,1979-02-03,Al Green - Truth N' Time,44,46,51,44.0,44,Truth N' Time,3.0,3,-7,0,2,1,down,1979-01-13
10999,Roy Ayers And Wayne Henderson,1979-01-13,Roy Ayers And Wayne Henderson - Step Into Our Life,51,51,47,45.0,49,Step Into Our Life,2.0,0,2,2,0,1,up,1979-01-13
11000,Roy Ayers And Wayne Henderson,1979-01-20,Roy Ayers And Wayne Henderson - Step Into Our Life,49,51,45,45.0,47,Step Into Our Life,2.0,1,2,2,2,1,up,1979-01-13
11001,Roy Ayers And Wayne Henderson,1979-01-27,Roy Ayers And Wayne Henderson - Step Into Our Life,47,49,51,45.0,45,Step Into Our Life,2.0,2,-6,2,2,1,down,1979-01-13
11002,Marvin Gaye,1979-01-20,"Marvin Gaye - Here,my Dear",51,51,9,4.0,12,"Here,my Dear",19.0,0,3,39,0,1,up,1979-01-20
11003,Marvin Gaye,1979-01-27,"Marvin Gaye - Here,my Dear",12,51,8,4.0,9,"Here,my Dear",19.0,1,1,3,39,1,up,1979-01-20
11004,Marvin Gaye,1979-02-03,"Marvin Gaye - Here,my Dear",9,12,4,4.0,8,"Here,my Dear",19.0,2,4,1,3,1,up,1979-01-20
11005,Marvin Gaye,1979-02-10,"Marvin Gaye - Here,my Dear",8,9,4,4.0,4,"Here,my Dear",19.0,3,0,4,1,0,stay,1979-01-20
11006,Marvin Gaye,1979-02-17,"Marvin Gaye - Here,my Dear",4,8,4,4.0,4,"Here,my Dear",19.0,4,0,0,4,0,stay,1979-01-20
11007,Marvin Gaye,1979-02-24,"Marvin Gaye - Here,my Dear",4,4,4,4.0,4,"Here,my Dear",19.0,5,0,0,0,0,stay,1979-01-20
11008,Marvin Gaye,1979-03-03,"Marvin Gaye - Here,my Dear",4,4,6,4.0,4,"Here,my Dear",19.0,6,-2,0,0,1,down,1979-01-20
11009,Marvin Gaye,1979-03-10,"Marvin Gaye - Here,my Dear",4,4,7,4.0,6,"Here,my Dear",19.0,7,-1,-2,0,1,down,1979-01-20
11010,Marvin Gaye,1979-03-17,"Marvin Gaye - Here,my Dear",6,4,8,4.0,7,"Here,my Dear",19.0,8,-1,-1,-2,1,down,1979-01-20
11011,Marvin Gaye,1979-03-24,"Marvin Gaye - Here,my Dear",7,6,12,4.0,8,"Here,my Dear",19.0,9,-4,-1,-1,1,down,1979-01-20
11012,Marvin Gaye,1979-03-31,"Marvin Gaye - Here,my Dear",8,7,10,4.0,12,"Here,my Dear",19.0,10,2,-4,-1,1,up,1979-01-20
11013,Marvin Gaye,1979-04-07,"Marvin Gaye - Here,my Dear",12,8,13,4.0,10,"Here,my Dear",19.0,11,-3,2,-4,1,down,1979-01-20
11014,Marvin Gaye,1979-04-14,"Marvin Gaye - Here,my Dear",10,12,13,4.0,13,"Here,my Dear",19.0,12,0,-3,2,0,stay,1979-01-20
11015,Marvin Gaye,1979-04-21,"Marvin Gaye - Here,my Dear",13,10,16,4.0,13,"Here,my Dear",19.0,13,-3,0,-3,1,down,1979-01-20
11016,Marvin Gaye,1979-04-28,"Marvin Gaye - Here,my Dear",13,13,18,4.0,16,"Here,my Dear",19.0,14,-2,-3,0,1,down,1979-01-20
11017,Marvin Gaye,1979-05-05,"Marvin Gaye - Here,my Dear",16,13,23,4.0,18,"Here,my Dear",19.0,15,-5,-2,-3,1,down,1979-01-20
11018,Marvin Gaye,1979-05-12,"Marvin Gaye - Here,my Dear",18,16,23,4.0,23,"Here,my Dear",19.0,16,0,-5,-2,0,stay,1979-01-20
11019,Marvin Gaye,1979-05-19,"Marvin Gaye - Here,my Dear",23,18,50,4.0,23,"Here,my Dear",19.0,17,-27,0,-5,1,down,1979-01-20
11020,Marvin Gaye,1979-05-26,"Marvin Gaye - Here,my Dear",23,23,48,4.0,50,"Here,my Dear",19.0,18,2,-27,0,1,up,1979-01-20
11021,Marvin Gaye,1979-06-02,"Marvin Gaye - Here,my Dear",50,23,51,4.0,48,"Here,my Dear",19.0,19,-3,2,-27,1,down,1979-01-20
11022,Edwin Starr,1979-01-20,Edwin Starr - Clean,51,51,49,22.0,49,Clean,10.0,0,0,2,0,0,stay,1979-01-20
11023,Edwin Starr,1979-01-27,Edwin Starr - Clean,49,51,39,22.0,49,Clean,10.0,1,10,0,2,1,up,1979-01-20
11024,Edwin Starr,1979-02-03,Edwin Starr - Clean,49,49,29,22.0,39,Clean,10.0,2,10,10,0,1,up,1979-01-20
11025,Edwin Starr,1979-02-10,Edwin Starr - Clean,39,49,22,22.0,29,Clean,10.0,3,7,10,10,1,up,1979-01-20
11026,Edwin Starr,1979-02-17,Edwin Starr - Clean,29,39,22,22.0,22,Clean,10.0,4,0,7,10,0,stay,1979-01-20
11027,Edwin Starr,1979-02-24,Edwin Starr - Clean,22,29,36,22.0,22,Clean,10.0,5,-14,0,7,1,down,1979-01-20
11028,Edwin Starr,1979-03-03,Edwin Starr - Clean,22,22,36,22.0,36,Clean,10.0,6,0,-14,0,0,stay,1979-01-20
11029,Edwin Starr,1979-03-10,Edwin Starr - Clean,36,22,40,22.0,36,Clean,10.0,7,-4,0,-14,1,down,1979-01-20
11030,Edwin Starr,1979-03-17,Edwin Starr - Clean,36,36,41,22.0,40,Clean,10.0,8,-1,-4,0,1,down,1979-01-20
11031,Edwin Starr,1979-03-24,Edwin Starr - Clean,40,36,45,22.0,41,Clean,10.0,9,-4,-1,-4,1,down,1979-01-20
11032,Edwin Starr,1979-03-31,Edwin Starr - Clean,41,40,51,22.0,45,Clean,10.0,10,-6,-4,-1,1,down,1979-01-20
11033,Captain Sky,1979-01-20,Captain Sky - The Adventures Of Captain Sky,51,51,47,30.0,50,The Adventures Of Captain Sky,10.0,0,3,1,0,1,up,1979-01-20
11034,Captain Sky,1979-01-27,Captain Sky - The Adventures Of Captain Sky,50,51,45,30.0,47,The Adventures Of Captain Sky,10.0,1,2,3,1,1,up,1979-01-20
11035,Captain Sky,1979-02-03,Captain Sky - The Adventures Of Captain Sky,47,50,43,30.0,45,The Adventures Of Captain Sky,10.0,2,2,2,3,1,up,1979-01-20
11036,Captain Sky,1979-02-24,Captain Sky - The Adventures Of Captain Sky,45,47,33,30.0,43,The Adventures Of Captain Sky,10.0,3,10,2,2,1,up,1979-01-20
11037,Captain Sky,1979-03-03,Captain Sky - The Adventures Of Captain Sky,43,45,30,30.0,33,The Adventures Of Captain Sky,10.0,4,3,10,2,1,up,1979-01-20
11038,Captain Sky,1979-03-10,Captain Sky - The Adventures Of Captain Sky,33,43,30,30.0,30,The Adventures Of Captain Sky,10.0,5,0,3,10,0,stay,1979-01-20
11039,Captain Sky,1979-03-17,Captain Sky - The Adventures Of Captain Sky,30,33,39,30.0,30,The Adventures Of Captain Sky,10.0,6,-9,0,3,1,down,1979-01-20
11040,Captain Sky,1979-03-24,Captain Sky - The Adventures Of Captain Sky,30,30,42,30.0,39,The Adventures Of Captain Sky,10.0,7,-3,-9,0,1,down,1979-01-20
11041,Captain Sky,1979-03-31,Captain Sky - The Adventures Of Captain Sky,39,30,44,30.0,42,The Adventures Of Captain Sky,10.0,8,-2,-3,-9,1,down,1979-01-20
11042,Captain Sky,1979-04-07,Captain Sky - The Adventures Of Captain Sky,42,39,49,30.0,44,The Adventures Of Captain Sky,10.0,9,-5,-2,-3,1,down,1979-01-20
11043,Captain Sky,1979-08-25,Captain Sky - The Adventures Of Captain Sky,44,42,51,30.0,49,The Adventures Of Captain Sky,10.0,10,-2,-5,-2,1,down,1979-01-20
11044,Hot Chocolate,1979-01-27,Hot Chocolate - Every 1's A Winner,51,51,32,18.0,42,Every 1's A Winner,7.0,0,10,9,0,1,up,1979-01-27
11045,Hot Chocolate,1979-02-03,Hot Chocolate - Every 1's A Winner,42,51,24,18.0,32,Every 1's A Winner,7.0,1,8,10,9,1,up,1979-01-27
11046,Hot Chocolate,1979-02-10,Hot Chocolate - Every 1's A Winner,32,42,18,18.0,24,Every 1's A Winner,7.0,2,6,8,10,1,up,1979-01-27
11047,Hot Chocolate,1979-02-17,Hot Chocolate - Every 1's A Winner,24,32,18,18.0,18,Every 1's A Winner,7.0,3,0,6,8,0,stay,1979-01-27
11048,Hot Chocolate,1979-02-24,Hot Chocolate - Every 1's A Winner,18,24,34,18.0,18,Every 1's A Winner,7.0,4,-16,0,6,1,down,1979-01-27
11049,Hot Chocolate,1979-03-03,Hot Chocolate - Every 1's A Winner,18,18,38,18.0,34,Every 1's A Winner,7.0,5,-4,-16,0,1,down,1979-01-27
11050,Hot Chocolate,1979-03-10,Hot Chocolate - Every 1's A Winner,34,18,49,18.0,38,Every 1's A Winner,7.0,6,-11,-4,-16,1,down,1979-01-27
11051,Hot Chocolate,1979-03-17,Hot Chocolate - Every 1's A Winner,38,34,51,18.0,49,Every 1's A Winner,7.0,7,-2,-11,-4,1,down,1979-01-27
11052,Joe Simon,1979-01-27,Joe Simon - Love Vibration,51,51,36,34.0,46,Love Vibration,3.0,0,10,5,0,1,up,1979-01-27
11053,Joe Simon,1979-02-03,Joe Simon - Love Vibration,46,51,34,34.0,36,Love Vibration,3.0,1,2,10,5,1,up,1979-01-27
11054,Joe Simon,1979-02-10,Joe Simon - Love Vibration,36,46,43,34.0,34,Love Vibration,3.0,2,-9,2,10,1,down,1979-01-27
11055,Joe Simon,1979-02-17,Joe Simon - Love Vibration,34,36,51,34.0,43,Love Vibration,3.0,3,-8,-9,2,1,down,1979-01-27
11056,Gloria Gaynor,1979-02-03,Gloria Gaynor - Love Tracks,51,51,21,4.0,41,Love Tracks,22.0,0,20,10,0,1,up,1979-02-03
11057,Gloria Gaynor,1979-02-10,Gloria Gaynor - Love Tracks,41,51,15,4.0,21,Love Tracks,22.0,1,6,20,10,1,up,1979-02-03
11058,Gloria Gaynor,1979-02-17,Gloria Gaynor - Love Tracks,21,41,11,4.0,15,Love Tracks,22.0,2,4,6,20,1,up,1979-02-03
11059,Gloria Gaynor,1979-02-24,Gloria Gaynor - Love Tracks,15,21,8,4.0,11,Love Tracks,22.0,3,3,4,6,1,up,1979-02-03
11060,Gloria Gaynor,1979-03-03,Gloria Gaynor - Love Tracks,11,15,4,4.0,8,Love Tracks,22.0,4,4,3,4,1,up,1979-02-03
11061,Gloria Gaynor,1979-03-10,Gloria Gaynor - Love Tracks,8,11,4,4.0,4,Love Tracks,22.0,5,0,4,3,0,stay,1979-02-03
11062,Gloria Gaynor,1979-03-17,Gloria Gaynor - Love Tracks,4,8,4,4.0,4,Love Tracks,22.0,6,0,0,4,0,stay,1979-02-03
11063,Gloria Gaynor,1979-03-24,Gloria Gaynor - Love Tracks,4,4,10,4.0,4,Love Tracks,22.0,7,-6,0,0,1,down,1979-02-03
11064,Gloria Gaynor,1979-03-31,Gloria Gaynor - Love Tracks,4,4,11,4.0,10,Love Tracks,22.0,8,-1,-6,0,1,down,1979-02-03
11065,Gloria Gaynor,1979-04-07,Gloria Gaynor - Love Tracks,10,4,11,4.0,11,Love Tracks,22.0,9,0,-1,-6,0,stay,1979-02-03
11066,Gloria Gaynor,1979-04-14,Gloria Gaynor - Love Tracks,11,10,11,4.0,11,Love Tracks,22.0,10,0,0,-1,0,stay,1979-02-03
11067,Gloria Gaynor,1979-04-21,Gloria Gaynor - Love Tracks,11,11,17,4.0,11,Love Tracks,22.0,11,-6,0,0,1,down,1979-02-03
11068,Gloria Gaynor,1979-04-28,Gloria Gaynor - Love Tracks,11,11,31,4.0,17,Love Tracks,22.0,12,-14,-6,0,1,down,1979-02-03
11069,Gloria Gaynor,1979-05-05,Gloria Gaynor - Love Tracks,17,11,31,4.0,31,Love Tracks,22.0,13,0,-14,-6,0,stay,1979-02-03
11070,Gloria Gaynor,1979-05-12,Gloria Gaynor - Love Tracks,31,17,33,4.0,31,Love Tracks,22.0,14,-2,0,-14,1,down,1979-02-03
11071,Gloria Gaynor,1979-05-19,Gloria Gaynor - Love Tracks,31,31,44,4.0,33,Love Tracks,22.0,15,-11,-2,0,1,down,1979-02-03
11072,Gloria Gaynor,1979-05-26,Gloria Gaynor - Love Tracks,33,31,34,4.0,44,Love Tracks,22.0,16,10,-11,-2,1,up,1979-02-03
11073,Gloria Gaynor,1979-06-02,Gloria Gaynor - Love Tracks,44,33,34,4.0,34,Love Tracks,22.0,17,0,10,-11,0,stay,1979-02-03
11074,Gloria Gaynor,1979-06-09,Gloria Gaynor - Love Tracks,34,44,44,4.0,34,Love Tracks,22.0,18,-10,0,10,1,down,1979-02-03
11075,Gloria Gaynor,1979-06-16,Gloria Gaynor - Love Tracks,34,34,44,4.0,44,Love Tracks,22.0,19,0,-10,0,0,stay,1979-02-03
11076,Gloria Gaynor,1979-06-23,Gloria Gaynor - Love Tracks,44,34,46,4.0,44,Love Tracks,22.0,20,-2,0,-10,1,down,1979-02-03
11077,Gloria Gaynor,1979-06-30,Gloria Gaynor - Love Tracks,44,44,49,4.0,46,Love Tracks,22.0,21,-3,-2,0,1,down,1979-02-03
11078,Gloria Gaynor,1979-07-07,Gloria Gaynor - Love Tracks,46,44,51,4.0,49,Love Tracks,22.0,22,-2,-3,-2,1,down,1979-02-03
11079,Bell And James,1979-02-10,Bell And James - Bell + James,51,51,23,17.0,31,Bell + James,14.0,0,8,20,0,1,up,1979-02-10
11080,Bell And James,1979-02-17,Bell And James - Bell + James,31,51,21,17.0,23,Bell + James,14.0,1,2,8,20,1,up,1979-02-10
11081,Bell And James,1979-02-24,Bell And James - Bell + James,23,31,28,17.0,21,Bell + James,14.0,2,-7,2,8,1,down,1979-02-10
11082,Bell And James,1979-03-03,Bell And James - Bell + James,21,23,31,17.0,28,Bell + James,14.0,3,-3,-7,2,1,down,1979-02-10
11083,Bell And James,1979-03-10,Bell And James - Bell + James,28,21,31,17.0,31,Bell + James,14.0,4,0,-3,-7,0,stay,1979-02-10
11084,Bell And James,1979-03-17,Bell And James - Bell + James,31,28,21,17.0,31,Bell + James,14.0,5,10,0,-3,1,up,1979-02-10
11085,Bell And James,1979-03-24,Bell And James - Bell + James,31,31,17,17.0,21,Bell + James,14.0,6,4,10,0,1,up,1979-02-10
11086,Bell And James,1979-03-31,Bell And James - Bell + James,21,31,17,17.0,17,Bell + James,14.0,7,0,4,10,0,stay,1979-02-10
11087,Bell And James,1979-04-07,Bell And James - Bell + James,17,21,18,17.0,17,Bell + James,14.0,8,-1,0,4,1,down,1979-02-10
11088,Bell And James,1979-04-14,Bell And James - Bell + James,17,17,21,17.0,18,Bell + James,14.0,9,-3,-1,0,1,down,1979-02-10
11089,Bell And James,1979-04-21,Bell And James - Bell + James,18,17,23,17.0,21,Bell + James,14.0,10,-2,-3,-1,1,down,1979-02-10
11090,Bell And James,1979-04-28,Bell And James - Bell + James,21,18,32,17.0,23,Bell + James,14.0,11,-9,-2,-3,1,down,1979-02-10
11091,Bell And James,1979-05-05,Bell And James - Bell + James,23,21,32,17.0,32,Bell + James,14.0,12,0,-9,-2,0,stay,1979-02-10
11092,Bell And James,1979-05-12,Bell And James - Bell + James,32,23,44,17.0,32,Bell + James,14.0,13,-12,0,-9,1,down,1979-02-10
11093,Bell And James,1979-05-19,Bell And James - Bell + James,32,32,51,17.0,44,Bell + James,14.0,14,-7,-12,0,1,down,1979-02-10
11094,The Pointer Sisters,1979-02-10,The Pointer Sisters - Energy,51,51,20,9.0,32,Energy,12.0,0,12,19,0,1,up,1979-02-10
11095,The Pointer Sisters,1979-02-17,The Pointer Sisters - Energy,32,51,15,9.0,20,Energy,12.0,1,5,12,19,1,up,1979-02-10
11096,The Pointer Sisters,1979-02-24,The Pointer Sisters - Energy,20,32,10,9.0,15,Energy,12.0,2,5,5,12,1,up,1979-02-10
11097,The Pointer Sisters,1979-03-03,The Pointer Sisters - Energy,15,20,9,9.0,10,Energy,12.0,3,1,5,5,1,up,1979-02-10
11098,The Pointer Sisters,1979-03-10,The Pointer Sisters - Energy,10,15,17,9.0,9,Energy,12.0,4,-8,1,5,1,down,1979-02-10
11099,The Pointer Sisters,1979-03-17,The Pointer Sisters - Energy,9,10,17,9.0,17,Energy,12.0,5,0,-8,1,0,stay,1979-02-10
11100,The Pointer Sisters,1979-03-24,The Pointer Sisters - Energy,17,9,23,9.0,17,Energy,12.0,6,-6,0,-8,1,down,1979-02-10
11101,The Pointer Sisters,1979-03-31,The Pointer Sisters - Energy,17,17,32,9.0,23,Energy,12.0,7,-9,-6,0,1,down,1979-02-10
11102,The Pointer Sisters,1979-04-07,The Pointer Sisters - Energy,23,17,32,9.0,32,Energy,12.0,8,0,-9,-6,0,stay,1979-02-10
11103,The Pointer Sisters,1979-04-14,The Pointer Sisters - Energy,32,23,38,9.0,32,Energy,12.0,9,-6,0,-9,1,down,1979-02-10
11104,The Pointer Sisters,1979-04-21,The Pointer Sisters - Energy,32,32,38,9.0,38,Energy,12.0,10,0,-6,0,0,stay,1979-02-10
11105,The Pointer Sisters,1979-04-28,The Pointer Sisters - Energy,38,32,47,9.0,38,Energy,12.0,11,-9,0,-6,1,down,1979-02-10
11106,The Pointer Sisters,1979-05-05,The Pointer Sisters - Energy,38,38,51,9.0,47,Energy,12.0,12,-4,-9,0,1,down,1979-02-10
11107,Phyllis Hyman,1979-02-10,Phyllis Hyman - Somewhere In My Lifetime,51,51,28,15.0,36,Somewhere In My Lifetime,14.0,0,8,15,0,1,up,1979-02-10
11108,Phyllis Hyman,1979-02-17,Phyllis Hyman - Somewhere In My Lifetime,36,51,23,15.0,28,Somewhere In My Lifetime,14.0,1,5,8,15,1,up,1979-02-10
11109,Phyllis Hyman,1979-02-24,Phyllis Hyman - Somewhere In My Lifetime,28,36,17,15.0,23,Somewhere In My Lifetime,14.0,2,6,5,8,1,up,1979-02-10
11110,Phyllis Hyman,1979-03-03,Phyllis Hyman - Somewhere In My Lifetime,23,28,16,15.0,17,Somewhere In My Lifetime,14.0,3,1,6,5,1,up,1979-02-10
11111,Phyllis Hyman,1979-03-10,Phyllis Hyman - Somewhere In My Lifetime,17,23,15,15.0,16,Somewhere In My Lifetime,14.0,4,1,1,6,1,up,1979-02-10
11112,Phyllis Hyman,1979-03-17,Phyllis Hyman - Somewhere In My Lifetime,16,17,15,15.0,15,Somewhere In My Lifetime,14.0,5,0,1,1,0,stay,1979-02-10
11113,Phyllis Hyman,1979-03-24,Phyllis Hyman - Somewhere In My Lifetime,15,16,15,15.0,15,Somewhere In My Lifetime,14.0,6,0,0,1,0,stay,1979-02-10
11114,Phyllis Hyman,1979-03-31,Phyllis Hyman - Somewhere In My Lifetime,15,15,18,15.0,15,Somewhere In My Lifetime,14.0,7,-3,0,0,1,down,1979-02-10
11115,Phyllis Hyman,1979-04-07,Phyllis Hyman - Somewhere In My Lifetime,15,15,19,15.0,18,Somewhere In My Lifetime,14.0,8,-1,-3,0,1,down,1979-02-10
11116,Phyllis Hyman,1979-04-14,Phyllis Hyman - Somewhere In My Lifetime,18,15,31,15.0,19,Somewhere In My Lifetime,14.0,9,-12,-1,-3,1,down,1979-02-10
11117,Phyllis Hyman,1979-04-21,Phyllis Hyman - Somewhere In My Lifetime,19,18,42,15.0,31,Somewhere In My Lifetime,14.0,10,-11,-12,-1,1,down,1979-02-10
11118,Phyllis Hyman,1979-04-28,Phyllis Hyman - Somewhere In My Lifetime,31,19,42,15.0,42,Somewhere In My Lifetime,14.0,11,0,-11,-12,0,stay,1979-02-10
11119,Phyllis Hyman,1979-05-05,Phyllis Hyman - Somewhere In My Lifetime,42,31,45,15.0,42,Somewhere In My Lifetime,14.0,12,-3,0,-11,1,down,1979-02-10
11120,Phyllis Hyman,1979-05-12,Phyllis Hyman - Somewhere In My Lifetime,42,42,46,15.0,45,Somewhere In My Lifetime,14.0,13,-1,-3,0,1,down,1979-02-10
11121,Phyllis Hyman,1979-05-19,Phyllis Hyman - Somewhere In My Lifetime,45,42,51,15.0,46,Somewhere In My Lifetime,14.0,14,-5,-1,-3,1,down,1979-02-10
11122,Rick James,1979-02-10,Rick James - Bustin' Out Of L.seven,51,51,12,2.0,38,Bustin' Out Of L.seven,29.0,0,26,13,0,1,up,1979-02-10
11123,Rick James,1979-02-17,Rick James - Bustin' Out Of L.seven,38,51,7,2.0,12,Bustin' Out Of L.seven,29.0,1,5,26,13,1,up,1979-02-10
11124,Rick James,1979-02-24,Rick James - Bustin' Out Of L.seven,12,38,3,2.0,7,Bustin' Out Of L.seven,29.0,2,4,5,26,1,up,1979-02-10
11125,Rick James,1979-03-03,Rick James - Bustin' Out Of L.seven,7,12,2,2.0,3,Bustin' Out Of L.seven,29.0,3,1,4,5,1,up,1979-02-10
11126,Rick James,1979-03-10,Rick James - Bustin' Out Of L.seven,3,7,2,2.0,2,Bustin' Out Of L.seven,29.0,4,0,1,4,0,stay,1979-02-10
11127,Rick James,1979-03-17,Rick James - Bustin' Out Of L.seven,2,3,2,2.0,2,Bustin' Out Of L.seven,29.0,5,0,0,1,0,stay,1979-02-10
11128,Rick James,1979-03-24,Rick James - Bustin' Out Of L.seven,2,2,2,2.0,2,Bustin' Out Of L.seven,29.0,6,0,0,0,0,stay,1979-02-10
11129,Rick James,1979-03-31,Rick James - Bustin' Out Of L.seven,2,2,5,2.0,2,Bustin' Out Of L.seven,29.0,7,-3,0,0,1,down,1979-02-10
11130,Rick James,1979-04-07,Rick James - Bustin' Out Of L.seven,2,2,5,2.0,5,Bustin' Out Of L.seven,29.0,8,0,-3,0,0,stay,1979-02-10
11131,Rick James,1979-04-14,Rick James - Bustin' Out Of L.seven,5,2,2,2.0,5,Bustin' Out Of L.seven,29.0,9,3,0,-3,1,up,1979-02-10
11132,Rick James,1979-04-21,Rick James - Bustin' Out Of L.seven,5,5,2,2.0,2,Bustin' Out Of L.seven,29.0,10,0,3,0,0,stay,1979-02-10
11133,Rick James,1979-04-28,Rick James - Bustin' Out Of L.seven,2,5,3,2.0,2,Bustin' Out Of L.seven,29.0,11,-1,0,3,1,down,1979-02-10
11134,Rick James,1979-05-05,Rick James - Bustin' Out Of L.seven,2,2,4,2.0,3,Bustin' Out Of L.seven,29.0,12,-1,-1,0,1,down,1979-02-10
11135,Rick James,1979-05-12,Rick James - Bustin' Out Of L.seven,3,2,4,2.0,4,Bustin' Out Of L.seven,29.0,13,0,-1,-1,0,stay,1979-02-10
11136,Rick James,1979-05-19,Rick James - Bustin' Out Of L.seven,4,3,6,2.0,4,Bustin' Out Of L.seven,29.0,14,-2,0,-1,1,down,1979-02-10
11137,Rick James,1979-05-26,Rick James - Bustin' Out Of L.seven,4,4,7,2.0,6,Bustin' Out Of L.seven,29.0,15,-1,-2,0,1,down,1979-02-10
11138,Rick James,1979-06-02,Rick James - Bustin' Out Of L.seven,6,4,7,2.0,7,Bustin' Out Of L.seven,29.0,16,0,-1,-2,0,stay,1979-02-10
11139,Rick James,1979-06-09,Rick James - Bustin' Out Of L.seven,7,6,7,2.0,7,Bustin' Out Of L.seven,29.0,17,0,0,-1,0,stay,1979-02-10
11140,Rick James,1979-06-16,Rick James - Bustin' Out Of L.seven,7,7,12,2.0,7,Bustin' Out Of L.seven,29.0,18,-5,0,0,1,down,1979-02-10
11141,Rick James,1979-06-23,Rick James - Bustin' Out Of L.seven,7,7,11,2.0,12,Bustin' Out Of L.seven,29.0,19,1,-5,0,1,up,1979-02-10
11142,Rick James,1979-06-30,Rick James - Bustin' Out Of L.seven,12,7,21,2.0,11,Bustin' Out Of L.seven,29.0,20,-10,1,-5,1,down,1979-02-10
11143,Rick James,1979-07-07,Rick James - Bustin' Out Of L.seven,11,12,23,2.0,21,Bustin' Out Of L.seven,29.0,21,-2,-10,1,1,down,1979-02-10
11144,Rick James,1979-07-14,Rick James - Bustin' Out Of L.seven,21,11,23,2.0,23,Bustin' Out Of L.seven,29.0,22,0,-2,-10,0,stay,1979-02-10
11145,Rick James,1979-07-21,Rick James - Bustin' Out Of L.seven,23,21,25,2.0,23,Bustin' Out Of L.seven,29.0,23,-2,0,-2,1,down,1979-02-10
11146,Rick James,1979-07-28,Rick James - Bustin' Out Of L.seven,23,23,33,2.0,25,Bustin' Out Of L.seven,29.0,24,-8,-2,0,1,down,1979-02-10
11147,Rick James,1979-08-04,Rick James - Bustin' Out Of L.seven,25,23,30,2.0,33,Bustin' Out Of L.seven,29.0,25,3,-8,-2,1,up,1979-02-10
11148,Rick James,1979-08-11,Rick James - Bustin' Out Of L.seven,33,25,35,2.0,30,Bustin' Out Of L.seven,29.0,26,-5,3,-8,1,down,1979-02-10
11149,Rick James,1979-08-18,Rick James - Bustin' Out Of L.seven,30,33,39,2.0,35,Bustin' Out Of L.seven,29.0,27,-4,-5,3,1,down,1979-02-10
11150,Rick James,1979-08-25,Rick James - Bustin' Out Of L.seven,35,30,49,2.0,39,Bustin' Out Of L.seven,29.0,28,-10,-4,-5,1,down,1979-02-10
11151,Rick James,1979-09-01,Rick James - Bustin' Out Of L.seven,39,35,51,2.0,49,Bustin' Out Of L.seven,29.0,29,-2,-10,-4,1,down,1979-02-10
11152,Chuck Brown & The Soul Searchers,1979-02-10,Chuck Brown & The Soul Searchers - Bustin' Loose,51,51,25,5.0,39,Bustin' Loose,14.0,0,14,12,0,1,up,1979-02-10
11153,Chuck Brown & The Soul Searchers,1979-02-17,Chuck Brown & The Soul Searchers - Bustin' Loose,39,51,17,5.0,25,Bustin' Loose,14.0,1,8,14,12,1,up,1979-02-10
11154,Chuck Brown & The Soul Searchers,1979-02-24,Chuck Brown & The Soul Searchers - Bustin' Loose,25,39,11,5.0,17,Bustin' Loose,14.0,2,6,8,14,1,up,1979-02-10
11155,Chuck Brown & The Soul Searchers,1979-03-03,Chuck Brown & The Soul Searchers - Bustin' Loose,17,25,10,5.0,11,Bustin' Loose,14.0,3,1,6,8,1,up,1979-02-10
11156,Chuck Brown & The Soul Searchers,1979-03-10,Chuck Brown & The Soul Searchers - Bustin' Loose,11,17,8,5.0,10,Bustin' Loose,14.0,4,2,1,6,1,up,1979-02-10
11157,Chuck Brown & The Soul Searchers,1979-03-17,Chuck Brown & The Soul Searchers - Bustin' Loose,10,11,5,5.0,8,Bustin' Loose,14.0,5,3,2,1,1,up,1979-02-10
11158,Chuck Brown & The Soul Searchers,1979-03-24,Chuck Brown & The Soul Searchers - Bustin' Loose,8,10,5,5.0,5,Bustin' Loose,14.0,6,0,3,2,0,stay,1979-02-10
11159,Chuck Brown & The Soul Searchers,1979-03-31,Chuck Brown & The Soul Searchers - Bustin' Loose,5,8,7,5.0,5,Bustin' Loose,14.0,7,-2,0,3,1,down,1979-02-10
11160,Chuck Brown & The Soul Searchers,1979-04-07,Chuck Brown & The Soul Searchers - Bustin' Loose,5,5,14,5.0,7,Bustin' Loose,14.0,8,-7,-2,0,1,down,1979-02-10
11161,Chuck Brown & The Soul Searchers,1979-04-14,Chuck Brown & The Soul Searchers - Bustin' Loose,7,5,25,5.0,14,Bustin' Loose,14.0,9,-11,-7,-2,1,down,1979-02-10
11162,Chuck Brown & The Soul Searchers,1979-04-21,Chuck Brown & The Soul Searchers - Bustin' Loose,14,7,28,5.0,25,Bustin' Loose,14.0,10,-3,-11,-7,1,down,1979-02-10
11163,Chuck Brown & The Soul Searchers,1979-04-28,Chuck Brown & The Soul Searchers - Bustin' Loose,25,14,29,5.0,28,Bustin' Loose,14.0,11,-1,-3,-11,1,down,1979-02-10
11164,Chuck Brown & The Soul Searchers,1979-05-05,Chuck Brown & The Soul Searchers - Bustin' Loose,28,25,29,5.0,29,Bustin' Loose,14.0,12,0,-1,-3,0,stay,1979-02-10
11165,Chuck Brown & The Soul Searchers,1979-05-12,Chuck Brown & The Soul Searchers - Bustin' Loose,29,28,34,5.0,29,Bustin' Loose,14.0,13,-5,0,-1,1,down,1979-02-10
11166,Chuck Brown & The Soul Searchers,1979-05-19,Chuck Brown & The Soul Searchers - Bustin' Loose,29,29,51,5.0,34,Bustin' Loose,14.0,14,-17,-5,0,1,down,1979-02-10
11167,Tavares,1979-02-10,Tavares - Madame Butterfly,51,51,32,13.0,46,Madame Butterfly,14.0,0,14,5,0,1,up,1979-02-10
11168,Tavares,1979-02-17,Tavares - Madame Butterfly,46,51,24,13.0,32,Madame Butterfly,14.0,1,8,14,5,1,up,1979-02-10
11169,Tavares,1979-02-24,Tavares - Madame Butterfly,32,46,18,13.0,24,Madame Butterfly,14.0,2,6,8,14,1,up,1979-02-10
11170,Tavares,1979-03-03,Tavares - Madame Butterfly,24,32,17,13.0,18,Madame Butterfly,14.0,3,1,6,8,1,up,1979-02-10
11171,Tavares,1979-03-10,Tavares - Madame Butterfly,18,24,13,13.0,17,Madame Butterfly,14.0,4,4,1,6,1,up,1979-02-10
11172,Tavares,1979-03-17,Tavares - Madame Butterfly,17,18,13,13.0,13,Madame Butterfly,14.0,5,0,4,1,0,stay,1979-02-10
11173,Tavares,1979-03-24,Tavares - Madame Butterfly,13,17,14,13.0,13,Madame Butterfly,14.0,6,-1,0,4,1,down,1979-02-10
11174,Tavares,1979-03-31,Tavares - Madame Butterfly,13,13,28,13.0,14,Madame Butterfly,14.0,7,-14,-1,0,1,down,1979-02-10
11175,Tavares,1979-04-07,Tavares - Madame Butterfly,14,13,28,13.0,28,Madame Butterfly,14.0,8,0,-14,-1,0,stay,1979-02-10
11176,Tavares,1979-04-14,Tavares - Madame Butterfly,28,14,43,13.0,28,Madame Butterfly,14.0,9,-15,0,-14,1,down,1979-02-10
11177,Tavares,1979-04-21,Tavares - Madame Butterfly,28,28,46,13.0,43,Madame Butterfly,14.0,10,-3,-15,0,1,down,1979-02-10
11178,Tavares,1979-04-28,Tavares - Madame Butterfly,43,28,46,13.0,46,Madame Butterfly,14.0,11,0,-3,-15,0,stay,1979-02-10
11179,Tavares,1979-05-05,Tavares - Madame Butterfly,46,43,42,13.0,46,Madame Butterfly,14.0,12,4,0,-3,1,up,1979-02-10
11180,Tavares,1979-05-12,Tavares - Madame Butterfly,46,46,49,13.0,42,Madame Butterfly,14.0,13,-7,4,0,1,down,1979-02-10
11181,Tavares,1979-05-19,Tavares - Madame Butterfly,42,46,51,13.0,49,Madame Butterfly,14.0,14,-2,-7,4,1,down,1979-02-10
11182,T-Connection,1979-02-10,T-Connection - T-connection,51,51,37,20.0,47,T-connection,18.0,0,10,4,0,1,up,1979-02-10
11183,T-Connection,1979-02-17,T-Connection - T-connection,47,51,29,20.0,37,T-connection,18.0,1,8,10,4,1,up,1979-02-10
11184,T-Connection,1979-02-24,T-Connection - T-connection,37,47,27,20.0,29,T-connection,18.0,2,2,8,10,1,up,1979-02-10
11185,T-Connection,1979-03-03,T-Connection - T-connection,29,37,22,20.0,27,T-connection,18.0,3,5,2,8,1,up,1979-02-10
11186,T-Connection,1979-03-10,T-Connection - T-connection,27,29,22,20.0,22,T-connection,18.0,4,0,5,2,0,stay,1979-02-10
11187,T-Connection,1979-03-17,T-Connection - T-connection,22,27,28,20.0,22,T-connection,18.0,5,-6,0,5,1,down,1979-02-10
11188,T-Connection,1979-03-24,T-Connection - T-connection,22,22,28,20.0,28,T-connection,18.0,6,0,-6,0,0,stay,1979-02-10
11189,T-Connection,1979-03-31,T-Connection - T-connection,28,22,27,20.0,28,T-connection,18.0,7,1,0,-6,1,up,1979-02-10
11190,T-Connection,1979-04-07,T-Connection - T-connection,28,28,27,20.0,27,T-connection,18.0,8,0,1,0,0,stay,1979-02-10
11191,T-Connection,1979-04-14,T-Connection - T-connection,27,28,20,20.0,27,T-connection,18.0,9,7,0,1,1,up,1979-02-10
11192,T-Connection,1979-04-21,T-Connection - T-connection,27,27,20,20.0,20,T-connection,18.0,10,0,7,0,0,stay,1979-02-10
11193,T-Connection,1979-04-28,T-Connection - T-connection,20,27,26,20.0,20,T-connection,18.0,11,-6,0,7,1,down,1979-02-10
11194,T-Connection,1979-05-05,T-Connection - T-connection,20,20,36,20.0,26,T-connection,18.0,12,-10,-6,0,1,down,1979-02-10
11195,T-Connection,1979-05-12,T-Connection - T-connection,26,20,36,20.0,36,T-connection,18.0,13,0,-10,-6,0,stay,1979-02-10
11196,T-Connection,1979-05-19,T-Connection - T-connection,36,26,42,20.0,36,T-connection,18.0,14,-6,0,-10,1,down,1979-02-10
11197,T-Connection,1979-05-26,T-Connection - T-connection,36,36,42,20.0,42,T-connection,18.0,15,0,-6,0,0,stay,1979-02-10
11198,T-Connection,1979-06-02,T-Connection - T-connection,42,36,49,20.0,42,T-connection,18.0,16,-7,0,-6,1,down,1979-02-10
11199,T-Connection,1979-06-09,T-Connection - T-connection,42,42,50,20.0,49,T-connection,18.0,17,-1,-7,0,1,down,1979-02-10
11200,T-Connection,1979-06-16,T-Connection - T-connection,49,42,51,20.0,50,T-connection,18.0,18,-1,-1,-7,1,down,1979-02-10
11201,Grey And Hanks,1979-02-10,Grey And Hanks - You Fooled Me,51,51,34,20.0,48,You Fooled Me,8.0,0,14,3,0,1,up,1979-02-10
11202,Grey And Hanks,1979-02-17,Grey And Hanks - You Fooled Me,48,51,26,20.0,34,You Fooled Me,8.0,1,8,14,3,1,up,1979-02-10
11203,Grey And Hanks,1979-02-24,Grey And Hanks - You Fooled Me,34,48,20,20.0,26,You Fooled Me,8.0,2,6,8,14,1,up,1979-02-10
11204,Grey And Hanks,1979-03-03,Grey And Hanks - You Fooled Me,26,34,20,20.0,20,You Fooled Me,8.0,3,0,6,8,0,stay,1979-02-10
11205,Grey And Hanks,1979-03-10,Grey And Hanks - You Fooled Me,20,26,24,20.0,20,You Fooled Me,8.0,4,-4,0,6,1,down,1979-02-10
11206,Grey And Hanks,1979-03-17,Grey And Hanks - You Fooled Me,20,20,29,20.0,24,You Fooled Me,8.0,5,-5,-4,0,1,down,1979-02-10
11207,Grey And Hanks,1979-03-24,Grey And Hanks - You Fooled Me,24,20,32,20.0,29,You Fooled Me,8.0,6,-3,-5,-4,1,down,1979-02-10
11208,Grey And Hanks,1979-03-31,Grey And Hanks - You Fooled Me,29,24,41,20.0,32,You Fooled Me,8.0,7,-9,-3,-5,1,down,1979-02-10
11209,Grey And Hanks,1979-04-07,Grey And Hanks - You Fooled Me,32,29,51,20.0,41,You Fooled Me,8.0,8,-10,-9,-3,1,down,1979-02-10
11210,Rufus,1979-02-17,Rufus - Numbers,51,51,20,15.0,27,Numbers,5.0,0,7,24,0,1,up,1979-02-17
11211,Rufus,1979-02-24,Rufus - Numbers,27,51,16,15.0,20,Numbers,5.0,1,4,7,24,1,up,1979-02-17
11212,Rufus,1979-03-03,Rufus - Numbers,20,27,15,15.0,16,Numbers,5.0,2,1,4,7,1,up,1979-02-17
11213,Rufus,1979-03-10,Rufus - Numbers,16,20,19,15.0,15,Numbers,5.0,3,-4,1,4,1,down,1979-02-17
11214,Rufus,1979-03-17,Rufus - Numbers,15,16,30,15.0,19,Numbers,5.0,4,-11,-4,1,1,down,1979-02-17
11215,Rufus,1979-03-24,Rufus - Numbers,19,15,51,15.0,30,Numbers,5.0,5,-21,-11,-4,1,down,1979-02-17
11216,Instant Funk,1979-02-17,Instant Funk - Instank Funk,51,51,38,1.0,48,Instank Funk,20.0,0,10,3,0,1,up,1979-02-17
11217,Instant Funk,1979-02-24,Instant Funk - Instank Funk,48,51,23,1.0,38,Instank Funk,20.0,1,15,10,3,1,up,1979-02-17
11218,Instant Funk,1979-03-03,Instant Funk - Instank Funk,38,48,18,1.0,23,Instank Funk,20.0,2,5,15,10,1,up,1979-02-17
11219,Instant Funk,1979-03-10,Instant Funk - Instank Funk,23,38,9,1.0,18,Instank Funk,20.0,3,9,5,15,1,up,1979-02-17
11220,Instant Funk,1979-03-17,Instant Funk - Instank Funk,18,23,7,1.0,9,Instank Funk,20.0,4,2,9,5,1,up,1979-02-17
11221,Instant Funk,1979-03-24,Instant Funk - Instank Funk,9,18,1,1.0,7,Instank Funk,20.0,5,6,2,9,1,up,1979-02-17
11222,Instant Funk,1979-03-31,Instant Funk - Instank Funk,7,9,2,1.0,1,Instank Funk,20.0,6,-1,6,2,1,down,1979-02-17
11223,Instant Funk,1979-04-07,Instant Funk - Instank Funk,1,7,2,1.0,2,Instank Funk,20.0,7,0,-1,6,0,stay,1979-02-17
11224,Instant Funk,1979-04-14,Instant Funk - Instank Funk,2,1,7,1.0,2,Instank Funk,20.0,8,-5,0,-1,1,down,1979-02-17
11225,Instant Funk,1979-04-21,Instant Funk - Instank Funk,2,2,7,1.0,7,Instank Funk,20.0,9,0,-5,0,0,stay,1979-02-17
11226,Instant Funk,1979-04-28,Instant Funk - Instank Funk,7,2,8,1.0,7,Instank Funk,20.0,10,-1,0,-5,1,down,1979-02-17
11227,Instant Funk,1979-05-05,Instant Funk - Instank Funk,7,7,10,1.0,8,Instank Funk,20.0,11,-2,-1,0,1,down,1979-02-17
11228,Instant Funk,1979-05-12,Instant Funk - Instank Funk,8,7,10,1.0,10,Instank Funk,20.0,12,0,-2,-1,0,stay,1979-02-17
11229,Instant Funk,1979-05-19,Instant Funk - Instank Funk,10,8,13,1.0,10,Instank Funk,20.0,13,-3,0,-2,1,down,1979-02-17
11230,Instant Funk,1979-05-26,Instant Funk - Instank Funk,10,10,16,1.0,13,Instank Funk,20.0,14,-3,-3,0,1,down,1979-02-17
11231,Instant Funk,1979-06-02,Instant Funk - Instank Funk,13,10,19,1.0,16,Instank Funk,20.0,15,-3,-3,-3,1,down,1979-02-17
11232,Instant Funk,1979-06-09,Instant Funk - Instank Funk,16,13,39,1.0,19,Instank Funk,20.0,16,-20,-3,-3,1,down,1979-02-17
11233,Instant Funk,1979-06-16,Instant Funk - Instank Funk,19,16,41,1.0,39,Instank Funk,20.0,17,-2,-20,-3,1,down,1979-02-17
11234,Instant Funk,1979-06-23,Instant Funk - Instank Funk,39,19,44,1.0,41,Instank Funk,20.0,18,-3,-2,-20,1,down,1979-02-17
11235,Instant Funk,1979-06-30,Instant Funk - Instank Funk,41,39,48,1.0,44,Instank Funk,20.0,19,-4,-3,-2,1,down,1979-02-17
11236,Instant Funk,1979-07-07,Instant Funk - Instank Funk,44,41,51,1.0,48,Instank Funk,20.0,20,-3,-4,-3,1,down,1979-02-17
11237,Joe Sample,1979-02-17,Joe Sample - Carmel,51,51,39,25.0,49,Carmel,7.0,0,10,2,0,1,up,1979-02-17
11238,Joe Sample,1979-02-24,Joe Sample - Carmel,49,51,31,25.0,39,Carmel,7.0,1,8,10,2,1,up,1979-02-17
11239,Joe Sample,1979-03-03,Joe Sample - Carmel,39,49,25,25.0,31,Carmel,7.0,2,6,8,10,1,up,1979-02-17
11240,Joe Sample,1979-03-10,Joe Sample - Carmel,31,39,25,25.0,25,Carmel,7.0,3,0,6,8,0,stay,1979-02-17
11241,Joe Sample,1979-03-17,Joe Sample - Carmel,25,31,34,25.0,25,Carmel,7.0,4,-9,0,6,1,down,1979-02-17
11242,Joe Sample,1979-03-24,Joe Sample - Carmel,25,25,40,25.0,34,Carmel,7.0,5,-6,-9,0,1,down,1979-02-17
11243,Joe Sample,1979-03-31,Joe Sample - Carmel,34,25,39,25.0,40,Carmel,7.0,6,1,-6,-9,1,up,1979-02-17
11244,Joe Sample,1979-04-07,Joe Sample - Carmel,40,34,51,25.0,39,Carmel,7.0,7,-12,1,-6,1,down,1979-02-17
11245,Bee Gees,1979-02-24,Bee Gees - Spirits Having Flown,51,51,22,9.0,32,Spirits Having Flown,18.0,0,10,19,0,1,up,1979-02-24
11246,Bee Gees,1979-03-03,Bee Gees - Spirits Having Flown,32,51,11,9.0,22,Spirits Having Flown,18.0,1,11,10,19,1,up,1979-02-24
11247,Bee Gees,1979-03-10,Bee Gees - Spirits Having Flown,22,32,10,9.0,11,Spirits Having Flown,18.0,2,1,11,10,1,up,1979-02-24
11248,Bee Gees,1979-03-17,Bee Gees - Spirits Having Flown,11,22,9,9.0,10,Spirits Having Flown,18.0,3,1,1,11,1,up,1979-02-24
11249,Bee Gees,1979-03-24,Bee Gees - Spirits Having Flown,10,11,9,9.0,9,Spirits Having Flown,18.0,4,0,1,1,0,stay,1979-02-24
11250,Bee Gees,1979-03-31,Bee Gees - Spirits Having Flown,9,10,12,9.0,9,Spirits Having Flown,18.0,5,-3,0,1,1,down,1979-02-24
11251,Bee Gees,1979-04-07,Bee Gees - Spirits Having Flown,9,9,15,9.0,12,Spirits Having Flown,18.0,6,-3,-3,0,1,down,1979-02-24
11252,Bee Gees,1979-04-14,Bee Gees - Spirits Having Flown,12,9,23,9.0,15,Spirits Having Flown,18.0,7,-8,-3,-3,1,down,1979-02-24
11253,Bee Gees,1979-04-21,Bee Gees - Spirits Having Flown,15,12,33,9.0,23,Spirits Having Flown,18.0,8,-10,-8,-3,1,down,1979-02-24
11254,Bee Gees,1979-04-28,Bee Gees - Spirits Having Flown,23,15,37,9.0,33,Spirits Having Flown,18.0,9,-4,-10,-8,1,down,1979-02-24
11255,Bee Gees,1979-05-05,Bee Gees - Spirits Having Flown,33,23,37,9.0,37,Spirits Having Flown,18.0,10,0,-4,-10,0,stay,1979-02-24
11256,Bee Gees,1979-05-12,Bee Gees - Spirits Having Flown,37,33,37,9.0,37,Spirits Having Flown,18.0,11,0,0,-4,0,stay,1979-02-24
11257,Bee Gees,1979-05-19,Bee Gees - Spirits Having Flown,37,37,40,9.0,37,Spirits Having Flown,18.0,12,-3,0,0,1,down,1979-02-24
11258,Bee Gees,1979-05-26,Bee Gees - Spirits Having Flown,37,37,40,9.0,40,Spirits Having Flown,18.0,13,0,-3,0,0,stay,1979-02-24
11259,Bee Gees,1979-06-02,Bee Gees - Spirits Having Flown,40,37,40,9.0,40,Spirits Having Flown,18.0,14,0,0,-3,0,stay,1979-02-24
11260,Bee Gees,1979-06-09,Bee Gees - Spirits Having Flown,40,40,43,9.0,40,Spirits Having Flown,18.0,15,-3,0,0,1,down,1979-02-24
11261,Bee Gees,1979-06-16,Bee Gees - Spirits Having Flown,40,40,50,9.0,43,Spirits Having Flown,18.0,16,-7,-3,0,1,down,1979-02-24
11262,Bee Gees,1979-06-23,Bee Gees - Spirits Having Flown,43,40,50,9.0,50,Spirits Having Flown,18.0,17,0,-7,-3,0,stay,1979-02-24
11263,Bee Gees,1979-06-30,Bee Gees - Spirits Having Flown,50,43,51,9.0,50,Spirits Having Flown,18.0,18,-1,0,-7,1,down,1979-02-24
11264,Angela Bofill,1979-02-24,Angela Bofill - Angie,51,51,25,20.0,35,Angie,16.0,0,10,16,0,1,up,1979-02-24
11265,Angela Bofill,1979-03-03,Angela Bofill - Angie,35,51,23,20.0,25,Angie,16.0,1,2,10,16,1,up,1979-02-24
11266,Angela Bofill,1979-03-10,Angela Bofill - Angie,25,35,20,20.0,23,Angie,16.0,2,3,2,10,1,up,1979-02-24
11267,Angela Bofill,1979-03-17,Angela Bofill - Angie,23,25,20,20.0,20,Angie,16.0,3,0,3,2,0,stay,1979-02-24
11268,Angela Bofill,1979-03-24,Angela Bofill - Angie,20,23,22,20.0,20,Angie,16.0,4,-2,0,3,1,down,1979-02-24
11269,Angela Bofill,1979-03-31,Angela Bofill - Angie,20,20,22,20.0,22,Angie,16.0,5,0,-2,0,0,stay,1979-02-24
11270,Angela Bofill,1979-04-07,Angela Bofill - Angie,22,20,23,20.0,22,Angie,16.0,6,-1,0,-2,1,down,1979-02-24
11271,Angela Bofill,1979-04-14,Angela Bofill - Angie,22,22,26,20.0,23,Angie,16.0,7,-3,-1,0,1,down,1979-02-24
11272,Angela Bofill,1979-04-21,Angela Bofill - Angie,23,22,29,20.0,26,Angie,16.0,8,-3,-3,-1,1,down,1979-02-24
11273,Angela Bofill,1979-04-28,Angela Bofill - Angie,26,23,28,20.0,29,Angie,16.0,9,1,-3,-3,1,up,1979-02-24
11274,Angela Bofill,1979-05-05,Angela Bofill - Angie,29,26,38,20.0,28,Angie,16.0,10,-10,1,-3,1,down,1979-02-24
11275,Angela Bofill,1979-05-12,Angela Bofill - Angie,28,29,38,20.0,38,Angie,16.0,11,0,-10,1,0,stay,1979-02-24
11276,Angela Bofill,1979-05-19,Angela Bofill - Angie,38,28,37,20.0,38,Angie,16.0,12,1,0,-10,1,up,1979-02-24
11277,Angela Bofill,1979-05-26,Angela Bofill - Angie,38,38,41,20.0,37,Angie,16.0,13,-4,1,0,1,down,1979-02-24
11278,Angela Bofill,1979-06-02,Angela Bofill - Angie,37,38,46,20.0,41,Angie,16.0,14,-5,-4,1,1,down,1979-02-24
11279,Angela Bofill,1979-06-09,Angela Bofill - Angie,41,37,46,20.0,46,Angie,16.0,15,0,-5,-4,0,stay,1979-02-24
11280,Angela Bofill,1979-06-16,Angela Bofill - Angie,46,41,51,20.0,46,Angie,16.0,16,-5,0,-5,1,down,1979-02-24
11281,Patrice Rushen,1979-02-24,Patrice Rushen - Patrice,51,51,29,27.0,42,Patrice,5.0,0,13,9,0,1,up,1979-02-24
11282,Patrice Rushen,1979-03-03,Patrice Rushen - Patrice,42,51,29,27.0,29,Patrice,5.0,1,0,13,9,0,stay,1979-02-24
11283,Patrice Rushen,1979-03-10,Patrice Rushen - Patrice,29,42,27,27.0,29,Patrice,5.0,2,2,0,13,1,up,1979-02-24
11284,Patrice Rushen,1979-03-17,Patrice Rushen - Patrice,29,29,47,27.0,27,Patrice,5.0,3,-20,2,0,1,down,1979-02-24
11285,Patrice Rushen,1979-03-24,Patrice Rushen - Patrice,27,29,47,27.0,47,Patrice,5.0,4,0,-20,2,0,stay,1979-02-24
11286,Patrice Rushen,1979-03-31,Patrice Rushen - Patrice,47,27,51,27.0,47,Patrice,5.0,5,-4,0,-20,1,down,1979-02-24
11287,Hamilton Bohannon,1979-02-24,Hamilton Bohannon - Cut Loose,51,51,40,34.0,50,Cut Loose,7.0,0,10,1,0,1,up,1979-02-24
11288,Hamilton Bohannon,1979-03-03,Hamilton Bohannon - Cut Loose,50,51,37,34.0,40,Cut Loose,7.0,1,3,10,1,1,up,1979-02-24
11289,Hamilton Bohannon,1979-03-10,Hamilton Bohannon - Cut Loose,40,50,35,34.0,37,Cut Loose,7.0,2,2,3,10,1,up,1979-02-24
11290,Hamilton Bohannon,1979-03-17,Hamilton Bohannon - Cut Loose,37,40,35,34.0,35,Cut Loose,7.0,3,0,2,3,0,stay,1979-02-24
11291,Hamilton Bohannon,1979-03-24,Hamilton Bohannon - Cut Loose,35,37,35,34.0,35,Cut Loose,7.0,4,0,0,2,0,stay,1979-02-24
11292,Hamilton Bohannon,1979-03-31,Hamilton Bohannon - Cut Loose,35,35,34,34.0,35,Cut Loose,7.0,5,1,0,0,1,up,1979-02-24
11293,Hamilton Bohannon,1979-04-07,Hamilton Bohannon - Cut Loose,35,35,38,34.0,34,Cut Loose,7.0,6,-4,1,0,1,down,1979-02-24
11294,Hamilton Bohannon,1979-04-14,Hamilton Bohannon - Cut Loose,34,35,51,34.0,38,Cut Loose,7.0,7,-13,-4,1,1,down,1979-02-24
11295,Sister Sledge,1979-03-03,Sister Sledge - We Are Family,51,51,26,1.0,37,We Are Family,30.0,0,11,14,0,1,up,1979-03-03
11296,Sister Sledge,1979-03-10,Sister Sledge - We Are Family,37,51,14,1.0,26,We Are Family,30.0,1,12,11,14,1,up,1979-03-03
11297,Sister Sledge,1979-03-17,Sister Sledge - We Are Family,26,37,10,1.0,14,We Are Family,30.0,2,4,12,11,1,up,1979-03-03
11298,Sister Sledge,1979-03-24,Sister Sledge - We Are Family,14,26,6,1.0,10,We Are Family,30.0,3,4,4,12,1,up,1979-03-03
11299,Sister Sledge,1979-03-31,Sister Sledge - We Are Family,10,14,1,1.0,6,We Are Family,30.0,4,5,4,4,1,up,1979-03-03
11300,Sister Sledge,1979-04-07,Sister Sledge - We Are Family,6,10,3,1.0,1,We Are Family,30.0,5,-2,5,4,1,down,1979-03-03
11301,Sister Sledge,1979-04-14,Sister Sledge - We Are Family,1,6,3,1.0,3,We Are Family,30.0,6,0,-2,5,0,stay,1979-03-03
11302,Sister Sledge,1979-04-21,Sister Sledge - We Are Family,3,1,5,1.0,3,We Are Family,30.0,7,-2,0,-2,1,down,1979-03-03
11303,Sister Sledge,1979-04-28,Sister Sledge - We Are Family,3,3,5,1.0,5,We Are Family,30.0,8,0,-2,0,0,stay,1979-03-03
11304,Sister Sledge,1979-05-05,Sister Sledge - We Are Family,5,3,1,1.0,5,We Are Family,30.0,9,4,0,-2,1,up,1979-03-03
11305,Sister Sledge,1979-05-12,Sister Sledge - We Are Family,5,5,1,1.0,1,We Are Family,30.0,10,0,4,0,0,stay,1979-03-03
11306,Sister Sledge,1979-05-19,Sister Sledge - We Are Family,1,5,1,1.0,1,We Are Family,30.0,11,0,0,4,0,stay,1979-03-03
11307,Sister Sledge,1979-05-26,Sister Sledge - We Are Family,1,1,1,1.0,1,We Are Family,30.0,12,0,0,0,0,stay,1979-03-03
11308,Sister Sledge,1979-06-02,Sister Sledge - We Are Family,1,1,1,1.0,1,We Are Family,30.0,13,0,0,0,0,stay,1979-03-03
11309,Sister Sledge,1979-06-09,Sister Sledge - We Are Family,1,1,1,1.0,1,We Are Family,30.0,14,0,0,0,0,stay,1979-03-03
11310,Sister Sledge,1979-06-16,Sister Sledge - We Are Family,1,1,2,1.0,1,We Are Family,30.0,15,-1,0,0,1,down,1979-03-03
11311,Sister Sledge,1979-06-23,Sister Sledge - We Are Family,1,1,3,1.0,2,We Are Family,30.0,16,-1,-1,0,1,down,1979-03-03
11312,Sister Sledge,1979-06-30,Sister Sledge - We Are Family,2,1,6,1.0,3,We Are Family,30.0,17,-3,-1,-1,1,down,1979-03-03
11313,Sister Sledge,1979-07-07,Sister Sledge - We Are Family,3,2,6,1.0,6,We Are Family,30.0,18,0,-3,-1,0,stay,1979-03-03
11314,Sister Sledge,1979-07-14,Sister Sledge - We Are Family,6,3,12,1.0,6,We Are Family,30.0,19,-6,0,-3,1,down,1979-03-03
11315,Sister Sledge,1979-07-21,Sister Sledge - We Are Family,6,6,15,1.0,12,We Are Family,30.0,20,-3,-6,0,1,down,1979-03-03
11316,Sister Sledge,1979-07-28,Sister Sledge - We Are Family,12,6,15,1.0,15,We Are Family,30.0,21,0,-3,-6,0,stay,1979-03-03
11317,Sister Sledge,1979-08-04,Sister Sledge - We Are Family,15,12,26,1.0,15,We Are Family,30.0,22,-11,0,-3,1,down,1979-03-03
11318,Sister Sledge,1979-08-11,Sister Sledge - We Are Family,15,15,31,1.0,26,We Are Family,30.0,23,-5,-11,0,1,down,1979-03-03
11319,Sister Sledge,1979-08-18,Sister Sledge - We Are Family,26,15,36,1.0,31,We Are Family,30.0,24,-5,-5,-11,1,down,1979-03-03
11320,Sister Sledge,1979-08-25,Sister Sledge - We Are Family,31,26,35,1.0,36,We Are Family,30.0,25,1,-5,-5,1,up,1979-03-03
11321,Sister Sledge,1979-09-01,Sister Sledge - We Are Family,36,31,39,1.0,35,We Are Family,30.0,26,-4,1,-5,1,down,1979-03-03
11322,Sister Sledge,1979-09-08,Sister Sledge - We Are Family,35,36,44,1.0,39,We Are Family,30.0,27,-5,-4,1,1,down,1979-03-03
11323,Sister Sledge,1979-09-15,Sister Sledge - We Are Family,39,35,44,1.0,44,We Are Family,30.0,28,0,-5,-4,0,stay,1979-03-03
11324,Sister Sledge,1979-09-22,Sister Sledge - We Are Family,44,39,46,1.0,44,We Are Family,30.0,29,-2,0,-5,1,down,1979-03-03
11325,Sister Sledge,1979-09-29,Sister Sledge - We Are Family,44,44,51,1.0,46,We Are Family,30.0,30,-5,-2,0,1,down,1979-03-03
11326,Delegation,1979-03-03,Delegation - Promise Of Love,51,51,39,8.0,49,Promise Of Love,11.0,0,10,2,0,1,up,1979-03-03
11327,Delegation,1979-03-10,Delegation - Promise Of Love,49,51,29,8.0,39,Promise Of Love,11.0,1,10,10,2,1,up,1979-03-03
11328,Delegation,1979-03-17,Delegation - Promise Of Love,39,49,23,8.0,29,Promise Of Love,11.0,2,6,10,10,1,up,1979-03-03
11329,Delegation,1979-03-24,Delegation - Promise Of Love,29,39,18,8.0,23,Promise Of Love,11.0,3,5,6,10,1,up,1979-03-03
11330,Delegation,1979-03-31,Delegation - Promise Of Love,23,29,13,8.0,18,Promise Of Love,11.0,4,5,5,6,1,up,1979-03-03
11331,Delegation,1979-04-07,Delegation - Promise Of Love,18,23,10,8.0,13,Promise Of Love,11.0,5,3,5,5,1,up,1979-03-03
11332,Delegation,1979-04-14,Delegation - Promise Of Love,13,18,8,8.0,10,Promise Of Love,11.0,6,2,3,5,1,up,1979-03-03
11333,Delegation,1979-04-21,Delegation - Promise Of Love,10,13,8,8.0,8,Promise Of Love,11.0,7,0,2,3,0,stay,1979-03-03
11334,Delegation,1979-04-28,Delegation - Promise Of Love,8,10,23,8.0,8,Promise Of Love,11.0,8,-15,0,2,1,down,1979-03-03
11335,Delegation,1979-05-05,Delegation - Promise Of Love,8,8,27,8.0,23,Promise Of Love,11.0,9,-4,-15,0,1,down,1979-03-03
11336,Delegation,1979-05-12,Delegation - Promise Of Love,23,8,27,8.0,27,Promise Of Love,11.0,10,0,-4,-15,0,stay,1979-03-03
11337,Delegation,1979-05-19,Delegation - Promise Of Love,27,23,51,8.0,27,Promise Of Love,11.0,11,-24,0,-4,1,down,1979-03-03
11338,Breakwater,1979-03-03,Breakwater - Breakwater,51,51,40,36.0,50,Breakwater,7.0,0,10,1,0,1,up,1979-03-03
11339,Breakwater,1979-03-10,Breakwater - Breakwater,50,51,36,36.0,40,Breakwater,7.0,1,4,10,1,1,up,1979-03-03
11340,Breakwater,1979-03-17,Breakwater - Breakwater,40,50,36,36.0,36,Breakwater,7.0,2,0,4,10,0,stay,1979-03-03
11341,Breakwater,1979-03-24,Breakwater - Breakwater,36,40,39,36.0,36,Breakwater,7.0,3,-3,0,4,1,down,1979-03-03
11342,Breakwater,1979-03-31,Breakwater - Breakwater,36,36,36,36.0,39,Breakwater,7.0,4,3,-3,0,1,up,1979-03-03
11343,Breakwater,1979-04-07,Breakwater - Breakwater,39,36,41,36.0,36,Breakwater,7.0,5,-5,3,-3,1,down,1979-03-03
11344,Breakwater,1979-04-14,Breakwater - Breakwater,36,39,41,36.0,41,Breakwater,7.0,6,0,-5,3,0,stay,1979-03-03
11345,Breakwater,1979-04-21,Breakwater - Breakwater,41,36,51,36.0,41,Breakwater,7.0,7,-10,0,-5,1,down,1979-03-03
11346,Lonnie Liston Smith,1979-03-10,Lonnie Liston Smith - Exotic Mysteries,51,51,50,50.0,50,Exotic Mysteries,1.0,0,0,1,0,0,stay,1979-03-10
11347,Lonnie Liston Smith,1979-03-17,Lonnie Liston Smith - Exotic Mysteries,50,51,51,50.0,50,Exotic Mysteries,1.0,1,-1,0,1,1,down,1979-03-10
11348,Amii Stewart,1979-03-17,Amii Stewart - Knock On Wood,51,51,25,9.0,37,Knock On Wood,16.0,0,12,14,0,1,up,1979-03-17
11349,Amii Stewart,1979-03-24,Amii Stewart - Knock On Wood,37,51,13,9.0,25,Knock On Wood,16.0,1,12,12,14,1,up,1979-03-17
11350,Amii Stewart,1979-03-31,Amii Stewart - Knock On Wood,25,37,9,9.0,13,Knock On Wood,16.0,2,4,12,12,1,up,1979-03-17
11351,Amii Stewart,1979-04-07,Amii Stewart - Knock On Wood,13,25,9,9.0,9,Knock On Wood,16.0,3,0,4,12,0,stay,1979-03-17
11352,Amii Stewart,1979-04-14,Amii Stewart - Knock On Wood,9,13,9,9.0,9,Knock On Wood,16.0,4,0,0,4,0,stay,1979-03-17
11353,Amii Stewart,1979-04-21,Amii Stewart - Knock On Wood,9,9,9,9.0,9,Knock On Wood,16.0,5,0,0,0,0,stay,1979-03-17
11354,Amii Stewart,1979-04-28,Amii Stewart - Knock On Wood,9,9,10,9.0,9,Knock On Wood,16.0,6,-1,0,0,1,down,1979-03-17
11355,Amii Stewart,1979-05-05,Amii Stewart - Knock On Wood,9,9,24,9.0,10,Knock On Wood,16.0,7,-14,-1,0,1,down,1979-03-17
11356,Amii Stewart,1979-05-12,Amii Stewart - Knock On Wood,10,9,18,9.0,24,Knock On Wood,16.0,8,6,-14,-1,1,up,1979-03-17
11357,Amii Stewart,1979-05-19,Amii Stewart - Knock On Wood,24,10,18,9.0,18,Knock On Wood,16.0,9,0,6,-14,0,stay,1979-03-17
11358,Amii Stewart,1979-05-26,Amii Stewart - Knock On Wood,18,24,28,9.0,18,Knock On Wood,16.0,10,-10,0,6,1,down,1979-03-17
11359,Amii Stewart,1979-06-02,Amii Stewart - Knock On Wood,18,18,35,9.0,28,Knock On Wood,16.0,11,-7,-10,0,1,down,1979-03-17
11360,Amii Stewart,1979-06-09,Amii Stewart - Knock On Wood,28,18,35,9.0,35,Knock On Wood,16.0,12,0,-7,-10,0,stay,1979-03-17
11361,Amii Stewart,1979-06-16,Amii Stewart - Knock On Wood,35,28,39,9.0,35,Knock On Wood,16.0,13,-4,0,-7,1,down,1979-03-17
11362,Amii Stewart,1979-06-23,Amii Stewart - Knock On Wood,35,35,39,9.0,39,Knock On Wood,16.0,14,0,-4,0,0,stay,1979-03-17
11363,Amii Stewart,1979-06-30,Amii Stewart - Knock On Wood,39,35,43,9.0,39,Knock On Wood,16.0,15,-4,0,-4,1,down,1979-03-17
11364,Amii Stewart,1979-07-07,Amii Stewart - Knock On Wood,39,39,51,9.0,43,Knock On Wood,16.0,16,-8,-4,0,1,down,1979-03-17
11365,George Duke,1979-03-17,George Duke - Follow The Rainbow,51,51,31,17.0,39,Follow The Rainbow,9.0,0,8,12,0,1,up,1979-03-17
11366,George Duke,1979-03-24,George Duke - Follow The Rainbow,39,51,24,17.0,31,Follow The Rainbow,9.0,1,7,8,12,1,up,1979-03-17
11367,George Duke,1979-03-31,George Duke - Follow The Rainbow,31,39,23,17.0,24,Follow The Rainbow,9.0,2,1,7,8,1,up,1979-03-17
11368,George Duke,1979-04-07,George Duke - Follow The Rainbow,24,31,17,17.0,23,Follow The Rainbow,9.0,3,6,1,7,1,up,1979-03-17
11369,George Duke,1979-04-14,George Duke - Follow The Rainbow,23,24,17,17.0,17,Follow The Rainbow,9.0,4,0,6,1,0,stay,1979-03-17
11370,George Duke,1979-04-21,George Duke - Follow The Rainbow,17,23,41,17.0,17,Follow The Rainbow,9.0,5,-24,0,6,1,down,1979-03-17
11371,George Duke,1979-04-28,George Duke - Follow The Rainbow,17,17,43,17.0,41,Follow The Rainbow,9.0,6,-2,-24,0,1,down,1979-03-17
11372,George Duke,1979-05-05,George Duke - Follow The Rainbow,41,17,43,17.0,43,Follow The Rainbow,9.0,7,0,-2,-24,0,stay,1979-03-17
11373,George Duke,1979-05-12,George Duke - Follow The Rainbow,43,41,43,17.0,43,Follow The Rainbow,9.0,8,0,0,-2,0,stay,1979-03-17
11374,George Duke,1979-05-19,George Duke - Follow The Rainbow,43,43,51,17.0,43,Follow The Rainbow,9.0,9,-8,0,0,1,down,1979-03-17
11375,Herbie Mann,1979-03-17,Herbie Mann - Super Mann,51,51,42,38.0,42,Super Mann,3.0,0,0,9,0,0,stay,1979-03-17
11376,Herbie Mann,1979-03-24,Herbie Mann - Super Mann,42,51,38,38.0,42,Super Mann,3.0,1,4,0,9,1,up,1979-03-17
11377,Herbie Mann,1979-03-31,Herbie Mann - Super Mann,42,42,38,38.0,38,Super Mann,3.0,2,0,4,0,0,stay,1979-03-17
11378,Herbie Mann,1979-04-07,Herbie Mann - Super Mann,38,42,51,38.0,38,Super Mann,3.0,3,-13,0,4,1,down,1979-03-17
11379,Herbie Hancock,1979-03-17,Herbie Hancock - Feets Don't Fail Me Now,51,51,43,16.0,44,Feets Don't Fail Me Now,22.0,0,1,7,0,1,up,1979-03-17
11380,Herbie Hancock,1979-03-24,Herbie Hancock - Feets Don't Fail Me Now,44,51,33,16.0,43,Feets Don't Fail Me Now,22.0,1,10,1,7,1,up,1979-03-17
11381,Herbie Hancock,1979-03-31,Herbie Hancock - Feets Don't Fail Me Now,43,44,26,16.0,33,Feets Don't Fail Me Now,22.0,2,7,10,1,1,up,1979-03-17
11382,Herbie Hancock,1979-04-07,Herbie Hancock - Feets Don't Fail Me Now,33,43,16,16.0,26,Feets Don't Fail Me Now,22.0,3,10,7,10,1,up,1979-03-17
11383,Herbie Hancock,1979-04-14,Herbie Hancock - Feets Don't Fail Me Now,26,33,16,16.0,16,Feets Don't Fail Me Now,22.0,4,0,10,7,0,stay,1979-03-17
11384,Herbie Hancock,1979-04-21,Herbie Hancock - Feets Don't Fail Me Now,16,26,21,16.0,16,Feets Don't Fail Me Now,22.0,5,-5,0,10,1,down,1979-03-17
11385,Herbie Hancock,1979-04-28,Herbie Hancock - Feets Don't Fail Me Now,16,16,24,16.0,21,Feets Don't Fail Me Now,22.0,6,-3,-5,0,1,down,1979-03-17
11386,Herbie Hancock,1979-05-05,Herbie Hancock - Feets Don't Fail Me Now,21,16,26,16.0,24,Feets Don't Fail Me Now,22.0,7,-2,-3,-5,1,down,1979-03-17
11387,Herbie Hancock,1979-05-12,Herbie Hancock - Feets Don't Fail Me Now,24,21,26,16.0,26,Feets Don't Fail Me Now,22.0,8,0,-2,-3,0,stay,1979-03-17
11388,Herbie Hancock,1979-05-19,Herbie Hancock - Feets Don't Fail Me Now,26,24,26,16.0,26,Feets Don't Fail Me Now,22.0,9,0,0,-2,0,stay,1979-03-17
11389,Herbie Hancock,1979-05-26,Herbie Hancock - Feets Don't Fail Me Now,26,26,32,16.0,26,Feets Don't Fail Me Now,22.0,10,-6,0,0,1,down,1979-03-17
11390,Herbie Hancock,1979-06-02,Herbie Hancock - Feets Don't Fail Me Now,26,26,27,16.0,32,Feets Don't Fail Me Now,22.0,11,5,-6,0,1,up,1979-03-17
11391,Herbie Hancock,1979-06-09,Herbie Hancock - Feets Don't Fail Me Now,32,26,27,16.0,27,Feets Don't Fail Me Now,22.0,12,0,5,-6,0,stay,1979-03-17
11392,Herbie Hancock,1979-06-16,Herbie Hancock - Feets Don't Fail Me Now,27,32,27,16.0,27,Feets Don't Fail Me Now,22.0,13,0,0,5,0,stay,1979-03-17
11393,Herbie Hancock,1979-06-23,Herbie Hancock - Feets Don't Fail Me Now,27,27,31,16.0,27,Feets Don't Fail Me Now,22.0,14,-4,0,0,1,down,1979-03-17
11394,Herbie Hancock,1979-06-30,Herbie Hancock - Feets Don't Fail Me Now,27,27,34,16.0,31,Feets Don't Fail Me Now,22.0,15,-3,-4,0,1,down,1979-03-17
11395,Herbie Hancock,1979-07-07,Herbie Hancock - Feets Don't Fail Me Now,31,27,34,16.0,34,Feets Don't Fail Me Now,22.0,16,0,-3,-4,0,stay,1979-03-17
11396,Herbie Hancock,1979-07-14,Herbie Hancock - Feets Don't Fail Me Now,34,31,38,16.0,34,Feets Don't Fail Me Now,22.0,17,-4,0,-3,1,down,1979-03-17
11397,Herbie Hancock,1979-07-21,Herbie Hancock - Feets Don't Fail Me Now,34,34,38,16.0,38,Feets Don't Fail Me Now,22.0,18,0,-4,0,0,stay,1979-03-17
11398,Herbie Hancock,1979-07-28,Herbie Hancock - Feets Don't Fail Me Now,38,34,38,16.0,38,Feets Don't Fail Me Now,22.0,19,0,0,-4,0,stay,1979-03-17
11399,Herbie Hancock,1979-08-04,Herbie Hancock - Feets Don't Fail Me Now,38,38,44,16.0,38,Feets Don't Fail Me Now,22.0,20,-6,0,0,1,down,1979-03-17
11400,Herbie Hancock,1979-08-18,Herbie Hancock - Feets Don't Fail Me Now,38,38,44,16.0,44,Feets Don't Fail Me Now,22.0,21,0,-6,0,0,stay,1979-03-17
11401,Herbie Hancock,1979-08-25,Herbie Hancock - Feets Don't Fail Me Now,44,38,51,16.0,44,Feets Don't Fail Me Now,22.0,22,-7,0,-6,1,down,1979-03-17
11402,Narada,1979-03-17,Narada - Awakening,51,51,44,15.0,46,Awakening,10.0,0,2,5,0,1,up,1979-03-17
11403,Narada,1979-03-24,Narada - Awakening,46,51,34,15.0,44,Awakening,10.0,1,10,2,5,1,up,1979-03-17
11404,Narada,1979-03-31,Narada - Awakening,44,46,24,15.0,34,Awakening,10.0,2,10,10,2,1,up,1979-03-17
11405,Narada,1979-04-07,Narada - Awakening,34,44,22,15.0,24,Awakening,10.0,3,2,10,10,1,up,1979-03-17
11406,Narada,1979-04-14,Narada - Awakening,24,34,19,15.0,22,Awakening,10.0,4,3,2,10,1,up,1979-03-17
11407,Narada,1979-04-21,Narada - Awakening,22,24,15,15.0,19,Awakening,10.0,5,4,3,2,1,up,1979-03-17
11408,Narada,1979-04-28,Narada - Awakening,19,22,15,15.0,15,Awakening,10.0,6,0,4,3,0,stay,1979-03-17
11409,Narada,1979-05-05,Narada - Awakening,15,19,18,15.0,15,Awakening,10.0,7,-3,0,4,1,down,1979-03-17
11410,Narada,1979-05-12,Narada - Awakening,15,15,31,15.0,18,Awakening,10.0,8,-13,-3,0,1,down,1979-03-17
11411,Narada,1979-05-19,Narada - Awakening,18,15,33,15.0,31,Awakening,10.0,9,-2,-13,-3,1,down,1979-03-17
11412,Narada,1979-05-26,Narada - Awakening,31,18,51,15.0,33,Awakening,10.0,10,-18,-2,-13,1,down,1979-03-17
11413,George Benson,1979-03-24,George Benson - Livin' Inside Your Love,51,51,7,4.0,19,Livin' Inside Your Love,19.0,0,12,32,0,1,up,1979-03-24
11414,George Benson,1979-03-31,George Benson - Livin' Inside Your Love,19,51,4,4.0,7,Livin' Inside Your Love,19.0,1,3,12,32,1,up,1979-03-24
11415,George Benson,1979-04-07,George Benson - Livin' Inside Your Love,7,19,4,4.0,4,Livin' Inside Your Love,19.0,2,0,3,12,0,stay,1979-03-24
11416,George Benson,1979-04-14,George Benson - Livin' Inside Your Love,4,7,4,4.0,4,Livin' Inside Your Love,19.0,3,0,0,3,0,stay,1979-03-24
11417,George Benson,1979-04-21,George Benson - Livin' Inside Your Love,4,4,6,4.0,4,Livin' Inside Your Love,19.0,4,-2,0,0,1,down,1979-03-24
11418,George Benson,1979-04-28,George Benson - Livin' Inside Your Love,4,4,6,4.0,6,Livin' Inside Your Love,19.0,5,0,-2,0,0,stay,1979-03-24
11419,George Benson,1979-05-05,George Benson - Livin' Inside Your Love,6,4,8,4.0,6,Livin' Inside Your Love,19.0,6,-2,0,-2,1,down,1979-03-24
11420,George Benson,1979-05-12,George Benson - Livin' Inside Your Love,6,6,8,4.0,8,Livin' Inside Your Love,19.0,7,0,-2,0,0,stay,1979-03-24
11421,George Benson,1979-05-19,George Benson - Livin' Inside Your Love,8,6,11,4.0,8,Livin' Inside Your Love,19.0,8,-3,0,-2,1,down,1979-03-24
11422,George Benson,1979-05-26,George Benson - Livin' Inside Your Love,8,8,11,4.0,11,Livin' Inside Your Love,19.0,9,0,-3,0,0,stay,1979-03-24
11423,George Benson,1979-06-02,George Benson - Livin' Inside Your Love,11,8,13,4.0,11,Livin' Inside Your Love,19.0,10,-2,0,-3,1,down,1979-03-24
11424,George Benson,1979-06-09,George Benson - Livin' Inside Your Love,11,11,18,4.0,13,Livin' Inside Your Love,19.0,11,-5,-2,0,1,down,1979-03-24
11425,George Benson,1979-06-16,George Benson - Livin' Inside Your Love,13,11,34,4.0,18,Livin' Inside Your Love,19.0,12,-16,-5,-2,1,down,1979-03-24
11426,George Benson,1979-06-23,George Benson - Livin' Inside Your Love,18,13,34,4.0,34,Livin' Inside Your Love,19.0,13,0,-16,-5,0,stay,1979-03-24
11427,George Benson,1979-06-30,George Benson - Livin' Inside Your Love,34,18,41,4.0,34,Livin' Inside Your Love,19.0,14,-7,0,-16,1,down,1979-03-24
11428,George Benson,1979-07-07,George Benson - Livin' Inside Your Love,34,34,39,4.0,41,Livin' Inside Your Love,19.0,15,2,-7,0,1,up,1979-03-24
11429,George Benson,1979-07-14,George Benson - Livin' Inside Your Love,41,34,44,4.0,39,Livin' Inside Your Love,19.0,16,-5,2,-7,1,down,1979-03-24
11430,George Benson,1979-07-21,George Benson - Livin' Inside Your Love,39,41,46,4.0,44,Livin' Inside Your Love,19.0,17,-2,-5,2,1,down,1979-03-24
11431,George Benson,1979-07-28,George Benson - Livin' Inside Your Love,44,39,48,4.0,46,Livin' Inside Your Love,19.0,18,-2,-2,-5,1,down,1979-03-24
11432,George Benson,1979-08-04,George Benson - Livin' Inside Your Love,46,44,51,4.0,48,Livin' Inside Your Love,19.0,19,-3,-2,-2,1,down,1979-03-24
11433,Enchantment,1979-03-24,Enchantment - Journey To The Land Of Enchantment,51,51,30,25.0,40,Journey To The Land Of Enchantment,8.0,0,10,11,0,1,up,1979-03-24
11434,Enchantment,1979-03-31,Enchantment - Journey To The Land Of Enchantment,40,51,25,25.0,30,Journey To The Land Of Enchantment,8.0,1,5,10,11,1,up,1979-03-24
11435,Enchantment,1979-04-07,Enchantment - Journey To The Land Of Enchantment,30,40,25,25.0,25,Journey To The Land Of Enchantment,8.0,2,0,5,10,0,stay,1979-03-24
11436,Enchantment,1979-04-14,Enchantment - Journey To The Land Of Enchantment,25,30,39,25.0,25,Journey To The Land Of Enchantment,8.0,3,-14,0,5,1,down,1979-03-24
11437,Enchantment,1979-04-21,Enchantment - Journey To The Land Of Enchantment,25,25,44,25.0,39,Journey To The Land Of Enchantment,8.0,4,-5,-14,0,1,down,1979-03-24
11438,Enchantment,1979-04-28,Enchantment - Journey To The Land Of Enchantment,39,25,44,25.0,44,Journey To The Land Of Enchantment,8.0,5,0,-5,-14,0,stay,1979-03-24
11439,Enchantment,1979-05-05,Enchantment - Journey To The Land Of Enchantment,44,39,44,25.0,44,Journey To The Land Of Enchantment,8.0,6,0,0,-5,0,stay,1979-03-24
11440,Enchantment,1979-05-12,Enchantment - Journey To The Land Of Enchantment,44,44,41,25.0,44,Journey To The Land Of Enchantment,8.0,7,3,0,0,1,up,1979-03-24
11441,Enchantment,1979-05-19,Enchantment - Journey To The Land Of Enchantment,44,44,51,25.0,41,Journey To The Land Of Enchantment,8.0,8,-10,3,0,1,down,1979-03-24
11442,Bill Withers,1979-03-24,Bill Withers - Bout Love,51,51,50,50.0,50,Bout Love,1.0,0,0,1,0,0,stay,1979-03-24
11443,Bill Withers,1979-03-31,Bill Withers - Bout Love,50,51,51,50.0,50,Bout Love,1.0,1,-1,0,1,1,down,1979-03-24
11444,GQ,1979-03-31,GQ - Disco Nights,51,51,15,2.0,37,Disco Nights,36.0,0,22,14,0,1,up,1979-03-31
11445,GQ,1979-04-07,GQ - Disco Nights,37,51,6,2.0,15,Disco Nights,36.0,1,9,22,14,1,up,1979-03-31
11446,GQ,1979-04-14,GQ - Disco Nights,15,37,5,2.0,6,Disco Nights,36.0,2,1,9,22,1,up,1979-03-31
11447,GQ,1979-04-21,GQ - Disco Nights,6,15,3,2.0,5,Disco Nights,36.0,3,2,1,9,1,up,1979-03-31
11448,GQ,1979-04-28,GQ - Disco Nights,5,6,2,2.0,3,Disco Nights,36.0,4,1,2,1,1,up,1979-03-31
11449,GQ,1979-05-05,GQ - Disco Nights,3,5,2,2.0,2,Disco Nights,36.0,5,0,1,2,0,stay,1979-03-31
11450,GQ,1979-05-12,GQ - Disco Nights,2,3,2,2.0,2,Disco Nights,36.0,6,0,0,1,0,stay,1979-03-31
11451,GQ,1979-05-19,GQ - Disco Nights,2,2,2,2.0,2,Disco Nights,36.0,7,0,0,0,0,stay,1979-03-31
11452,GQ,1979-05-26,GQ - Disco Nights,2,2,2,2.0,2,Disco Nights,36.0,8,0,0,0,0,stay,1979-03-31
11453,GQ,1979-06-02,GQ - Disco Nights,2,2,6,2.0,2,Disco Nights,36.0,9,-4,0,0,1,down,1979-03-31
11454,GQ,1979-06-09,GQ - Disco Nights,2,2,5,2.0,6,Disco Nights,36.0,10,1,-4,0,1,up,1979-03-31
11455,GQ,1979-06-16,GQ - Disco Nights,6,2,8,2.0,5,Disco Nights,36.0,11,-3,1,-4,1,down,1979-03-31
11456,GQ,1979-06-23,GQ - Disco Nights,5,6,9,2.0,8,Disco Nights,36.0,12,-1,-3,1,1,down,1979-03-31
11457,GQ,1979-06-30,GQ - Disco Nights,8,5,9,2.0,9,Disco Nights,36.0,13,0,-1,-3,0,stay,1979-03-31
11458,GQ,1979-07-07,GQ - Disco Nights,9,8,9,2.0,9,Disco Nights,36.0,14,0,0,-1,0,stay,1979-03-31
11459,GQ,1979-07-14,GQ - Disco Nights,9,9,13,2.0,9,Disco Nights,36.0,15,-4,0,0,1,down,1979-03-31
11460,GQ,1979-07-21,GQ - Disco Nights,9,9,18,2.0,13,Disco Nights,36.0,16,-5,-4,0,1,down,1979-03-31
11461,GQ,1979-07-28,GQ - Disco Nights,13,9,25,2.0,18,Disco Nights,36.0,17,-7,-5,-4,1,down,1979-03-31
11462,GQ,1979-08-04,GQ - Disco Nights,18,13,25,2.0,25,Disco Nights,36.0,18,0,-7,-5,0,stay,1979-03-31
11463,GQ,1979-08-11,GQ - Disco Nights,25,18,22,2.0,25,Disco Nights,36.0,19,3,0,-7,1,up,1979-03-31
11464,GQ,1979-08-18,GQ - Disco Nights,25,25,18,2.0,22,Disco Nights,36.0,20,4,3,0,1,up,1979-03-31
11465,GQ,1979-08-25,GQ - Disco Nights,22,25,15,2.0,18,Disco Nights,36.0,21,3,4,3,1,up,1979-03-31
11466,GQ,1979-09-01,GQ - Disco Nights,18,22,11,2.0,15,Disco Nights,36.0,22,4,3,4,1,up,1979-03-31
11467,GQ,1979-09-08,GQ - Disco Nights,15,18,11,2.0,11,Disco Nights,36.0,23,0,4,3,0,stay,1979-03-31
11468,GQ,1979-09-15,GQ - Disco Nights,11,15,11,2.0,11,Disco Nights,36.0,24,0,0,4,0,stay,1979-03-31
11469,GQ,1979-09-22,GQ - Disco Nights,11,11,10,2.0,11,Disco Nights,36.0,25,1,0,0,1,up,1979-03-31
11470,GQ,1979-09-29,GQ - Disco Nights,11,11,9,2.0,10,Disco Nights,36.0,26,1,1,0,1,up,1979-03-31
11471,GQ,1979-10-06,GQ - Disco Nights,10,11,9,2.0,9,Disco Nights,36.0,27,0,1,1,0,stay,1979-03-31
11472,GQ,1979-10-13,GQ - Disco Nights,9,10,9,2.0,9,Disco Nights,36.0,28,0,0,1,0,stay,1979-03-31
11473,GQ,1979-10-20,GQ - Disco Nights,9,9,13,2.0,9,Disco Nights,36.0,29,-4,0,0,1,down,1979-03-31
11474,GQ,1979-10-27,GQ - Disco Nights,9,9,14,2.0,13,Disco Nights,36.0,30,-1,-4,0,1,down,1979-03-31
11475,GQ,1979-11-03,GQ - Disco Nights,13,9,30,2.0,14,Disco Nights,36.0,31,-16,-1,-4,1,down,1979-03-31
11476,GQ,1979-11-10,GQ - Disco Nights,14,13,30,2.0,30,Disco Nights,36.0,32,0,-16,-1,0,stay,1979-03-31
11477,GQ,1979-11-17,GQ - Disco Nights,30,14,32,2.0,30,Disco Nights,36.0,33,-2,0,-16,1,down,1979-03-31
11478,GQ,1979-11-24,GQ - Disco Nights,30,30,38,2.0,32,Disco Nights,36.0,34,-6,-2,0,1,down,1979-03-31
11479,GQ,1979-12-01,GQ - Disco Nights,32,30,43,2.0,38,Disco Nights,36.0,35,-5,-6,-2,1,down,1979-03-31
11480,GQ,1979-12-08,GQ - Disco Nights,38,32,51,2.0,43,Disco Nights,36.0,36,-8,-5,-6,1,down,1979-03-31
11481,Tyrone Davis,1979-03-31,Tyrone Davis - In The Mood With Tyrone Davis,51,51,31,9.0,41,In The Mood With Tyrone Davis,20.0,0,10,10,0,1,up,1979-03-31
11482,Tyrone Davis,1979-04-07,Tyrone Davis - In The Mood With Tyrone Davis,41,51,21,9.0,31,In The Mood With Tyrone Davis,20.0,1,10,10,10,1,up,1979-03-31
11483,Tyrone Davis,1979-04-14,Tyrone Davis - In The Mood With Tyrone Davis,31,41,15,9.0,21,In The Mood With Tyrone Davis,20.0,2,6,10,10,1,up,1979-03-31
11484,Tyrone Davis,1979-04-21,Tyrone Davis - In The Mood With Tyrone Davis,21,31,13,9.0,15,In The Mood With Tyrone Davis,20.0,3,2,6,10,1,up,1979-03-31
11485,Tyrone Davis,1979-04-28,Tyrone Davis - In The Mood With Tyrone Davis,15,21,11,9.0,13,In The Mood With Tyrone Davis,20.0,4,2,2,6,1,up,1979-03-31
11486,Tyrone Davis,1979-05-05,Tyrone Davis - In The Mood With Tyrone Davis,13,15,9,9.0,11,In The Mood With Tyrone Davis,20.0,5,2,2,2,1,up,1979-03-31
11487,Tyrone Davis,1979-05-12,Tyrone Davis - In The Mood With Tyrone Davis,11,13,9,9.0,9,In The Mood With Tyrone Davis,20.0,6,0,2,2,0,stay,1979-03-31
11488,Tyrone Davis,1979-05-19,Tyrone Davis - In The Mood With Tyrone Davis,9,11,9,9.0,9,In The Mood With Tyrone Davis,20.0,7,0,0,2,0,stay,1979-03-31
11489,Tyrone Davis,1979-05-26,Tyrone Davis - In The Mood With Tyrone Davis,9,9,13,9.0,9,In The Mood With Tyrone Davis,20.0,8,-4,0,0,1,down,1979-03-31
11490,Tyrone Davis,1979-06-02,Tyrone Davis - In The Mood With Tyrone Davis,9,9,15,9.0,13,In The Mood With Tyrone Davis,20.0,9,-2,-4,0,1,down,1979-03-31
11491,Tyrone Davis,1979-06-09,Tyrone Davis - In The Mood With Tyrone Davis,13,9,16,9.0,15,In The Mood With Tyrone Davis,20.0,10,-1,-2,-4,1,down,1979-03-31
11492,Tyrone Davis,1979-06-16,Tyrone Davis - In The Mood With Tyrone Davis,15,13,28,9.0,16,In The Mood With Tyrone Davis,20.0,11,-12,-1,-2,1,down,1979-03-31
11493,Tyrone Davis,1979-06-23,Tyrone Davis - In The Mood With Tyrone Davis,16,15,28,9.0,28,In The Mood With Tyrone Davis,20.0,12,0,-12,-1,0,stay,1979-03-31
11494,Tyrone Davis,1979-06-30,Tyrone Davis - In The Mood With Tyrone Davis,28,16,28,9.0,28,In The Mood With Tyrone Davis,20.0,13,0,0,-12,0,stay,1979-03-31
11495,Tyrone Davis,1979-07-07,Tyrone Davis - In The Mood With Tyrone Davis,28,28,41,9.0,28,In The Mood With Tyrone Davis,20.0,14,-13,0,0,1,down,1979-03-31
11496,Tyrone Davis,1979-07-14,Tyrone Davis - In The Mood With Tyrone Davis,28,28,41,9.0,41,In The Mood With Tyrone Davis,20.0,15,0,-13,0,0,stay,1979-03-31
11497,Tyrone Davis,1979-07-21,Tyrone Davis - In The Mood With Tyrone Davis,41,28,42,9.0,41,In The Mood With Tyrone Davis,20.0,16,-1,0,-13,1,down,1979-03-31
11498,Tyrone Davis,1979-07-28,Tyrone Davis - In The Mood With Tyrone Davis,41,41,42,9.0,42,In The Mood With Tyrone Davis,20.0,17,0,-1,0,0,stay,1979-03-31
11499,Tyrone Davis,1979-08-04,Tyrone Davis - In The Mood With Tyrone Davis,42,41,45,9.0,42,In The Mood With Tyrone Davis,20.0,18,-3,0,-1,1,down,1979-03-31
11500,Tyrone Davis,1979-08-18,Tyrone Davis - In The Mood With Tyrone Davis,42,42,45,9.0,45,In The Mood With Tyrone Davis,20.0,19,0,-3,0,0,stay,1979-03-31
11501,Tyrone Davis,1979-08-25,Tyrone Davis - In The Mood With Tyrone Davis,45,42,51,9.0,45,In The Mood With Tyrone Davis,20.0,20,-6,0,-3,1,down,1979-03-31
11502,Patti LaBelle,1979-03-31,Patti LaBelle - It's Alright With Me,51,51,33,33.0,43,It's Alright With Me,7.0,0,10,8,0,1,up,1979-03-31
11503,Patti LaBelle,1979-04-07,Patti LaBelle - It's Alright With Me,43,51,33,33.0,33,It's Alright With Me,7.0,1,0,10,8,0,stay,1979-03-31
11504,Patti LaBelle,1979-04-14,Patti LaBelle - It's Alright With Me,33,43,42,33.0,33,It's Alright With Me,7.0,2,-9,0,10,1,down,1979-03-31
11505,Patti LaBelle,1979-05-19,Patti LaBelle - It's Alright With Me,33,33,39,33.0,42,It's Alright With Me,7.0,3,3,-9,0,1,up,1979-03-31
11506,Patti LaBelle,1979-05-26,Patti LaBelle - It's Alright With Me,42,33,43,33.0,39,It's Alright With Me,7.0,4,-4,3,-9,1,down,1979-03-31
11507,Patti LaBelle,1979-06-02,Patti LaBelle - It's Alright With Me,39,42,47,33.0,43,It's Alright With Me,7.0,5,-4,-4,3,1,down,1979-03-31
11508,Patti LaBelle,1979-06-09,Patti LaBelle - It's Alright With Me,43,39,49,33.0,47,It's Alright With Me,7.0,6,-2,-4,-4,1,down,1979-03-31
11509,Patti LaBelle,1979-06-16,Patti LaBelle - It's Alright With Me,47,43,51,33.0,49,It's Alright With Me,7.0,7,-2,-2,-4,1,down,1979-03-31
11510,Cher,1979-03-31,Cher - Take Me Home,51,51,40,32.0,49,Take Me Home,9.0,0,9,2,0,1,up,1979-03-31
11511,Cher,1979-04-07,Cher - Take Me Home,49,51,39,32.0,40,Take Me Home,9.0,1,1,9,2,1,up,1979-03-31
11512,Cher,1979-04-14,Cher - Take Me Home,40,49,37,32.0,39,Take Me Home,9.0,2,2,1,9,1,up,1979-03-31
11513,Cher,1979-04-21,Cher - Take Me Home,39,40,37,32.0,37,Take Me Home,9.0,3,0,2,1,0,stay,1979-03-31
11514,Cher,1979-04-28,Cher - Take Me Home,37,39,35,32.0,37,Take Me Home,9.0,4,2,0,2,1,up,1979-03-31
11515,Cher,1979-05-05,Cher - Take Me Home,37,37,34,32.0,35,Take Me Home,9.0,5,1,2,0,1,up,1979-03-31
11516,Cher,1979-05-12,Cher - Take Me Home,35,37,32,32.0,34,Take Me Home,9.0,6,2,1,2,1,up,1979-03-31
11517,Cher,1979-05-19,Cher - Take Me Home,34,35,32,32.0,32,Take Me Home,9.0,7,0,2,1,0,stay,1979-03-31
11518,Cher,1979-05-26,Cher - Take Me Home,32,34,46,32.0,32,Take Me Home,9.0,8,-14,0,2,1,down,1979-03-31
11519,Cher,1979-06-02,Cher - Take Me Home,32,32,51,32.0,46,Take Me Home,9.0,9,-5,-14,0,1,down,1979-03-31
11520,Gary's Gang,1979-04-07,Gary's Gang - Keep On Dancin',51,51,29,27.0,37,Keep On Dancin',4.0,0,8,14,0,1,up,1979-04-07
11521,Gary's Gang,1979-04-14,Gary's Gang - Keep On Dancin',37,51,27,27.0,29,Keep On Dancin',4.0,1,2,8,14,1,up,1979-04-07
11522,Gary's Gang,1979-04-21,Gary's Gang - Keep On Dancin',29,37,40,27.0,27,Keep On Dancin',4.0,2,-13,2,8,1,down,1979-04-07
11523,Gary's Gang,1979-04-28,Gary's Gang - Keep On Dancin',27,29,45,27.0,40,Keep On Dancin',4.0,3,-5,-13,2,1,down,1979-04-07
11524,Gary's Gang,1979-05-05,Gary's Gang - Keep On Dancin',40,27,51,27.0,45,Keep On Dancin',4.0,4,-6,-5,-13,1,down,1979-04-07
11525,Arpeggio,1979-04-07,Arpeggio - Let The Music Play,51,51,43,43.0,43,Let The Music Play,1.0,0,0,8,0,0,stay,1979-04-07
11526,Arpeggio,1979-04-14,Arpeggio - Let The Music Play,43,51,51,43.0,43,Let The Music Play,1.0,1,-8,0,8,1,down,1979-04-07
11527,Gino Soccio,1979-04-07,Gino Soccio - Outline,51,51,46,34.0,46,Outline,7.0,0,0,5,0,0,stay,1979-04-07
11528,Gino Soccio,1979-04-14,Gino Soccio - Outline,46,51,36,34.0,46,Outline,7.0,1,10,0,5,1,up,1979-04-07
11529,Gino Soccio,1979-04-21,Gino Soccio - Outline,46,46,34,34.0,36,Outline,7.0,2,2,10,0,1,up,1979-04-07
11530,Gino Soccio,1979-04-28,Gino Soccio - Outline,36,46,34,34.0,34,Outline,7.0,3,0,2,10,0,stay,1979-04-07
11531,Gino Soccio,1979-05-05,Gino Soccio - Outline,34,36,39,34.0,34,Outline,7.0,4,-5,0,2,1,down,1979-04-07
11532,Gino Soccio,1979-05-12,Gino Soccio - Outline,34,34,39,34.0,39,Outline,7.0,5,0,-5,0,0,stay,1979-04-07
11533,Gino Soccio,1979-05-19,Gino Soccio - Outline,39,34,46,34.0,39,Outline,7.0,6,-7,0,-5,1,down,1979-04-07
11534,Gino Soccio,1979-05-26,Gino Soccio - Outline,39,39,51,34.0,46,Outline,7.0,7,-5,-7,0,1,down,1979-04-07
11535,Alton McClain & Destiny,1979-04-07,Alton McClain & Destiny - Alton Mc Clain + Destiny,51,51,37,27.0,47,Alton Mc Clain + Destiny,8.0,0,10,4,0,1,up,1979-04-07
11536,Alton McClain & Destiny,1979-04-14,Alton McClain & Destiny - Alton Mc Clain + Destiny,47,51,35,27.0,37,Alton Mc Clain + Destiny,8.0,1,2,10,4,1,up,1979-04-07
11537,Alton McClain & Destiny,1979-04-21,Alton McClain & Destiny - Alton Mc Clain + Destiny,37,47,27,27.0,35,Alton Mc Clain + Destiny,8.0,2,8,2,10,1,up,1979-04-07
11538,Alton McClain & Destiny,1979-04-28,Alton McClain & Destiny - Alton Mc Clain + Destiny,35,37,27,27.0,27,Alton Mc Clain + Destiny,8.0,3,0,8,2,0,stay,1979-04-07
11539,Alton McClain & Destiny,1979-05-05,Alton McClain & Destiny - Alton Mc Clain + Destiny,27,35,28,27.0,27,Alton Mc Clain + Destiny,8.0,4,-1,0,8,1,down,1979-04-07
11540,Alton McClain & Destiny,1979-05-12,Alton McClain & Destiny - Alton Mc Clain + Destiny,27,27,35,27.0,28,Alton Mc Clain + Destiny,8.0,5,-7,-1,0,1,down,1979-04-07
11541,Alton McClain & Destiny,1979-05-19,Alton McClain & Destiny - Alton Mc Clain + Destiny,28,27,45,27.0,35,Alton Mc Clain + Destiny,8.0,6,-10,-7,-1,1,down,1979-04-07
11542,Alton McClain & Destiny,1979-05-26,Alton McClain & Destiny - Alton Mc Clain + Destiny,35,28,45,27.0,45,Alton Mc Clain + Destiny,8.0,7,0,-10,-7,0,stay,1979-04-07
11543,Alton McClain & Destiny,1979-06-02,Alton McClain & Destiny - Alton Mc Clain + Destiny,45,35,51,27.0,45,Alton Mc Clain + Destiny,8.0,8,-6,0,-10,1,down,1979-04-07
11544,Randy Brown,1979-04-07,Randy Brown - Intimately,51,51,48,48.0,48,Intimately,1.0,0,0,3,0,0,stay,1979-04-07
11545,Randy Brown,1979-04-14,Randy Brown - Intimately,48,51,51,48.0,48,Intimately,1.0,1,-3,0,3,1,down,1979-04-07
11546,Bunny Sigler,1979-04-07,Bunny Sigler - I've Always Wanted To Sing Not Just Write Songs,51,51,49,49.0,49,I've Always Wanted To Sing Not Just Write Songs,3.0,0,0,2,0,0,stay,1979-04-07
11547,Bunny Sigler,1979-04-14,Bunny Sigler - I've Always Wanted To Sing Not Just Write Songs,49,51,49,49.0,49,I've Always Wanted To Sing Not Just Write Songs,3.0,1,0,0,2,0,stay,1979-04-07
11548,Bunny Sigler,1979-05-05,Bunny Sigler - I've Always Wanted To Sing Not Just Write Songs,49,49,49,49.0,49,I've Always Wanted To Sing Not Just Write Songs,3.0,2,0,0,0,0,stay,1979-04-07
11549,Bunny Sigler,1979-05-12,Bunny Sigler - I've Always Wanted To Sing Not Just Write Songs,49,49,51,49.0,49,I've Always Wanted To Sing Not Just Write Songs,3.0,3,-2,0,0,1,down,1979-04-07
11550,Crown Heights Affair,1979-04-07,Crown Heights Affair - Dance Lady Dance,51,51,40,40.0,50,Dance Lady Dance,2.0,0,10,1,0,1,up,1979-04-07
11551,Crown Heights Affair,1979-04-14,Crown Heights Affair - Dance Lady Dance,50,51,40,40.0,40,Dance Lady Dance,2.0,1,0,10,1,0,stay,1979-04-07
11552,Crown Heights Affair,1979-04-21,Crown Heights Affair - Dance Lady Dance,40,50,51,40.0,40,Dance Lady Dance,2.0,2,-11,0,10,1,down,1979-04-07
11553,"Evelyn ""Champagne"" King",1979-04-14,"Evelyn ""Champagne"" King - Music Box",51,51,22,12.0,30,Music Box,14.0,0,8,21,0,1,up,1979-04-14
11554,"Evelyn ""Champagne"" King",1979-04-21,"Evelyn ""Champagne"" King - Music Box",30,51,18,12.0,22,Music Box,14.0,1,4,8,21,1,up,1979-04-14
11555,"Evelyn ""Champagne"" King",1979-04-28,"Evelyn ""Champagne"" King - Music Box",22,30,17,12.0,18,Music Box,14.0,2,1,4,8,1,up,1979-04-14
11556,"Evelyn ""Champagne"" King",1979-05-05,"Evelyn ""Champagne"" King - Music Box",18,22,12,12.0,17,Music Box,14.0,3,5,1,4,1,up,1979-04-14
11557,"Evelyn ""Champagne"" King",1979-05-12,"Evelyn ""Champagne"" King - Music Box",17,18,12,12.0,12,Music Box,14.0,4,0,5,1,0,stay,1979-04-14
11558,"Evelyn ""Champagne"" King",1979-05-19,"Evelyn ""Champagne"" King - Music Box",12,17,16,12.0,12,Music Box,14.0,5,-4,0,5,1,down,1979-04-14
11559,"Evelyn ""Champagne"" King",1979-05-26,"Evelyn ""Champagne"" King - Music Box",12,12,21,12.0,16,Music Box,14.0,6,-5,-4,0,1,down,1979-04-14
11560,"Evelyn ""Champagne"" King",1979-06-02,"Evelyn ""Champagne"" King - Music Box",16,12,21,12.0,21,Music Box,14.0,7,0,-5,-4,0,stay,1979-04-14
11561,"Evelyn ""Champagne"" King",1979-06-09,"Evelyn ""Champagne"" King - Music Box",21,16,22,12.0,21,Music Box,14.0,8,-1,0,-5,1,down,1979-04-14
11562,"Evelyn ""Champagne"" King",1979-06-16,"Evelyn ""Champagne"" King - Music Box",21,21,29,12.0,22,Music Box,14.0,9,-7,-1,0,1,down,1979-04-14
11563,"Evelyn ""Champagne"" King",1979-06-23,"Evelyn ""Champagne"" King - Music Box",22,21,29,12.0,29,Music Box,14.0,10,0,-7,-1,0,stay,1979-04-14
11564,"Evelyn ""Champagne"" King",1979-06-30,"Evelyn ""Champagne"" King - Music Box",29,22,29,12.0,29,Music Box,14.0,11,0,0,-7,0,stay,1979-04-14
11565,"Evelyn ""Champagne"" King",1979-07-07,"Evelyn ""Champagne"" King - Music Box",29,29,33,12.0,29,Music Box,14.0,12,-4,0,0,1,down,1979-04-14
11566,"Evelyn ""Champagne"" King",1979-07-14,"Evelyn ""Champagne"" King - Music Box",29,29,43,12.0,33,Music Box,14.0,13,-10,-4,0,1,down,1979-04-14
11567,"Evelyn ""Champagne"" King",1979-07-21,"Evelyn ""Champagne"" King - Music Box",33,29,51,12.0,43,Music Box,14.0,14,-8,-10,-4,1,down,1979-04-14
11568,The Manhattans,1979-04-14,The Manhattans - Love Talk,51,51,30,20.0,35,Love Talk,12.0,0,5,16,0,1,up,1979-04-14
11569,The Manhattans,1979-04-21,The Manhattans - Love Talk,35,51,24,20.0,30,Love Talk,12.0,1,6,5,16,1,up,1979-04-14
11570,The Manhattans,1979-04-28,The Manhattans - Love Talk,30,35,20,20.0,24,Love Talk,12.0,2,4,6,5,1,up,1979-04-14
11571,The Manhattans,1979-05-05,The Manhattans - Love Talk,24,30,20,20.0,20,Love Talk,12.0,3,0,4,6,0,stay,1979-04-14
11572,The Manhattans,1979-05-12,The Manhattans - Love Talk,20,24,21,20.0,20,Love Talk,12.0,4,-1,0,4,1,down,1979-04-14
11573,The Manhattans,1979-05-19,The Manhattans - Love Talk,20,20,31,20.0,21,Love Talk,12.0,5,-10,-1,0,1,down,1979-04-14
11574,The Manhattans,1979-05-26,The Manhattans - Love Talk,21,20,36,20.0,31,Love Talk,12.0,6,-5,-10,-1,1,down,1979-04-14
11575,The Manhattans,1979-06-02,The Manhattans - Love Talk,31,21,38,20.0,36,Love Talk,12.0,7,-2,-5,-10,1,down,1979-04-14
11576,The Manhattans,1979-06-09,The Manhattans - Love Talk,36,31,38,20.0,38,Love Talk,12.0,8,0,-2,-5,0,stay,1979-04-14
11577,The Manhattans,1979-06-16,The Manhattans - Love Talk,38,36,38,20.0,38,Love Talk,12.0,9,0,0,-2,0,stay,1979-04-14
11578,The Manhattans,1979-06-23,The Manhattans - Love Talk,38,38,38,20.0,38,Love Talk,12.0,10,0,0,0,0,stay,1979-04-14
11579,The Manhattans,1979-06-30,The Manhattans - Love Talk,38,38,42,20.0,38,Love Talk,12.0,11,-4,0,0,1,down,1979-04-14
11580,The Manhattans,1979-07-07,The Manhattans - Love Talk,38,38,51,20.0,42,Love Talk,12.0,12,-9,-4,0,1,down,1979-04-14
11581,War,1979-04-14,War - The Music Band,51,51,28,11.0,36,The Music Band,15.0,0,8,15,0,1,up,1979-04-14
11582,War,1979-04-21,War - The Music Band,36,51,22,11.0,28,The Music Band,15.0,1,6,8,15,1,up,1979-04-14
11583,War,1979-04-28,War - The Music Band,28,36,19,11.0,22,The Music Band,15.0,2,3,6,8,1,up,1979-04-14
11584,War,1979-05-05,War - The Music Band,22,28,16,11.0,19,The Music Band,15.0,3,3,3,6,1,up,1979-04-14
11585,War,1979-05-12,War - The Music Band,19,22,16,11.0,16,The Music Band,15.0,4,0,3,3,0,stay,1979-04-14
11586,War,1979-05-19,War - The Music Band,16,19,12,11.0,16,The Music Band,15.0,5,4,0,3,1,up,1979-04-14
11587,War,1979-05-26,War - The Music Band,16,16,12,11.0,12,The Music Band,15.0,6,0,4,0,0,stay,1979-04-14
11588,War,1979-06-02,War - The Music Band,12,16,11,11.0,12,The Music Band,15.0,7,1,0,4,1,up,1979-04-14
11589,War,1979-06-09,War - The Music Band,12,12,14,11.0,11,The Music Band,15.0,8,-3,1,0,1,down,1979-04-14
11590,War,1979-06-16,War - The Music Band,11,12,18,11.0,14,The Music Band,15.0,9,-4,-3,1,1,down,1979-04-14
11591,War,1979-06-23,War - The Music Band,14,11,27,11.0,18,The Music Band,15.0,10,-9,-4,-3,1,down,1979-04-14
11592,War,1979-06-30,War - The Music Band,18,14,27,11.0,27,The Music Band,15.0,11,0,-9,-4,0,stay,1979-04-14
11593,War,1979-07-07,War - The Music Band,27,18,29,11.0,27,The Music Band,15.0,12,-2,0,-9,1,down,1979-04-14
11594,War,1979-07-14,War - The Music Band,27,27,37,11.0,29,The Music Band,15.0,13,-8,-2,0,1,down,1979-04-14
11595,War,1979-07-21,War - The Music Band,29,27,49,11.0,37,The Music Band,15.0,14,-12,-8,-2,1,down,1979-04-14
11596,War,1979-07-28,War - The Music Band,37,29,51,11.0,49,The Music Band,15.0,15,-2,-12,-8,1,down,1979-04-14
11597,Average White Band,1979-04-14,Average White Band - Feel No Fret,51,51,44,30.0,44,Feel No Fret,6.0,0,0,7,0,0,stay,1979-04-14
11598,Average White Band,1979-04-21,Average White Band - Feel No Fret,44,51,43,30.0,44,Feel No Fret,6.0,1,1,0,7,1,up,1979-04-14
11599,Average White Band,1979-04-28,Average White Band - Feel No Fret,44,44,41,30.0,43,Feel No Fret,6.0,2,2,1,0,1,up,1979-04-14
11600,Average White Band,1979-05-05,Average White Band - Feel No Fret,43,44,40,30.0,41,Feel No Fret,6.0,3,1,2,1,1,up,1979-04-14
11601,Average White Band,1979-05-12,Average White Band - Feel No Fret,41,43,30,30.0,40,Feel No Fret,6.0,4,10,1,2,1,up,1979-04-14
11602,Average White Band,1979-05-19,Average White Band - Feel No Fret,40,41,30,30.0,30,Feel No Fret,6.0,5,0,10,1,0,stay,1979-04-14
11603,Average White Band,1979-05-26,Average White Band - Feel No Fret,30,40,51,30.0,30,Feel No Fret,6.0,6,-21,0,10,1,down,1979-04-14
11604,Mass Production,1979-04-14,Mass Production - In The Purest Form,51,51,50,10.0,50,In The Purest Form,23.0,0,0,1,0,0,stay,1979-04-14
11605,Mass Production,1979-04-21,Mass Production - In The Purest Form,50,51,45,10.0,50,In The Purest Form,23.0,1,5,0,1,1,up,1979-04-14
11606,Mass Production,1979-06-23,Mass Production - In The Purest Form,50,50,41,10.0,45,In The Purest Form,23.0,2,4,5,0,1,up,1979-04-14
11607,Mass Production,1979-06-30,Mass Production - In The Purest Form,45,50,37,10.0,41,In The Purest Form,23.0,3,4,4,5,1,up,1979-04-14
11608,Mass Production,1979-07-07,Mass Production - In The Purest Form,41,45,35,10.0,37,In The Purest Form,23.0,4,2,4,4,1,up,1979-04-14
11609,Mass Production,1979-07-14,Mass Production - In The Purest Form,37,41,33,10.0,35,In The Purest Form,23.0,5,2,2,4,1,up,1979-04-14
11610,Mass Production,1979-07-21,Mass Production - In The Purest Form,35,37,37,10.0,33,In The Purest Form,23.0,6,-4,2,2,1,down,1979-04-14
11611,Mass Production,1979-07-28,Mass Production - In The Purest Form,33,35,27,10.0,37,In The Purest Form,23.0,7,10,-4,2,1,up,1979-04-14
11612,Mass Production,1979-08-04,Mass Production - In The Purest Form,37,33,22,10.0,27,In The Purest Form,23.0,8,5,10,-4,1,up,1979-04-14
11613,Mass Production,1979-08-11,Mass Production - In The Purest Form,27,37,18,10.0,22,In The Purest Form,23.0,9,4,5,10,1,up,1979-04-14
11614,Mass Production,1979-08-18,Mass Production - In The Purest Form,22,27,15,10.0,18,In The Purest Form,23.0,10,3,4,5,1,up,1979-04-14
11615,Mass Production,1979-08-25,Mass Production - In The Purest Form,18,22,12,10.0,15,In The Purest Form,23.0,11,3,3,4,1,up,1979-04-14
11616,Mass Production,1979-09-01,Mass Production - In The Purest Form,15,18,10,10.0,12,In The Purest Form,23.0,12,2,3,3,1,up,1979-04-14
11617,Mass Production,1979-09-08,Mass Production - In The Purest Form,12,15,10,10.0,10,In The Purest Form,23.0,13,0,2,3,0,stay,1979-04-14
11618,Mass Production,1979-09-15,Mass Production - In The Purest Form,10,12,10,10.0,10,In The Purest Form,23.0,14,0,0,2,0,stay,1979-04-14
11619,Mass Production,1979-09-22,Mass Production - In The Purest Form,10,10,11,10.0,10,In The Purest Form,23.0,15,-1,0,0,1,down,1979-04-14
11620,Mass Production,1979-09-29,Mass Production - In The Purest Form,10,10,17,10.0,11,In The Purest Form,23.0,16,-6,-1,0,1,down,1979-04-14
11621,Mass Production,1979-10-06,Mass Production - In The Purest Form,11,10,17,10.0,17,In The Purest Form,23.0,17,0,-6,-1,0,stay,1979-04-14
11622,Mass Production,1979-10-13,Mass Production - In The Purest Form,17,11,21,10.0,17,In The Purest Form,23.0,18,-4,0,-6,1,down,1979-04-14
11623,Mass Production,1979-10-20,Mass Production - In The Purest Form,17,17,27,10.0,21,In The Purest Form,23.0,19,-6,-4,0,1,down,1979-04-14
11624,Mass Production,1979-10-27,Mass Production - In The Purest Form,21,17,28,10.0,27,In The Purest Form,23.0,20,-1,-6,-4,1,down,1979-04-14
11625,Mass Production,1979-11-03,Mass Production - In The Purest Form,27,21,40,10.0,28,In The Purest Form,23.0,21,-12,-1,-6,1,down,1979-04-14
11626,Mass Production,1979-11-10,Mass Production - In The Purest Form,28,27,47,10.0,40,In The Purest Form,23.0,22,-7,-12,-1,1,down,1979-04-14
11627,Mass Production,1979-11-17,Mass Production - In The Purest Form,40,28,51,10.0,47,In The Purest Form,23.0,23,-4,-7,-12,1,down,1979-04-14
11628,Maze,1979-04-21,Maze - Inspiration,51,51,10,5.0,14,Inspiration,20.0,0,4,37,0,1,up,1979-04-21
11629,Maze,1979-04-28,Maze - Inspiration,14,51,7,5.0,10,Inspiration,20.0,1,3,4,37,1,up,1979-04-21
11630,Maze,1979-05-05,Maze - Inspiration,10,14,7,5.0,7,Inspiration,20.0,2,0,3,4,0,stay,1979-04-21
11631,Maze,1979-05-12,Maze - Inspiration,7,10,6,5.0,7,Inspiration,20.0,3,1,0,3,1,up,1979-04-21
11632,Maze,1979-05-19,Maze - Inspiration,7,7,5,5.0,6,Inspiration,20.0,4,1,1,0,1,up,1979-04-21
11633,Maze,1979-05-26,Maze - Inspiration,6,7,5,5.0,5,Inspiration,20.0,5,0,1,1,0,stay,1979-04-21
11634,Maze,1979-06-02,Maze - Inspiration,5,6,5,5.0,5,Inspiration,20.0,6,0,0,1,0,stay,1979-04-21
11635,Maze,1979-06-09,Maze - Inspiration,5,5,11,5.0,5,Inspiration,20.0,7,-6,0,0,1,down,1979-04-21
11636,Maze,1979-06-16,Maze - Inspiration,5,5,11,5.0,11,Inspiration,20.0,8,0,-6,0,0,stay,1979-04-21
11637,Maze,1979-06-23,Maze - Inspiration,11,5,16,5.0,11,Inspiration,20.0,9,-5,0,-6,1,down,1979-04-21
11638,Maze,1979-06-30,Maze - Inspiration,11,11,12,5.0,16,Inspiration,20.0,10,4,-5,0,1,up,1979-04-21
11639,Maze,1979-07-07,Maze - Inspiration,16,11,12,5.0,12,Inspiration,20.0,11,0,4,-5,0,stay,1979-04-21
11640,Maze,1979-07-14,Maze - Inspiration,12,16,19,5.0,12,Inspiration,20.0,12,-7,0,4,1,down,1979-04-21
11641,Maze,1979-07-21,Maze - Inspiration,12,12,23,5.0,19,Inspiration,20.0,13,-4,-7,0,1,down,1979-04-21
11642,Maze,1979-07-28,Maze - Inspiration,19,12,26,5.0,23,Inspiration,20.0,14,-3,-4,-7,1,down,1979-04-21
11643,Maze,1979-08-04,Maze - Inspiration,23,19,29,5.0,26,Inspiration,20.0,15,-3,-3,-4,1,down,1979-04-21
11644,Maze,1979-08-11,Maze - Inspiration,26,23,32,5.0,29,Inspiration,20.0,16,-3,-3,-3,1,down,1979-04-21
11645,Maze,1979-08-18,Maze - Inspiration,29,26,38,5.0,32,Inspiration,20.0,17,-6,-3,-3,1,down,1979-04-21
11646,Maze,1979-08-25,Maze - Inspiration,32,29,47,5.0,38,Inspiration,20.0,18,-9,-6,-3,1,down,1979-04-21
11647,Maze,1979-09-01,Maze - Inspiration,38,32,47,5.0,47,Inspiration,20.0,19,0,-9,-6,0,stay,1979-04-21
11648,Maze,1979-09-08,Maze - Inspiration,47,38,51,5.0,47,Inspiration,20.0,20,-4,0,-9,1,down,1979-04-21
11649,Natalie Cole,1979-04-21,Natalie Cole - I Love You So,51,51,14,11.0,18,I Love You So,13.0,0,4,33,0,1,up,1979-04-21
11650,Natalie Cole,1979-04-28,Natalie Cole - I Love You So,18,51,12,11.0,14,I Love You So,13.0,1,2,4,33,1,up,1979-04-21
11651,Natalie Cole,1979-05-05,Natalie Cole - I Love You So,14,18,11,11.0,12,I Love You So,13.0,2,1,2,4,1,up,1979-04-21
11652,Natalie Cole,1979-05-12,Natalie Cole - I Love You So,12,14,13,11.0,11,I Love You So,13.0,3,-2,1,2,1,down,1979-04-21
11653,Natalie Cole,1979-05-19,Natalie Cole - I Love You So,11,12,21,11.0,13,I Love You So,13.0,4,-8,-2,1,1,down,1979-04-21
11654,Natalie Cole,1979-05-26,Natalie Cole - I Love You So,13,11,27,11.0,21,I Love You So,13.0,5,-6,-8,-2,1,down,1979-04-21
11655,Natalie Cole,1979-06-02,Natalie Cole - I Love You So,21,13,32,11.0,27,I Love You So,13.0,6,-5,-6,-8,1,down,1979-04-21
11656,Natalie Cole,1979-06-09,Natalie Cole - I Love You So,27,21,32,11.0,32,I Love You So,13.0,7,0,-5,-6,0,stay,1979-04-21
11657,Natalie Cole,1979-06-16,Natalie Cole - I Love You So,32,27,37,11.0,32,I Love You So,13.0,8,-5,0,-5,1,down,1979-04-21
11658,Natalie Cole,1979-06-23,Natalie Cole - I Love You So,32,32,37,11.0,37,I Love You So,13.0,9,0,-5,0,0,stay,1979-04-21
11659,Natalie Cole,1979-06-30,Natalie Cole - I Love You So,37,32,38,11.0,37,I Love You So,13.0,10,-1,0,-5,1,down,1979-04-21
11660,Natalie Cole,1979-07-07,Natalie Cole - I Love You So,37,37,42,11.0,38,I Love You So,13.0,11,-4,-1,0,1,down,1979-04-21
11661,Natalie Cole,1979-07-14,Natalie Cole - I Love You So,38,37,42,11.0,42,I Love You So,13.0,12,0,-4,-1,0,stay,1979-04-21
11662,Natalie Cole,1979-07-21,Natalie Cole - I Love You So,42,38,51,11.0,42,I Love You So,13.0,13,-9,0,-4,1,down,1979-04-21
11663,Village People,1979-04-21,Village People - Go West,51,51,19,14.0,29,Go West,11.0,0,10,22,0,1,up,1979-04-21
11664,Village People,1979-04-28,Village People - Go West,29,51,14,14.0,19,Go West,11.0,1,5,10,22,1,up,1979-04-21
11665,Village People,1979-05-05,Village People - Go West,19,29,14,14.0,14,Go West,11.0,2,0,5,10,0,stay,1979-04-21
11666,Village People,1979-05-12,Village People - Go West,14,19,15,14.0,14,Go West,11.0,3,-1,0,5,1,down,1979-04-21
11667,Village People,1979-05-19,Village People - Go West,14,14,24,14.0,15,Go West,11.0,4,-9,-1,0,1,down,1979-04-21
11668,Village People,1979-05-26,Village People - Go West,15,14,29,14.0,24,Go West,11.0,5,-5,-9,-1,1,down,1979-04-21
11669,Village People,1979-06-02,Village People - Go West,24,15,31,14.0,29,Go West,11.0,6,-2,-5,-9,1,down,1979-04-21
11670,Village People,1979-06-09,Village People - Go West,29,24,41,14.0,31,Go West,11.0,7,-10,-2,-5,1,down,1979-04-21
11671,Village People,1979-06-16,Village People - Go West,31,29,43,14.0,41,Go West,11.0,8,-2,-10,-2,1,down,1979-04-21
11672,Village People,1979-06-23,Village People - Go West,41,31,43,14.0,43,Go West,11.0,9,0,-2,-10,0,stay,1979-04-21
11673,Village People,1979-06-30,Village People - Go West,43,41,45,14.0,43,Go West,11.0,10,-2,0,-2,1,down,1979-04-21
11674,Village People,1979-07-07,Village People - Go West,43,43,51,14.0,45,Go West,11.0,11,-6,-2,0,1,down,1979-04-21
11675,Linda Clifford,1979-04-21,Linda Clifford - Let Me Be Your Woman,51,51,36,19.0,46,Let Me Be Your Woman,12.0,0,10,5,0,1,up,1979-04-21
11676,Linda Clifford,1979-04-28,Linda Clifford - Let Me Be Your Woman,46,51,30,19.0,36,Let Me Be Your Woman,12.0,1,6,10,5,1,up,1979-04-21
11677,Linda Clifford,1979-05-05,Linda Clifford - Let Me Be Your Woman,36,46,25,19.0,30,Let Me Be Your Woman,12.0,2,5,6,10,1,up,1979-04-21
11678,Linda Clifford,1979-05-12,Linda Clifford - Let Me Be Your Woman,30,36,24,19.0,25,Let Me Be Your Woman,12.0,3,1,5,6,1,up,1979-04-21
11679,Linda Clifford,1979-05-19,Linda Clifford - Let Me Be Your Woman,25,30,20,19.0,24,Let Me Be Your Woman,12.0,4,4,1,5,1,up,1979-04-21
11680,Linda Clifford,1979-05-26,Linda Clifford - Let Me Be Your Woman,24,25,19,19.0,20,Let Me Be Your Woman,12.0,5,1,4,1,1,up,1979-04-21
11681,Linda Clifford,1979-06-02,Linda Clifford - Let Me Be Your Woman,20,24,22,19.0,19,Let Me Be Your Woman,12.0,6,-3,1,4,1,down,1979-04-21
11682,Linda Clifford,1979-06-09,Linda Clifford - Let Me Be Your Woman,19,20,31,19.0,22,Let Me Be Your Woman,12.0,7,-9,-3,1,1,down,1979-04-21
11683,Linda Clifford,1979-06-16,Linda Clifford - Let Me Be Your Woman,22,19,32,19.0,31,Let Me Be Your Woman,12.0,8,-1,-9,-3,1,down,1979-04-21
11684,Linda Clifford,1979-06-23,Linda Clifford - Let Me Be Your Woman,31,22,35,19.0,32,Let Me Be Your Woman,12.0,9,-3,-1,-9,1,down,1979-04-21
11685,Linda Clifford,1979-06-30,Linda Clifford - Let Me Be Your Woman,32,31,36,19.0,35,Let Me Be Your Woman,12.0,10,-1,-3,-1,1,down,1979-04-21
11686,Linda Clifford,1979-07-07,Linda Clifford - Let Me Be Your Woman,35,32,48,19.0,36,Let Me Be Your Woman,12.0,11,-12,-1,-3,1,down,1979-04-21
11687,Linda Clifford,1979-07-14,Linda Clifford - Let Me Be Your Woman,36,35,51,19.0,48,Let Me Be Your Woman,12.0,12,-3,-12,-1,1,down,1979-04-21
11688,The Whispers,1979-04-21,The Whispers - Whisper In Your Ear,51,51,39,28.0,47,Whisper In Your Ear,9.0,0,8,4,0,1,up,1979-04-21
11689,The Whispers,1979-04-28,The Whispers - Whisper In Your Ear,47,51,33,28.0,39,Whisper In Your Ear,9.0,1,6,8,4,1,up,1979-04-21
11690,The Whispers,1979-05-05,The Whispers - Whisper In Your Ear,39,47,33,28.0,33,Whisper In Your Ear,9.0,2,0,6,8,0,stay,1979-04-21
11691,The Whispers,1979-05-12,The Whispers - Whisper In Your Ear,33,39,28,28.0,33,Whisper In Your Ear,9.0,3,5,0,6,1,up,1979-04-21
11692,The Whispers,1979-05-19,The Whispers - Whisper In Your Ear,33,33,28,28.0,28,Whisper In Your Ear,9.0,4,0,5,0,0,stay,1979-04-21
11693,The Whispers,1979-05-26,The Whispers - Whisper In Your Ear,28,33,39,28.0,28,Whisper In Your Ear,9.0,5,-11,0,5,1,down,1979-04-21
11694,The Whispers,1979-06-02,The Whispers - Whisper In Your Ear,28,28,28,28.0,39,Whisper In Your Ear,9.0,6,11,-11,0,1,up,1979-04-21
11695,The Whispers,1979-06-09,The Whispers - Whisper In Your Ear,39,28,28,28.0,28,Whisper In Your Ear,9.0,7,0,11,-11,0,stay,1979-04-21
11696,The Whispers,1979-06-16,The Whispers - Whisper In Your Ear,28,39,33,28.0,28,Whisper In Your Ear,9.0,8,-5,0,11,1,down,1979-04-21
11697,The Whispers,1979-06-23,The Whispers - Whisper In Your Ear,28,28,51,28.0,33,Whisper In Your Ear,9.0,9,-18,-5,0,1,down,1979-04-21
11698,Barry White,1979-04-21,Barry White - The Message Is Love,51,51,32,14.0,49,The Message Is Love,11.0,0,17,2,0,1,up,1979-04-21
11699,Barry White,1979-04-28,Barry White - The Message Is Love,49,51,22,14.0,32,The Message Is Love,11.0,1,10,17,2,1,up,1979-04-21
11700,Barry White,1979-05-05,Barry White - The Message Is Love,32,49,17,14.0,22,The Message Is Love,11.0,2,5,10,17,1,up,1979-04-21
11701,Barry White,1979-05-12,Barry White - The Message Is Love,22,32,14,14.0,17,The Message Is Love,11.0,3,3,5,10,1,up,1979-04-21
11702,Barry White,1979-05-19,Barry White - The Message Is Love,17,22,14,14.0,14,The Message Is Love,11.0,4,0,3,5,0,stay,1979-04-21
11703,Barry White,1979-05-26,Barry White - The Message Is Love,14,17,22,14.0,14,The Message Is Love,11.0,5,-8,0,3,1,down,1979-04-21
11704,Barry White,1979-06-02,Barry White - The Message Is Love,14,14,24,14.0,22,The Message Is Love,11.0,6,-2,-8,0,1,down,1979-04-21
11705,Barry White,1979-06-09,Barry White - The Message Is Love,22,14,40,14.0,24,The Message Is Love,11.0,7,-16,-2,-8,1,down,1979-04-21
11706,Barry White,1979-06-16,Barry White - The Message Is Love,24,22,40,14.0,40,The Message Is Love,11.0,8,0,-16,-2,0,stay,1979-04-21
11707,Barry White,1979-06-23,Barry White - The Message Is Love,40,24,40,14.0,40,The Message Is Love,11.0,9,0,0,-16,0,stay,1979-04-21
11708,Barry White,1979-06-30,Barry White - The Message Is Love,40,40,46,14.0,40,The Message Is Love,11.0,10,-6,0,0,1,down,1979-04-21
11709,Barry White,1979-07-07,Barry White - The Message Is Love,40,40,51,14.0,46,The Message Is Love,11.0,11,-5,-6,0,1,down,1979-04-21
11710,Raydio,1979-04-28,Raydio - Rock On,51,51,9,4.0,26,Rock On,27.0,0,17,25,0,1,up,1979-04-28
11711,Raydio,1979-05-05,Raydio - Rock On,26,51,6,4.0,9,Rock On,27.0,1,3,17,25,1,up,1979-04-28
11712,Raydio,1979-05-12,Raydio - Rock On,9,26,5,4.0,6,Rock On,27.0,2,1,3,17,1,up,1979-04-28
11713,Raydio,1979-05-19,Raydio - Rock On,6,9,4,4.0,5,Rock On,27.0,3,1,1,3,1,up,1979-04-28
11714,Raydio,1979-05-26,Raydio - Rock On,5,6,4,4.0,4,Rock On,27.0,4,0,1,1,0,stay,1979-04-28
11715,Raydio,1979-06-02,Raydio - Rock On,4,5,4,4.0,4,Rock On,27.0,5,0,0,1,0,stay,1979-04-28
11716,Raydio,1979-06-09,Raydio - Rock On,4,4,8,4.0,4,Rock On,27.0,6,-4,0,0,1,down,1979-04-28
11717,Raydio,1979-06-16,Raydio - Rock On,4,4,14,4.0,8,Rock On,27.0,7,-6,-4,0,1,down,1979-04-28
11718,Raydio,1979-06-23,Raydio - Rock On,8,4,12,4.0,14,Rock On,27.0,8,2,-6,-4,1,up,1979-04-28
11719,Raydio,1979-06-30,Raydio - Rock On,14,8,17,4.0,12,Rock On,27.0,9,-5,2,-6,1,down,1979-04-28
11720,Raydio,1979-07-07,Raydio - Rock On,12,14,19,4.0,17,Rock On,27.0,10,-2,-5,2,1,down,1979-04-28
11721,Raydio,1979-07-14,Raydio - Rock On,17,12,21,4.0,19,Rock On,27.0,11,-2,-2,-5,1,down,1979-04-28
11722,Raydio,1979-07-21,Raydio - Rock On,19,17,17,4.0,21,Rock On,27.0,12,4,-2,-2,1,up,1979-04-28
11723,Raydio,1979-07-28,Raydio - Rock On,21,19,11,4.0,17,Rock On,27.0,13,6,4,-2,1,up,1979-04-28
11724,Raydio,1979-08-04,Raydio - Rock On,17,21,9,4.0,11,Rock On,27.0,14,2,6,4,1,up,1979-04-28
11725,Raydio,1979-08-11,Raydio - Rock On,11,17,9,4.0,9,Rock On,27.0,15,0,2,6,0,stay,1979-04-28
11726,Raydio,1979-08-18,Raydio - Rock On,9,11,13,4.0,9,Rock On,27.0,16,-4,0,2,1,down,1979-04-28
11727,Raydio,1979-08-25,Raydio - Rock On,9,9,17,4.0,13,Rock On,27.0,17,-4,-4,0,1,down,1979-04-28
11728,Raydio,1979-09-01,Raydio - Rock On,13,9,21,4.0,17,Rock On,27.0,18,-4,-4,-4,1,down,1979-04-28
11729,Raydio,1979-09-08,Raydio - Rock On,17,13,28,4.0,21,Rock On,27.0,19,-7,-4,-4,1,down,1979-04-28
11730,Raydio,1979-09-15,Raydio - Rock On,21,17,29,4.0,28,Rock On,27.0,20,-1,-7,-4,1,down,1979-04-28
11731,Raydio,1979-09-22,Raydio - Rock On,28,21,29,4.0,29,Rock On,27.0,21,0,-1,-7,0,stay,1979-04-28
11732,Raydio,1979-09-29,Raydio - Rock On,29,28,31,4.0,29,Rock On,27.0,22,-2,0,-1,1,down,1979-04-28
11733,Raydio,1979-10-06,Raydio - Rock On,29,29,36,4.0,31,Rock On,27.0,23,-5,-2,0,1,down,1979-04-28
11734,Raydio,1979-10-13,Raydio - Rock On,31,29,36,4.0,36,Rock On,27.0,24,0,-5,-2,0,stay,1979-04-28
11735,Raydio,1979-10-20,Raydio - Rock On,36,31,38,4.0,36,Rock On,27.0,25,-2,0,-5,1,down,1979-04-28
11736,Raydio,1979-10-27,Raydio - Rock On,36,36,36,4.0,38,Rock On,27.0,26,2,-2,0,1,up,1979-04-28
11737,Raydio,1979-11-03,Raydio - Rock On,38,36,51,4.0,36,Rock On,27.0,27,-15,2,-2,1,down,1979-04-28
11738,Foxy,1979-04-28,Foxy - Hot Numbers,51,51,16,10.0,30,Hot Numbers,12.0,0,14,21,0,1,up,1979-04-28
11739,Foxy,1979-05-05,Foxy - Hot Numbers,30,51,13,10.0,16,Hot Numbers,12.0,1,3,14,21,1,up,1979-04-28
11740,Foxy,1979-05-12,Foxy - Hot Numbers,16,30,11,10.0,13,Hot Numbers,12.0,2,2,3,14,1,up,1979-04-28
11741,Foxy,1979-05-19,Foxy - Hot Numbers,13,16,10,10.0,11,Hot Numbers,12.0,3,1,2,3,1,up,1979-04-28
11742,Foxy,1979-05-26,Foxy - Hot Numbers,11,13,10,10.0,10,Hot Numbers,12.0,4,0,1,2,0,stay,1979-04-28
11743,Foxy,1979-06-02,Foxy - Hot Numbers,10,11,18,10.0,10,Hot Numbers,12.0,5,-8,0,1,1,down,1979-04-28
11744,Foxy,1979-06-09,Foxy - Hot Numbers,10,10,19,10.0,18,Hot Numbers,12.0,6,-1,-8,0,1,down,1979-04-28
11745,Foxy,1979-06-16,Foxy - Hot Numbers,18,10,22,10.0,19,Hot Numbers,12.0,7,-3,-1,-8,1,down,1979-04-28
11746,Foxy,1979-06-23,Foxy - Hot Numbers,19,18,33,10.0,22,Hot Numbers,12.0,8,-11,-3,-1,1,down,1979-04-28
11747,Foxy,1979-06-30,Foxy - Hot Numbers,22,19,33,10.0,33,Hot Numbers,12.0,9,0,-11,-3,0,stay,1979-04-28
11748,Foxy,1979-07-07,Foxy - Hot Numbers,33,22,38,10.0,33,Hot Numbers,12.0,10,-5,0,-11,1,down,1979-04-28
11749,Foxy,1979-07-14,Foxy - Hot Numbers,33,33,49,10.0,38,Hot Numbers,12.0,11,-11,-5,0,1,down,1979-04-28
11750,Foxy,1979-07-21,Foxy - Hot Numbers,38,33,51,10.0,49,Hot Numbers,12.0,12,-2,-11,-5,1,down,1979-04-28
11751,Ohio Players,1979-04-28,Ohio Players - Everybody Up,51,51,25,19.0,31,Everybody Up,15.0,0,6,20,0,1,up,1979-04-28
11752,Ohio Players,1979-05-05,Ohio Players - Everybody Up,31,51,21,19.0,25,Everybody Up,15.0,1,4,6,20,1,up,1979-04-28
11753,Ohio Players,1979-05-12,Ohio Players - Everybody Up,25,31,20,19.0,21,Everybody Up,15.0,2,1,4,6,1,up,1979-04-28
11754,Ohio Players,1979-05-19,Ohio Players - Everybody Up,21,25,19,19.0,20,Everybody Up,15.0,3,1,1,4,1,up,1979-04-28
11755,Ohio Players,1979-05-26,Ohio Players - Everybody Up,20,21,23,19.0,19,Everybody Up,15.0,4,-4,1,1,1,down,1979-04-28
11756,Ohio Players,1979-06-02,Ohio Players - Everybody Up,19,20,26,19.0,23,Everybody Up,15.0,5,-3,-4,1,1,down,1979-04-28
11757,Ohio Players,1979-06-09,Ohio Players - Everybody Up,23,19,23,19.0,26,Everybody Up,15.0,6,3,-3,-4,1,up,1979-04-28
11758,Ohio Players,1979-06-16,Ohio Players - Everybody Up,26,23,31,19.0,23,Everybody Up,15.0,7,-8,3,-3,1,down,1979-04-28
11759,Ohio Players,1979-06-23,Ohio Players - Everybody Up,23,26,32,19.0,31,Everybody Up,15.0,8,-1,-8,3,1,down,1979-04-28
11760,Ohio Players,1979-06-30,Ohio Players - Everybody Up,31,23,35,19.0,32,Everybody Up,15.0,9,-3,-1,-8,1,down,1979-04-28
11761,Ohio Players,1979-07-07,Ohio Players - Everybody Up,32,31,44,19.0,35,Everybody Up,15.0,10,-9,-3,-1,1,down,1979-04-28
11762,Ohio Players,1979-07-14,Ohio Players - Everybody Up,35,32,45,19.0,44,Everybody Up,15.0,11,-1,-9,-3,1,down,1979-04-28
11763,Ohio Players,1979-07-21,Ohio Players - Everybody Up,44,35,50,19.0,45,Everybody Up,15.0,12,-5,-1,-9,1,down,1979-04-28
11764,Ohio Players,1979-07-28,Ohio Players - Everybody Up,45,44,50,19.0,50,Everybody Up,15.0,13,0,-5,-1,0,stay,1979-04-28
11765,Ohio Players,1979-08-04,Ohio Players - Everybody Up,50,45,50,19.0,50,Everybody Up,15.0,14,0,0,-5,0,stay,1979-04-28
11766,Ohio Players,1979-08-11,Ohio Players - Everybody Up,50,50,51,19.0,50,Everybody Up,15.0,15,-1,0,0,1,down,1979-04-28
11767,Hubert Laws,1979-04-28,Hubert Laws - Land Of Passion,51,51,48,48.0,50,Land Of Passion,1.0,0,2,1,0,1,up,1979-04-28
11768,Hubert Laws,1979-05-05,Hubert Laws - Land Of Passion,50,51,51,48.0,48,Land Of Passion,1.0,1,-3,2,1,1,down,1979-04-28
11769,"Grover Washington, Jr.",1979-05-05,"Grover Washington, Jr. - Paradise",51,51,19,15.0,36,Paradise,12.0,0,17,15,0,1,up,1979-05-05
11770,"Grover Washington, Jr.",1979-05-12,"Grover Washington, Jr. - Paradise",36,51,19,15.0,19,Paradise,12.0,1,0,17,15,0,stay,1979-05-05
11771,"Grover Washington, Jr.",1979-05-19,"Grover Washington, Jr. - Paradise",19,36,15,15.0,19,Paradise,12.0,2,4,0,17,1,up,1979-05-05
11772,"Grover Washington, Jr.",1979-05-26,"Grover Washington, Jr. - Paradise",19,19,15,15.0,15,Paradise,12.0,3,0,4,0,0,stay,1979-05-05
11773,"Grover Washington, Jr.",1979-06-02,"Grover Washington, Jr. - Paradise",15,19,20,15.0,15,Paradise,12.0,4,-5,0,4,1,down,1979-05-05
11774,"Grover Washington, Jr.",1979-06-09,"Grover Washington, Jr. - Paradise",15,15,21,15.0,20,Paradise,12.0,5,-1,-5,0,1,down,1979-05-05
11775,"Grover Washington, Jr.",1979-06-16,"Grover Washington, Jr. - Paradise",20,15,30,15.0,21,Paradise,12.0,6,-9,-1,-5,1,down,1979-05-05
11776,"Grover Washington, Jr.",1979-06-23,"Grover Washington, Jr. - Paradise",21,20,30,15.0,30,Paradise,12.0,7,0,-9,-1,0,stay,1979-05-05
11777,"Grover Washington, Jr.",1979-06-30,"Grover Washington, Jr. - Paradise",30,21,31,15.0,30,Paradise,12.0,8,-1,0,-9,1,down,1979-05-05
11778,"Grover Washington, Jr.",1979-07-07,"Grover Washington, Jr. - Paradise",30,30,31,15.0,31,Paradise,12.0,9,0,-1,0,0,stay,1979-05-05
11779,"Grover Washington, Jr.",1979-07-14,"Grover Washington, Jr. - Paradise",31,30,34,15.0,31,Paradise,12.0,10,-3,0,-1,1,down,1979-05-05
11780,"Grover Washington, Jr.",1979-07-21,"Grover Washington, Jr. - Paradise",31,31,39,15.0,34,Paradise,12.0,11,-5,-3,0,1,down,1979-05-05
11781,"Grover Washington, Jr.",1979-07-28,"Grover Washington, Jr. - Paradise",34,31,51,15.0,39,Paradise,12.0,12,-12,-5,-3,1,down,1979-05-05
11782,Sylvester,1979-05-05,Sylvester - Stars,51,51,30,27.0,40,Stars,5.0,0,10,11,0,1,up,1979-05-05
11783,Sylvester,1979-05-12,Sylvester - Stars,40,51,29,27.0,30,Stars,5.0,1,1,10,11,1,up,1979-05-05
11784,Sylvester,1979-05-19,Sylvester - Stars,30,40,27,27.0,29,Stars,5.0,2,2,1,10,1,up,1979-05-05
11785,Sylvester,1979-05-26,Sylvester - Stars,29,30,30,27.0,27,Stars,5.0,3,-3,2,1,1,down,1979-05-05
11786,Sylvester,1979-06-02,Sylvester - Stars,27,29,41,27.0,30,Stars,5.0,4,-11,-3,2,1,down,1979-05-05
11787,Sylvester,1979-06-09,Sylvester - Stars,30,27,51,27.0,41,Stars,5.0,5,-10,-11,-3,1,down,1979-05-05
11788,The Gap Band,1979-05-12,The Gap Band - The Gap Band,51,51,25,10.0,35,The Gap Band,21.0,0,10,16,0,1,up,1979-05-12
11789,The Gap Band,1979-05-19,The Gap Band - The Gap Band,35,51,17,10.0,25,The Gap Band,21.0,1,8,10,16,1,up,1979-05-12
11790,The Gap Band,1979-05-26,The Gap Band - The Gap Band,25,35,14,10.0,17,The Gap Band,21.0,2,3,8,10,1,up,1979-05-12
11791,The Gap Band,1979-06-02,The Gap Band - The Gap Band,17,25,12,10.0,14,The Gap Band,21.0,3,2,3,8,1,up,1979-05-12
11792,The Gap Band,1979-06-09,The Gap Band - The Gap Band,14,17,10,10.0,12,The Gap Band,21.0,4,2,2,3,1,up,1979-05-12
11793,The Gap Band,1979-06-16,The Gap Band - The Gap Band,12,14,10,10.0,10,The Gap Band,21.0,5,0,2,2,0,stay,1979-05-12
11794,The Gap Band,1979-06-23,The Gap Band - The Gap Band,10,12,10,10.0,10,The Gap Band,21.0,6,0,0,2,0,stay,1979-05-12
11795,The Gap Band,1979-06-30,The Gap Band - The Gap Band,10,10,19,10.0,10,The Gap Band,21.0,7,-9,0,0,1,down,1979-05-12
11796,The Gap Band,1979-07-07,The Gap Band - The Gap Band,10,10,22,10.0,19,The Gap Band,21.0,8,-3,-9,0,1,down,1979-05-12
11797,The Gap Band,1979-07-14,The Gap Band - The Gap Band,19,10,28,10.0,22,The Gap Band,21.0,9,-6,-3,-9,1,down,1979-05-12
11798,The Gap Band,1979-07-21,The Gap Band - The Gap Band,22,19,27,10.0,28,The Gap Band,21.0,10,1,-6,-3,1,up,1979-05-12
11799,The Gap Band,1979-07-28,The Gap Band - The Gap Band,28,22,31,10.0,27,The Gap Band,21.0,11,-4,1,-6,1,down,1979-05-12
11800,The Gap Band,1979-08-04,The Gap Band - The Gap Band,27,28,43,10.0,31,The Gap Band,21.0,12,-12,-4,1,1,down,1979-05-12
11801,The Gap Band,1979-08-18,The Gap Band - The Gap Band,31,27,35,10.0,43,The Gap Band,21.0,13,8,-12,-4,1,up,1979-05-12
11802,The Gap Band,1979-08-25,The Gap Band - The Gap Band,43,31,28,10.0,35,The Gap Band,21.0,14,7,8,-12,1,up,1979-05-12
11803,The Gap Band,1979-09-01,The Gap Band - The Gap Band,35,43,27,10.0,28,The Gap Band,21.0,15,1,7,8,1,up,1979-05-12
11804,The Gap Band,1979-09-08,The Gap Band - The Gap Band,28,35,30,10.0,27,The Gap Band,21.0,16,-3,1,7,1,down,1979-05-12
11805,The Gap Band,1979-09-15,The Gap Band - The Gap Band,27,28,30,10.0,30,The Gap Band,21.0,17,0,-3,1,0,stay,1979-05-12
11806,The Gap Band,1979-09-22,The Gap Band - The Gap Band,30,27,36,10.0,30,The Gap Band,21.0,18,-6,0,-3,1,down,1979-05-12
11807,The Gap Band,1979-09-29,The Gap Band - The Gap Band,30,30,37,10.0,36,The Gap Band,21.0,19,-1,-6,0,1,down,1979-05-12
11808,The Gap Band,1979-10-06,The Gap Band - The Gap Band,36,30,39,10.0,37,The Gap Band,21.0,20,-2,-1,-6,1,down,1979-05-12
11809,The Gap Band,1979-10-13,The Gap Band - The Gap Band,37,36,51,10.0,39,The Gap Band,21.0,21,-12,-2,-1,1,down,1979-05-12
11810,Millie Jackson,1979-05-12,Millie Jackson - A Moment's Pleasure,51,51,47,47.0,47,A Moment's Pleasure,1.0,0,0,4,0,0,stay,1979-05-12
11811,Millie Jackson,1979-05-19,Millie Jackson - A Moment's Pleasure,47,51,51,47.0,47,A Moment's Pleasure,1.0,1,-4,0,4,1,down,1979-05-12
11812,Harvey Mason,1979-05-12,Harvey Mason - Groovin' You,51,51,48,48.0,48,Groovin' You,1.0,0,0,3,0,0,stay,1979-05-12
11813,Harvey Mason,1979-05-19,Harvey Mason - Groovin' You,48,51,51,48.0,48,Groovin' You,1.0,1,-3,0,3,1,down,1979-05-12
11814,Donna Summer,1979-05-19,Donna Summer - Bad Girls,51,51,8,1.0,40,Bad Girls,36.0,0,32,11,0,1,up,1979-05-19
11815,Donna Summer,1979-05-26,Donna Summer - Bad Girls,40,51,3,1.0,8,Bad Girls,36.0,1,5,32,11,1,up,1979-05-19
11816,Donna Summer,1979-06-02,Donna Summer - Bad Girls,8,40,2,1.0,3,Bad Girls,36.0,2,1,5,32,1,up,1979-05-19
11817,Donna Summer,1979-06-09,Donna Summer - Bad Girls,3,8,2,1.0,2,Bad Girls,36.0,3,0,1,5,0,stay,1979-05-19
11818,Donna Summer,1979-06-16,Donna Summer - Bad Girls,2,3,1,1.0,2,Bad Girls,36.0,4,1,0,1,1,up,1979-05-19
11819,Donna Summer,1979-06-23,Donna Summer - Bad Girls,2,2,1,1.0,1,Bad Girls,36.0,5,0,1,0,0,stay,1979-05-19
11820,Donna Summer,1979-06-30,Donna Summer - Bad Girls,1,2,1,1.0,1,Bad Girls,36.0,6,0,0,1,0,stay,1979-05-19
11821,Donna Summer,1979-07-07,Donna Summer - Bad Girls,1,1,5,1.0,1,Bad Girls,36.0,7,-4,0,0,1,down,1979-05-19
11822,Donna Summer,1979-07-14,Donna Summer - Bad Girls,1,1,4,1.0,5,Bad Girls,36.0,8,1,-4,0,1,up,1979-05-19
11823,Donna Summer,1979-07-21,Donna Summer - Bad Girls,5,1,4,1.0,4,Bad Girls,36.0,9,0,1,-4,0,stay,1979-05-19
11824,Donna Summer,1979-07-28,Donna Summer - Bad Girls,4,5,4,1.0,4,Bad Girls,36.0,10,0,0,1,0,stay,1979-05-19
11825,Donna Summer,1979-08-04,Donna Summer - Bad Girls,4,4,4,1.0,4,Bad Girls,36.0,11,0,0,0,0,stay,1979-05-19
11826,Donna Summer,1979-08-11,Donna Summer - Bad Girls,4,4,5,1.0,4,Bad Girls,36.0,12,-1,0,0,1,down,1979-05-19
11827,Donna Summer,1979-08-18,Donna Summer - Bad Girls,4,4,8,1.0,5,Bad Girls,36.0,13,-3,-1,0,1,down,1979-05-19
11828,Donna Summer,1979-08-25,Donna Summer - Bad Girls,5,4,9,1.0,8,Bad Girls,36.0,14,-1,-3,-1,1,down,1979-05-19
11829,Donna Summer,1979-09-01,Donna Summer - Bad Girls,8,5,13,1.0,9,Bad Girls,36.0,15,-4,-1,-3,1,down,1979-05-19
11830,Donna Summer,1979-09-08,Donna Summer - Bad Girls,9,8,14,1.0,13,Bad Girls,36.0,16,-1,-4,-1,1,down,1979-05-19
11831,Donna Summer,1979-09-15,Donna Summer - Bad Girls,13,9,18,1.0,14,Bad Girls,36.0,17,-4,-1,-4,1,down,1979-05-19
11832,Donna Summer,1979-09-22,Donna Summer - Bad Girls,14,13,19,1.0,18,Bad Girls,36.0,18,-1,-4,-1,1,down,1979-05-19
11833,Donna Summer,1979-09-29,Donna Summer - Bad Girls,18,14,21,1.0,19,Bad Girls,36.0,19,-2,-1,-4,1,down,1979-05-19
11834,Donna Summer,1979-10-06,Donna Summer - Bad Girls,19,18,22,1.0,21,Bad Girls,36.0,20,-1,-2,-1,1,down,1979-05-19
11835,Donna Summer,1979-10-13,Donna Summer - Bad Girls,21,19,23,1.0,22,Bad Girls,36.0,21,-1,-1,-2,1,down,1979-05-19
11836,Donna Summer,1979-10-20,Donna Summer - Bad Girls,22,21,29,1.0,23,Bad Girls,36.0,22,-6,-1,-1,1,down,1979-05-19
11837,Donna Summer,1979-10-27,Donna Summer - Bad Girls,23,22,29,1.0,29,Bad Girls,36.0,23,0,-6,-1,0,stay,1979-05-19
11838,Donna Summer,1979-11-03,Donna Summer - Bad Girls,29,23,35,1.0,29,Bad Girls,36.0,24,-6,0,-6,1,down,1979-05-19
11839,Donna Summer,1979-11-10,Donna Summer - Bad Girls,29,29,35,1.0,35,Bad Girls,36.0,25,0,-6,0,0,stay,1979-05-19
11840,Donna Summer,1979-11-17,Donna Summer - Bad Girls,35,29,36,1.0,35,Bad Girls,36.0,26,-1,0,-6,1,down,1979-05-19
11841,Donna Summer,1979-11-24,Donna Summer - Bad Girls,35,35,37,1.0,36,Bad Girls,36.0,27,-1,-1,0,1,down,1979-05-19
11842,Donna Summer,1979-12-01,Donna Summer - Bad Girls,36,35,37,1.0,37,Bad Girls,36.0,28,0,-1,-1,0,stay,1979-05-19
11843,Donna Summer,1979-12-08,Donna Summer - Bad Girls,37,36,37,1.0,37,Bad Girls,36.0,29,0,0,-1,0,stay,1979-05-19
11844,Donna Summer,1979-12-15,Donna Summer - Bad Girls,37,37,49,1.0,37,Bad Girls,36.0,30,-12,0,0,1,down,1979-05-19
11845,Donna Summer,1979-12-22,Donna Summer - Bad Girls,37,37,49,1.0,49,Bad Girls,36.0,31,0,-12,0,0,stay,1979-05-19
11846,Donna Summer,1979-12-29,Donna Summer - Bad Girls,49,37,49,1.0,49,Bad Girls,36.0,32,0,0,-12,0,stay,1979-05-19
11847,Donna Summer,1980-01-05,Donna Summer - Bad Girls,49,49,49,1.0,49,Bad Girls,36.0,33,0,0,0,0,stay,1979-05-19
11848,Donna Summer,1980-01-12,Donna Summer - Bad Girls,49,49,47,1.0,49,Bad Girls,36.0,34,2,0,0,1,up,1979-05-19
11849,Donna Summer,1980-01-19,Donna Summer - Bad Girls,49,49,49,1.0,47,Bad Girls,36.0,35,-2,2,0,1,down,1979-05-19
11850,Donna Summer,1980-02-09,Donna Summer - Bad Girls,47,49,51,1.0,49,Bad Girls,36.0,36,-2,-2,2,1,down,1979-05-19
11851,The Dramatics,1979-05-19,"The Dramatics - Any Time,any Place",51,51,35,15.0,45,"Any Time,any Place",18.0,0,10,6,0,1,up,1979-05-19
11852,The Dramatics,1979-05-26,"The Dramatics - Any Time,any Place",45,51,25,15.0,35,"Any Time,any Place",18.0,1,10,10,6,1,up,1979-05-19
11853,The Dramatics,1979-06-02,"The Dramatics - Any Time,any Place",35,45,23,15.0,25,"Any Time,any Place",18.0,2,2,10,10,1,up,1979-05-19
11854,The Dramatics,1979-06-09,"The Dramatics - Any Time,any Place",25,35,20,15.0,23,"Any Time,any Place",18.0,3,3,2,10,1,up,1979-05-19
11855,The Dramatics,1979-06-16,"The Dramatics - Any Time,any Place",23,25,15,15.0,20,"Any Time,any Place",18.0,4,5,3,2,1,up,1979-05-19
11856,The Dramatics,1979-06-23,"The Dramatics - Any Time,any Place",20,23,15,15.0,15,"Any Time,any Place",18.0,5,0,5,3,0,stay,1979-05-19
11857,The Dramatics,1979-06-30,"The Dramatics - Any Time,any Place",15,20,25,15.0,15,"Any Time,any Place",18.0,6,-10,0,5,1,down,1979-05-19
11858,The Dramatics,1979-07-07,"The Dramatics - Any Time,any Place",15,15,28,15.0,25,"Any Time,any Place",18.0,7,-3,-10,0,1,down,1979-05-19
11859,The Dramatics,1979-07-14,"The Dramatics - Any Time,any Place",25,15,36,15.0,28,"Any Time,any Place",18.0,8,-8,-3,-10,1,down,1979-05-19
11860,The Dramatics,1979-07-21,"The Dramatics - Any Time,any Place",28,25,45,15.0,36,"Any Time,any Place",18.0,9,-9,-8,-3,1,down,1979-05-19
11861,The Dramatics,1979-07-28,"The Dramatics - Any Time,any Place",36,28,40,15.0,45,"Any Time,any Place",18.0,10,5,-9,-8,1,up,1979-05-19
11862,The Dramatics,1979-08-04,"The Dramatics - Any Time,any Place",45,36,40,15.0,40,"Any Time,any Place",18.0,11,0,5,-9,0,stay,1979-05-19
11863,The Dramatics,1979-08-11,"The Dramatics - Any Time,any Place",40,45,42,15.0,40,"Any Time,any Place",18.0,12,-2,0,5,1,down,1979-05-19
11864,The Dramatics,1979-08-18,"The Dramatics - Any Time,any Place",40,40,42,15.0,42,"Any Time,any Place",18.0,13,0,-2,0,0,stay,1979-05-19
11865,The Dramatics,1979-08-25,"The Dramatics - Any Time,any Place",42,40,46,15.0,42,"Any Time,any Place",18.0,14,-4,0,-2,1,down,1979-05-19
11866,The Dramatics,1979-09-01,"The Dramatics - Any Time,any Place",42,42,46,15.0,46,"Any Time,any Place",18.0,15,0,-4,0,0,stay,1979-05-19
11867,The Dramatics,1979-09-08,"The Dramatics - Any Time,any Place",46,42,47,15.0,46,"Any Time,any Place",18.0,16,-1,0,-4,1,down,1979-05-19
11868,The Dramatics,1979-09-15,"The Dramatics - Any Time,any Place",46,46,48,15.0,47,"Any Time,any Place",18.0,17,-1,-1,0,1,down,1979-05-19
11869,The Dramatics,1979-09-22,"The Dramatics - Any Time,any Place",47,46,51,15.0,48,"Any Time,any Place",18.0,18,-3,-1,-1,1,down,1979-05-19
11870,Heatwave,1979-05-19,Heatwave - Hot Property,51,51,23,16.0,50,Hot Property,12.0,0,27,1,0,1,up,1979-05-19
11871,Heatwave,1979-05-26,Heatwave - Hot Property,50,51,17,16.0,23,Hot Property,12.0,1,6,27,1,1,up,1979-05-19
11872,Heatwave,1979-06-02,Heatwave - Hot Property,23,50,16,16.0,17,Hot Property,12.0,2,1,6,27,1,up,1979-05-19
11873,Heatwave,1979-06-09,Heatwave - Hot Property,17,23,17,16.0,16,Hot Property,12.0,3,-1,1,6,1,down,1979-05-19
11874,Heatwave,1979-06-16,Heatwave - Hot Property,16,17,17,16.0,17,Hot Property,12.0,4,0,-1,1,0,stay,1979-05-19
11875,Heatwave,1979-06-23,Heatwave - Hot Property,17,16,23,16.0,17,Hot Property,12.0,5,-6,0,-1,1,down,1979-05-19
11876,Heatwave,1979-06-30,Heatwave - Hot Property,17,17,24,16.0,23,Hot Property,12.0,6,-1,-6,0,1,down,1979-05-19
11877,Heatwave,1979-07-07,Heatwave - Hot Property,23,17,26,16.0,24,Hot Property,12.0,7,-2,-1,-6,1,down,1979-05-19
11878,Heatwave,1979-07-14,Heatwave - Hot Property,24,23,32,16.0,26,Hot Property,12.0,8,-6,-2,-1,1,down,1979-05-19
11879,Heatwave,1979-07-21,Heatwave - Hot Property,26,24,44,16.0,32,Hot Property,12.0,9,-12,-6,-2,1,down,1979-05-19
11880,Heatwave,1979-07-28,Heatwave - Hot Property,32,26,44,16.0,44,Hot Property,12.0,10,0,-12,-6,0,stay,1979-05-19
11881,Heatwave,1979-08-04,Heatwave - Hot Property,44,32,41,16.0,44,Hot Property,12.0,11,3,0,-12,1,up,1979-05-19
11882,Heatwave,1979-08-11,Heatwave - Hot Property,44,44,51,16.0,41,Hot Property,12.0,12,-10,3,0,1,down,1979-05-19
11883,McFadden And Whitehead,1979-05-26,McFadden And Whitehead - Mcfadden + Whitehead,51,51,9,5.0,25,Mcfadden + Whitehead,19.0,0,16,26,0,1,up,1979-05-26
11884,McFadden And Whitehead,1979-06-02,McFadden And Whitehead - Mcfadden + Whitehead,25,51,8,5.0,9,Mcfadden + Whitehead,19.0,1,1,16,26,1,up,1979-05-26
11885,McFadden And Whitehead,1979-06-09,McFadden And Whitehead - Mcfadden + Whitehead,9,25,6,5.0,8,Mcfadden + Whitehead,19.0,2,2,1,16,1,up,1979-05-26
11886,McFadden And Whitehead,1979-06-16,McFadden And Whitehead - Mcfadden + Whitehead,8,9,5,5.0,6,Mcfadden + Whitehead,19.0,3,1,2,1,1,up,1979-05-26
11887,McFadden And Whitehead,1979-06-23,McFadden And Whitehead - Mcfadden + Whitehead,6,8,5,5.0,5,Mcfadden + Whitehead,19.0,4,0,1,2,0,stay,1979-05-26
11888,McFadden And Whitehead,1979-06-30,McFadden And Whitehead - Mcfadden + Whitehead,5,6,7,5.0,5,Mcfadden + Whitehead,19.0,5,-2,0,1,1,down,1979-05-26
11889,McFadden And Whitehead,1979-07-07,McFadden And Whitehead - Mcfadden + Whitehead,5,5,7,5.0,7,Mcfadden + Whitehead,19.0,6,0,-2,0,0,stay,1979-05-26
11890,McFadden And Whitehead,1979-07-14,McFadden And Whitehead - Mcfadden + Whitehead,7,5,6,5.0,7,Mcfadden + Whitehead,19.0,7,1,0,-2,1,up,1979-05-26
11891,McFadden And Whitehead,1979-07-21,McFadden And Whitehead - Mcfadden + Whitehead,7,7,6,5.0,6,Mcfadden + Whitehead,19.0,8,0,1,0,0,stay,1979-05-26
11892,McFadden And Whitehead,1979-07-28,McFadden And Whitehead - Mcfadden + Whitehead,6,7,7,5.0,6,Mcfadden + Whitehead,19.0,9,-1,0,1,1,down,1979-05-26
11893,McFadden And Whitehead,1979-08-04,McFadden And Whitehead - Mcfadden + Whitehead,6,6,7,5.0,7,Mcfadden + Whitehead,19.0,10,0,-1,0,0,stay,1979-05-26
11894,McFadden And Whitehead,1979-08-11,McFadden And Whitehead - Mcfadden + Whitehead,7,6,15,5.0,7,Mcfadden + Whitehead,19.0,11,-8,0,-1,1,down,1979-05-26
11895,McFadden And Whitehead,1979-08-18,McFadden And Whitehead - Mcfadden + Whitehead,7,7,20,5.0,15,Mcfadden + Whitehead,19.0,12,-5,-8,0,1,down,1979-05-26
11896,McFadden And Whitehead,1979-08-25,McFadden And Whitehead - Mcfadden + Whitehead,15,7,22,5.0,20,Mcfadden + Whitehead,19.0,13,-2,-5,-8,1,down,1979-05-26
11897,McFadden And Whitehead,1979-09-01,McFadden And Whitehead - Mcfadden + Whitehead,20,15,22,5.0,22,Mcfadden + Whitehead,19.0,14,0,-2,-5,0,stay,1979-05-26
11898,McFadden And Whitehead,1979-09-08,McFadden And Whitehead - Mcfadden + Whitehead,22,20,31,5.0,22,Mcfadden + Whitehead,19.0,15,-9,0,-2,1,down,1979-05-26
11899,McFadden And Whitehead,1979-09-15,McFadden And Whitehead - Mcfadden + Whitehead,22,22,31,5.0,31,Mcfadden + Whitehead,19.0,16,0,-9,0,0,stay,1979-05-26
11900,McFadden And Whitehead,1979-09-22,McFadden And Whitehead - Mcfadden + Whitehead,31,22,37,5.0,31,Mcfadden + Whitehead,19.0,17,-6,0,-9,1,down,1979-05-26
11901,McFadden And Whitehead,1979-09-29,McFadden And Whitehead - Mcfadden + Whitehead,31,31,46,5.0,37,Mcfadden + Whitehead,19.0,18,-9,-6,0,1,down,1979-05-26
11902,McFadden And Whitehead,1979-10-06,McFadden And Whitehead - Mcfadden + Whitehead,37,31,51,5.0,46,Mcfadden + Whitehead,19.0,19,-5,-9,-6,1,down,1979-05-26
11903,ConFunkShun,1979-05-26,ConFunkShun - Candy,51,51,18,7.0,29,Candy,23.0,0,11,22,0,1,up,1979-05-26
11904,ConFunkShun,1979-06-02,ConFunkShun - Candy,29,51,14,7.0,18,Candy,23.0,1,4,11,22,1,up,1979-05-26
11905,ConFunkShun,1979-06-09,ConFunkShun - Candy,18,29,9,7.0,14,Candy,23.0,2,5,4,11,1,up,1979-05-26
11906,ConFunkShun,1979-06-16,ConFunkShun - Candy,14,18,7,7.0,9,Candy,23.0,3,2,5,4,1,up,1979-05-26
11907,ConFunkShun,1979-06-23,ConFunkShun - Candy,9,14,7,7.0,7,Candy,23.0,4,0,2,5,0,stay,1979-05-26
11908,ConFunkShun,1979-06-30,ConFunkShun - Candy,7,9,8,7.0,7,Candy,23.0,5,-1,0,2,1,down,1979-05-26
11909,ConFunkShun,1979-07-07,ConFunkShun - Candy,7,7,8,7.0,8,Candy,23.0,6,0,-1,0,0,stay,1979-05-26
11910,ConFunkShun,1979-07-14,ConFunkShun - Candy,8,7,8,7.0,8,Candy,23.0,7,0,0,-1,0,stay,1979-05-26
11911,ConFunkShun,1979-07-21,ConFunkShun - Candy,8,8,14,7.0,8,Candy,23.0,8,-6,0,0,1,down,1979-05-26
11912,ConFunkShun,1979-07-28,ConFunkShun - Candy,8,8,14,7.0,14,Candy,23.0,9,0,-6,0,0,stay,1979-05-26
11913,ConFunkShun,1979-08-04,ConFunkShun - Candy,14,8,15,7.0,14,Candy,23.0,10,-1,0,-6,1,down,1979-05-26
11914,ConFunkShun,1979-08-11,ConFunkShun - Candy,14,14,14,7.0,15,Candy,23.0,11,1,-1,0,1,up,1979-05-26
11915,ConFunkShun,1979-08-18,ConFunkShun - Candy,15,14,14,7.0,14,Candy,23.0,12,0,1,-1,0,stay,1979-05-26
11916,ConFunkShun,1979-08-25,ConFunkShun - Candy,14,15,18,7.0,14,Candy,23.0,13,-4,0,1,1,down,1979-05-26
11917,ConFunkShun,1979-09-01,ConFunkShun - Candy,14,14,19,7.0,18,Candy,23.0,14,-1,-4,0,1,down,1979-05-26
11918,ConFunkShun,1979-09-08,ConFunkShun - Candy,18,14,19,7.0,19,Candy,23.0,15,0,-1,-4,0,stay,1979-05-26
11919,ConFunkShun,1979-09-15,ConFunkShun - Candy,19,18,19,7.0,19,Candy,23.0,16,0,0,-1,0,stay,1979-05-26
11920,ConFunkShun,1979-09-22,ConFunkShun - Candy,19,19,18,7.0,19,Candy,23.0,17,1,0,0,1,up,1979-05-26
11921,ConFunkShun,1979-09-29,ConFunkShun - Candy,19,19,18,7.0,18,Candy,23.0,18,0,1,0,0,stay,1979-05-26
11922,ConFunkShun,1979-10-06,ConFunkShun - Candy,18,19,29,7.0,18,Candy,23.0,19,-11,0,1,1,down,1979-05-26
11923,ConFunkShun,1979-10-13,ConFunkShun - Candy,18,18,31,7.0,29,Candy,23.0,20,-2,-11,0,1,down,1979-05-26
11924,ConFunkShun,1979-10-20,ConFunkShun - Candy,29,18,35,7.0,31,Candy,23.0,21,-4,-2,-11,1,down,1979-05-26
11925,ConFunkShun,1979-10-27,ConFunkShun - Candy,31,29,35,7.0,35,Candy,23.0,22,0,-4,-2,0,stay,1979-05-26
11926,ConFunkShun,1979-11-03,ConFunkShun - Candy,35,31,51,7.0,35,Candy,23.0,23,-16,0,-4,1,down,1979-05-26
11927,Switch,1979-05-26,Switch - Switch Ii,51,51,24,8.0,34,Switch Ii,40.0,0,10,17,0,1,up,1979-05-26
11928,Switch,1979-06-02,Switch - Switch Ii,34,51,17,8.0,24,Switch Ii,40.0,1,7,10,17,1,up,1979-05-26
11929,Switch,1979-06-09,Switch - Switch Ii,24,34,13,8.0,17,Switch Ii,40.0,2,4,7,10,1,up,1979-05-26
11930,Switch,1979-06-16,Switch - Switch Ii,17,24,13,8.0,13,Switch Ii,40.0,3,0,4,7,0,stay,1979-05-26
11931,Switch,1979-06-23,Switch - Switch Ii,13,17,20,8.0,13,Switch Ii,40.0,4,-7,0,4,1,down,1979-05-26
11932,Switch,1979-06-30,Switch - Switch Ii,13,13,16,8.0,20,Switch Ii,40.0,5,4,-7,0,1,up,1979-05-26
11933,Switch,1979-07-07,Switch - Switch Ii,20,13,13,8.0,16,Switch Ii,40.0,6,3,4,-7,1,up,1979-05-26
11934,Switch,1979-07-14,Switch - Switch Ii,16,20,11,8.0,13,Switch Ii,40.0,7,2,3,4,1,up,1979-05-26
11935,Switch,1979-07-21,Switch - Switch Ii,13,16,11,8.0,11,Switch Ii,40.0,8,0,2,3,0,stay,1979-05-26
11936,Switch,1979-07-28,Switch - Switch Ii,11,13,16,8.0,11,Switch Ii,40.0,9,-5,0,2,1,down,1979-05-26
11937,Switch,1979-08-04,Switch - Switch Ii,11,11,13,8.0,16,Switch Ii,40.0,10,3,-5,0,1,up,1979-05-26
11938,Switch,1979-08-11,Switch - Switch Ii,16,11,11,8.0,13,Switch Ii,40.0,11,2,3,-5,1,up,1979-05-26
11939,Switch,1979-08-18,Switch - Switch Ii,13,16,9,8.0,11,Switch Ii,40.0,12,2,2,3,1,up,1979-05-26
11940,Switch,1979-08-25,Switch - Switch Ii,11,13,8,8.0,9,Switch Ii,40.0,13,1,2,2,1,up,1979-05-26
11941,Switch,1979-09-01,Switch - Switch Ii,9,11,8,8.0,8,Switch Ii,40.0,14,0,1,2,0,stay,1979-05-26
11942,Switch,1979-09-08,Switch - Switch Ii,8,9,9,8.0,8,Switch Ii,40.0,15,-1,0,1,1,down,1979-05-26
11943,Switch,1979-09-15,Switch - Switch Ii,8,8,16,8.0,9,Switch Ii,40.0,16,-7,-1,0,1,down,1979-05-26
11944,Switch,1979-09-22,Switch - Switch Ii,9,8,17,8.0,16,Switch Ii,40.0,17,-1,-7,-1,1,down,1979-05-26
11945,Switch,1979-09-29,Switch - Switch Ii,16,9,19,8.0,17,Switch Ii,40.0,18,-2,-1,-7,1,down,1979-05-26
11946,Switch,1979-10-06,Switch - Switch Ii,17,16,18,8.0,19,Switch Ii,40.0,19,1,-2,-1,1,up,1979-05-26
11947,Switch,1979-10-13,Switch - Switch Ii,19,17,16,8.0,18,Switch Ii,40.0,20,2,1,-2,1,up,1979-05-26
11948,Switch,1979-10-20,Switch - Switch Ii,18,19,16,8.0,16,Switch Ii,40.0,21,0,2,1,0,stay,1979-05-26
11949,Switch,1979-10-27,Switch - Switch Ii,16,18,17,8.0,16,Switch Ii,40.0,22,-1,0,2,1,down,1979-05-26
11950,Switch,1979-11-03,Switch - Switch Ii,16,16,22,8.0,17,Switch Ii,40.0,23,-5,-1,0,1,down,1979-05-26
11951,Switch,1979-11-10,Switch - Switch Ii,17,16,24,8.0,22,Switch Ii,40.0,24,-2,-5,-1,1,down,1979-05-26
11952,Switch,1979-11-17,Switch - Switch Ii,22,17,23,8.0,24,Switch Ii,40.0,25,1,-2,-5,1,up,1979-05-26
11953,Switch,1979-11-24,Switch - Switch Ii,24,22,23,8.0,23,Switch Ii,40.0,26,0,1,-2,0,stay,1979-05-26
11954,Switch,1979-12-01,Switch - Switch Ii,23,24,34,8.0,23,Switch Ii,40.0,27,-11,0,1,1,down,1979-05-26
11955,Switch,1979-12-08,Switch - Switch Ii,23,23,34,8.0,34,Switch Ii,40.0,28,0,-11,0,0,stay,1979-05-26
11956,Switch,1979-12-15,Switch - Switch Ii,34,23,37,8.0,34,Switch Ii,40.0,29,-3,0,-11,1,down,1979-05-26
11957,Switch,1979-12-22,Switch - Switch Ii,34,34,37,8.0,37,Switch Ii,40.0,30,0,-3,0,0,stay,1979-05-26
11958,Switch,1979-12-29,Switch - Switch Ii,37,34,37,8.0,37,Switch Ii,40.0,31,0,0,-3,0,stay,1979-05-26
11959,Switch,1980-01-05,Switch - Switch Ii,37,37,37,8.0,37,Switch Ii,40.0,32,0,0,0,0,stay,1979-05-26
11960,Switch,1980-01-12,Switch - Switch Ii,37,37,36,8.0,37,Switch Ii,40.0,33,1,0,0,1,up,1979-05-26
11961,Switch,1980-01-19,Switch - Switch Ii,37,37,36,8.0,36,Switch Ii,40.0,34,0,1,0,0,stay,1979-05-26
11962,Switch,1980-01-26,Switch - Switch Ii,36,37,33,8.0,36,Switch Ii,40.0,35,3,0,1,1,up,1979-05-26
11963,Switch,1980-02-02,Switch - Switch Ii,36,36,33,8.0,33,Switch Ii,40.0,36,0,3,0,0,stay,1979-05-26
11964,Switch,1980-02-09,Switch - Switch Ii,33,36,35,8.0,33,Switch Ii,40.0,37,-2,0,3,1,down,1979-05-26
11965,Switch,1980-02-16,Switch - Switch Ii,33,33,36,8.0,35,Switch Ii,40.0,38,-1,-2,0,1,down,1979-05-26
11966,Switch,1980-02-23,Switch - Switch Ii,35,33,39,8.0,36,Switch Ii,40.0,39,-3,-1,-2,1,down,1979-05-26
11967,Switch,1980-03-01,Switch - Switch Ii,36,35,51,8.0,39,Switch Ii,40.0,40,-12,-3,-1,1,down,1979-05-26
11968,Brick,1979-05-26,Brick - Stoneheart,51,51,26,25.0,36,Stoneheart,6.0,0,10,15,0,1,up,1979-05-26
11969,Brick,1979-06-02,Brick - Stoneheart,36,51,25,25.0,26,Stoneheart,6.0,1,1,10,15,1,up,1979-05-26
11970,Brick,1979-06-09,Brick - Stoneheart,26,36,36,25.0,25,Stoneheart,6.0,2,-11,1,10,1,down,1979-05-26
11971,Brick,1979-06-16,Brick - Stoneheart,25,26,36,25.0,36,Stoneheart,6.0,3,0,-11,1,0,stay,1979-05-26
11972,Brick,1979-06-23,Brick - Stoneheart,36,25,36,25.0,36,Stoneheart,6.0,4,0,0,-11,0,stay,1979-05-26
11973,Brick,1979-06-30,Brick - Stoneheart,36,36,39,25.0,36,Stoneheart,6.0,5,-3,0,0,1,down,1979-05-26
11974,Brick,1979-07-07,Brick - Stoneheart,36,36,51,25.0,39,Stoneheart,6.0,6,-12,-3,0,1,down,1979-05-26
11975,Anita Ward,1979-05-26,Anita Ward - Songs Of Love,51,51,20,2.0,38,Songs Of Love,16.0,0,18,13,0,1,up,1979-05-26
11976,Anita Ward,1979-06-02,Anita Ward - Songs Of Love,38,51,9,2.0,20,Songs Of Love,16.0,1,11,18,13,1,up,1979-05-26
11977,Anita Ward,1979-06-09,Anita Ward - Songs Of Love,20,38,4,2.0,9,Songs Of Love,16.0,2,5,11,18,1,up,1979-05-26
11978,Anita Ward,1979-06-16,Anita Ward - Songs Of Love,9,20,3,2.0,4,Songs Of Love,16.0,3,1,5,11,1,up,1979-05-26
11979,Anita Ward,1979-06-23,Anita Ward - Songs Of Love,4,9,2,2.0,3,Songs Of Love,16.0,4,1,1,5,1,up,1979-05-26
11980,Anita Ward,1979-06-30,Anita Ward - Songs Of Love,3,4,2,2.0,2,Songs Of Love,16.0,5,0,1,1,0,stay,1979-05-26
11981,Anita Ward,1979-07-07,Anita Ward - Songs Of Love,2,3,2,2.0,2,Songs Of Love,16.0,6,0,0,1,0,stay,1979-05-26
11982,Anita Ward,1979-07-14,Anita Ward - Songs Of Love,2,2,5,2.0,2,Songs Of Love,16.0,7,-3,0,0,1,down,1979-05-26
11983,Anita Ward,1979-07-21,Anita Ward - Songs Of Love,2,2,10,2.0,5,Songs Of Love,16.0,8,-5,-3,0,1,down,1979-05-26
11984,Anita Ward,1979-07-28,Anita Ward - Songs Of Love,5,2,10,2.0,10,Songs Of Love,16.0,9,0,-5,-3,0,stay,1979-05-26
11985,Anita Ward,1979-08-04,Anita Ward - Songs Of Love,10,5,23,2.0,10,Songs Of Love,16.0,10,-13,0,-5,1,down,1979-05-26
11986,Anita Ward,1979-08-11,Anita Ward - Songs Of Love,10,10,23,2.0,23,Songs Of Love,16.0,11,0,-13,0,0,stay,1979-05-26
11987,Anita Ward,1979-08-18,Anita Ward - Songs Of Love,23,10,27,2.0,23,Songs Of Love,16.0,12,-4,0,-13,1,down,1979-05-26
11988,Anita Ward,1979-08-25,Anita Ward - Songs Of Love,23,23,33,2.0,27,Songs Of Love,16.0,13,-6,-4,0,1,down,1979-05-26
11989,Anita Ward,1979-09-01,Anita Ward - Songs Of Love,27,23,33,2.0,33,Songs Of Love,16.0,14,0,-6,-4,0,stay,1979-05-26
11990,Anita Ward,1979-09-08,Anita Ward - Songs Of Love,33,27,41,2.0,33,Songs Of Love,16.0,15,-8,0,-6,1,down,1979-05-26
11991,Anita Ward,1979-09-15,Anita Ward - Songs Of Love,33,33,51,2.0,41,Songs Of Love,16.0,16,-10,-8,0,1,down,1979-05-26
11992,Earl Klugh,1979-05-26,Earl Klugh - Heart Strings,51,51,33,32.0,41,Heart Strings,7.0,0,8,10,0,1,up,1979-05-26
11993,Earl Klugh,1979-06-02,Earl Klugh - Heart Strings,41,51,33,32.0,33,Heart Strings,7.0,1,0,8,10,0,stay,1979-05-26
11994,Earl Klugh,1979-06-09,Earl Klugh - Heart Strings,33,41,37,32.0,33,Heart Strings,7.0,2,-4,0,8,1,down,1979-05-26
11995,Earl Klugh,1979-06-16,Earl Klugh - Heart Strings,33,33,42,32.0,37,Heart Strings,7.0,3,-5,-4,0,1,down,1979-05-26
11996,Earl Klugh,1979-06-23,Earl Klugh - Heart Strings,37,33,42,32.0,42,Heart Strings,7.0,4,0,-5,-4,0,stay,1979-05-26
11997,Earl Klugh,1979-06-30,Earl Klugh - Heart Strings,42,37,32,32.0,42,Heart Strings,7.0,5,10,0,-5,1,up,1979-05-26
11998,Earl Klugh,1979-07-07,Earl Klugh - Heart Strings,42,42,32,32.0,32,Heart Strings,7.0,6,0,10,0,0,stay,1979-05-26
11999,Earl Klugh,1979-07-14,Earl Klugh - Heart Strings,32,42,51,32.0,32,Heart Strings,7.0,7,-19,0,10,1,down,1979-05-26
12000,Minnie Riperton,1979-05-26,Minnie Riperton - Minnie,51,51,35,5.0,43,Minnie,26.0,0,8,8,0,1,up,1979-05-26
12001,Minnie Riperton,1979-06-02,Minnie Riperton - Minnie,43,51,29,5.0,35,Minnie,26.0,1,6,8,8,1,up,1979-05-26
12002,Minnie Riperton,1979-06-09,Minnie Riperton - Minnie,35,43,29,5.0,29,Minnie,26.0,2,0,6,8,0,stay,1979-05-26
12003,Minnie Riperton,1979-06-16,Minnie Riperton - Minnie,29,35,21,5.0,29,Minnie,26.0,3,8,0,6,1,up,1979-05-26
12004,Minnie Riperton,1979-06-23,Minnie Riperton - Minnie,29,29,17,5.0,21,Minnie,26.0,4,4,8,0,1,up,1979-05-26
12005,Minnie Riperton,1979-06-30,Minnie Riperton - Minnie,21,29,15,5.0,17,Minnie,26.0,5,2,4,8,1,up,1979-05-26
12006,Minnie Riperton,1979-07-07,Minnie Riperton - Minnie,17,21,16,5.0,15,Minnie,26.0,6,-1,2,4,1,down,1979-05-26
12007,Minnie Riperton,1979-07-14,Minnie Riperton - Minnie,15,17,22,5.0,16,Minnie,26.0,7,-6,-1,2,1,down,1979-05-26
12008,Minnie Riperton,1979-07-21,Minnie Riperton - Minnie,16,15,30,5.0,22,Minnie,26.0,8,-8,-6,-1,1,down,1979-05-26
12009,Minnie Riperton,1979-07-28,Minnie Riperton - Minnie,22,16,21,5.0,30,Minnie,26.0,9,9,-8,-6,1,up,1979-05-26
12010,Minnie Riperton,1979-08-04,Minnie Riperton - Minnie,30,22,11,5.0,21,Minnie,26.0,10,10,9,-8,1,up,1979-05-26
12011,Minnie Riperton,1979-08-11,Minnie Riperton - Minnie,21,30,7,5.0,11,Minnie,26.0,11,4,10,9,1,up,1979-05-26
12012,Minnie Riperton,1979-08-18,Minnie Riperton - Minnie,11,21,5,5.0,7,Minnie,26.0,12,2,4,10,1,up,1979-05-26
12013,Minnie Riperton,1979-08-25,Minnie Riperton - Minnie,7,11,5,5.0,5,Minnie,26.0,13,0,2,4,0,stay,1979-05-26
12014,Minnie Riperton,1979-09-01,Minnie Riperton - Minnie,5,7,12,5.0,5,Minnie,26.0,14,-7,0,2,1,down,1979-05-26
12015,Minnie Riperton,1979-09-08,Minnie Riperton - Minnie,5,5,12,5.0,12,Minnie,26.0,15,0,-7,0,0,stay,1979-05-26
12016,Minnie Riperton,1979-09-15,Minnie Riperton - Minnie,12,5,12,5.0,12,Minnie,26.0,16,0,0,-7,0,stay,1979-05-26
12017,Minnie Riperton,1979-09-22,Minnie Riperton - Minnie,12,12,13,5.0,12,Minnie,26.0,17,-1,0,0,1,down,1979-05-26
12018,Minnie Riperton,1979-09-29,Minnie Riperton - Minnie,12,12,13,5.0,13,Minnie,26.0,18,0,-1,0,0,stay,1979-05-26
12019,Minnie Riperton,1979-10-06,Minnie Riperton - Minnie,13,12,15,5.0,13,Minnie,26.0,19,-2,0,-1,1,down,1979-05-26
12020,Minnie Riperton,1979-10-13,Minnie Riperton - Minnie,13,13,15,5.0,15,Minnie,26.0,20,0,-2,0,0,stay,1979-05-26
12021,Minnie Riperton,1979-10-20,Minnie Riperton - Minnie,15,13,30,5.0,15,Minnie,26.0,21,-15,0,-2,1,down,1979-05-26
12022,Minnie Riperton,1979-10-27,Minnie Riperton - Minnie,15,15,30,5.0,30,Minnie,26.0,22,0,-15,0,0,stay,1979-05-26
12023,Minnie Riperton,1979-11-03,Minnie Riperton - Minnie,30,15,43,5.0,30,Minnie,26.0,23,-13,0,-15,1,down,1979-05-26
12024,Minnie Riperton,1979-11-10,Minnie Riperton - Minnie,30,30,43,5.0,43,Minnie,26.0,24,0,-13,0,0,stay,1979-05-26
12025,Minnie Riperton,1979-11-17,Minnie Riperton - Minnie,43,30,50,5.0,43,Minnie,26.0,25,-7,0,-13,1,down,1979-05-26
12026,Minnie Riperton,1979-11-24,Minnie Riperton - Minnie,43,43,51,5.0,50,Minnie,26.0,26,-1,-7,0,1,down,1979-05-26
12027,Carrie Lucas,1979-05-26,Carrie Lucas - Carrie Lucas In Danceland,51,51,37,37.0,47,Carrie Lucas In Danceland,4.0,0,10,4,0,1,up,1979-05-26
12028,Carrie Lucas,1979-06-02,Carrie Lucas - Carrie Lucas In Danceland,47,51,37,37.0,37,Carrie Lucas In Danceland,4.0,1,0,10,4,0,stay,1979-05-26
12029,Carrie Lucas,1979-06-09,Carrie Lucas - Carrie Lucas In Danceland,37,47,47,37.0,37,Carrie Lucas In Danceland,4.0,2,-10,0,10,1,down,1979-05-26
12030,Carrie Lucas,1979-06-16,Carrie Lucas - Carrie Lucas In Danceland,37,37,47,37.0,47,Carrie Lucas In Danceland,4.0,3,0,-10,0,0,stay,1979-05-26
12031,Carrie Lucas,1979-06-23,Carrie Lucas - Carrie Lucas In Danceland,47,37,51,37.0,47,Carrie Lucas In Danceland,4.0,4,-4,0,-10,1,down,1979-05-26
12032,Stephanie Mills,1979-05-26,Stephanie Mills - What Cha Gonna Do With My Lovin',51,51,38,12.0,48,What Cha Gonna Do With My Lovin',29.0,0,10,3,0,1,up,1979-05-26
12033,Stephanie Mills,1979-06-02,Stephanie Mills - What Cha Gonna Do With My Lovin',48,51,30,12.0,38,What Cha Gonna Do With My Lovin',29.0,1,8,10,3,1,up,1979-05-26
12034,Stephanie Mills,1979-06-09,Stephanie Mills - What Cha Gonna Do With My Lovin',38,48,24,12.0,30,What Cha Gonna Do With My Lovin',29.0,2,6,8,10,1,up,1979-05-26
12035,Stephanie Mills,1979-06-16,Stephanie Mills - What Cha Gonna Do With My Lovin',30,38,24,12.0,24,What Cha Gonna Do With My Lovin',29.0,3,0,6,8,0,stay,1979-05-26
12036,Stephanie Mills,1979-06-23,Stephanie Mills - What Cha Gonna Do With My Lovin',24,30,22,12.0,24,What Cha Gonna Do With My Lovin',29.0,4,2,0,6,1,up,1979-05-26
12037,Stephanie Mills,1979-06-30,Stephanie Mills - What Cha Gonna Do With My Lovin',24,24,23,12.0,22,What Cha Gonna Do With My Lovin',29.0,5,-1,2,0,1,down,1979-05-26
12038,Stephanie Mills,1979-07-07,Stephanie Mills - What Cha Gonna Do With My Lovin',22,24,21,12.0,23,What Cha Gonna Do With My Lovin',29.0,6,2,-1,2,1,up,1979-05-26
12039,Stephanie Mills,1979-07-14,Stephanie Mills - What Cha Gonna Do With My Lovin',23,22,17,12.0,21,What Cha Gonna Do With My Lovin',29.0,7,4,2,-1,1,up,1979-05-26
12040,Stephanie Mills,1979-07-21,Stephanie Mills - What Cha Gonna Do With My Lovin',21,23,12,12.0,17,What Cha Gonna Do With My Lovin',29.0,8,5,4,2,1,up,1979-05-26
12041,Stephanie Mills,1979-07-28,Stephanie Mills - What Cha Gonna Do With My Lovin',17,21,12,12.0,12,What Cha Gonna Do With My Lovin',29.0,9,0,5,4,0,stay,1979-05-26
12042,Stephanie Mills,1979-08-04,Stephanie Mills - What Cha Gonna Do With My Lovin',12,17,12,12.0,12,What Cha Gonna Do With My Lovin',29.0,10,0,0,5,0,stay,1979-05-26
12043,Stephanie Mills,1979-08-11,Stephanie Mills - What Cha Gonna Do With My Lovin',12,12,16,12.0,12,What Cha Gonna Do With My Lovin',29.0,11,-4,0,0,1,down,1979-05-26
12044,Stephanie Mills,1979-08-18,Stephanie Mills - What Cha Gonna Do With My Lovin',12,12,16,12.0,16,What Cha Gonna Do With My Lovin',29.0,12,0,-4,0,0,stay,1979-05-26
12045,Stephanie Mills,1979-08-25,Stephanie Mills - What Cha Gonna Do With My Lovin',16,12,16,12.0,16,What Cha Gonna Do With My Lovin',29.0,13,0,0,-4,0,stay,1979-05-26
12046,Stephanie Mills,1979-09-01,Stephanie Mills - What Cha Gonna Do With My Lovin',16,16,18,12.0,16,What Cha Gonna Do With My Lovin',29.0,14,-2,0,0,1,down,1979-05-26
12047,Stephanie Mills,1979-09-08,Stephanie Mills - What Cha Gonna Do With My Lovin',16,16,15,12.0,18,What Cha Gonna Do With My Lovin',29.0,15,3,-2,0,1,up,1979-05-26
12048,Stephanie Mills,1979-09-15,Stephanie Mills - What Cha Gonna Do With My Lovin',18,16,15,12.0,15,What Cha Gonna Do With My Lovin',29.0,16,0,3,-2,0,stay,1979-05-26
12049,Stephanie Mills,1979-09-22,Stephanie Mills - What Cha Gonna Do With My Lovin',15,18,12,12.0,15,What Cha Gonna Do With My Lovin',29.0,17,3,0,3,1,up,1979-05-26
12050,Stephanie Mills,1979-09-29,Stephanie Mills - What Cha Gonna Do With My Lovin',15,15,12,12.0,12,What Cha Gonna Do With My Lovin',29.0,18,0,3,0,0,stay,1979-05-26
12051,Stephanie Mills,1979-10-06,Stephanie Mills - What Cha Gonna Do With My Lovin',12,15,14,12.0,12,What Cha Gonna Do With My Lovin',29.0,19,-2,0,3,1,down,1979-05-26
12052,Stephanie Mills,1979-10-13,Stephanie Mills - What Cha Gonna Do With My Lovin',12,12,14,12.0,14,What Cha Gonna Do With My Lovin',29.0,20,0,-2,0,0,stay,1979-05-26
12053,Stephanie Mills,1979-10-20,Stephanie Mills - What Cha Gonna Do With My Lovin',14,12,17,12.0,14,What Cha Gonna Do With My Lovin',29.0,21,-3,0,-2,1,down,1979-05-26
12054,Stephanie Mills,1979-10-27,Stephanie Mills - What Cha Gonna Do With My Lovin',14,14,23,12.0,17,What Cha Gonna Do With My Lovin',29.0,22,-6,-3,0,1,down,1979-05-26
12055,Stephanie Mills,1979-11-03,Stephanie Mills - What Cha Gonna Do With My Lovin',17,14,28,12.0,23,What Cha Gonna Do With My Lovin',29.0,23,-5,-6,-3,1,down,1979-05-26
12056,Stephanie Mills,1979-11-10,Stephanie Mills - What Cha Gonna Do With My Lovin',23,17,28,12.0,28,What Cha Gonna Do With My Lovin',29.0,24,0,-5,-6,0,stay,1979-05-26
12057,Stephanie Mills,1979-11-17,Stephanie Mills - What Cha Gonna Do With My Lovin',28,23,29,12.0,28,What Cha Gonna Do With My Lovin',29.0,25,-1,0,-5,1,down,1979-05-26
12058,Stephanie Mills,1979-11-24,Stephanie Mills - What Cha Gonna Do With My Lovin',28,28,34,12.0,29,What Cha Gonna Do With My Lovin',29.0,26,-5,-1,0,1,down,1979-05-26
12059,Stephanie Mills,1979-12-01,Stephanie Mills - What Cha Gonna Do With My Lovin',29,28,40,12.0,34,What Cha Gonna Do With My Lovin',29.0,27,-6,-5,-1,1,down,1979-05-26
12060,Stephanie Mills,1979-12-08,Stephanie Mills - What Cha Gonna Do With My Lovin',34,29,42,12.0,40,What Cha Gonna Do With My Lovin',29.0,28,-2,-6,-5,1,down,1979-05-26
12061,Stephanie Mills,1979-12-15,Stephanie Mills - What Cha Gonna Do With My Lovin',40,34,51,12.0,42,What Cha Gonna Do With My Lovin',29.0,29,-9,-2,-6,1,down,1979-05-26
12062,The Jones Girls,1979-06-02,The Jones Girls - The Jones Girls,51,51,36,8.0,47,The Jones Girls,17.0,0,11,4,0,1,up,1979-06-02
12063,The Jones Girls,1979-06-09,The Jones Girls - The Jones Girls,47,51,34,8.0,36,The Jones Girls,17.0,1,2,11,4,1,up,1979-06-02
12064,The Jones Girls,1979-06-16,The Jones Girls - The Jones Girls,36,47,23,8.0,34,The Jones Girls,17.0,2,11,2,11,1,up,1979-06-02
12065,The Jones Girls,1979-06-23,The Jones Girls - The Jones Girls,34,36,18,8.0,23,The Jones Girls,17.0,3,5,11,2,1,up,1979-06-02
12066,The Jones Girls,1979-06-30,The Jones Girls - The Jones Girls,23,34,14,8.0,18,The Jones Girls,17.0,4,4,5,11,1,up,1979-06-02
12067,The Jones Girls,1979-07-07,The Jones Girls - The Jones Girls,18,23,11,8.0,14,The Jones Girls,17.0,5,3,4,5,1,up,1979-06-02
12068,The Jones Girls,1979-07-14,The Jones Girls - The Jones Girls,14,18,9,8.0,11,The Jones Girls,17.0,6,2,3,4,1,up,1979-06-02
12069,The Jones Girls,1979-07-21,The Jones Girls - The Jones Girls,11,14,8,8.0,9,The Jones Girls,17.0,7,1,2,3,1,up,1979-06-02
12070,The Jones Girls,1979-07-28,The Jones Girls - The Jones Girls,9,11,8,8.0,8,The Jones Girls,17.0,8,0,1,2,0,stay,1979-06-02
12071,The Jones Girls,1979-08-04,The Jones Girls - The Jones Girls,8,9,8,8.0,8,The Jones Girls,17.0,9,0,0,1,0,stay,1979-06-02
12072,The Jones Girls,1979-08-11,The Jones Girls - The Jones Girls,8,8,13,8.0,8,The Jones Girls,17.0,10,-5,0,0,1,down,1979-06-02
12073,The Jones Girls,1979-08-18,The Jones Girls - The Jones Girls,8,8,19,8.0,13,The Jones Girls,17.0,11,-6,-5,0,1,down,1979-06-02
12074,The Jones Girls,1979-08-25,The Jones Girls - The Jones Girls,13,8,19,8.0,19,The Jones Girls,17.0,12,0,-6,-5,0,stay,1979-06-02
12075,The Jones Girls,1979-09-01,The Jones Girls - The Jones Girls,19,13,28,8.0,19,The Jones Girls,17.0,13,-9,0,-6,1,down,1979-06-02
12076,The Jones Girls,1979-09-08,The Jones Girls - The Jones Girls,19,19,33,8.0,28,The Jones Girls,17.0,14,-5,-9,0,1,down,1979-06-02
12077,The Jones Girls,1979-09-15,The Jones Girls - The Jones Girls,28,19,34,8.0,33,The Jones Girls,17.0,15,-1,-5,-9,1,down,1979-06-02
12078,The Jones Girls,1979-09-22,The Jones Girls - The Jones Girls,33,28,40,8.0,34,The Jones Girls,17.0,16,-6,-1,-5,1,down,1979-06-02
12079,The Jones Girls,1979-09-29,The Jones Girls - The Jones Girls,34,33,51,8.0,40,The Jones Girls,17.0,17,-11,-6,-1,1,down,1979-06-02
12080,Roy Ayers,1979-06-02,Roy Ayers - Fever,51,51,39,25.0,49,Fever,11.0,0,10,2,0,1,up,1979-06-02
12081,Roy Ayers,1979-06-09,Roy Ayers - Fever,49,51,26,25.0,39,Fever,11.0,1,13,10,2,1,up,1979-06-02
12082,Roy Ayers,1979-06-16,Roy Ayers - Fever,39,49,25,25.0,26,Fever,11.0,2,1,13,10,1,up,1979-06-02
12083,Roy Ayers,1979-06-23,Roy Ayers - Fever,26,39,25,25.0,25,Fever,11.0,3,0,1,13,0,stay,1979-06-02
12084,Roy Ayers,1979-06-30,Roy Ayers - Fever,25,26,26,25.0,25,Fever,11.0,4,-1,0,1,1,down,1979-06-02
12085,Roy Ayers,1979-07-07,Roy Ayers - Fever,25,25,27,25.0,26,Fever,11.0,5,-1,-1,0,1,down,1979-06-02
12086,Roy Ayers,1979-07-14,Roy Ayers - Fever,26,25,30,25.0,27,Fever,11.0,6,-3,-1,-1,1,down,1979-06-02
12087,Roy Ayers,1979-07-21,Roy Ayers - Fever,27,26,32,25.0,30,Fever,11.0,7,-2,-3,-1,1,down,1979-06-02
12088,Roy Ayers,1979-07-28,Roy Ayers - Fever,30,27,35,25.0,32,Fever,11.0,8,-3,-2,-3,1,down,1979-06-02
12089,Roy Ayers,1979-08-04,Roy Ayers - Fever,32,30,33,25.0,35,Fever,11.0,9,2,-3,-2,1,up,1979-06-02
12090,Roy Ayers,1979-08-11,Roy Ayers - Fever,35,32,39,25.0,33,Fever,11.0,10,-6,2,-3,1,down,1979-06-02
12091,Roy Ayers,1979-08-18,Roy Ayers - Fever,33,35,51,25.0,39,Fever,11.0,11,-12,-6,2,1,down,1979-06-02
12092,Spyro Gyra,1979-06-02,Spyro Gyra - Morning Dance,51,51,42,33.0,50,Morning Dance,13.0,0,8,1,0,1,up,1979-06-02
12093,Spyro Gyra,1979-06-09,Spyro Gyra - Morning Dance,50,51,42,33.0,42,Morning Dance,13.0,1,0,8,1,0,stay,1979-06-02
12094,Spyro Gyra,1979-06-16,Spyro Gyra - Morning Dance,42,50,43,33.0,42,Morning Dance,13.0,2,-1,0,8,1,down,1979-06-02
12095,Spyro Gyra,1979-08-11,Spyro Gyra - Morning Dance,42,42,33,33.0,43,Morning Dance,13.0,3,10,-1,0,1,up,1979-06-02
12096,Spyro Gyra,1979-08-18,Spyro Gyra - Morning Dance,43,42,33,33.0,33,Morning Dance,13.0,4,0,10,-1,0,stay,1979-06-02
12097,Spyro Gyra,1979-08-25,Spyro Gyra - Morning Dance,33,43,42,33.0,33,Morning Dance,13.0,5,-9,0,10,1,down,1979-06-02
12098,Spyro Gyra,1979-09-01,Spyro Gyra - Morning Dance,33,33,42,33.0,42,Morning Dance,13.0,6,0,-9,0,0,stay,1979-06-02
12099,Spyro Gyra,1979-09-08,Spyro Gyra - Morning Dance,42,33,43,33.0,42,Morning Dance,13.0,7,-1,0,-9,1,down,1979-06-02
12100,Spyro Gyra,1979-09-15,Spyro Gyra - Morning Dance,42,42,43,33.0,43,Morning Dance,13.0,8,0,-1,0,0,stay,1979-06-02
12101,Spyro Gyra,1979-09-22,Spyro Gyra - Morning Dance,43,42,47,33.0,43,Morning Dance,13.0,9,-4,0,-1,1,down,1979-06-02
12102,Spyro Gyra,1979-09-29,Spyro Gyra - Morning Dance,43,43,48,33.0,47,Morning Dance,13.0,10,-1,-4,0,1,down,1979-06-02
12103,Spyro Gyra,1979-10-06,Spyro Gyra - Morning Dance,47,43,50,33.0,48,Morning Dance,13.0,11,-2,-1,-4,1,down,1979-06-02
12104,Spyro Gyra,1979-10-13,Spyro Gyra - Morning Dance,48,47,50,33.0,50,Morning Dance,13.0,12,0,-2,-1,0,stay,1979-06-02
12105,Spyro Gyra,1979-10-20,Spyro Gyra - Morning Dance,50,48,51,33.0,50,Morning Dance,13.0,13,-1,0,-2,1,down,1979-06-02
12106,Teena Marie,1979-06-09,Teena Marie - Wild + Peaceful,51,51,33,18.0,43,Wild + Peaceful,17.0,0,10,8,0,1,up,1979-06-09
12107,Teena Marie,1979-06-16,Teena Marie - Wild + Peaceful,43,51,26,18.0,33,Wild + Peaceful,17.0,1,7,10,8,1,up,1979-06-09
12108,Teena Marie,1979-06-23,Teena Marie - Wild + Peaceful,33,43,21,18.0,26,Wild + Peaceful,17.0,2,5,7,10,1,up,1979-06-09
12109,Teena Marie,1979-06-30,Teena Marie - Wild + Peaceful,26,33,18,18.0,21,Wild + Peaceful,17.0,3,3,5,7,1,up,1979-06-09
12110,Teena Marie,1979-07-07,Teena Marie - Wild + Peaceful,21,26,18,18.0,18,Wild + Peaceful,17.0,4,0,3,5,0,stay,1979-06-09
12111,Teena Marie,1979-07-14,Teena Marie - Wild + Peaceful,18,21,18,18.0,18,Wild + Peaceful,17.0,5,0,0,3,0,stay,1979-06-09
12112,Teena Marie,1979-07-21,Teena Marie - Wild + Peaceful,18,18,19,18.0,18,Wild + Peaceful,17.0,6,-1,0,0,1,down,1979-06-09
12113,Teena Marie,1979-07-28,Teena Marie - Wild + Peaceful,18,18,20,18.0,19,Wild + Peaceful,17.0,7,-1,-1,0,1,down,1979-06-09
12114,Teena Marie,1979-08-04,Teena Marie - Wild + Peaceful,19,18,32,18.0,20,Wild + Peaceful,17.0,8,-12,-1,-1,1,down,1979-06-09
12115,Teena Marie,1979-08-11,Teena Marie - Wild + Peaceful,20,19,25,18.0,32,Wild + Peaceful,17.0,9,7,-12,-1,1,up,1979-06-09
12116,Teena Marie,1979-08-18,Teena Marie - Wild + Peaceful,32,20,25,18.0,25,Wild + Peaceful,17.0,10,0,7,-12,0,stay,1979-06-09
12117,Teena Marie,1979-08-25,Teena Marie - Wild + Peaceful,25,32,24,18.0,25,Wild + Peaceful,17.0,11,1,0,7,1,up,1979-06-09
12118,Teena Marie,1979-09-01,Teena Marie - Wild + Peaceful,25,25,29,18.0,24,Wild + Peaceful,17.0,12,-5,1,0,1,down,1979-06-09
12119,Teena Marie,1979-09-08,Teena Marie - Wild + Peaceful,24,25,39,18.0,29,Wild + Peaceful,17.0,13,-10,-5,1,1,down,1979-06-09
12120,Teena Marie,1979-09-15,Teena Marie - Wild + Peaceful,29,24,39,18.0,39,Wild + Peaceful,17.0,14,0,-10,-5,0,stay,1979-06-09
12121,Teena Marie,1979-09-22,Teena Marie - Wild + Peaceful,39,29,42,18.0,39,Wild + Peaceful,17.0,15,-3,0,-10,1,down,1979-06-09
12122,Teena Marie,1979-09-29,Teena Marie - Wild + Peaceful,39,39,45,18.0,42,Wild + Peaceful,17.0,16,-3,-3,0,1,down,1979-06-09
12123,Teena Marie,1979-10-06,Teena Marie - Wild + Peaceful,42,39,51,18.0,45,Wild + Peaceful,17.0,17,-6,-3,-3,1,down,1979-06-09
12124,The Crusaders,1979-06-09,The Crusaders - Street Life,51,51,25,3.0,48,Street Life,29.0,0,23,3,0,1,up,1979-06-09
12125,The Crusaders,1979-06-16,The Crusaders - Street Life,48,51,19,3.0,25,Street Life,29.0,1,6,23,3,1,up,1979-06-09
12126,The Crusaders,1979-06-23,The Crusaders - Street Life,25,48,14,3.0,19,Street Life,29.0,2,5,6,23,1,up,1979-06-09
12127,The Crusaders,1979-06-30,The Crusaders - Street Life,19,25,10,3.0,14,Street Life,29.0,3,4,5,6,1,up,1979-06-09
12128,The Crusaders,1979-07-07,The Crusaders - Street Life,14,19,10,3.0,10,Street Life,29.0,4,0,4,5,0,stay,1979-06-09
12129,The Crusaders,1979-07-14,The Crusaders - Street Life,10,14,7,3.0,10,Street Life,29.0,5,3,0,4,1,up,1979-06-09
12130,The Crusaders,1979-07-21,The Crusaders - Street Life,10,10,7,3.0,7,Street Life,29.0,6,0,3,0,0,stay,1979-06-09
12131,The Crusaders,1979-07-28,The Crusaders - Street Life,7,10,6,3.0,7,Street Life,29.0,7,1,0,3,1,up,1979-06-09
12132,The Crusaders,1979-08-04,The Crusaders - Street Life,7,7,5,3.0,6,Street Life,29.0,8,1,1,0,1,up,1979-06-09
12133,The Crusaders,1979-08-11,The Crusaders - Street Life,6,7,4,3.0,5,Street Life,29.0,9,1,1,1,1,up,1979-06-09
12134,The Crusaders,1979-08-18,The Crusaders - Street Life,5,6,3,3.0,4,Street Life,29.0,10,1,1,1,1,up,1979-06-09
12135,The Crusaders,1979-08-25,The Crusaders - Street Life,4,5,3,3.0,3,Street Life,29.0,11,0,1,1,0,stay,1979-06-09
12136,The Crusaders,1979-09-01,The Crusaders - Street Life,3,4,4,3.0,3,Street Life,29.0,12,-1,0,1,1,down,1979-06-09
12137,The Crusaders,1979-09-08,The Crusaders - Street Life,3,3,6,3.0,4,Street Life,29.0,13,-2,-1,0,1,down,1979-06-09
12138,The Crusaders,1979-09-15,The Crusaders - Street Life,4,3,9,3.0,6,Street Life,29.0,14,-3,-2,-1,1,down,1979-06-09
12139,The Crusaders,1979-09-22,The Crusaders - Street Life,6,4,9,3.0,9,Street Life,29.0,15,0,-3,-2,0,stay,1979-06-09
12140,The Crusaders,1979-09-29,The Crusaders - Street Life,9,6,10,3.0,9,Street Life,29.0,16,-1,0,-3,1,down,1979-06-09
12141,The Crusaders,1979-10-06,The Crusaders - Street Life,9,9,12,3.0,10,Street Life,29.0,17,-2,-1,0,1,down,1979-06-09
12142,The Crusaders,1979-10-13,The Crusaders - Street Life,10,9,12,3.0,12,Street Life,29.0,18,0,-2,-1,0,stay,1979-06-09
12143,The Crusaders,1979-10-20,The Crusaders - Street Life,12,10,18,3.0,12,Street Life,29.0,19,-6,0,-2,1,down,1979-06-09
12144,The Crusaders,1979-10-27,The Crusaders - Street Life,12,12,20,3.0,18,Street Life,29.0,20,-2,-6,0,1,down,1979-06-09
12145,The Crusaders,1979-11-03,The Crusaders - Street Life,18,12,25,3.0,20,Street Life,29.0,21,-5,-2,-6,1,down,1979-06-09
12146,The Crusaders,1979-11-10,The Crusaders - Street Life,20,18,25,3.0,25,Street Life,29.0,22,0,-5,-2,0,stay,1979-06-09
12147,The Crusaders,1979-11-17,The Crusaders - Street Life,25,20,24,3.0,25,Street Life,29.0,23,1,0,-5,1,up,1979-06-09
12148,The Crusaders,1979-11-24,The Crusaders - Street Life,25,25,33,3.0,24,Street Life,29.0,24,-9,1,0,1,down,1979-06-09
12149,The Crusaders,1979-12-01,The Crusaders - Street Life,24,25,38,3.0,33,Street Life,29.0,25,-5,-9,1,1,down,1979-06-09
12150,The Crusaders,1979-12-08,The Crusaders - Street Life,33,24,38,3.0,38,Street Life,29.0,26,0,-5,-9,0,stay,1979-06-09
12151,The Crusaders,1979-12-15,The Crusaders - Street Life,38,33,39,3.0,38,Street Life,29.0,27,-1,0,-5,1,down,1979-06-09
12152,The Crusaders,1979-12-22,The Crusaders - Street Life,38,38,39,3.0,39,Street Life,29.0,28,0,-1,0,0,stay,1979-06-09
12153,The Crusaders,1979-12-29,The Crusaders - Street Life,39,38,51,3.0,39,Street Life,29.0,29,-12,0,-1,1,down,1979-06-09
12154,Betty Wright,1979-06-09,Betty Wright - Betty Travelin'in The Wright Circle,51,51,48,48.0,50,Betty Travelin'in The Wright Circle,3.0,0,2,1,0,1,up,1979-06-09
12155,Betty Wright,1979-06-16,Betty Wright - Betty Travelin'in The Wright Circle,50,51,49,48.0,48,Betty Travelin'in The Wright Circle,3.0,1,-1,2,1,1,down,1979-06-09
12156,Betty Wright,1979-06-23,Betty Wright - Betty Travelin'in The Wright Circle,48,50,49,48.0,49,Betty Travelin'in The Wright Circle,3.0,2,0,-1,2,0,stay,1979-06-09
12157,Betty Wright,1979-06-30,Betty Wright - Betty Travelin'in The Wright Circle,49,48,51,48.0,49,Betty Travelin'in The Wright Circle,3.0,3,-2,0,-1,1,down,1979-06-09
12158,The Isley Brothers,1979-06-16,The Isley Brothers - Winner Takes All,51,51,4,3.0,12,Winner Takes All,20.0,0,8,39,0,1,up,1979-06-16
12159,The Isley Brothers,1979-06-23,The Isley Brothers - Winner Takes All,12,51,4,3.0,4,Winner Takes All,20.0,1,0,8,39,0,stay,1979-06-16
12160,The Isley Brothers,1979-06-30,The Isley Brothers - Winner Takes All,4,12,3,3.0,4,Winner Takes All,20.0,2,1,0,8,1,up,1979-06-16
12161,The Isley Brothers,1979-07-07,The Isley Brothers - Winner Takes All,4,4,3,3.0,3,Winner Takes All,20.0,3,0,1,0,0,stay,1979-06-16
12162,The Isley Brothers,1979-07-14,The Isley Brothers - Winner Takes All,3,4,3,3.0,3,Winner Takes All,20.0,4,0,0,1,0,stay,1979-06-16
12163,The Isley Brothers,1979-07-21,The Isley Brothers - Winner Takes All,3,3,3,3.0,3,Winner Takes All,20.0,5,0,0,0,0,stay,1979-06-16
12164,The Isley Brothers,1979-07-28,The Isley Brothers - Winner Takes All,3,3,3,3.0,3,Winner Takes All,20.0,6,0,0,0,0,stay,1979-06-16
12165,The Isley Brothers,1979-08-04,The Isley Brothers - Winner Takes All,3,3,3,3.0,3,Winner Takes All,20.0,7,0,0,0,0,stay,1979-06-16
12166,The Isley Brothers,1979-08-11,The Isley Brothers - Winner Takes All,3,3,3,3.0,3,Winner Takes All,20.0,8,0,0,0,0,stay,1979-06-16
12167,The Isley Brothers,1979-08-18,The Isley Brothers - Winner Takes All,3,3,7,3.0,3,Winner Takes All,20.0,9,-4,0,0,1,down,1979-06-16
12168,The Isley Brothers,1979-08-25,The Isley Brothers - Winner Takes All,3,3,10,3.0,7,Winner Takes All,20.0,10,-3,-4,0,1,down,1979-06-16
12169,The Isley Brothers,1979-09-01,The Isley Brothers - Winner Takes All,7,3,17,3.0,10,Winner Takes All,20.0,11,-7,-3,-4,1,down,1979-06-16
12170,The Isley Brothers,1979-09-08,The Isley Brothers - Winner Takes All,10,7,18,3.0,17,Winner Takes All,20.0,12,-1,-7,-3,1,down,1979-06-16
12171,The Isley Brothers,1979-09-15,The Isley Brothers - Winner Takes All,17,10,20,3.0,18,Winner Takes All,20.0,13,-2,-1,-7,1,down,1979-06-16
12172,The Isley Brothers,1979-09-22,The Isley Brothers - Winner Takes All,18,17,20,3.0,20,Winner Takes All,20.0,14,0,-2,-1,0,stay,1979-06-16
12173,The Isley Brothers,1979-09-29,The Isley Brothers - Winner Takes All,20,18,25,3.0,20,Winner Takes All,20.0,15,-5,0,-2,1,down,1979-06-16
12174,The Isley Brothers,1979-10-06,The Isley Brothers - Winner Takes All,20,20,28,3.0,25,Winner Takes All,20.0,16,-3,-5,0,1,down,1979-06-16
12175,The Isley Brothers,1979-10-13,The Isley Brothers - Winner Takes All,25,20,35,3.0,28,Winner Takes All,20.0,17,-7,-3,-5,1,down,1979-06-16
12176,The Isley Brothers,1979-10-20,The Isley Brothers - Winner Takes All,28,25,32,3.0,35,Winner Takes All,20.0,18,3,-7,-3,1,up,1979-06-16
12177,The Isley Brothers,1979-10-27,The Isley Brothers - Winner Takes All,35,28,50,3.0,32,Winner Takes All,20.0,19,-18,3,-7,1,down,1979-06-16
12178,The Isley Brothers,1979-11-17,The Isley Brothers - Winner Takes All,32,35,51,3.0,50,Winner Takes All,20.0,20,-1,-18,3,1,down,1979-06-16
12179,Lou Rawls,1979-06-16,Lou Rawls - Let Me Be Good To You,51,51,20,13.0,30,Let Me Be Good To You,14.0,0,10,21,0,1,up,1979-06-16
12180,Lou Rawls,1979-06-23,Lou Rawls - Let Me Be Good To You,30,51,13,13.0,20,Let Me Be Good To You,14.0,1,7,10,21,1,up,1979-06-16
12181,Lou Rawls,1979-06-30,Lou Rawls - Let Me Be Good To You,20,30,13,13.0,13,Let Me Be Good To You,14.0,2,0,7,10,0,stay,1979-06-16
12182,Lou Rawls,1979-07-07,Lou Rawls - Let Me Be Good To You,13,20,14,13.0,13,Let Me Be Good To You,14.0,3,-1,0,7,1,down,1979-06-16
12183,Lou Rawls,1979-07-14,Lou Rawls - Let Me Be Good To You,13,13,14,13.0,14,Let Me Be Good To You,14.0,4,0,-1,0,0,stay,1979-06-16
12184,Lou Rawls,1979-07-21,Lou Rawls - Let Me Be Good To You,14,13,16,13.0,14,Let Me Be Good To You,14.0,5,-2,0,-1,1,down,1979-06-16
12185,Lou Rawls,1979-07-28,Lou Rawls - Let Me Be Good To You,14,14,19,13.0,16,Let Me Be Good To You,14.0,6,-3,-2,0,1,down,1979-06-16
12186,Lou Rawls,1979-08-04,Lou Rawls - Let Me Be Good To You,16,14,19,13.0,19,Let Me Be Good To You,14.0,7,0,-3,-2,0,stay,1979-06-16
12187,Lou Rawls,1979-08-11,Lou Rawls - Let Me Be Good To You,19,16,27,13.0,19,Let Me Be Good To You,14.0,8,-8,0,-3,1,down,1979-06-16
12188,Lou Rawls,1979-08-18,Lou Rawls - Let Me Be Good To You,19,19,29,13.0,27,Let Me Be Good To You,14.0,9,-2,-8,0,1,down,1979-06-16
12189,Lou Rawls,1979-08-25,Lou Rawls - Let Me Be Good To You,27,19,38,13.0,29,Let Me Be Good To You,14.0,10,-9,-2,-8,1,down,1979-06-16
12190,Lou Rawls,1979-09-01,Lou Rawls - Let Me Be Good To You,29,27,38,13.0,38,Let Me Be Good To You,14.0,11,0,-9,-2,0,stay,1979-06-16
12191,Lou Rawls,1979-09-08,Lou Rawls - Let Me Be Good To You,38,29,48,13.0,38,Let Me Be Good To You,14.0,12,-10,0,-9,1,down,1979-06-16
12192,Lou Rawls,1979-09-15,Lou Rawls - Let Me Be Good To You,38,38,49,13.0,48,Let Me Be Good To You,14.0,13,-1,-10,0,1,down,1979-06-16
12193,Lou Rawls,1979-09-22,Lou Rawls - Let Me Be Good To You,48,38,51,13.0,49,Let Me Be Good To You,14.0,14,-2,-1,-10,1,down,1979-06-16
12194,"Earth, Wind & Fire",1979-06-23,"Earth, Wind & Fire - I Am",51,51,6,1.0,9,I Am,32.0,0,3,42,0,1,up,1979-06-23
12195,"Earth, Wind & Fire",1979-06-30,"Earth, Wind & Fire - I Am",9,51,5,1.0,6,I Am,32.0,1,1,3,42,1,up,1979-06-23
12196,"Earth, Wind & Fire",1979-07-07,"Earth, Wind & Fire - I Am",6,9,1,1.0,5,I Am,32.0,2,4,1,3,1,up,1979-06-23
12197,"Earth, Wind & Fire",1979-07-14,"Earth, Wind & Fire - I Am",5,6,2,1.0,1,I Am,32.0,3,-1,4,1,1,down,1979-06-23
12198,"Earth, Wind & Fire",1979-07-21,"Earth, Wind & Fire - I Am",1,5,2,1.0,2,I Am,32.0,4,0,-1,4,0,stay,1979-06-23
12199,"Earth, Wind & Fire",1979-07-28,"Earth, Wind & Fire - I Am",2,1,2,1.0,2,I Am,32.0,5,0,0,-1,0,stay,1979-06-23
12200,"Earth, Wind & Fire",1979-08-04,"Earth, Wind & Fire - I Am",2,2,2,1.0,2,I Am,32.0,6,0,0,0,0,stay,1979-06-23
12201,"Earth, Wind & Fire",1979-08-11,"Earth, Wind & Fire - I Am",2,2,2,1.0,2,I Am,32.0,7,0,0,0,0,stay,1979-06-23
12202,"Earth, Wind & Fire",1979-08-18,"Earth, Wind & Fire - I Am",2,2,2,1.0,2,I Am,32.0,8,0,0,0,0,stay,1979-06-23
12203,"Earth, Wind & Fire",1979-08-25,"Earth, Wind & Fire - I Am",2,2,4,1.0,2,I Am,32.0,9,-2,0,0,1,down,1979-06-23
12204,"Earth, Wind & Fire",1979-09-01,"Earth, Wind & Fire - I Am",2,2,7,1.0,4,I Am,32.0,10,-3,-2,0,1,down,1979-06-23
12205,"Earth, Wind & Fire",1979-09-08,"Earth, Wind & Fire - I Am",4,2,8,1.0,7,I Am,32.0,11,-1,-3,-2,1,down,1979-06-23
12206,"Earth, Wind & Fire",1979-09-15,"Earth, Wind & Fire - I Am",7,4,8,1.0,8,I Am,32.0,12,0,-1,-3,0,stay,1979-06-23
12207,"Earth, Wind & Fire",1979-09-22,"Earth, Wind & Fire - I Am",8,7,8,1.0,8,I Am,32.0,13,0,0,-1,0,stay,1979-06-23
12208,"Earth, Wind & Fire",1979-09-29,"Earth, Wind & Fire - I Am",8,8,8,1.0,8,I Am,32.0,14,0,0,0,0,stay,1979-06-23
12209,"Earth, Wind & Fire",1979-10-06,"Earth, Wind & Fire - I Am",8,8,11,1.0,8,I Am,32.0,15,-3,0,0,1,down,1979-06-23
12210,"Earth, Wind & Fire",1979-10-13,"Earth, Wind & Fire - I Am",8,8,11,1.0,11,I Am,32.0,16,0,-3,0,0,stay,1979-06-23
12211,"Earth, Wind & Fire",1979-10-20,"Earth, Wind & Fire - I Am",11,8,10,1.0,11,I Am,32.0,17,1,0,-3,1,up,1979-06-23
12212,"Earth, Wind & Fire",1979-10-27,"Earth, Wind & Fire - I Am",11,11,12,1.0,10,I Am,32.0,18,-2,1,0,1,down,1979-06-23
12213,"Earth, Wind & Fire",1979-11-03,"Earth, Wind & Fire - I Am",10,11,12,1.0,12,I Am,32.0,19,0,-2,1,0,stay,1979-06-23
12214,"Earth, Wind & Fire",1979-11-10,"Earth, Wind & Fire - I Am",12,10,14,1.0,12,I Am,32.0,20,-2,0,-2,1,down,1979-06-23
12215,"Earth, Wind & Fire",1979-11-17,"Earth, Wind & Fire - I Am",12,12,19,1.0,14,I Am,32.0,21,-5,-2,0,1,down,1979-06-23
12216,"Earth, Wind & Fire",1979-11-24,"Earth, Wind & Fire - I Am",14,12,22,1.0,19,I Am,32.0,22,-3,-5,-2,1,down,1979-06-23
12217,"Earth, Wind & Fire",1979-12-01,"Earth, Wind & Fire - I Am",19,14,26,1.0,22,I Am,32.0,23,-4,-3,-5,1,down,1979-06-23
12218,"Earth, Wind & Fire",1979-12-08,"Earth, Wind & Fire - I Am",22,19,26,1.0,26,I Am,32.0,24,0,-4,-3,0,stay,1979-06-23
12219,"Earth, Wind & Fire",1979-12-15,"Earth, Wind & Fire - I Am",26,22,33,1.0,26,I Am,32.0,25,-7,0,-4,1,down,1979-06-23
12220,"Earth, Wind & Fire",1979-12-22,"Earth, Wind & Fire - I Am",26,26,33,1.0,33,I Am,32.0,26,0,-7,0,0,stay,1979-06-23
12221,"Earth, Wind & Fire",1979-12-29,"Earth, Wind & Fire - I Am",33,26,42,1.0,33,I Am,32.0,27,-9,0,-7,1,down,1979-06-23
12222,"Earth, Wind & Fire",1980-01-05,"Earth, Wind & Fire - I Am",33,33,45,1.0,42,I Am,32.0,28,-3,-9,0,1,down,1979-06-23
12223,"Earth, Wind & Fire",1980-01-12,"Earth, Wind & Fire - I Am",42,33,45,1.0,45,I Am,32.0,29,0,-3,-9,0,stay,1979-06-23
12224,"Earth, Wind & Fire",1980-01-19,"Earth, Wind & Fire - I Am",45,42,45,1.0,45,I Am,32.0,30,0,0,-3,0,stay,1979-06-23
12225,"Earth, Wind & Fire",1980-01-26,"Earth, Wind & Fire - I Am",45,45,48,1.0,45,I Am,32.0,31,-3,0,0,1,down,1979-06-23
12226,"Earth, Wind & Fire",1980-02-02,"Earth, Wind & Fire - I Am",45,45,51,1.0,48,I Am,32.0,32,-3,-3,0,1,down,1979-06-23
12227,Diana Ross,1979-06-23,Diana Ross - The Boss,51,51,24,10.0,35,The Boss,34.0,0,11,16,0,1,up,1979-06-23
12228,Diana Ross,1979-06-30,Diana Ross - The Boss,35,51,20,10.0,24,The Boss,34.0,1,4,11,16,1,up,1979-06-23
12229,Diana Ross,1979-07-07,Diana Ross - The Boss,24,35,17,10.0,20,The Boss,34.0,2,3,4,11,1,up,1979-06-23
12230,Diana Ross,1979-07-14,Diana Ross - The Boss,20,24,15,10.0,17,The Boss,34.0,3,2,3,4,1,up,1979-06-23
12231,Diana Ross,1979-07-21,Diana Ross - The Boss,17,20,13,10.0,15,The Boss,34.0,4,2,2,3,1,up,1979-06-23
12232,Diana Ross,1979-07-28,Diana Ross - The Boss,15,17,13,10.0,13,The Boss,34.0,5,0,2,2,0,stay,1979-06-23
12233,Diana Ross,1979-08-04,Diana Ross - The Boss,13,15,10,10.0,13,The Boss,34.0,6,3,0,2,1,up,1979-06-23
12234,Diana Ross,1979-08-11,Diana Ross - The Boss,13,13,10,10.0,10,The Boss,34.0,7,0,3,0,0,stay,1979-06-23
12235,Diana Ross,1979-08-18,Diana Ross - The Boss,10,13,11,10.0,10,The Boss,34.0,8,-1,0,3,1,down,1979-06-23
12236,Diana Ross,1979-08-25,Diana Ross - The Boss,10,10,11,10.0,11,The Boss,34.0,9,0,-1,0,0,stay,1979-06-23
12237,Diana Ross,1979-09-01,Diana Ross - The Boss,11,10,15,10.0,11,The Boss,34.0,10,-4,0,-1,1,down,1979-06-23
12238,Diana Ross,1979-09-08,Diana Ross - The Boss,11,11,13,10.0,15,The Boss,34.0,11,2,-4,0,1,up,1979-06-23
12239,Diana Ross,1979-09-15,Diana Ross - The Boss,15,11,13,10.0,13,The Boss,34.0,12,0,2,-4,0,stay,1979-06-23
12240,Diana Ross,1979-09-22,Diana Ross - The Boss,13,15,14,10.0,13,The Boss,34.0,13,-1,0,2,1,down,1979-06-23
12241,Diana Ross,1979-09-29,Diana Ross - The Boss,13,13,16,10.0,14,The Boss,34.0,14,-2,-1,0,1,down,1979-06-23
12242,Diana Ross,1979-10-06,Diana Ross - The Boss,14,13,16,10.0,16,The Boss,34.0,15,0,-2,-1,0,stay,1979-06-23
12243,Diana Ross,1979-10-13,Diana Ross - The Boss,16,14,20,10.0,16,The Boss,34.0,16,-4,0,-2,1,down,1979-06-23
12244,Diana Ross,1979-10-20,Diana Ross - The Boss,16,16,20,10.0,20,The Boss,34.0,17,0,-4,0,0,stay,1979-06-23
12245,Diana Ross,1979-10-27,Diana Ross - The Boss,20,16,22,10.0,20,The Boss,34.0,18,-2,0,-4,1,down,1979-06-23
12246,Diana Ross,1979-11-03,Diana Ross - The Boss,20,20,32,10.0,22,The Boss,34.0,19,-10,-2,0,1,down,1979-06-23
12247,Diana Ross,1979-11-10,Diana Ross - The Boss,22,20,40,10.0,32,The Boss,34.0,20,-8,-10,-2,1,down,1979-06-23
12248,Diana Ross,1979-11-17,Diana Ross - The Boss,32,22,40,10.0,40,The Boss,34.0,21,0,-8,-10,0,stay,1979-06-23
12249,Diana Ross,1979-11-24,Diana Ross - The Boss,40,32,41,10.0,40,The Boss,34.0,22,-1,0,-8,1,down,1979-06-23
12250,Diana Ross,1979-12-01,Diana Ross - The Boss,40,40,42,10.0,41,The Boss,34.0,23,-1,-1,0,1,down,1979-06-23
12251,Diana Ross,1979-12-08,Diana Ross - The Boss,41,40,43,10.0,42,The Boss,34.0,24,-1,-1,-1,1,down,1979-06-23
12252,Diana Ross,1979-12-15,Diana Ross - The Boss,42,41,43,10.0,43,The Boss,34.0,25,0,-1,-1,0,stay,1979-06-23
12253,Diana Ross,1979-12-22,Diana Ross - The Boss,43,42,43,10.0,43,The Boss,34.0,26,0,0,-1,0,stay,1979-06-23
12254,Diana Ross,1979-12-29,Diana Ross - The Boss,43,43,50,10.0,43,The Boss,34.0,27,-7,0,0,1,down,1979-06-23
12255,Diana Ross,1980-01-19,Diana Ross - The Boss,43,43,47,10.0,50,The Boss,34.0,28,3,-7,0,1,up,1979-06-23
12256,Diana Ross,1980-01-26,Diana Ross - The Boss,50,43,42,10.0,47,The Boss,34.0,29,5,3,-7,1,up,1979-06-23
12257,Diana Ross,1980-02-02,Diana Ross - The Boss,47,50,41,10.0,42,The Boss,34.0,30,1,5,3,1,up,1979-06-23
12258,Diana Ross,1980-02-09,Diana Ross - The Boss,42,47,43,10.0,41,The Boss,34.0,31,-2,1,5,1,down,1979-06-23
12259,Diana Ross,1980-02-16,Diana Ross - The Boss,41,42,47,10.0,43,The Boss,34.0,32,-4,-2,1,1,down,1979-06-23
12260,Diana Ross,1980-02-23,Diana Ross - The Boss,43,41,49,10.0,47,The Boss,34.0,33,-2,-4,-2,1,down,1979-06-23
12261,Diana Ross,1980-03-01,Diana Ross - The Boss,47,43,51,10.0,49,The Boss,34.0,34,-2,-2,-4,1,down,1979-06-23
12262,Skyy,1979-06-23,Skyy - Skyy,51,51,45,40.0,46,Skyy,7.0,0,1,5,0,1,up,1979-06-23
12263,Skyy,1979-06-30,Skyy - Skyy,46,51,40,40.0,45,Skyy,7.0,1,5,1,5,1,up,1979-06-23
12264,Skyy,1979-07-07,Skyy - Skyy,45,46,49,40.0,40,Skyy,7.0,2,-9,5,1,1,down,1979-06-23
12265,Skyy,1979-07-14,Skyy - Skyy,40,45,46,40.0,49,Skyy,7.0,3,3,-9,5,1,up,1979-06-23
12266,Skyy,1979-07-21,Skyy - Skyy,49,40,47,40.0,46,Skyy,7.0,4,-1,3,-9,1,down,1979-06-23
12267,Skyy,1979-07-28,Skyy - Skyy,46,49,47,40.0,47,Skyy,7.0,5,0,-1,3,0,stay,1979-06-23
12268,Skyy,1979-08-04,Skyy - Skyy,47,46,47,40.0,47,Skyy,7.0,6,0,0,-1,0,stay,1979-06-23
12269,Skyy,1979-08-11,Skyy - Skyy,47,47,51,40.0,47,Skyy,7.0,7,-4,0,0,1,down,1979-06-23
12270,Taka Boom,1979-06-23,Taka Boom - Taka Boom,51,51,48,48.0,48,Taka Boom,1.0,0,0,3,0,0,stay,1979-06-23
12271,Taka Boom,1979-06-30,Taka Boom - Taka Boom,48,51,51,48.0,48,Taka Boom,1.0,1,-3,0,3,1,down,1979-06-23
12272,Teddy Pendergrass,1979-06-30,Teddy Pendergrass - Teddy,51,51,4,1.0,26,Teddy,27.0,0,22,25,0,1,up,1979-06-30
12273,Teddy Pendergrass,1979-07-07,Teddy Pendergrass - Teddy,26,51,4,1.0,4,Teddy,27.0,1,0,22,25,0,stay,1979-06-30
12274,Teddy Pendergrass,1979-07-14,Teddy Pendergrass - Teddy,4,26,1,1.0,4,Teddy,27.0,2,3,0,22,1,up,1979-06-30
12275,Teddy Pendergrass,1979-07-21,Teddy Pendergrass - Teddy,4,4,1,1.0,1,Teddy,27.0,3,0,3,0,0,stay,1979-06-30
12276,Teddy Pendergrass,1979-07-28,Teddy Pendergrass - Teddy,1,4,1,1.0,1,Teddy,27.0,4,0,0,3,0,stay,1979-06-30
12277,Teddy Pendergrass,1979-08-04,Teddy Pendergrass - Teddy,1,1,1,1.0,1,Teddy,27.0,5,0,0,0,0,stay,1979-06-30
12278,Teddy Pendergrass,1979-08-11,Teddy Pendergrass - Teddy,1,1,1,1.0,1,Teddy,27.0,6,0,0,0,0,stay,1979-06-30
12279,Teddy Pendergrass,1979-08-18,Teddy Pendergrass - Teddy,1,1,1,1.0,1,Teddy,27.0,7,0,0,0,0,stay,1979-06-30
12280,Teddy Pendergrass,1979-08-25,Teddy Pendergrass - Teddy,1,1,1,1.0,1,Teddy,27.0,8,0,0,0,0,stay,1979-06-30
12281,Teddy Pendergrass,1979-09-01,Teddy Pendergrass - Teddy,1,1,1,1.0,1,Teddy,27.0,9,0,0,0,0,stay,1979-06-30
12282,Teddy Pendergrass,1979-09-08,Teddy Pendergrass - Teddy,1,1,3,1.0,1,Teddy,27.0,10,-2,0,0,1,down,1979-06-30
12283,Teddy Pendergrass,1979-09-15,Teddy Pendergrass - Teddy,1,1,5,1.0,3,Teddy,27.0,11,-2,-2,0,1,down,1979-06-30
12284,Teddy Pendergrass,1979-09-22,Teddy Pendergrass - Teddy,3,1,7,1.0,5,Teddy,27.0,12,-2,-2,-2,1,down,1979-06-30
12285,Teddy Pendergrass,1979-09-29,Teddy Pendergrass - Teddy,5,3,7,1.0,7,Teddy,27.0,13,0,-2,-2,0,stay,1979-06-30
12286,Teddy Pendergrass,1979-10-06,Teddy Pendergrass - Teddy,7,5,7,1.0,7,Teddy,27.0,14,0,0,-2,0,stay,1979-06-30
12287,Teddy Pendergrass,1979-10-13,Teddy Pendergrass - Teddy,7,7,7,1.0,7,Teddy,27.0,15,0,0,0,0,stay,1979-06-30
12288,Teddy Pendergrass,1979-10-20,Teddy Pendergrass - Teddy,7,7,7,1.0,7,Teddy,27.0,16,0,0,0,0,stay,1979-06-30
12289,Teddy Pendergrass,1979-10-27,Teddy Pendergrass - Teddy,7,7,13,1.0,7,Teddy,27.0,17,-6,0,0,1,down,1979-06-30
12290,Teddy Pendergrass,1979-11-03,Teddy Pendergrass - Teddy,7,7,18,1.0,13,Teddy,27.0,18,-5,-6,0,1,down,1979-06-30
12291,Teddy Pendergrass,1979-11-10,Teddy Pendergrass - Teddy,13,7,39,1.0,18,Teddy,27.0,19,-21,-5,-6,1,down,1979-06-30
12292,Teddy Pendergrass,1979-11-17,Teddy Pendergrass - Teddy,18,13,39,1.0,39,Teddy,27.0,20,0,-21,-5,0,stay,1979-06-30
12293,Teddy Pendergrass,1979-11-24,Teddy Pendergrass - Teddy,39,18,40,1.0,39,Teddy,27.0,21,-1,0,-21,1,down,1979-06-30
12294,Teddy Pendergrass,1979-12-01,Teddy Pendergrass - Teddy,39,39,44,1.0,40,Teddy,27.0,22,-4,-1,0,1,down,1979-06-30
12295,Teddy Pendergrass,1979-12-08,Teddy Pendergrass - Teddy,40,39,48,1.0,44,Teddy,27.0,23,-4,-4,-1,1,down,1979-06-30
12296,Teddy Pendergrass,1979-12-15,Teddy Pendergrass - Teddy,44,40,48,1.0,48,Teddy,27.0,24,0,-4,-4,0,stay,1979-06-30
12297,Teddy Pendergrass,1979-12-22,Teddy Pendergrass - Teddy,48,44,48,1.0,48,Teddy,27.0,25,0,0,-4,0,stay,1979-06-30
12298,Teddy Pendergrass,1979-12-29,Teddy Pendergrass - Teddy,48,48,50,1.0,48,Teddy,27.0,26,-2,0,0,1,down,1979-06-30
12299,Teddy Pendergrass,1980-01-05,Teddy Pendergrass - Teddy,48,48,51,1.0,50,Teddy,27.0,27,-1,-2,0,1,down,1979-06-30
12300,Larry Graham And Graham Central Station,1979-06-30,Larry Graham And Graham Central Station - Star Walk,51,51,44,44.0,47,Star Walk,5.0,0,3,4,0,1,up,1979-06-30
12301,Larry Graham And Graham Central Station,1979-07-07,Larry Graham And Graham Central Station - Star Walk,47,51,50,44.0,44,Star Walk,5.0,1,-6,3,4,1,down,1979-06-30
12302,Larry Graham And Graham Central Station,1979-07-14,Larry Graham And Graham Central Station - Star Walk,44,47,50,44.0,50,Star Walk,5.0,2,0,-6,3,0,stay,1979-06-30
12303,Larry Graham And Graham Central Station,1979-07-21,Larry Graham And Graham Central Station - Star Walk,50,44,48,44.0,50,Star Walk,5.0,3,2,0,-6,1,up,1979-06-30
12304,Larry Graham And Graham Central Station,1979-08-11,Larry Graham And Graham Central Station - Star Walk,50,50,49,44.0,48,Star Walk,5.0,4,-1,2,0,1,down,1979-06-30
12305,Larry Graham And Graham Central Station,1979-08-18,Larry Graham And Graham Central Station - Star Walk,48,50,51,44.0,49,Star Walk,5.0,5,-2,-1,2,1,down,1979-06-30
12306,KC And The Sunshine Band,1979-07-07,KC And The Sunshine Band - Do You Wanna Go Party,51,51,20,19.0,30,Do You Wanna Go Party,34.0,0,10,21,0,1,up,1979-07-07
12307,KC And The Sunshine Band,1979-07-14,KC And The Sunshine Band - Do You Wanna Go Party,30,51,20,19.0,20,Do You Wanna Go Party,34.0,1,0,10,21,0,stay,1979-07-07
12308,KC And The Sunshine Band,1979-07-21,KC And The Sunshine Band - Do You Wanna Go Party,20,30,22,19.0,20,Do You Wanna Go Party,34.0,2,-2,0,10,1,down,1979-07-07
12309,KC And The Sunshine Band,1979-07-28,KC And The Sunshine Band - Do You Wanna Go Party,20,20,29,19.0,22,Do You Wanna Go Party,34.0,3,-7,-2,0,1,down,1979-07-07
12310,KC And The Sunshine Band,1979-08-04,KC And The Sunshine Band - Do You Wanna Go Party,22,20,21,19.0,29,Do You Wanna Go Party,34.0,4,8,-7,-2,1,up,1979-07-07
12311,KC And The Sunshine Band,1979-08-11,KC And The Sunshine Band - Do You Wanna Go Party,29,22,20,19.0,21,Do You Wanna Go Party,34.0,5,1,8,-7,1,up,1979-07-07
12312,KC And The Sunshine Band,1979-08-18,KC And The Sunshine Band - Do You Wanna Go Party,21,29,23,19.0,20,Do You Wanna Go Party,34.0,6,-3,1,8,1,down,1979-07-07
12313,KC And The Sunshine Band,1979-08-25,KC And The Sunshine Band - Do You Wanna Go Party,20,21,25,19.0,23,Do You Wanna Go Party,34.0,7,-2,-3,1,1,down,1979-07-07
12314,KC And The Sunshine Band,1979-09-01,KC And The Sunshine Band - Do You Wanna Go Party,23,20,26,19.0,25,Do You Wanna Go Party,34.0,8,-1,-2,-3,1,down,1979-07-07
12315,KC And The Sunshine Band,1979-09-08,KC And The Sunshine Band - Do You Wanna Go Party,25,23,26,19.0,26,Do You Wanna Go Party,34.0,9,0,-1,-2,0,stay,1979-07-07
12316,KC And The Sunshine Band,1979-09-15,KC And The Sunshine Band - Do You Wanna Go Party,26,25,26,19.0,26,Do You Wanna Go Party,34.0,10,0,0,-1,0,stay,1979-07-07
12317,KC And The Sunshine Band,1979-09-22,KC And The Sunshine Band - Do You Wanna Go Party,26,26,26,19.0,26,Do You Wanna Go Party,34.0,11,0,0,0,0,stay,1979-07-07
12318,KC And The Sunshine Band,1979-09-29,KC And The Sunshine Band - Do You Wanna Go Party,26,26,29,19.0,26,Do You Wanna Go Party,34.0,12,-3,0,0,1,down,1979-07-07
12319,KC And The Sunshine Band,1979-10-06,KC And The Sunshine Band - Do You Wanna Go Party,26,26,31,19.0,29,Do You Wanna Go Party,34.0,13,-2,-3,0,1,down,1979-07-07
12320,KC And The Sunshine Band,1979-10-13,KC And The Sunshine Band - Do You Wanna Go Party,29,26,39,19.0,31,Do You Wanna Go Party,34.0,14,-8,-2,-3,1,down,1979-07-07
12321,KC And The Sunshine Band,1979-10-20,KC And The Sunshine Band - Do You Wanna Go Party,31,29,39,19.0,39,Do You Wanna Go Party,34.0,15,0,-8,-2,0,stay,1979-07-07
12322,KC And The Sunshine Band,1979-10-27,KC And The Sunshine Band - Do You Wanna Go Party,39,31,41,19.0,39,Do You Wanna Go Party,34.0,16,-2,0,-8,1,down,1979-07-07
12323,KC And The Sunshine Band,1979-11-03,KC And The Sunshine Band - Do You Wanna Go Party,39,39,41,19.0,41,Do You Wanna Go Party,34.0,17,0,-2,0,0,stay,1979-07-07
12324,KC And The Sunshine Band,1979-11-10,KC And The Sunshine Band - Do You Wanna Go Party,41,39,41,19.0,41,Do You Wanna Go Party,34.0,18,0,0,-2,0,stay,1979-07-07
12325,KC And The Sunshine Band,1979-11-17,KC And The Sunshine Band - Do You Wanna Go Party,41,41,31,19.0,41,Do You Wanna Go Party,34.0,19,10,0,0,1,up,1979-07-07
12326,KC And The Sunshine Band,1979-11-24,KC And The Sunshine Band - Do You Wanna Go Party,41,41,25,19.0,31,Do You Wanna Go Party,34.0,20,6,10,0,1,up,1979-07-07
12327,KC And The Sunshine Band,1979-12-01,KC And The Sunshine Band - Do You Wanna Go Party,31,41,20,19.0,25,Do You Wanna Go Party,34.0,21,5,6,10,1,up,1979-07-07
12328,KC And The Sunshine Band,1979-12-08,KC And The Sunshine Band - Do You Wanna Go Party,25,31,19,19.0,20,Do You Wanna Go Party,34.0,22,1,5,6,1,up,1979-07-07
12329,KC And The Sunshine Band,1979-12-15,KC And The Sunshine Band - Do You Wanna Go Party,20,25,24,19.0,19,Do You Wanna Go Party,34.0,23,-5,1,5,1,down,1979-07-07
12330,KC And The Sunshine Band,1979-12-22,KC And The Sunshine Band - Do You Wanna Go Party,19,20,24,19.0,24,Do You Wanna Go Party,34.0,24,0,-5,1,0,stay,1979-07-07
12331,KC And The Sunshine Band,1979-12-29,KC And The Sunshine Band - Do You Wanna Go Party,24,19,30,19.0,24,Do You Wanna Go Party,34.0,25,-6,0,-5,1,down,1979-07-07
12332,KC And The Sunshine Band,1980-01-05,KC And The Sunshine Band - Do You Wanna Go Party,24,24,31,19.0,30,Do You Wanna Go Party,34.0,26,-1,-6,0,1,down,1979-07-07
12333,KC And The Sunshine Band,1980-01-12,KC And The Sunshine Band - Do You Wanna Go Party,30,24,31,19.0,31,Do You Wanna Go Party,34.0,27,0,-1,-6,0,stay,1979-07-07
12334,KC And The Sunshine Band,1980-01-19,KC And The Sunshine Band - Do You Wanna Go Party,31,30,34,19.0,31,Do You Wanna Go Party,34.0,28,-3,0,-1,1,down,1979-07-07
12335,KC And The Sunshine Band,1980-01-26,KC And The Sunshine Band - Do You Wanna Go Party,31,31,35,19.0,34,Do You Wanna Go Party,34.0,29,-1,-3,0,1,down,1979-07-07
12336,KC And The Sunshine Band,1980-02-02,KC And The Sunshine Band - Do You Wanna Go Party,34,31,43,19.0,35,Do You Wanna Go Party,34.0,30,-8,-1,-3,1,down,1979-07-07
12337,KC And The Sunshine Band,1980-02-09,KC And The Sunshine Band - Do You Wanna Go Party,35,34,44,19.0,43,Do You Wanna Go Party,34.0,31,-1,-8,-1,1,down,1979-07-07
12338,KC And The Sunshine Band,1980-02-16,KC And The Sunshine Band - Do You Wanna Go Party,43,35,49,19.0,44,Do You Wanna Go Party,34.0,32,-5,-1,-8,1,down,1979-07-07
12339,KC And The Sunshine Band,1980-02-23,KC And The Sunshine Band - Do You Wanna Go Party,44,43,50,19.0,49,Do You Wanna Go Party,34.0,33,-1,-5,-1,1,down,1979-07-07
12340,KC And The Sunshine Band,1980-03-01,KC And The Sunshine Band - Do You Wanna Go Party,49,44,51,19.0,50,Do You Wanna Go Party,34.0,34,-1,-1,-5,1,down,1979-07-07
12341,Dionne Warwick,1979-07-07,Dionne Warwick - Dionne,51,51,37,10.0,47,Dionne,39.0,0,10,4,0,1,up,1979-07-07
12342,Dionne Warwick,1979-07-14,Dionne Warwick - Dionne,47,51,25,10.0,37,Dionne,39.0,1,12,10,4,1,up,1979-07-07
12343,Dionne Warwick,1979-07-21,Dionne Warwick - Dionne,37,47,20,10.0,25,Dionne,39.0,2,5,12,10,1,up,1979-07-07
12344,Dionne Warwick,1979-07-28,Dionne Warwick - Dionne,25,37,17,10.0,20,Dionne,39.0,3,3,5,12,1,up,1979-07-07
12345,Dionne Warwick,1979-08-04,Dionne Warwick - Dionne,20,25,14,10.0,17,Dionne,39.0,4,3,3,5,1,up,1979-07-07
12346,Dionne Warwick,1979-08-11,Dionne Warwick - Dionne,17,20,12,10.0,14,Dionne,39.0,5,2,3,3,1,up,1979-07-07
12347,Dionne Warwick,1979-08-18,Dionne Warwick - Dionne,14,17,12,10.0,12,Dionne,39.0,6,0,2,3,0,stay,1979-07-07
12348,Dionne Warwick,1979-08-25,Dionne Warwick - Dionne,12,14,13,10.0,12,Dionne,39.0,7,-1,0,2,1,down,1979-07-07
12349,Dionne Warwick,1979-09-01,Dionne Warwick - Dionne,12,12,14,10.0,13,Dionne,39.0,8,-1,-1,0,1,down,1979-07-07
12350,Dionne Warwick,1979-09-08,Dionne Warwick - Dionne,13,12,16,10.0,14,Dionne,39.0,9,-2,-1,-1,1,down,1979-07-07
12351,Dionne Warwick,1979-09-15,Dionne Warwick - Dionne,14,13,14,10.0,16,Dionne,39.0,10,2,-2,-1,1,up,1979-07-07
12352,Dionne Warwick,1979-09-22,Dionne Warwick - Dionne,16,14,15,10.0,14,Dionne,39.0,11,-1,2,-2,1,down,1979-07-07
12353,Dionne Warwick,1979-09-29,Dionne Warwick - Dionne,14,16,11,10.0,15,Dionne,39.0,12,4,-1,2,1,up,1979-07-07
12354,Dionne Warwick,1979-10-06,Dionne Warwick - Dionne,15,14,10,10.0,11,Dionne,39.0,13,1,4,-1,1,up,1979-07-07
12355,Dionne Warwick,1979-10-13,Dionne Warwick - Dionne,11,15,10,10.0,10,Dionne,39.0,14,0,1,4,0,stay,1979-07-07
12356,Dionne Warwick,1979-10-20,Dionne Warwick - Dionne,10,11,11,10.0,10,Dionne,39.0,15,-1,0,1,1,down,1979-07-07
12357,Dionne Warwick,1979-10-27,Dionne Warwick - Dionne,10,10,11,10.0,11,Dionne,39.0,16,0,-1,0,0,stay,1979-07-07
12358,Dionne Warwick,1979-11-03,Dionne Warwick - Dionne,11,10,11,10.0,11,Dionne,39.0,17,0,0,-1,0,stay,1979-07-07
12359,Dionne Warwick,1979-11-10,Dionne Warwick - Dionne,11,11,18,10.0,11,Dionne,39.0,18,-7,0,0,1,down,1979-07-07
12360,Dionne Warwick,1979-11-17,Dionne Warwick - Dionne,11,11,21,10.0,18,Dionne,39.0,19,-3,-7,0,1,down,1979-07-07
12361,Dionne Warwick,1979-11-24,Dionne Warwick - Dionne,18,11,24,10.0,21,Dionne,39.0,20,-3,-3,-7,1,down,1979-07-07
12362,Dionne Warwick,1979-12-01,Dionne Warwick - Dionne,21,18,29,10.0,24,Dionne,39.0,21,-5,-3,-3,1,down,1979-07-07
12363,Dionne Warwick,1979-12-08,Dionne Warwick - Dionne,24,21,31,10.0,29,Dionne,39.0,22,-2,-5,-3,1,down,1979-07-07
12364,Dionne Warwick,1979-12-15,Dionne Warwick - Dionne,29,24,31,10.0,31,Dionne,39.0,23,0,-2,-5,0,stay,1979-07-07
12365,Dionne Warwick,1979-12-22,Dionne Warwick - Dionne,31,29,31,10.0,31,Dionne,39.0,24,0,0,-2,0,stay,1979-07-07
12366,Dionne Warwick,1979-12-29,Dionne Warwick - Dionne,31,31,39,10.0,31,Dionne,39.0,25,-8,0,0,1,down,1979-07-07
12367,Dionne Warwick,1980-01-05,Dionne Warwick - Dionne,31,31,47,10.0,39,Dionne,39.0,26,-8,-8,0,1,down,1979-07-07
12368,Dionne Warwick,1980-01-12,Dionne Warwick - Dionne,39,31,33,10.0,47,Dionne,39.0,27,14,-8,-8,1,up,1979-07-07
12369,Dionne Warwick,1980-01-19,Dionne Warwick - Dionne,47,39,32,10.0,33,Dionne,39.0,28,1,14,-8,1,up,1979-07-07
12370,Dionne Warwick,1980-01-26,Dionne Warwick - Dionne,33,47,32,10.0,32,Dionne,39.0,29,0,1,14,0,stay,1979-07-07
12371,Dionne Warwick,1980-02-02,Dionne Warwick - Dionne,32,33,32,10.0,32,Dionne,39.0,30,0,0,1,0,stay,1979-07-07
12372,Dionne Warwick,1980-02-09,Dionne Warwick - Dionne,32,32,34,10.0,32,Dionne,39.0,31,-2,0,0,1,down,1979-07-07
12373,Dionne Warwick,1980-02-16,Dionne Warwick - Dionne,32,32,35,10.0,34,Dionne,39.0,32,-1,-2,0,1,down,1979-07-07
12374,Dionne Warwick,1980-02-23,Dionne Warwick - Dionne,34,32,36,10.0,35,Dionne,39.0,33,-1,-1,-2,1,down,1979-07-07
12375,Dionne Warwick,1980-03-01,Dionne Warwick - Dionne,35,34,45,10.0,36,Dionne,39.0,34,-9,-1,-1,1,down,1979-07-07
12376,Dionne Warwick,1980-03-08,Dionne Warwick - Dionne,36,35,48,10.0,45,Dionne,39.0,35,-3,-9,-1,1,down,1979-07-07
12377,Dionne Warwick,1980-03-15,Dionne Warwick - Dionne,45,36,38,10.0,48,Dionne,39.0,36,10,-3,-9,1,up,1979-07-07
12378,Dionne Warwick,1980-03-22,Dionne Warwick - Dionne,48,45,38,10.0,38,Dionne,39.0,37,0,10,-3,0,stay,1979-07-07
12379,Dionne Warwick,1980-03-29,Dionne Warwick - Dionne,38,48,36,10.0,38,Dionne,39.0,38,2,0,10,1,up,1979-07-07
12380,Dionne Warwick,1980-04-05,Dionne Warwick - Dionne,38,38,51,10.0,36,Dionne,39.0,39,-15,2,0,1,down,1979-07-07
12381,Norman Connors,1979-07-07,Norman Connors - Invitation,51,51,40,34.0,50,Invitation,7.0,0,10,1,0,1,up,1979-07-07
12382,Norman Connors,1979-07-14,Norman Connors - Invitation,50,51,40,34.0,40,Invitation,7.0,1,0,10,1,0,stay,1979-07-07
12383,Norman Connors,1979-07-21,Norman Connors - Invitation,40,50,34,34.0,40,Invitation,7.0,2,6,0,10,1,up,1979-07-07
12384,Norman Connors,1979-07-28,Norman Connors - Invitation,40,40,34,34.0,34,Invitation,7.0,3,0,6,0,0,stay,1979-07-07
12385,Norman Connors,1979-08-04,Norman Connors - Invitation,34,40,34,34.0,34,Invitation,7.0,4,0,0,6,0,stay,1979-07-07
12386,Norman Connors,1979-08-11,Norman Connors - Invitation,34,34,47,34.0,34,Invitation,7.0,5,-13,0,0,1,down,1979-07-07
12387,Norman Connors,1979-08-18,Norman Connors - Invitation,34,34,48,34.0,47,Invitation,7.0,6,-1,-13,0,1,down,1979-07-07
12388,Norman Connors,1979-08-25,Norman Connors - Invitation,47,34,51,34.0,48,Invitation,7.0,7,-3,-1,-13,1,down,1979-07-07
12389,Bootsy's Rubber Band,1979-07-14,Bootsy's Rubber Band - This Boot Is Made For Fonk-n,51,51,10,9.0,15,This Boot Is Made For Fonk-n,10.0,0,5,36,0,1,up,1979-07-14
12390,Bootsy's Rubber Band,1979-07-21,Bootsy's Rubber Band - This Boot Is Made For Fonk-n,15,51,9,9.0,10,This Boot Is Made For Fonk-n,10.0,1,1,5,36,1,up,1979-07-14
12391,Bootsy's Rubber Band,1979-07-28,Bootsy's Rubber Band - This Boot Is Made For Fonk-n,10,15,9,9.0,9,This Boot Is Made For Fonk-n,10.0,2,0,1,5,0,stay,1979-07-14
12392,Bootsy's Rubber Band,1979-08-04,Bootsy's Rubber Band - This Boot Is Made For Fonk-n,9,10,16,9.0,9,This Boot Is Made For Fonk-n,10.0,3,-7,0,1,1,down,1979-07-14
12393,Bootsy's Rubber Band,1979-08-11,Bootsy's Rubber Band - This Boot Is Made For Fonk-n,9,9,17,9.0,16,This Boot Is Made For Fonk-n,10.0,4,-1,-7,0,1,down,1979-07-14
12394,Bootsy's Rubber Band,1979-08-18,Bootsy's Rubber Band - This Boot Is Made For Fonk-n,16,9,21,9.0,17,This Boot Is Made For Fonk-n,10.0,5,-4,-1,-7,1,down,1979-07-14
12395,Bootsy's Rubber Band,1979-08-25,Bootsy's Rubber Band - This Boot Is Made For Fonk-n,17,16,29,9.0,21,This Boot Is Made For Fonk-n,10.0,6,-8,-4,-1,1,down,1979-07-14
12396,Bootsy's Rubber Band,1979-09-01,Bootsy's Rubber Band - This Boot Is Made For Fonk-n,21,17,31,9.0,29,This Boot Is Made For Fonk-n,10.0,7,-2,-8,-4,1,down,1979-07-14
12397,Bootsy's Rubber Band,1979-09-08,Bootsy's Rubber Band - This Boot Is Made For Fonk-n,29,21,36,9.0,31,This Boot Is Made For Fonk-n,10.0,8,-5,-2,-8,1,down,1979-07-14
12398,Bootsy's Rubber Band,1979-09-15,Bootsy's Rubber Band - This Boot Is Made For Fonk-n,31,29,41,9.0,36,This Boot Is Made For Fonk-n,10.0,9,-5,-5,-2,1,down,1979-07-14
12399,Bootsy's Rubber Band,1979-09-22,Bootsy's Rubber Band - This Boot Is Made For Fonk-n,36,31,51,9.0,41,This Boot Is Made For Fonk-n,10.0,10,-10,-5,-5,1,down,1979-07-14
12400,LTD,1979-07-14,LTD - Devotion,51,51,16,5.0,30,Devotion,26.0,0,14,21,0,1,up,1979-07-14
12401,LTD,1979-07-21,LTD - Devotion,30,51,5,5.0,16,Devotion,26.0,1,11,14,21,1,up,1979-07-14
12402,LTD,1979-07-28,LTD - Devotion,16,30,5,5.0,5,Devotion,26.0,2,0,11,14,0,stay,1979-07-14
12403,LTD,1979-08-04,LTD - Devotion,5,16,6,5.0,5,Devotion,26.0,3,-1,0,11,1,down,1979-07-14
12404,LTD,1979-08-11,LTD - Devotion,5,5,6,5.0,6,Devotion,26.0,4,0,-1,0,0,stay,1979-07-14
12405,LTD,1979-08-18,LTD - Devotion,6,5,10,5.0,6,Devotion,26.0,5,-4,0,-1,1,down,1979-07-14
12406,LTD,1979-08-25,LTD - Devotion,6,6,14,5.0,10,Devotion,26.0,6,-4,-4,0,1,down,1979-07-14
12407,LTD,1979-09-01,LTD - Devotion,10,6,16,5.0,14,Devotion,26.0,7,-2,-4,-4,1,down,1979-07-14
12408,LTD,1979-09-08,LTD - Devotion,14,10,17,5.0,16,Devotion,26.0,8,-1,-2,-4,1,down,1979-07-14
12409,LTD,1979-09-15,LTD - Devotion,16,14,24,5.0,17,Devotion,26.0,9,-7,-1,-2,1,down,1979-07-14
12410,LTD,1979-09-22,LTD - Devotion,17,16,24,5.0,24,Devotion,26.0,10,0,-7,-1,0,stay,1979-07-14
12411,LTD,1979-09-29,LTD - Devotion,24,17,23,5.0,24,Devotion,26.0,11,1,0,-7,1,up,1979-07-14
12412,LTD,1979-10-06,LTD - Devotion,24,24,23,5.0,23,Devotion,26.0,12,0,1,0,0,stay,1979-07-14
12413,LTD,1979-10-13,LTD - Devotion,23,24,28,5.0,23,Devotion,26.0,13,-5,0,1,1,down,1979-07-14
12414,LTD,1979-10-20,LTD - Devotion,23,23,22,5.0,28,Devotion,26.0,14,6,-5,0,1,up,1979-07-14
12415,LTD,1979-10-27,LTD - Devotion,28,23,15,5.0,22,Devotion,26.0,15,7,6,-5,1,up,1979-07-14
12416,LTD,1979-11-03,LTD - Devotion,22,28,15,5.0,15,Devotion,26.0,16,0,7,6,0,stay,1979-07-14
12417,LTD,1979-11-10,LTD - Devotion,15,22,15,5.0,15,Devotion,26.0,17,0,0,7,0,stay,1979-07-14
12418,LTD,1979-11-17,LTD - Devotion,15,15,16,5.0,15,Devotion,26.0,18,-1,0,0,1,down,1979-07-14
12419,LTD,1979-11-24,LTD - Devotion,15,15,19,5.0,16,Devotion,26.0,19,-3,-1,0,1,down,1979-07-14
12420,LTD,1979-12-01,LTD - Devotion,16,15,22,5.0,19,Devotion,26.0,20,-3,-3,-1,1,down,1979-07-14
12421,LTD,1979-12-08,LTD - Devotion,19,16,22,5.0,22,Devotion,26.0,21,0,-3,-3,0,stay,1979-07-14
12422,LTD,1979-12-15,LTD - Devotion,22,19,28,5.0,22,Devotion,26.0,22,-6,0,-3,1,down,1979-07-14
12423,LTD,1979-12-22,LTD - Devotion,22,22,28,5.0,28,Devotion,26.0,23,0,-6,0,0,stay,1979-07-14
12424,LTD,1979-12-29,LTD - Devotion,28,22,44,5.0,28,Devotion,26.0,24,-16,0,-6,1,down,1979-07-14
12425,LTD,1980-01-05,LTD - Devotion,28,28,48,5.0,44,Devotion,26.0,25,-4,-16,0,1,down,1979-07-14
12426,LTD,1980-01-12,LTD - Devotion,44,28,51,5.0,48,Devotion,26.0,26,-3,-4,-16,1,down,1979-07-14
12427,Candi Staton,1979-07-14,Candi Staton - Chance,51,51,29,23.0,36,Chance,11.0,0,7,15,0,1,up,1979-07-14
12428,Candi Staton,1979-07-21,Candi Staton - Chance,36,51,24,23.0,29,Chance,11.0,1,5,7,15,1,up,1979-07-14
12429,Candi Staton,1979-07-28,Candi Staton - Chance,29,36,23,23.0,24,Chance,11.0,2,1,5,7,1,up,1979-07-14
12430,Candi Staton,1979-08-04,Candi Staton - Chance,24,29,36,23.0,23,Chance,11.0,3,-13,1,5,1,down,1979-07-14
12431,Candi Staton,1979-08-11,Candi Staton - Chance,23,24,37,23.0,36,Chance,11.0,4,-1,-13,1,1,down,1979-07-14
12432,Candi Staton,1979-08-18,Candi Staton - Chance,36,23,32,23.0,37,Chance,11.0,5,5,-1,-13,1,up,1979-07-14
12433,Candi Staton,1979-08-25,Candi Staton - Chance,37,36,45,23.0,32,Chance,11.0,6,-13,5,-1,1,down,1979-07-14
12434,Candi Staton,1979-09-01,Candi Staton - Chance,32,37,45,23.0,45,Chance,11.0,7,0,-13,5,0,stay,1979-07-14
12435,Candi Staton,1979-09-08,Candi Staton - Chance,45,32,45,23.0,45,Chance,11.0,8,0,0,-13,0,stay,1979-07-14
12436,Candi Staton,1979-09-15,Candi Staton - Chance,45,45,47,23.0,45,Chance,11.0,9,-2,0,0,1,down,1979-07-14
12437,Candi Staton,1979-09-22,Candi Staton - Chance,45,45,49,23.0,47,Chance,11.0,10,-2,-2,0,1,down,1979-07-14
12438,Candi Staton,1979-09-29,Candi Staton - Chance,47,45,51,23.0,49,Chance,11.0,11,-2,-2,-2,1,down,1979-07-14
12439,Johnny Guitar Watson,1979-07-14,Johnny Guitar Watson - What The Hell Is This,51,51,35,35.0,43,What The Hell Is This,4.0,0,8,8,0,1,up,1979-07-14
12440,Johnny Guitar Watson,1979-07-21,Johnny Guitar Watson - What The Hell Is This,43,51,35,35.0,35,What The Hell Is This,4.0,1,0,8,8,0,stay,1979-07-14
12441,Johnny Guitar Watson,1979-07-28,Johnny Guitar Watson - What The Hell Is This,35,43,45,35.0,35,What The Hell Is This,4.0,2,-10,0,8,1,down,1979-07-14
12442,Johnny Guitar Watson,1979-08-04,Johnny Guitar Watson - What The Hell Is This,35,35,45,35.0,45,What The Hell Is This,4.0,3,0,-10,0,0,stay,1979-07-14
12443,Johnny Guitar Watson,1979-08-11,Johnny Guitar Watson - What The Hell Is This,45,35,51,35.0,45,What The Hell Is This,4.0,4,-6,0,-10,1,down,1979-07-14
12444,Lenny Williams,1979-07-14,Lenny Williams - Love Current,51,51,31,24.0,45,Love Current,10.0,0,14,6,0,1,up,1979-07-14
12445,Lenny Williams,1979-07-21,Lenny Williams - Love Current,45,51,26,24.0,31,Love Current,10.0,1,5,14,6,1,up,1979-07-14
12446,Lenny Williams,1979-07-28,Lenny Williams - Love Current,31,45,24,24.0,26,Love Current,10.0,2,2,5,14,1,up,1979-07-14
12447,Lenny Williams,1979-08-04,Lenny Williams - Love Current,26,31,24,24.0,24,Love Current,10.0,3,0,2,5,0,stay,1979-07-14
12448,Lenny Williams,1979-08-11,Lenny Williams - Love Current,24,26,28,24.0,24,Love Current,10.0,4,-4,0,2,1,down,1979-07-14
12449,Lenny Williams,1979-08-18,Lenny Williams - Love Current,24,24,30,24.0,28,Love Current,10.0,5,-2,-4,0,1,down,1979-07-14
12450,Lenny Williams,1979-08-25,Lenny Williams - Love Current,28,24,26,24.0,30,Love Current,10.0,6,4,-2,-4,1,up,1979-07-14
12451,Lenny Williams,1979-09-01,Lenny Williams - Love Current,30,28,44,24.0,26,Love Current,10.0,7,-18,4,-2,1,down,1979-07-14
12452,Lenny Williams,1979-09-08,Lenny Williams - Love Current,26,30,50,24.0,44,Love Current,10.0,8,-6,-18,4,1,down,1979-07-14
12453,Lenny Williams,1979-09-15,Lenny Williams - Love Current,44,26,50,24.0,50,Love Current,10.0,9,0,-6,-18,0,stay,1979-07-14
12454,Lenny Williams,1979-09-22,Lenny Williams - Love Current,50,44,51,24.0,50,Love Current,10.0,10,-1,0,-6,1,down,1979-07-14
12455,Sun,1979-07-14,Sun - Destination: Sun,51,51,27,17.0,46,Destination: Sun,12.0,0,19,5,0,1,up,1979-07-14
12456,Sun,1979-07-21,Sun - Destination: Sun,46,51,21,17.0,27,Destination: Sun,12.0,1,6,19,5,1,up,1979-07-14
12457,Sun,1979-07-28,Sun - Destination: Sun,27,46,18,17.0,21,Destination: Sun,12.0,2,3,6,19,1,up,1979-07-14
12458,Sun,1979-08-04,Sun - Destination: Sun,21,27,17,17.0,18,Destination: Sun,12.0,3,1,3,6,1,up,1979-07-14
12459,Sun,1979-08-11,Sun - Destination: Sun,18,21,24,17.0,17,Destination: Sun,12.0,4,-7,1,3,1,down,1979-07-14
12460,Sun,1979-08-18,Sun - Destination: Sun,17,18,24,17.0,24,Destination: Sun,12.0,5,0,-7,1,0,stay,1979-07-14
12461,Sun,1979-08-25,Sun - Destination: Sun,24,17,34,17.0,24,Destination: Sun,12.0,6,-10,0,-7,1,down,1979-07-14
12462,Sun,1979-09-01,Sun - Destination: Sun,24,24,34,17.0,34,Destination: Sun,12.0,7,0,-10,0,0,stay,1979-07-14
12463,Sun,1979-09-08,Sun - Destination: Sun,34,24,34,17.0,34,Destination: Sun,12.0,8,0,0,-10,0,stay,1979-07-14
12464,Sun,1979-09-15,Sun - Destination: Sun,34,34,36,17.0,34,Destination: Sun,12.0,9,-2,0,0,1,down,1979-07-14
12465,Sun,1979-09-22,Sun - Destination: Sun,34,34,39,17.0,36,Destination: Sun,12.0,10,-3,-2,0,1,down,1979-07-14
12466,Sun,1979-09-29,Sun - Destination: Sun,36,34,41,17.0,39,Destination: Sun,12.0,11,-2,-3,-2,1,down,1979-07-14
12467,Sun,1979-10-06,Sun - Destination: Sun,39,36,51,17.0,41,Destination: Sun,12.0,12,-10,-2,-3,1,down,1979-07-14
12468,Smokey Robinson,1979-07-14,Smokey Robinson - Where There's Smoke,51,51,47,8.0,47,Where There's Smoke,36.0,0,0,4,0,0,stay,1979-07-14
12469,Smokey Robinson,1979-07-21,Smokey Robinson - Where There's Smoke,47,51,43,8.0,47,Where There's Smoke,36.0,1,4,0,4,1,up,1979-07-14
12470,Smokey Robinson,1979-07-28,Smokey Robinson - Where There's Smoke,47,47,43,8.0,43,Where There's Smoke,36.0,2,0,4,0,0,stay,1979-07-14
12471,Smokey Robinson,1979-08-04,Smokey Robinson - Where There's Smoke,43,47,42,8.0,43,Where There's Smoke,36.0,3,1,0,4,1,up,1979-07-14
12472,Smokey Robinson,1979-08-11,Smokey Robinson - Where There's Smoke,43,43,49,8.0,42,Where There's Smoke,36.0,4,-7,1,0,1,down,1979-07-14
12473,Smokey Robinson,1979-09-08,Smokey Robinson - Where There's Smoke,42,43,42,8.0,49,Where There's Smoke,36.0,5,7,-7,1,1,up,1979-07-14
12474,Smokey Robinson,1979-09-15,Smokey Robinson - Where There's Smoke,49,42,40,8.0,42,Where There's Smoke,36.0,6,2,7,-7,1,up,1979-07-14
12475,Smokey Robinson,1979-09-22,Smokey Robinson - Where There's Smoke,42,49,32,8.0,40,Where There's Smoke,36.0,7,8,2,7,1,up,1979-07-14
12476,Smokey Robinson,1979-09-29,Smokey Robinson - Where There's Smoke,40,42,24,8.0,32,Where There's Smoke,36.0,8,8,8,2,1,up,1979-07-14
12477,Smokey Robinson,1979-10-06,Smokey Robinson - Where There's Smoke,32,40,20,8.0,24,Where There's Smoke,36.0,9,4,8,8,1,up,1979-07-14
12478,Smokey Robinson,1979-10-13,Smokey Robinson - Where There's Smoke,24,32,17,8.0,20,Where There's Smoke,36.0,10,3,4,8,1,up,1979-07-14
12479,Smokey Robinson,1979-10-20,Smokey Robinson - Where There's Smoke,20,24,14,8.0,17,Where There's Smoke,36.0,11,3,3,4,1,up,1979-07-14
12480,Smokey Robinson,1979-10-27,Smokey Robinson - Where There's Smoke,17,20,10,8.0,14,Where There's Smoke,36.0,12,4,3,3,1,up,1979-07-14
12481,Smokey Robinson,1979-11-03,Smokey Robinson - Where There's Smoke,14,17,10,8.0,10,Where There's Smoke,36.0,13,0,4,3,0,stay,1979-07-14
12482,Smokey Robinson,1979-11-10,Smokey Robinson - Where There's Smoke,10,14,12,8.0,10,Where There's Smoke,36.0,14,-2,0,4,1,down,1979-07-14
12483,Smokey Robinson,1979-11-17,Smokey Robinson - Where There's Smoke,10,10,12,8.0,12,Where There's Smoke,36.0,15,0,-2,0,0,stay,1979-07-14
12484,Smokey Robinson,1979-11-24,Smokey Robinson - Where There's Smoke,12,10,13,8.0,12,Where There's Smoke,36.0,16,-1,0,-2,1,down,1979-07-14
12485,Smokey Robinson,1979-12-01,Smokey Robinson - Where There's Smoke,12,12,13,8.0,13,Where There's Smoke,36.0,17,0,-1,0,0,stay,1979-07-14
12486,Smokey Robinson,1979-12-08,Smokey Robinson - Where There's Smoke,13,12,10,8.0,13,Where There's Smoke,36.0,18,3,0,-1,1,up,1979-07-14
12487,Smokey Robinson,1979-12-15,Smokey Robinson - Where There's Smoke,13,13,10,8.0,10,Where There's Smoke,36.0,19,0,3,0,0,stay,1979-07-14
12488,Smokey Robinson,1979-12-22,Smokey Robinson - Where There's Smoke,10,13,10,8.0,10,Where There's Smoke,36.0,20,0,0,3,0,stay,1979-07-14
12489,Smokey Robinson,1979-12-29,Smokey Robinson - Where There's Smoke,10,10,11,8.0,10,Where There's Smoke,36.0,21,-1,0,0,1,down,1979-07-14
12490,Smokey Robinson,1980-01-05,Smokey Robinson - Where There's Smoke,10,10,12,8.0,11,Where There's Smoke,36.0,22,-1,-1,0,1,down,1979-07-14
12491,Smokey Robinson,1980-01-12,Smokey Robinson - Where There's Smoke,11,10,11,8.0,12,Where There's Smoke,36.0,23,1,-1,-1,1,up,1979-07-14
12492,Smokey Robinson,1980-01-19,Smokey Robinson - Where There's Smoke,12,11,8,8.0,11,Where There's Smoke,36.0,24,3,1,-1,1,up,1979-07-14
12493,Smokey Robinson,1980-01-26,Smokey Robinson - Where There's Smoke,11,12,8,8.0,8,Where There's Smoke,36.0,25,0,3,1,0,stay,1979-07-14
12494,Smokey Robinson,1980-02-02,Smokey Robinson - Where There's Smoke,8,11,8,8.0,8,Where There's Smoke,36.0,26,0,0,3,0,stay,1979-07-14
12495,Smokey Robinson,1980-02-09,Smokey Robinson - Where There's Smoke,8,8,8,8.0,8,Where There's Smoke,36.0,27,0,0,0,0,stay,1979-07-14
12496,Smokey Robinson,1980-02-16,Smokey Robinson - Where There's Smoke,8,8,15,8.0,8,Where There's Smoke,36.0,28,-7,0,0,1,down,1979-07-14
12497,Smokey Robinson,1980-02-23,Smokey Robinson - Where There's Smoke,8,8,15,8.0,15,Where There's Smoke,36.0,29,0,-7,0,0,stay,1979-07-14
12498,Smokey Robinson,1980-03-01,Smokey Robinson - Where There's Smoke,15,8,16,8.0,15,Where There's Smoke,36.0,30,-1,0,-7,1,down,1979-07-14
12499,Smokey Robinson,1980-03-08,Smokey Robinson - Where There's Smoke,15,15,21,8.0,16,Where There's Smoke,36.0,31,-5,-1,0,1,down,1979-07-14
12500,Smokey Robinson,1980-03-15,Smokey Robinson - Where There's Smoke,16,15,28,8.0,21,Where There's Smoke,36.0,32,-7,-5,-1,1,down,1979-07-14
12501,Smokey Robinson,1980-03-22,Smokey Robinson - Where There's Smoke,21,16,33,8.0,28,Where There's Smoke,36.0,33,-5,-7,-5,1,down,1979-07-14
12502,Smokey Robinson,1980-03-29,Smokey Robinson - Where There's Smoke,28,21,37,8.0,33,Where There's Smoke,36.0,34,-4,-5,-7,1,down,1979-07-14
12503,Smokey Robinson,1980-04-05,Smokey Robinson - Where There's Smoke,33,28,40,8.0,37,Where There's Smoke,36.0,35,-3,-4,-5,1,down,1979-07-14
12504,Smokey Robinson,1980-04-12,Smokey Robinson - Where There's Smoke,37,33,51,8.0,40,Where There's Smoke,36.0,36,-11,-3,-4,1,down,1979-07-14
12505,Deniece Williams,1979-07-21,Deniece Williams - When Love Comes Calling,51,51,29,27.0,39,When Love Comes Calling,12.0,0,10,12,0,1,up,1979-07-21
12506,Deniece Williams,1979-07-28,Deniece Williams - When Love Comes Calling,39,51,28,27.0,29,When Love Comes Calling,12.0,1,1,10,12,1,up,1979-07-21
12507,Deniece Williams,1979-08-04,Deniece Williams - When Love Comes Calling,29,39,27,27.0,28,When Love Comes Calling,12.0,2,1,1,10,1,up,1979-07-21
12508,Deniece Williams,1979-08-11,Deniece Williams - When Love Comes Calling,28,29,30,27.0,27,When Love Comes Calling,12.0,3,-3,1,1,1,down,1979-07-21
12509,Deniece Williams,1979-08-18,Deniece Williams - When Love Comes Calling,27,28,31,27.0,30,When Love Comes Calling,12.0,4,-1,-3,1,1,down,1979-07-21
12510,Deniece Williams,1979-08-25,Deniece Williams - When Love Comes Calling,30,27,37,27.0,31,When Love Comes Calling,12.0,5,-6,-1,-3,1,down,1979-07-21
12511,Deniece Williams,1979-09-01,Deniece Williams - When Love Comes Calling,31,30,35,27.0,37,When Love Comes Calling,12.0,6,2,-6,-1,1,up,1979-07-21
12512,Deniece Williams,1979-09-08,Deniece Williams - When Love Comes Calling,37,31,38,27.0,35,When Love Comes Calling,12.0,7,-3,2,-6,1,down,1979-07-21
12513,Deniece Williams,1979-09-15,Deniece Williams - When Love Comes Calling,35,37,42,27.0,38,When Love Comes Calling,12.0,8,-4,-3,2,1,down,1979-07-21
12514,Deniece Williams,1979-09-22,Deniece Williams - When Love Comes Calling,38,35,44,27.0,42,When Love Comes Calling,12.0,9,-2,-4,-3,1,down,1979-07-21
12515,Deniece Williams,1979-09-29,Deniece Williams - When Love Comes Calling,42,38,40,27.0,44,When Love Comes Calling,12.0,10,4,-2,-4,1,up,1979-07-21
12516,Deniece Williams,1979-10-06,Deniece Williams - When Love Comes Calling,44,42,45,27.0,40,When Love Comes Calling,12.0,11,-5,4,-2,1,down,1979-07-21
12517,Deniece Williams,1979-10-13,Deniece Williams - When Love Comes Calling,40,44,51,27.0,45,When Love Comes Calling,12.0,12,-6,-5,4,1,down,1979-07-21
12518,Cameo,1979-07-21,Cameo - Secret Omen,51,51,28,4.0,48,Secret Omen,29.0,0,20,3,0,1,up,1979-07-21
12519,Cameo,1979-07-28,Cameo - Secret Omen,48,51,22,4.0,28,Secret Omen,29.0,1,6,20,3,1,up,1979-07-21
12520,Cameo,1979-08-04,Cameo - Secret Omen,28,48,18,4.0,22,Secret Omen,29.0,2,4,6,20,1,up,1979-07-21
12521,Cameo,1979-08-11,Cameo - Secret Omen,22,28,8,4.0,18,Secret Omen,29.0,3,10,4,6,1,up,1979-07-21
12522,Cameo,1979-08-18,Cameo - Secret Omen,18,22,6,4.0,8,Secret Omen,29.0,4,2,10,4,1,up,1979-07-21
12523,Cameo,1979-08-25,Cameo - Secret Omen,8,18,6,4.0,6,Secret Omen,29.0,5,0,2,10,0,stay,1979-07-21
12524,Cameo,1979-09-01,Cameo - Secret Omen,6,8,5,4.0,6,Secret Omen,29.0,6,1,0,2,1,up,1979-07-21
12525,Cameo,1979-09-08,Cameo - Secret Omen,6,6,4,4.0,5,Secret Omen,29.0,7,1,1,0,1,up,1979-07-21
12526,Cameo,1979-09-15,Cameo - Secret Omen,5,6,4,4.0,4,Secret Omen,29.0,8,0,1,1,0,stay,1979-07-21
12527,Cameo,1979-09-22,Cameo - Secret Omen,4,5,6,4.0,4,Secret Omen,29.0,9,-2,0,1,1,down,1979-07-21
12528,Cameo,1979-09-29,Cameo - Secret Omen,4,4,6,4.0,6,Secret Omen,29.0,10,0,-2,0,0,stay,1979-07-21
12529,Cameo,1979-10-06,Cameo - Secret Omen,6,4,8,4.0,6,Secret Omen,29.0,11,-2,0,-2,1,down,1979-07-21
12530,Cameo,1979-10-13,Cameo - Secret Omen,6,6,8,4.0,8,Secret Omen,29.0,12,0,-2,0,0,stay,1979-07-21
12531,Cameo,1979-10-20,Cameo - Secret Omen,8,6,12,4.0,8,Secret Omen,29.0,13,-4,0,-2,1,down,1979-07-21
12532,Cameo,1979-10-27,Cameo - Secret Omen,8,8,16,4.0,12,Secret Omen,29.0,14,-4,-4,0,1,down,1979-07-21
12533,Cameo,1979-11-03,Cameo - Secret Omen,12,8,20,4.0,16,Secret Omen,29.0,15,-4,-4,-4,1,down,1979-07-21
12534,Cameo,1979-11-10,Cameo - Secret Omen,16,12,21,4.0,20,Secret Omen,29.0,16,-1,-4,-4,1,down,1979-07-21
12535,Cameo,1979-11-17,Cameo - Secret Omen,20,16,27,4.0,21,Secret Omen,29.0,17,-6,-1,-4,1,down,1979-07-21
12536,Cameo,1979-11-24,Cameo - Secret Omen,21,20,27,4.0,27,Secret Omen,29.0,18,0,-6,-1,0,stay,1979-07-21
12537,Cameo,1979-12-01,Cameo - Secret Omen,27,21,36,4.0,27,Secret Omen,29.0,19,-9,0,-6,1,down,1979-07-21
12538,Cameo,1979-12-08,Cameo - Secret Omen,27,27,40,4.0,36,Secret Omen,29.0,20,-4,-9,0,1,down,1979-07-21
12539,Cameo,1979-12-15,Cameo - Secret Omen,36,27,40,4.0,40,Secret Omen,29.0,21,0,-4,-9,0,stay,1979-07-21
12540,Cameo,1979-12-22,Cameo - Secret Omen,40,36,40,4.0,40,Secret Omen,29.0,22,0,0,-4,0,stay,1979-07-21
12541,Cameo,1979-12-29,Cameo - Secret Omen,40,40,46,4.0,40,Secret Omen,29.0,23,-6,0,0,1,down,1979-07-21
12542,Cameo,1980-01-05,Cameo - Secret Omen,40,40,46,4.0,46,Secret Omen,29.0,24,0,-6,0,0,stay,1979-07-21
12543,Cameo,1980-01-12,Cameo - Secret Omen,46,40,42,4.0,46,Secret Omen,29.0,25,4,0,-6,1,up,1979-07-21
12544,Cameo,1980-02-09,Cameo - Secret Omen,46,46,42,4.0,42,Secret Omen,29.0,26,0,4,0,0,stay,1979-07-21
12545,Cameo,1980-02-16,Cameo - Secret Omen,42,46,40,4.0,42,Secret Omen,29.0,27,2,0,4,1,up,1979-07-21
12546,Cameo,1980-02-23,Cameo - Secret Omen,42,42,44,4.0,40,Secret Omen,29.0,28,-4,2,0,1,down,1979-07-21
12547,Cameo,1980-03-01,Cameo - Secret Omen,40,42,51,4.0,44,Secret Omen,29.0,29,-7,-4,2,1,down,1979-07-21
12548,Michael Henderson,1979-07-28,Michael Henderson - Do It All,51,51,30,17.0,36,Do It All,14.0,0,6,15,0,1,up,1979-07-28
12549,Michael Henderson,1979-08-04,Michael Henderson - Do It All,36,51,20,17.0,30,Do It All,14.0,1,10,6,15,1,up,1979-07-28
12550,Michael Henderson,1979-08-11,Michael Henderson - Do It All,30,36,19,17.0,20,Do It All,14.0,2,1,10,6,1,up,1979-07-28
12551,Michael Henderson,1979-08-18,Michael Henderson - Do It All,20,30,17,17.0,19,Do It All,14.0,3,2,1,10,1,up,1979-07-28
12552,Michael Henderson,1979-08-25,Michael Henderson - Do It All,19,20,23,17.0,17,Do It All,14.0,4,-6,2,1,1,down,1979-07-28
12553,Michael Henderson,1979-09-01,Michael Henderson - Do It All,17,19,23,17.0,23,Do It All,14.0,5,0,-6,2,0,stay,1979-07-28
12554,Michael Henderson,1979-09-08,Michael Henderson - Do It All,23,17,25,17.0,23,Do It All,14.0,6,-2,0,-6,1,down,1979-07-28
12555,Michael Henderson,1979-09-15,Michael Henderson - Do It All,23,23,27,17.0,25,Do It All,14.0,7,-2,-2,0,1,down,1979-07-28
12556,Michael Henderson,1979-09-22,Michael Henderson - Do It All,25,23,28,17.0,27,Do It All,14.0,8,-1,-2,-2,1,down,1979-07-28
12557,Michael Henderson,1979-09-29,Michael Henderson - Do It All,27,25,32,17.0,28,Do It All,14.0,9,-4,-1,-2,1,down,1979-07-28
12558,Michael Henderson,1979-10-06,Michael Henderson - Do It All,28,27,33,17.0,32,Do It All,14.0,10,-1,-4,-1,1,down,1979-07-28
12559,Michael Henderson,1979-10-13,Michael Henderson - Do It All,32,28,38,17.0,33,Do It All,14.0,11,-5,-1,-4,1,down,1979-07-28
12560,Michael Henderson,1979-10-20,Michael Henderson - Do It All,33,32,41,17.0,38,Do It All,14.0,12,-3,-5,-1,1,down,1979-07-28
12561,Michael Henderson,1979-10-27,Michael Henderson - Do It All,38,33,49,17.0,41,Do It All,14.0,13,-8,-3,-5,1,down,1979-07-28
12562,Michael Henderson,1979-11-03,Michael Henderson - Do It All,41,38,51,17.0,49,Do It All,14.0,14,-2,-8,-3,1,down,1979-07-28
12563,Stanley Clarke,1979-07-28,Stanley Clarke - I Wanna' Play For You,51,51,39,36.0,40,I Wanna' Play For You,3.0,0,1,11,0,1,up,1979-07-28
12564,Stanley Clarke,1979-08-04,Stanley Clarke - I Wanna' Play For You,40,51,38,36.0,39,I Wanna' Play For You,3.0,1,1,1,11,1,up,1979-07-28
12565,Stanley Clarke,1979-08-11,Stanley Clarke - I Wanna' Play For You,39,40,36,36.0,38,I Wanna' Play For You,3.0,2,2,1,1,1,up,1979-07-28
12566,Stanley Clarke,1979-08-18,Stanley Clarke - I Wanna' Play For You,38,39,51,36.0,36,I Wanna' Play For You,3.0,3,-15,2,1,1,down,1979-07-28
12567,James Brown,1979-07-28,James Brown - The Original Disco Man,51,51,41,37.0,41,The Original Disco Man,5.0,0,0,10,0,0,stay,1979-07-28
12568,James Brown,1979-08-04,James Brown - The Original Disco Man,41,51,37,37.0,41,The Original Disco Man,5.0,1,4,0,10,1,up,1979-07-28
12569,James Brown,1979-08-11,James Brown - The Original Disco Man,41,41,40,37.0,37,The Original Disco Man,5.0,2,-3,4,0,1,down,1979-07-28
12570,James Brown,1979-08-18,James Brown - The Original Disco Man,37,41,41,37.0,40,The Original Disco Man,5.0,3,-1,-3,4,1,down,1979-07-28
12571,James Brown,1979-08-25,James Brown - The Original Disco Man,40,37,48,37.0,41,The Original Disco Man,5.0,4,-7,-1,-3,1,down,1979-07-28
12572,James Brown,1979-09-01,James Brown - The Original Disco Man,41,40,51,37.0,48,The Original Disco Man,5.0,5,-3,-7,-1,1,down,1979-07-28
12573,Edwin Starr,1979-07-28,Edwin Starr - H.a.p.p.y. Radio,51,51,46,44.0,48,H.a.p.p.y. Radio,2.0,0,2,3,0,1,up,1979-07-28
12574,Edwin Starr,1979-08-04,Edwin Starr - H.a.p.p.y. Radio,48,51,44,44.0,46,H.a.p.p.y. Radio,2.0,1,2,2,3,1,up,1979-07-28
12575,Edwin Starr,1979-08-11,Edwin Starr - H.a.p.p.y. Radio,46,48,51,44.0,44,H.a.p.p.y. Radio,2.0,2,-7,2,2,1,down,1979-07-28
12576,A Taste Of Honey,1979-08-04,A Taste Of Honey - Another Taste,51,51,28,26.0,37,Another Taste,9.0,0,9,14,0,1,up,1979-08-04
12577,A Taste Of Honey,1979-08-11,A Taste Of Honey - Another Taste,37,51,26,26.0,28,Another Taste,9.0,1,2,9,14,1,up,1979-08-04
12578,A Taste Of Honey,1979-08-18,A Taste Of Honey - Another Taste,28,37,26,26.0,26,Another Taste,9.0,2,0,2,9,0,stay,1979-08-04
12579,A Taste Of Honey,1979-08-25,A Taste Of Honey - Another Taste,26,28,31,26.0,26,Another Taste,9.0,3,-5,0,2,1,down,1979-08-04
12580,A Taste Of Honey,1979-09-01,A Taste Of Honey - Another Taste,26,26,32,26.0,31,Another Taste,9.0,4,-1,-5,0,1,down,1979-08-04
12581,A Taste Of Honey,1979-09-08,A Taste Of Honey - Another Taste,31,26,32,26.0,32,Another Taste,9.0,5,0,-1,-5,0,stay,1979-08-04
12582,A Taste Of Honey,1979-09-15,A Taste Of Honey - Another Taste,32,31,33,26.0,32,Another Taste,9.0,6,-1,0,-1,1,down,1979-08-04
12583,A Taste Of Honey,1979-09-22,A Taste Of Honey - Another Taste,32,32,33,26.0,33,Another Taste,9.0,7,0,-1,0,0,stay,1979-08-04
12584,A Taste Of Honey,1979-09-29,A Taste Of Honey - Another Taste,33,32,34,26.0,33,Another Taste,9.0,8,-1,0,-1,1,down,1979-08-04
12585,A Taste Of Honey,1979-10-06,A Taste Of Honey - Another Taste,33,33,51,26.0,34,Another Taste,9.0,9,-17,-1,0,1,down,1979-08-04
12586,5 Special,1979-08-04,5 Special - Five Special,51,51,39,20.0,49,Five Special,13.0,0,10,2,0,1,up,1979-08-04
12587,5 Special,1979-08-11,5 Special - Five Special,49,51,29,20.0,39,Five Special,13.0,1,10,10,2,1,up,1979-08-04
12588,5 Special,1979-08-18,5 Special - Five Special,39,49,28,20.0,29,Five Special,13.0,2,1,10,10,1,up,1979-08-04
12589,5 Special,1979-08-25,5 Special - Five Special,29,39,21,20.0,28,Five Special,13.0,3,7,1,10,1,up,1979-08-04
12590,5 Special,1979-09-01,5 Special - Five Special,28,29,20,20.0,21,Five Special,13.0,4,1,7,1,1,up,1979-08-04
12591,5 Special,1979-09-08,5 Special - Five Special,21,28,24,20.0,20,Five Special,13.0,5,-4,1,7,1,down,1979-08-04
12592,5 Special,1979-09-15,5 Special - Five Special,20,21,25,20.0,24,Five Special,13.0,6,-1,-4,1,1,down,1979-08-04
12593,5 Special,1979-09-22,5 Special - Five Special,24,20,25,20.0,25,Five Special,13.0,7,0,-1,-4,0,stay,1979-08-04
12594,5 Special,1979-09-29,5 Special - Five Special,25,24,27,20.0,25,Five Special,13.0,8,-2,0,-1,1,down,1979-08-04
12595,5 Special,1979-10-06,5 Special - Five Special,25,25,27,20.0,27,Five Special,13.0,9,0,-2,0,0,stay,1979-08-04
12596,5 Special,1979-10-13,5 Special - Five Special,27,25,33,20.0,27,Five Special,13.0,10,-6,0,-2,1,down,1979-08-04
12597,5 Special,1979-10-20,5 Special - Five Special,27,27,36,20.0,33,Five Special,13.0,11,-3,-6,0,1,down,1979-08-04
12598,5 Special,1979-10-27,5 Special - Five Special,33,27,45,20.0,36,Five Special,13.0,12,-9,-3,-6,1,down,1979-08-04
12599,5 Special,1979-11-03,5 Special - Five Special,36,33,51,20.0,45,Five Special,13.0,13,-6,-9,-3,1,down,1979-08-04
12600,Denise LaSalle,1979-08-11,Denise LaSalle - Unwrapped,51,51,46,46.0,46,Unwrapped,1.0,0,0,5,0,0,stay,1979-08-11
12601,Denise LaSalle,1979-08-18,Denise LaSalle - Unwrapped,46,51,51,46.0,46,Unwrapped,1.0,1,-5,0,5,1,down,1979-08-11
12602,Various Artists,1979-08-11,Various Artists - A Night At Studio 54,51,51,48,37.0,49,A Night At Studio 54,11.0,0,1,2,0,1,up,1979-08-11
12603,Various Artists,1979-08-18,Various Artists - A Night At Studio 54,49,51,43,37.0,48,A Night At Studio 54,11.0,1,5,1,2,1,up,1979-08-11
12604,Various Artists,1979-08-25,Various Artists - A Night At Studio 54,48,49,39,37.0,43,A Night At Studio 54,11.0,2,4,5,1,1,up,1979-08-11
12605,Various Artists,1979-09-01,Various Artists - A Night At Studio 54,43,48,37,37.0,39,A Night At Studio 54,11.0,3,2,4,5,1,up,1979-08-11
12606,Various Artists,1979-09-08,Various Artists - A Night At Studio 54,39,43,37,37.0,37,A Night At Studio 54,11.0,4,0,2,4,0,stay,1979-08-11
12607,Various Artists,1979-09-15,Various Artists - A Night At Studio 54,37,39,38,37.0,37,A Night At Studio 54,11.0,5,-1,0,2,1,down,1979-08-11
12608,Various Artists,1979-09-22,Various Artists - A Night At Studio 54,37,37,38,37.0,38,A Night At Studio 54,11.0,6,0,-1,0,0,stay,1979-08-11
12609,Various Artists,1979-09-29,Various Artists - A Night At Studio 54,38,37,38,37.0,38,A Night At Studio 54,11.0,7,0,0,-1,0,stay,1979-08-11
12610,Various Artists,1979-10-06,Various Artists - A Night At Studio 54,38,38,38,37.0,38,A Night At Studio 54,11.0,8,0,0,0,0,stay,1979-08-11
12611,Various Artists,1979-10-13,Various Artists - A Night At Studio 54,38,38,41,37.0,38,A Night At Studio 54,11.0,9,-3,0,0,1,down,1979-08-11
12612,Various Artists,1979-10-20,Various Artists - A Night At Studio 54,38,38,44,37.0,41,A Night At Studio 54,11.0,10,-3,-3,0,1,down,1979-08-11
12613,Various Artists,1979-10-27,Various Artists - A Night At Studio 54,41,38,51,37.0,44,A Night At Studio 54,11.0,11,-7,-3,-3,1,down,1979-08-11
12614,Commodores,1979-08-18,Commodores - Midnight Magic,51,51,4,1.0,21,Midnight Magic,34.0,0,17,30,0,1,up,1979-08-18
12615,Commodores,1979-08-25,Commodores - Midnight Magic,21,51,2,1.0,4,Midnight Magic,34.0,1,2,17,30,1,up,1979-08-18
12616,Commodores,1979-09-01,Commodores - Midnight Magic,4,21,2,1.0,2,Midnight Magic,34.0,2,0,2,17,0,stay,1979-08-18
12617,Commodores,1979-09-08,Commodores - Midnight Magic,2,4,1,1.0,2,Midnight Magic,34.0,3,1,0,2,1,up,1979-08-18
12618,Commodores,1979-09-15,Commodores - Midnight Magic,2,2,1,1.0,1,Midnight Magic,34.0,4,0,1,0,0,stay,1979-08-18
12619,Commodores,1979-09-22,Commodores - Midnight Magic,1,2,1,1.0,1,Midnight Magic,34.0,5,0,0,1,0,stay,1979-08-18
12620,Commodores,1979-09-29,Commodores - Midnight Magic,1,1,2,1.0,1,Midnight Magic,34.0,6,-1,0,0,1,down,1979-08-18
12621,Commodores,1979-10-06,Commodores - Midnight Magic,1,1,2,1.0,2,Midnight Magic,34.0,7,0,-1,0,0,stay,1979-08-18
12622,Commodores,1979-10-13,Commodores - Midnight Magic,2,1,4,1.0,2,Midnight Magic,34.0,8,-2,0,-1,1,down,1979-08-18
12623,Commodores,1979-10-20,Commodores - Midnight Magic,2,2,4,1.0,4,Midnight Magic,34.0,9,0,-2,0,0,stay,1979-08-18
12624,Commodores,1979-10-27,Commodores - Midnight Magic,4,2,4,1.0,4,Midnight Magic,34.0,10,0,0,-2,0,stay,1979-08-18
12625,Commodores,1979-11-03,Commodores - Midnight Magic,4,4,4,1.0,4,Midnight Magic,34.0,11,0,0,0,0,stay,1979-08-18
12626,Commodores,1979-11-10,Commodores - Midnight Magic,4,4,3,1.0,4,Midnight Magic,34.0,12,1,0,0,1,up,1979-08-18
12627,Commodores,1979-11-17,Commodores - Midnight Magic,4,4,3,1.0,3,Midnight Magic,34.0,13,0,1,0,0,stay,1979-08-18
12628,Commodores,1979-11-24,Commodores - Midnight Magic,3,4,3,1.0,3,Midnight Magic,34.0,14,0,0,1,0,stay,1979-08-18
12629,Commodores,1979-12-01,Commodores - Midnight Magic,3,3,9,1.0,3,Midnight Magic,34.0,15,-6,0,0,1,down,1979-08-18
12630,Commodores,1979-12-08,Commodores - Midnight Magic,3,3,7,1.0,9,Midnight Magic,34.0,16,2,-6,0,1,up,1979-08-18
12631,Commodores,1979-12-15,Commodores - Midnight Magic,9,3,6,1.0,7,Midnight Magic,34.0,17,1,2,-6,1,up,1979-08-18
12632,Commodores,1979-12-22,Commodores - Midnight Magic,7,9,6,1.0,6,Midnight Magic,34.0,18,0,1,2,0,stay,1979-08-18
12633,Commodores,1979-12-29,Commodores - Midnight Magic,6,7,6,1.0,6,Midnight Magic,34.0,19,0,0,1,0,stay,1979-08-18
12634,Commodores,1980-01-05,Commodores - Midnight Magic,6,6,9,1.0,6,Midnight Magic,34.0,20,-3,0,0,1,down,1979-08-18
12635,Commodores,1980-01-12,Commodores - Midnight Magic,6,6,9,1.0,9,Midnight Magic,34.0,21,0,-3,0,0,stay,1979-08-18
12636,Commodores,1980-01-19,Commodores - Midnight Magic,9,6,19,1.0,9,Midnight Magic,34.0,22,-10,0,-3,1,down,1979-08-18
12637,Commodores,1980-01-26,Commodores - Midnight Magic,9,9,16,1.0,19,Midnight Magic,34.0,23,3,-10,0,1,up,1979-08-18
12638,Commodores,1980-02-02,Commodores - Midnight Magic,19,9,16,1.0,16,Midnight Magic,34.0,24,0,3,-10,0,stay,1979-08-18
12639,Commodores,1980-02-09,Commodores - Midnight Magic,16,19,18,1.0,16,Midnight Magic,34.0,25,-2,0,3,1,down,1979-08-18
12640,Commodores,1980-02-16,Commodores - Midnight Magic,16,16,18,1.0,18,Midnight Magic,34.0,26,0,-2,0,0,stay,1979-08-18
12641,Commodores,1980-02-23,Commodores - Midnight Magic,18,16,19,1.0,18,Midnight Magic,34.0,27,-1,0,-2,1,down,1979-08-18
12642,Commodores,1980-03-01,Commodores - Midnight Magic,18,18,24,1.0,19,Midnight Magic,34.0,28,-5,-1,0,1,down,1979-08-18
12643,Commodores,1980-03-08,Commodores - Midnight Magic,19,18,34,1.0,24,Midnight Magic,34.0,29,-10,-5,-1,1,down,1979-08-18
12644,Commodores,1980-03-15,Commodores - Midnight Magic,24,19,34,1.0,34,Midnight Magic,34.0,30,0,-10,-5,0,stay,1979-08-18
12645,Commodores,1980-03-22,Commodores - Midnight Magic,34,24,36,1.0,34,Midnight Magic,34.0,31,-2,0,-10,1,down,1979-08-18
12646,Commodores,1980-03-29,Commodores - Midnight Magic,34,34,35,1.0,36,Midnight Magic,34.0,32,1,-2,0,1,up,1979-08-18
12647,Commodores,1980-04-05,Commodores - Midnight Magic,36,34,36,1.0,35,Midnight Magic,34.0,33,-1,1,-2,1,down,1979-08-18
12648,Commodores,1980-04-12,Commodores - Midnight Magic,35,36,51,1.0,36,Midnight Magic,34.0,34,-15,-1,1,1,down,1979-08-18
12649,Curtis Mayfield,1979-08-18,Curtis Mayfield - Heartbeat,51,51,34,19.0,41,Heartbeat,17.0,0,7,10,0,1,up,1979-08-18
12650,Curtis Mayfield,1979-08-25,Curtis Mayfield - Heartbeat,41,51,27,19.0,34,Heartbeat,17.0,1,7,7,10,1,up,1979-08-18
12651,Curtis Mayfield,1979-09-01,Curtis Mayfield - Heartbeat,34,41,25,19.0,27,Heartbeat,17.0,2,2,7,7,1,up,1979-08-18
12652,Curtis Mayfield,1979-09-08,Curtis Mayfield - Heartbeat,27,34,23,19.0,25,Heartbeat,17.0,3,2,2,7,1,up,1979-08-18
12653,Curtis Mayfield,1979-09-15,Curtis Mayfield - Heartbeat,25,27,21,19.0,23,Heartbeat,17.0,4,2,2,2,1,up,1979-08-18
12654,Curtis Mayfield,1979-09-22,Curtis Mayfield - Heartbeat,23,25,21,19.0,21,Heartbeat,17.0,5,0,2,2,0,stay,1979-08-18
12655,Curtis Mayfield,1979-09-29,Curtis Mayfield - Heartbeat,21,23,20,19.0,21,Heartbeat,17.0,6,1,0,2,1,up,1979-08-18
12656,Curtis Mayfield,1979-10-06,Curtis Mayfield - Heartbeat,21,21,19,19.0,20,Heartbeat,17.0,7,1,1,0,1,up,1979-08-18
12657,Curtis Mayfield,1979-10-13,Curtis Mayfield - Heartbeat,20,21,19,19.0,19,Heartbeat,17.0,8,0,1,1,0,stay,1979-08-18
12658,Curtis Mayfield,1979-10-20,Curtis Mayfield - Heartbeat,19,20,24,19.0,19,Heartbeat,17.0,9,-5,0,1,1,down,1979-08-18
12659,Curtis Mayfield,1979-10-27,Curtis Mayfield - Heartbeat,19,19,24,19.0,24,Heartbeat,17.0,10,0,-5,0,0,stay,1979-08-18
12660,Curtis Mayfield,1979-11-03,Curtis Mayfield - Heartbeat,24,19,29,19.0,24,Heartbeat,17.0,11,-5,0,-5,1,down,1979-08-18
12661,Curtis Mayfield,1979-11-10,Curtis Mayfield - Heartbeat,24,24,29,19.0,29,Heartbeat,17.0,12,0,-5,0,0,stay,1979-08-18
12662,Curtis Mayfield,1979-11-17,Curtis Mayfield - Heartbeat,29,24,30,19.0,29,Heartbeat,17.0,13,-1,0,-5,1,down,1979-08-18
12663,Curtis Mayfield,1979-11-24,Curtis Mayfield - Heartbeat,29,29,39,19.0,30,Heartbeat,17.0,14,-9,-1,0,1,down,1979-08-18
12664,Curtis Mayfield,1979-12-01,Curtis Mayfield - Heartbeat,30,29,41,19.0,39,Heartbeat,17.0,15,-2,-9,-1,1,down,1979-08-18
12665,Curtis Mayfield,1979-12-08,Curtis Mayfield - Heartbeat,39,30,41,19.0,41,Heartbeat,17.0,16,0,-2,-9,0,stay,1979-08-18
12666,Curtis Mayfield,1979-12-15,Curtis Mayfield - Heartbeat,41,39,51,19.0,41,Heartbeat,17.0,17,-10,0,-2,1,down,1979-08-18
12667,Pleasure,1979-08-18,Pleasure - Future Now,51,51,40,13.0,50,Future Now,28.0,0,10,1,0,1,up,1979-08-18
12668,Pleasure,1979-08-25,Pleasure - Future Now,50,51,30,13.0,40,Future Now,28.0,1,10,10,1,1,up,1979-08-18
12669,Pleasure,1979-09-01,Pleasure - Future Now,40,50,24,13.0,30,Future Now,28.0,2,6,10,10,1,up,1979-08-18
12670,Pleasure,1979-09-08,Pleasure - Future Now,30,40,20,13.0,24,Future Now,28.0,3,4,6,10,1,up,1979-08-18
12671,Pleasure,1979-09-15,Pleasure - Future Now,24,30,17,13.0,20,Future Now,28.0,4,3,4,6,1,up,1979-08-18
12672,Pleasure,1979-09-22,Pleasure - Future Now,20,24,16,13.0,17,Future Now,28.0,5,1,3,4,1,up,1979-08-18
12673,Pleasure,1979-09-29,Pleasure - Future Now,17,20,14,13.0,16,Future Now,28.0,6,2,1,3,1,up,1979-08-18
12674,Pleasure,1979-10-06,Pleasure - Future Now,16,17,13,13.0,14,Future Now,28.0,7,1,2,1,1,up,1979-08-18
12675,Pleasure,1979-10-13,Pleasure - Future Now,14,16,13,13.0,13,Future Now,28.0,8,0,1,2,0,stay,1979-08-18
12676,Pleasure,1979-10-20,Pleasure - Future Now,13,14,19,13.0,13,Future Now,28.0,9,-6,0,1,1,down,1979-08-18
12677,Pleasure,1979-10-27,Pleasure - Future Now,13,13,18,13.0,19,Future Now,28.0,10,1,-6,0,1,up,1979-08-18
12678,Pleasure,1979-11-03,Pleasure - Future Now,19,13,13,13.0,18,Future Now,28.0,11,5,1,-6,1,up,1979-08-18
12679,Pleasure,1979-11-10,Pleasure - Future Now,18,19,13,13.0,13,Future Now,28.0,12,0,5,1,0,stay,1979-08-18
12680,Pleasure,1979-11-17,Pleasure - Future Now,13,18,14,13.0,13,Future Now,28.0,13,-1,0,5,1,down,1979-08-18
12681,Pleasure,1979-11-24,Pleasure - Future Now,13,13,20,13.0,14,Future Now,28.0,14,-6,-1,0,1,down,1979-08-18
12682,Pleasure,1979-12-01,Pleasure - Future Now,14,13,19,13.0,20,Future Now,28.0,15,1,-6,-1,1,up,1979-08-18
12683,Pleasure,1979-12-08,Pleasure - Future Now,20,14,21,13.0,19,Future Now,28.0,16,-2,1,-6,1,down,1979-08-18
12684,Pleasure,1979-12-15,Pleasure - Future Now,19,20,22,13.0,21,Future Now,28.0,17,-1,-2,1,1,down,1979-08-18
12685,Pleasure,1979-12-22,Pleasure - Future Now,21,19,22,13.0,22,Future Now,28.0,18,0,-1,-2,0,stay,1979-08-18
12686,Pleasure,1979-12-29,Pleasure - Future Now,22,21,27,13.0,22,Future Now,28.0,19,-5,0,-1,1,down,1979-08-18
12687,Pleasure,1980-01-05,Pleasure - Future Now,22,22,29,13.0,27,Future Now,28.0,20,-2,-5,0,1,down,1979-08-18
12688,Pleasure,1980-01-12,Pleasure - Future Now,27,22,29,13.0,29,Future Now,28.0,21,0,-2,-5,0,stay,1979-08-18
12689,Pleasure,1980-01-19,Pleasure - Future Now,29,27,25,13.0,29,Future Now,28.0,22,4,0,-2,1,up,1979-08-18
12690,Pleasure,1980-01-26,Pleasure - Future Now,29,29,25,13.0,25,Future Now,28.0,23,0,4,0,0,stay,1979-08-18
12691,Pleasure,1980-02-02,Pleasure - Future Now,25,29,39,13.0,25,Future Now,28.0,24,-14,0,4,1,down,1979-08-18
12692,Pleasure,1980-02-09,Pleasure - Future Now,25,25,41,13.0,39,Future Now,28.0,25,-2,-14,0,1,down,1979-08-18
12693,Pleasure,1980-02-16,Pleasure - Future Now,39,25,45,13.0,41,Future Now,28.0,26,-4,-2,-14,1,down,1979-08-18
12694,Pleasure,1980-02-23,Pleasure - Future Now,41,39,48,13.0,45,Future Now,28.0,27,-3,-4,-2,1,down,1979-08-18
12695,Pleasure,1980-03-01,Pleasure - Future Now,45,41,51,13.0,48,Future Now,28.0,28,-3,-3,-4,1,down,1979-08-18
12696,Chic,1979-08-25,Chic - Risque,51,51,7,2.0,22,Risque,13.0,0,15,29,0,1,up,1979-08-25
12697,Chic,1979-09-01,Chic - Risque,22,51,3,2.0,7,Risque,13.0,1,4,15,29,1,up,1979-08-25
12698,Chic,1979-09-08,Chic - Risque,7,22,2,2.0,3,Risque,13.0,2,1,4,15,1,up,1979-08-25
12699,Chic,1979-09-15,Chic - Risque,3,7,2,2.0,2,Risque,13.0,3,0,1,4,0,stay,1979-08-25
12700,Chic,1979-09-22,Chic - Risque,2,3,4,2.0,2,Risque,13.0,4,-2,0,1,1,down,1979-08-25
12701,Chic,1979-09-29,Chic - Risque,2,2,5,2.0,4,Risque,13.0,5,-1,-2,0,1,down,1979-08-25
12702,Chic,1979-10-06,Chic - Risque,4,2,6,2.0,5,Risque,13.0,6,-1,-1,-2,1,down,1979-08-25
12703,Chic,1979-10-13,Chic - Risque,5,4,6,2.0,6,Risque,13.0,7,0,-1,-1,0,stay,1979-08-25
12704,Chic,1979-10-20,Chic - Risque,6,5,8,2.0,6,Risque,13.0,8,-2,0,-1,1,down,1979-08-25
12705,Chic,1979-10-27,Chic - Risque,6,6,8,2.0,8,Risque,13.0,9,0,-2,0,0,stay,1979-08-25
12706,Chic,1979-11-03,Chic - Risque,8,6,8,2.0,8,Risque,13.0,10,0,0,-2,0,stay,1979-08-25
12707,Chic,1979-11-10,Chic - Risque,8,8,34,2.0,8,Risque,13.0,11,-26,0,0,1,down,1979-08-25
12708,Chic,1979-11-17,Chic - Risque,8,8,41,2.0,34,Risque,13.0,12,-7,-26,0,1,down,1979-08-25
12709,Chic,1979-11-24,Chic - Risque,34,8,51,2.0,41,Risque,13.0,13,-10,-7,-26,1,down,1979-08-25
12710,Tower Of Power,1979-08-25,Tower Of Power - Back On The Streets,51,51,36,28.0,46,Back On The Streets,8.0,0,10,5,0,1,up,1979-08-25
12711,Tower Of Power,1979-09-01,Tower Of Power - Back On The Streets,46,51,36,28.0,36,Back On The Streets,8.0,1,0,10,5,0,stay,1979-08-25
12712,Tower Of Power,1979-09-08,Tower Of Power - Back On The Streets,36,46,29,28.0,36,Back On The Streets,8.0,2,7,0,10,1,up,1979-08-25
12713,Tower Of Power,1979-09-15,Tower Of Power - Back On The Streets,36,36,28,28.0,29,Back On The Streets,8.0,3,1,7,0,1,up,1979-08-25
12714,Tower Of Power,1979-09-22,Tower Of Power - Back On The Streets,29,36,30,28.0,28,Back On The Streets,8.0,4,-2,1,7,1,down,1979-08-25
12715,Tower Of Power,1979-09-29,Tower Of Power - Back On The Streets,28,29,33,28.0,30,Back On The Streets,8.0,5,-3,-2,1,1,down,1979-08-25
12716,Tower Of Power,1979-10-06,Tower Of Power - Back On The Streets,30,28,43,28.0,33,Back On The Streets,8.0,6,-10,-3,-2,1,down,1979-08-25
12717,Tower Of Power,1979-10-13,Tower Of Power - Back On The Streets,33,30,46,28.0,43,Back On The Streets,8.0,7,-3,-10,-3,1,down,1979-08-25
12718,Tower Of Power,1979-10-20,Tower Of Power - Back On The Streets,43,33,51,28.0,46,Back On The Streets,8.0,8,-5,-3,-10,1,down,1979-08-25
12719,Maxine Nightingale,1979-08-25,Maxine Nightingale - Lead Me On,51,51,44,35.0,47,Lead Me On,7.0,0,3,4,0,1,up,1979-08-25
12720,Maxine Nightingale,1979-09-01,Maxine Nightingale - Lead Me On,47,51,43,35.0,44,Lead Me On,7.0,1,1,3,4,1,up,1979-08-25
12721,Maxine Nightingale,1979-09-08,Maxine Nightingale - Lead Me On,44,47,35,35.0,43,Lead Me On,7.0,2,8,1,3,1,up,1979-08-25
12722,Maxine Nightingale,1979-09-15,Maxine Nightingale - Lead Me On,43,44,35,35.0,35,Lead Me On,7.0,3,0,8,1,0,stay,1979-08-25
12723,Maxine Nightingale,1979-09-22,Maxine Nightingale - Lead Me On,35,43,35,35.0,35,Lead Me On,7.0,4,0,0,8,0,stay,1979-08-25
12724,Maxine Nightingale,1979-09-29,Maxine Nightingale - Lead Me On,35,35,36,35.0,35,Lead Me On,7.0,5,-1,0,0,1,down,1979-08-25
12725,Maxine Nightingale,1979-10-06,Maxine Nightingale - Lead Me On,35,35,46,35.0,36,Lead Me On,7.0,6,-10,-1,0,1,down,1979-08-25
12726,Maxine Nightingale,1979-10-13,Maxine Nightingale - Lead Me On,36,35,51,35.0,46,Lead Me On,7.0,7,-5,-10,-1,1,down,1979-08-25
12727,Barry White,1979-08-25,Barry White - I Love To Sing The Songs I Sing,51,51,40,40.0,50,I Love To Sing The Songs I Sing,3.0,0,10,1,0,1,up,1979-08-25
12728,Barry White,1979-09-01,Barry White - I Love To Sing The Songs I Sing,50,51,40,40.0,40,I Love To Sing The Songs I Sing,3.0,1,0,10,1,0,stay,1979-08-25
12729,Barry White,1979-09-08,Barry White - I Love To Sing The Songs I Sing,40,50,49,40.0,40,I Love To Sing The Songs I Sing,3.0,2,-9,0,10,1,down,1979-08-25
12730,Barry White,1979-09-15,Barry White - I Love To Sing The Songs I Sing,40,40,51,40.0,49,I Love To Sing The Songs I Sing,3.0,3,-2,-9,0,1,down,1979-08-25
12731,Ashford & Simpson,1979-09-01,Ashford & Simpson - Stay Free,51,51,9,3.0,20,Stay Free,24.0,0,11,31,0,1,up,1979-09-01
12732,Ashford & Simpson,1979-09-08,Ashford & Simpson - Stay Free,20,51,7,3.0,9,Stay Free,24.0,1,2,11,31,1,up,1979-09-01
12733,Ashford & Simpson,1979-09-15,Ashford & Simpson - Stay Free,9,20,6,3.0,7,Stay Free,24.0,2,1,2,11,1,up,1979-09-01
12734,Ashford & Simpson,1979-09-22,Ashford & Simpson - Stay Free,7,9,3,3.0,6,Stay Free,24.0,3,3,1,2,1,up,1979-09-01
12735,Ashford & Simpson,1979-09-29,Ashford & Simpson - Stay Free,6,7,3,3.0,3,Stay Free,24.0,4,0,3,1,0,stay,1979-09-01
12736,Ashford & Simpson,1979-10-06,Ashford & Simpson - Stay Free,3,6,4,3.0,3,Stay Free,24.0,5,-1,0,3,1,down,1979-09-01
12737,Ashford & Simpson,1979-10-13,Ashford & Simpson - Stay Free,3,3,5,3.0,4,Stay Free,24.0,6,-1,-1,0,1,down,1979-09-01
12738,Ashford & Simpson,1979-10-20,Ashford & Simpson - Stay Free,4,3,6,3.0,5,Stay Free,24.0,7,-1,-1,-1,1,down,1979-09-01
12739,Ashford & Simpson,1979-10-27,Ashford & Simpson - Stay Free,5,4,7,3.0,6,Stay Free,24.0,8,-1,-1,-1,1,down,1979-09-01
12740,Ashford & Simpson,1979-11-03,Ashford & Simpson - Stay Free,6,5,7,3.0,7,Stay Free,24.0,9,0,-1,-1,0,stay,1979-09-01
12741,Ashford & Simpson,1979-11-10,Ashford & Simpson - Stay Free,7,6,9,3.0,7,Stay Free,24.0,10,-2,0,-1,1,down,1979-09-01
12742,Ashford & Simpson,1979-11-17,Ashford & Simpson - Stay Free,7,7,15,3.0,9,Stay Free,24.0,11,-6,-2,0,1,down,1979-09-01
12743,Ashford & Simpson,1979-11-24,Ashford & Simpson - Stay Free,9,7,15,3.0,15,Stay Free,24.0,12,0,-6,-2,0,stay,1979-09-01
12744,Ashford & Simpson,1979-12-01,Ashford & Simpson - Stay Free,15,9,15,3.0,15,Stay Free,24.0,13,0,0,-6,0,stay,1979-09-01
12745,Ashford & Simpson,1979-12-08,Ashford & Simpson - Stay Free,15,15,20,3.0,15,Stay Free,24.0,14,-5,0,0,1,down,1979-09-01
12746,Ashford & Simpson,1979-12-15,Ashford & Simpson - Stay Free,15,15,25,3.0,20,Stay Free,24.0,15,-5,-5,0,1,down,1979-09-01
12747,Ashford & Simpson,1979-12-22,Ashford & Simpson - Stay Free,20,15,25,3.0,25,Stay Free,24.0,16,0,-5,-5,0,stay,1979-09-01
12748,Ashford & Simpson,1979-12-29,Ashford & Simpson - Stay Free,25,20,38,3.0,25,Stay Free,24.0,17,-13,0,-5,1,down,1979-09-01
12749,Ashford & Simpson,1980-01-05,Ashford & Simpson - Stay Free,25,25,43,3.0,38,Stay Free,24.0,18,-5,-13,0,1,down,1979-09-01
12750,Ashford & Simpson,1980-01-12,Ashford & Simpson - Stay Free,38,25,46,3.0,43,Stay Free,24.0,19,-3,-5,-13,1,down,1979-09-01
12751,Ashford & Simpson,1980-01-19,Ashford & Simpson - Stay Free,43,38,46,3.0,46,Stay Free,24.0,20,0,-3,-5,0,stay,1979-09-01
12752,Ashford & Simpson,1980-01-26,Ashford & Simpson - Stay Free,46,43,46,3.0,46,Stay Free,24.0,21,0,0,-3,0,stay,1979-09-01
12753,Ashford & Simpson,1980-02-02,Ashford & Simpson - Stay Free,46,46,50,3.0,46,Stay Free,24.0,22,-4,0,0,1,down,1979-09-01
12754,Ashford & Simpson,1980-02-09,Ashford & Simpson - Stay Free,46,46,50,3.0,50,Stay Free,24.0,23,0,-4,0,0,stay,1979-09-01
12755,Ashford & Simpson,1980-02-16,Ashford & Simpson - Stay Free,50,46,51,3.0,50,Stay Free,24.0,24,-1,0,-4,1,down,1979-09-01
12756,Michael Jackson,1979-09-01,Michael Jackson - Off The Wall,51,51,6,1.0,32,Off The Wall,56.0,0,26,19,0,1,up,1979-09-01
12757,Michael Jackson,1979-09-08,Michael Jackson - Off The Wall,32,51,5,1.0,6,Off The Wall,56.0,1,1,26,19,1,up,1979-09-01
12758,Michael Jackson,1979-09-15,Michael Jackson - Off The Wall,6,32,3,1.0,5,Off The Wall,56.0,2,2,1,26,1,up,1979-09-01
12759,Michael Jackson,1979-09-22,Michael Jackson - Off The Wall,5,6,2,1.0,3,Off The Wall,56.0,3,1,2,1,1,up,1979-09-01
12760,Michael Jackson,1979-09-29,Michael Jackson - Off The Wall,3,5,1,1.0,2,Off The Wall,56.0,4,1,1,2,1,up,1979-09-01
12761,Michael Jackson,1979-10-06,Michael Jackson - Off The Wall,2,3,1,1.0,1,Off The Wall,56.0,5,0,1,1,0,stay,1979-09-01
12762,Michael Jackson,1979-10-13,Michael Jackson - Off The Wall,1,2,1,1.0,1,Off The Wall,56.0,6,0,0,1,0,stay,1979-09-01
12763,Michael Jackson,1979-10-20,Michael Jackson - Off The Wall,1,1,2,1.0,1,Off The Wall,56.0,7,-1,0,0,1,down,1979-09-01
12764,Michael Jackson,1979-10-27,Michael Jackson - Off The Wall,1,1,2,1.0,2,Off The Wall,56.0,8,0,-1,0,0,stay,1979-09-01
12765,Michael Jackson,1979-11-03,Michael Jackson - Off The Wall,2,1,1,1.0,2,Off The Wall,56.0,9,1,0,-1,1,up,1979-09-01
12766,Michael Jackson,1979-11-10,Michael Jackson - Off The Wall,2,2,1,1.0,1,Off The Wall,56.0,10,0,1,0,0,stay,1979-09-01
12767,Michael Jackson,1979-11-17,Michael Jackson - Off The Wall,1,2,1,1.0,1,Off The Wall,56.0,11,0,0,1,0,stay,1979-09-01
12768,Michael Jackson,1979-11-24,Michael Jackson - Off The Wall,1,1,1,1.0,1,Off The Wall,56.0,12,0,0,0,0,stay,1979-09-01
12769,Michael Jackson,1979-12-01,Michael Jackson - Off The Wall,1,1,1,1.0,1,Off The Wall,56.0,13,0,0,0,0,stay,1979-09-01
12770,Michael Jackson,1979-12-08,Michael Jackson - Off The Wall,1,1,1,1.0,1,Off The Wall,56.0,14,0,0,0,0,stay,1979-09-01
12771,Michael Jackson,1979-12-15,Michael Jackson - Off The Wall,1,1,2,1.0,1,Off The Wall,56.0,15,-1,0,0,1,down,1979-09-01
12772,Michael Jackson,1979-12-22,Michael Jackson - Off The Wall,1,1,2,1.0,2,Off The Wall,56.0,16,0,-1,0,0,stay,1979-09-01
12773,Michael Jackson,1979-12-29,Michael Jackson - Off The Wall,2,1,1,1.0,2,Off The Wall,56.0,17,1,0,-1,1,up,1979-09-01
12774,Michael Jackson,1980-01-05,Michael Jackson - Off The Wall,2,2,1,1.0,1,Off The Wall,56.0,18,0,1,0,0,stay,1979-09-01
12775,Michael Jackson,1980-01-12,Michael Jackson - Off The Wall,1,2,1,1.0,1,Off The Wall,56.0,19,0,0,1,0,stay,1979-09-01
12776,Michael Jackson,1980-01-19,Michael Jackson - Off The Wall,1,1,1,1.0,1,Off The Wall,56.0,20,0,0,0,0,stay,1979-09-01
12777,Michael Jackson,1980-01-26,Michael Jackson - Off The Wall,1,1,1,1.0,1,Off The Wall,56.0,21,0,0,0,0,stay,1979-09-01
12778,Michael Jackson,1980-02-02,Michael Jackson - Off The Wall,1,1,1,1.0,1,Off The Wall,56.0,22,0,0,0,0,stay,1979-09-01
12779,Michael Jackson,1980-02-09,Michael Jackson - Off The Wall,1,1,1,1.0,1,Off The Wall,56.0,23,0,0,0,0,stay,1979-09-01
12780,Michael Jackson,1980-02-16,Michael Jackson - Off The Wall,1,1,2,1.0,1,Off The Wall,56.0,24,-1,0,0,1,down,1979-09-01
12781,Michael Jackson,1980-02-23,Michael Jackson - Off The Wall,1,1,2,1.0,2,Off The Wall,56.0,25,0,-1,0,0,stay,1979-09-01
12782,Michael Jackson,1980-03-01,Michael Jackson - Off The Wall,2,1,4,1.0,2,Off The Wall,56.0,26,-2,0,-1,1,down,1979-09-01
12783,Michael Jackson,1980-03-08,Michael Jackson - Off The Wall,2,2,4,1.0,4,Off The Wall,56.0,27,0,-2,0,0,stay,1979-09-01
12784,Michael Jackson,1980-03-15,Michael Jackson - Off The Wall,4,2,4,1.0,4,Off The Wall,56.0,28,0,0,-2,0,stay,1979-09-01
12785,Michael Jackson,1980-03-22,Michael Jackson - Off The Wall,4,4,5,1.0,4,Off The Wall,56.0,29,-1,0,0,1,down,1979-09-01
12786,Michael Jackson,1980-03-29,Michael Jackson - Off The Wall,4,4,5,1.0,5,Off The Wall,56.0,30,0,-1,0,0,stay,1979-09-01
12787,Michael Jackson,1980-04-05,Michael Jackson - Off The Wall,5,4,4,1.0,5,Off The Wall,56.0,31,1,0,-1,1,up,1979-09-01
12788,Michael Jackson,1980-04-12,Michael Jackson - Off The Wall,5,5,4,1.0,4,Off The Wall,56.0,32,0,1,0,0,stay,1979-09-01
12789,Michael Jackson,1980-04-19,Michael Jackson - Off The Wall,4,5,4,1.0,4,Off The Wall,56.0,33,0,0,1,0,stay,1979-09-01
12790,Michael Jackson,1980-04-26,Michael Jackson - Off The Wall,4,4,5,1.0,4,Off The Wall,56.0,34,-1,0,0,1,down,1979-09-01
12791,Michael Jackson,1980-05-03,Michael Jackson - Off The Wall,4,4,8,1.0,5,Off The Wall,56.0,35,-3,-1,0,1,down,1979-09-01
12792,Michael Jackson,1980-05-10,Michael Jackson - Off The Wall,5,4,12,1.0,8,Off The Wall,56.0,36,-4,-3,-1,1,down,1979-09-01
12793,Michael Jackson,1980-05-17,Michael Jackson - Off The Wall,8,5,15,1.0,12,Off The Wall,56.0,37,-3,-4,-3,1,down,1979-09-01
12794,Michael Jackson,1980-05-24,Michael Jackson - Off The Wall,12,8,16,1.0,15,Off The Wall,56.0,38,-1,-3,-4,1,down,1979-09-01
12795,Michael Jackson,1980-05-31,Michael Jackson - Off The Wall,15,12,16,1.0,16,Off The Wall,56.0,39,0,-1,-3,0,stay,1979-09-01
12796,Michael Jackson,1980-06-07,Michael Jackson - Off The Wall,16,15,15,1.0,16,Off The Wall,56.0,40,1,0,-1,1,up,1979-09-01
12797,Michael Jackson,1980-06-14,Michael Jackson - Off The Wall,16,16,18,1.0,15,Off The Wall,56.0,41,-3,1,0,1,down,1979-09-01
12798,Michael Jackson,1980-06-21,Michael Jackson - Off The Wall,15,16,23,1.0,18,Off The Wall,56.0,42,-5,-3,1,1,down,1979-09-01
12799,Michael Jackson,1980-06-28,Michael Jackson - Off The Wall,18,15,25,1.0,23,Off The Wall,56.0,43,-2,-5,-3,1,down,1979-09-01
12800,Michael Jackson,1980-07-05,Michael Jackson - Off The Wall,23,18,26,1.0,25,Off The Wall,56.0,44,-1,-2,-5,1,down,1979-09-01
12801,Michael Jackson,1980-07-12,Michael Jackson - Off The Wall,25,23,28,1.0,26,Off The Wall,56.0,45,-2,-1,-2,1,down,1979-09-01
12802,Michael Jackson,1980-07-19,Michael Jackson - Off The Wall,26,25,29,1.0,28,Off The Wall,56.0,46,-1,-2,-1,1,down,1979-09-01
12803,Michael Jackson,1980-07-26,Michael Jackson - Off The Wall,28,26,31,1.0,29,Off The Wall,56.0,47,-2,-1,-2,1,down,1979-09-01
12804,Michael Jackson,1980-08-02,Michael Jackson - Off The Wall,29,28,31,1.0,31,Off The Wall,56.0,48,0,-2,-1,0,stay,1979-09-01
12805,Michael Jackson,1980-08-09,Michael Jackson - Off The Wall,31,29,33,1.0,31,Off The Wall,56.0,49,-2,0,-2,1,down,1979-09-01
12806,Michael Jackson,1980-08-16,Michael Jackson - Off The Wall,31,31,43,1.0,33,Off The Wall,56.0,50,-10,-2,0,1,down,1979-09-01
12807,Michael Jackson,1980-08-23,Michael Jackson - Off The Wall,33,31,42,1.0,43,Off The Wall,56.0,51,1,-10,-2,1,up,1979-09-01
12808,Michael Jackson,1980-08-30,Michael Jackson - Off The Wall,43,33,43,1.0,42,Off The Wall,56.0,52,-1,1,-10,1,down,1979-09-01
12809,Michael Jackson,1980-09-06,Michael Jackson - Off The Wall,42,43,43,1.0,43,Off The Wall,56.0,53,0,-1,1,0,stay,1979-09-01
12810,Michael Jackson,1980-09-13,Michael Jackson - Off The Wall,43,42,44,1.0,43,Off The Wall,56.0,54,-1,0,-1,1,down,1979-09-01
12811,Michael Jackson,1980-09-20,Michael Jackson - Off The Wall,43,43,49,1.0,44,Off The Wall,56.0,55,-5,-1,0,1,down,1979-09-01
12812,Michael Jackson,1980-09-27,Michael Jackson - Off The Wall,44,43,51,1.0,49,Off The Wall,56.0,56,-2,-5,-1,1,down,1979-09-01
12813,B.B. King,1979-09-01,B.B. King - Take It Home,51,51,30,22.0,43,Take It Home,13.0,0,13,8,0,1,up,1979-09-01
12814,B.B. King,1979-09-08,B.B. King - Take It Home,43,51,22,22.0,30,Take It Home,13.0,1,8,13,8,1,up,1979-09-01
12815,B.B. King,1979-09-15,B.B. King - Take It Home,30,43,22,22.0,22,Take It Home,13.0,2,0,8,13,0,stay,1979-09-01
12816,B.B. King,1979-09-22,B.B. King - Take It Home,22,30,23,22.0,22,Take It Home,13.0,3,-1,0,8,1,down,1979-09-01
12817,B.B. King,1979-09-29,B.B. King - Take It Home,22,22,28,22.0,23,Take It Home,13.0,4,-5,-1,0,1,down,1979-09-01
12818,B.B. King,1979-10-06,B.B. King - Take It Home,23,22,26,22.0,28,Take It Home,13.0,5,2,-5,-1,1,up,1979-09-01
12819,B.B. King,1979-10-13,B.B. King - Take It Home,28,23,37,22.0,26,Take It Home,13.0,6,-11,2,-5,1,down,1979-09-01
12820,B.B. King,1979-10-20,B.B. King - Take It Home,26,28,37,22.0,37,Take It Home,13.0,7,0,-11,2,0,stay,1979-09-01
12821,B.B. King,1979-10-27,B.B. King - Take It Home,37,26,38,22.0,37,Take It Home,13.0,8,-1,0,-11,1,down,1979-09-01
12822,B.B. King,1979-11-03,B.B. King - Take It Home,37,37,44,22.0,38,Take It Home,13.0,9,-6,-1,0,1,down,1979-09-01
12823,B.B. King,1979-11-10,B.B. King - Take It Home,38,37,44,22.0,44,Take It Home,13.0,10,0,-6,-1,0,stay,1979-09-01
12824,B.B. King,1979-11-17,B.B. King - Take It Home,44,38,43,22.0,44,Take It Home,13.0,11,1,0,-6,1,up,1979-09-01
12825,B.B. King,1979-11-24,B.B. King - Take It Home,44,44,46,22.0,43,Take It Home,13.0,12,-3,1,0,1,down,1979-09-01
12826,B.B. King,1979-12-01,B.B. King - Take It Home,43,44,51,22.0,46,Take It Home,13.0,13,-5,-3,1,1,down,1979-09-01
12827,Gene Chandler,1979-09-01,Gene Chandler - When Your # 1,51,51,50,50.0,50,When Your # 1,1.0,0,0,1,0,0,stay,1979-09-01
12828,Gene Chandler,1979-09-08,Gene Chandler - When Your # 1,50,51,51,50.0,50,When Your # 1,1.0,1,-1,0,1,1,down,1979-09-01
12829,One Way,1979-09-08,One Way - Happy Feet,51,51,40,30.0,48,Happy Feet,7.0,0,8,3,0,1,up,1979-09-08
12830,One Way,1979-09-15,One Way - Happy Feet,48,51,32,30.0,40,Happy Feet,7.0,1,8,8,3,1,up,1979-09-08
12831,One Way,1979-09-22,One Way - Happy Feet,40,48,31,30.0,32,Happy Feet,7.0,2,1,8,8,1,up,1979-09-08
12832,One Way,1979-09-29,One Way - Happy Feet,32,40,30,30.0,31,Happy Feet,7.0,3,1,1,8,1,up,1979-09-08
12833,One Way,1979-10-06,One Way - Happy Feet,31,32,30,30.0,30,Happy Feet,7.0,4,0,1,1,0,stay,1979-09-08
12834,One Way,1979-10-13,One Way - Happy Feet,30,31,42,30.0,30,Happy Feet,7.0,5,-12,0,1,1,down,1979-09-08
12835,One Way,1979-10-20,One Way - Happy Feet,30,30,46,30.0,42,Happy Feet,7.0,6,-4,-12,0,1,down,1979-09-08
12836,One Way,1979-10-27,One Way - Happy Feet,42,30,51,30.0,46,Happy Feet,7.0,7,-5,-4,-12,1,down,1979-09-08
12837,The O'Jays,1979-09-15,The O'Jays - Identify Yourself,51,51,7,3.0,21,Identify Yourself,28.0,0,14,30,0,1,up,1979-09-15
12838,The O'Jays,1979-09-22,The O'Jays - Identify Yourself,21,51,5,3.0,7,Identify Yourself,28.0,1,2,14,30,1,up,1979-09-15
12839,The O'Jays,1979-09-29,The O'Jays - Identify Yourself,7,21,4,3.0,5,Identify Yourself,28.0,2,1,2,14,1,up,1979-09-15
12840,The O'Jays,1979-10-06,The O'Jays - Identify Yourself,5,7,3,3.0,4,Identify Yourself,28.0,3,1,1,2,1,up,1979-09-15
12841,The O'Jays,1979-10-13,The O'Jays - Identify Yourself,4,5,3,3.0,3,Identify Yourself,28.0,4,0,1,1,0,stay,1979-09-15
12842,The O'Jays,1979-10-20,The O'Jays - Identify Yourself,3,4,5,3.0,3,Identify Yourself,28.0,5,-2,0,1,1,down,1979-09-15
12843,The O'Jays,1979-10-27,The O'Jays - Identify Yourself,3,3,5,3.0,5,Identify Yourself,28.0,6,0,-2,0,0,stay,1979-09-15
12844,The O'Jays,1979-11-03,The O'Jays - Identify Yourself,5,3,5,3.0,5,Identify Yourself,28.0,7,0,0,-2,0,stay,1979-09-15
12845,The O'Jays,1979-11-10,The O'Jays - Identify Yourself,5,5,5,3.0,5,Identify Yourself,28.0,8,0,0,0,0,stay,1979-09-15
12846,The O'Jays,1979-11-17,The O'Jays - Identify Yourself,5,5,8,3.0,5,Identify Yourself,28.0,9,-3,0,0,1,down,1979-09-15
12847,The O'Jays,1979-11-24,The O'Jays - Identify Yourself,5,5,11,3.0,8,Identify Yourself,28.0,10,-3,-3,0,1,down,1979-09-15
12848,The O'Jays,1979-12-01,The O'Jays - Identify Yourself,8,5,11,3.0,11,Identify Yourself,28.0,11,0,-3,-3,0,stay,1979-09-15
12849,The O'Jays,1979-12-08,The O'Jays - Identify Yourself,11,8,9,3.0,11,Identify Yourself,28.0,12,2,0,-3,1,up,1979-09-15
12850,The O'Jays,1979-12-15,The O'Jays - Identify Yourself,11,11,9,3.0,9,Identify Yourself,28.0,13,0,2,0,0,stay,1979-09-15
12851,The O'Jays,1979-12-22,The O'Jays - Identify Yourself,9,11,9,3.0,9,Identify Yourself,28.0,14,0,0,2,0,stay,1979-09-15
12852,The O'Jays,1979-12-29,The O'Jays - Identify Yourself,9,9,17,3.0,9,Identify Yourself,28.0,15,-8,0,0,1,down,1979-09-15
12853,The O'Jays,1980-01-05,The O'Jays - Identify Yourself,9,9,17,3.0,17,Identify Yourself,28.0,16,0,-8,0,0,stay,1979-09-15
12854,The O'Jays,1980-01-12,The O'Jays - Identify Yourself,17,9,17,3.0,17,Identify Yourself,28.0,17,0,0,-8,0,stay,1979-09-15
12855,The O'Jays,1980-01-19,The O'Jays - Identify Yourself,17,17,17,3.0,17,Identify Yourself,28.0,18,0,0,0,0,stay,1979-09-15
12856,The O'Jays,1980-01-26,The O'Jays - Identify Yourself,17,17,23,3.0,17,Identify Yourself,28.0,19,-6,0,0,1,down,1979-09-15
12857,The O'Jays,1980-02-02,The O'Jays - Identify Yourself,17,17,27,3.0,23,Identify Yourself,28.0,20,-4,-6,0,1,down,1979-09-15
12858,The O'Jays,1980-02-09,The O'Jays - Identify Yourself,23,17,27,3.0,27,Identify Yourself,28.0,21,0,-4,-6,0,stay,1979-09-15
12859,The O'Jays,1980-02-16,The O'Jays - Identify Yourself,27,23,29,3.0,27,Identify Yourself,28.0,22,-2,0,-4,1,down,1979-09-15
12860,The O'Jays,1980-02-23,The O'Jays - Identify Yourself,27,27,29,3.0,29,Identify Yourself,28.0,23,0,-2,0,0,stay,1979-09-15
12861,The O'Jays,1980-03-01,The O'Jays - Identify Yourself,29,27,29,3.0,29,Identify Yourself,28.0,24,0,0,-2,0,stay,1979-09-15
12862,The O'Jays,1980-03-08,The O'Jays - Identify Yourself,29,29,31,3.0,29,Identify Yourself,28.0,25,-2,0,0,1,down,1979-09-15
12863,The O'Jays,1980-03-15,The O'Jays - Identify Yourself,29,29,44,3.0,31,Identify Yourself,28.0,26,-13,-2,0,1,down,1979-09-15
12864,The O'Jays,1980-03-22,The O'Jays - Identify Yourself,31,29,44,3.0,44,Identify Yourself,28.0,27,0,-13,-2,0,stay,1979-09-15
12865,The O'Jays,1980-03-29,The O'Jays - Identify Yourself,44,31,51,3.0,44,Identify Yourself,28.0,28,-7,0,-13,1,down,1979-09-15
12866,Rose Royce,1979-09-15,Rose Royce - Rose Royce IV/Rainbow Connection,51,51,23,22.0,27,Rose Royce IV/Rainbow Connection,8.0,0,4,24,0,1,up,1979-09-15
12867,Rose Royce,1979-09-22,Rose Royce - Rose Royce IV/Rainbow Connection,27,51,22,22.0,23,Rose Royce IV/Rainbow Connection,8.0,1,1,4,24,1,up,1979-09-15
12868,Rose Royce,1979-09-29,Rose Royce - Rose Royce IV/Rainbow Connection,23,27,22,22.0,22,Rose Royce IV/Rainbow Connection,8.0,2,0,1,4,0,stay,1979-09-15
12869,Rose Royce,1979-10-06,Rose Royce - Rose Royce IV/Rainbow Connection,22,23,24,22.0,22,Rose Royce IV/Rainbow Connection,8.0,3,-2,0,1,1,down,1979-09-15
12870,Rose Royce,1979-10-13,Rose Royce - Rose Royce IV/Rainbow Connection,22,22,24,22.0,24,Rose Royce IV/Rainbow Connection,8.0,4,0,-2,0,0,stay,1979-09-15
12871,Rose Royce,1979-10-20,Rose Royce - Rose Royce IV/Rainbow Connection,24,22,31,22.0,24,Rose Royce IV/Rainbow Connection,8.0,5,-7,0,-2,1,down,1979-09-15
12872,Rose Royce,1979-10-27,Rose Royce - Rose Royce IV/Rainbow Connection,24,24,39,22.0,31,Rose Royce IV/Rainbow Connection,8.0,6,-8,-7,0,1,down,1979-09-15
12873,Rose Royce,1979-11-03,Rose Royce - Rose Royce IV/Rainbow Connection,31,24,46,22.0,39,Rose Royce IV/Rainbow Connection,8.0,7,-7,-8,-7,1,down,1979-09-15
12874,Rose Royce,1979-11-10,Rose Royce - Rose Royce IV/Rainbow Connection,39,31,51,22.0,46,Rose Royce IV/Rainbow Connection,8.0,8,-5,-7,-8,1,down,1979-09-15
12875,Kool & The Gang,1979-09-22,Kool & The Gang - Ladies' Night,51,51,27,1.0,37,Ladies' Night,37.0,0,10,14,0,1,up,1979-09-22
12876,Kool & The Gang,1979-09-29,Kool & The Gang - Ladies' Night,37,51,15,1.0,27,Ladies' Night,37.0,1,12,10,14,1,up,1979-09-22
12877,Kool & The Gang,1979-10-06,Kool & The Gang - Ladies' Night,27,37,5,1.0,15,Ladies' Night,37.0,2,10,12,10,1,up,1979-09-22
12878,Kool & The Gang,1979-10-13,Kool & The Gang - Ladies' Night,15,27,2,1.0,5,Ladies' Night,37.0,3,3,10,12,1,up,1979-09-22
12879,Kool & The Gang,1979-10-20,Kool & The Gang - Ladies' Night,5,15,1,1.0,2,Ladies' Night,37.0,4,1,3,10,1,up,1979-09-22
12880,Kool & The Gang,1979-10-27,Kool & The Gang - Ladies' Night,2,5,1,1.0,1,Ladies' Night,37.0,5,0,1,3,0,stay,1979-09-22
12881,Kool & The Gang,1979-11-03,Kool & The Gang - Ladies' Night,1,2,3,1.0,1,Ladies' Night,37.0,6,-2,0,1,1,down,1979-09-22
12882,Kool & The Gang,1979-11-10,Kool & The Gang - Ladies' Night,1,1,4,1.0,3,Ladies' Night,37.0,7,-1,-2,0,1,down,1979-09-22
12883,Kool & The Gang,1979-11-17,Kool & The Gang - Ladies' Night,3,1,4,1.0,4,Ladies' Night,37.0,8,0,-1,-2,0,stay,1979-09-22
12884,Kool & The Gang,1979-11-24,Kool & The Gang - Ladies' Night,4,3,4,1.0,4,Ladies' Night,37.0,9,0,0,-1,0,stay,1979-09-22
12885,Kool & The Gang,1979-12-01,Kool & The Gang - Ladies' Night,4,4,8,1.0,4,Ladies' Night,37.0,10,-4,0,0,1,down,1979-09-22
12886,Kool & The Gang,1979-12-08,Kool & The Gang - Ladies' Night,4,4,8,1.0,8,Ladies' Night,37.0,11,0,-4,0,0,stay,1979-09-22
12887,Kool & The Gang,1979-12-15,Kool & The Gang - Ladies' Night,8,4,8,1.0,8,Ladies' Night,37.0,12,0,0,-4,0,stay,1979-09-22
12888,Kool & The Gang,1979-12-22,Kool & The Gang - Ladies' Night,8,8,8,1.0,8,Ladies' Night,37.0,13,0,0,0,0,stay,1979-09-22
12889,Kool & The Gang,1979-12-29,Kool & The Gang - Ladies' Night,8,8,13,1.0,8,Ladies' Night,37.0,14,-5,0,0,1,down,1979-09-22
12890,Kool & The Gang,1980-01-05,Kool & The Gang - Ladies' Night,8,8,13,1.0,13,Ladies' Night,37.0,15,0,-5,0,0,stay,1979-09-22
12891,Kool & The Gang,1980-01-12,Kool & The Gang - Ladies' Night,13,8,12,1.0,13,Ladies' Night,37.0,16,1,0,-5,1,up,1979-09-22
12892,Kool & The Gang,1980-01-19,Kool & The Gang - Ladies' Night,13,13,23,1.0,12,Ladies' Night,37.0,17,-11,1,0,1,down,1979-09-22
12893,Kool & The Gang,1980-01-26,Kool & The Gang - Ladies' Night,12,13,18,1.0,23,Ladies' Night,37.0,18,5,-11,1,1,up,1979-09-22
12894,Kool & The Gang,1980-02-02,Kool & The Gang - Ladies' Night,23,12,15,1.0,18,Ladies' Night,37.0,19,3,5,-11,1,up,1979-09-22
12895,Kool & The Gang,1980-02-09,Kool & The Gang - Ladies' Night,18,23,13,1.0,15,Ladies' Night,37.0,20,2,3,5,1,up,1979-09-22
12896,Kool & The Gang,1980-02-16,Kool & The Gang - Ladies' Night,15,18,13,1.0,13,Ladies' Night,37.0,21,0,2,3,0,stay,1979-09-22
12897,Kool & The Gang,1980-02-23,Kool & The Gang - Ladies' Night,13,15,13,1.0,13,Ladies' Night,37.0,22,0,0,2,0,stay,1979-09-22
12898,Kool & The Gang,1980-03-01,Kool & The Gang - Ladies' Night,13,13,12,1.0,13,Ladies' Night,37.0,23,1,0,0,1,up,1979-09-22
12899,Kool & The Gang,1980-03-08,Kool & The Gang - Ladies' Night,13,13,11,1.0,12,Ladies' Night,37.0,24,1,1,0,1,up,1979-09-22
12900,Kool & The Gang,1980-03-15,Kool & The Gang - Ladies' Night,12,13,11,1.0,11,Ladies' Night,37.0,25,0,1,1,0,stay,1979-09-22
12901,Kool & The Gang,1980-03-22,Kool & The Gang - Ladies' Night,11,12,15,1.0,11,Ladies' Night,37.0,26,-4,0,1,1,down,1979-09-22
12902,Kool & The Gang,1980-03-29,Kool & The Gang - Ladies' Night,11,11,16,1.0,15,Ladies' Night,37.0,27,-1,-4,0,1,down,1979-09-22
12903,Kool & The Gang,1980-04-05,Kool & The Gang - Ladies' Night,15,11,16,1.0,16,Ladies' Night,37.0,28,0,-1,-4,0,stay,1979-09-22
12904,Kool & The Gang,1980-04-12,Kool & The Gang - Ladies' Night,16,15,20,1.0,16,Ladies' Night,37.0,29,-4,0,-1,1,down,1979-09-22
12905,Kool & The Gang,1980-04-19,Kool & The Gang - Ladies' Night,16,16,22,1.0,20,Ladies' Night,37.0,30,-2,-4,0,1,down,1979-09-22
12906,Kool & The Gang,1980-04-26,Kool & The Gang - Ladies' Night,20,16,24,1.0,22,Ladies' Night,37.0,31,-2,-2,-4,1,down,1979-09-22
12907,Kool & The Gang,1980-05-03,Kool & The Gang - Ladies' Night,22,20,30,1.0,24,Ladies' Night,37.0,32,-6,-2,-2,1,down,1979-09-22
12908,Kool & The Gang,1980-05-10,Kool & The Gang - Ladies' Night,24,22,38,1.0,30,Ladies' Night,37.0,33,-8,-6,-2,1,down,1979-09-22
12909,Kool & The Gang,1980-05-17,Kool & The Gang - Ladies' Night,30,24,44,1.0,38,Ladies' Night,37.0,34,-6,-8,-6,1,down,1979-09-22
12910,Kool & The Gang,1980-05-24,Kool & The Gang - Ladies' Night,38,30,44,1.0,44,Ladies' Night,37.0,35,0,-6,-8,0,stay,1979-09-22
12911,Kool & The Gang,1980-05-31,Kool & The Gang - Ladies' Night,44,38,49,1.0,44,Ladies' Night,37.0,36,-5,0,-6,1,down,1979-09-22
12912,Kool & The Gang,1980-06-07,Kool & The Gang - Ladies' Night,44,44,51,1.0,49,Ladies' Night,37.0,37,-2,-5,0,1,down,1979-09-22
12913,Jackie Moore,1979-09-22,Jackie Moore - I'm On My Way,51,51,45,45.0,45,I'm On My Way,1.0,0,0,6,0,0,stay,1979-09-22
12914,Jackie Moore,1979-09-29,Jackie Moore - I'm On My Way,45,51,51,45.0,45,I'm On My Way,1.0,1,-6,0,6,1,down,1979-09-22
12915,Isaac Hayes,1979-09-29,Isaac Hayes - Don't Let Go,51,51,26,9.0,34,Don't Let Go,26.0,0,8,17,0,1,up,1979-09-29
12916,Isaac Hayes,1979-10-06,Isaac Hayes - Don't Let Go,34,51,21,9.0,26,Don't Let Go,26.0,1,5,8,17,1,up,1979-09-29
12917,Isaac Hayes,1979-10-13,Isaac Hayes - Don't Let Go,26,34,18,9.0,21,Don't Let Go,26.0,2,3,5,8,1,up,1979-09-29
12918,Isaac Hayes,1979-10-20,Isaac Hayes - Don't Let Go,21,26,15,9.0,18,Don't Let Go,26.0,3,3,3,5,1,up,1979-09-29
12919,Isaac Hayes,1979-10-27,Isaac Hayes - Don't Let Go,18,21,9,9.0,15,Don't Let Go,26.0,4,6,3,3,1,up,1979-09-29
12920,Isaac Hayes,1979-11-03,Isaac Hayes - Don't Let Go,15,18,9,9.0,9,Don't Let Go,26.0,5,0,6,3,0,stay,1979-09-29
12921,Isaac Hayes,1979-11-10,Isaac Hayes - Don't Let Go,9,15,10,9.0,9,Don't Let Go,26.0,6,-1,0,6,1,down,1979-09-29
12922,Isaac Hayes,1979-11-17,Isaac Hayes - Don't Let Go,9,9,13,9.0,10,Don't Let Go,26.0,7,-3,-1,0,1,down,1979-09-29
12923,Isaac Hayes,1979-11-24,Isaac Hayes - Don't Let Go,10,9,16,9.0,13,Don't Let Go,26.0,8,-3,-3,-1,1,down,1979-09-29
12924,Isaac Hayes,1979-12-01,Isaac Hayes - Don't Let Go,13,10,17,9.0,16,Don't Let Go,26.0,9,-1,-3,-3,1,down,1979-09-29
12925,Isaac Hayes,1979-12-08,Isaac Hayes - Don't Let Go,16,13,16,9.0,17,Don't Let Go,26.0,10,1,-1,-3,1,up,1979-09-29
12926,Isaac Hayes,1979-12-15,Isaac Hayes - Don't Let Go,17,16,19,9.0,16,Don't Let Go,26.0,11,-3,1,-1,1,down,1979-09-29
12927,Isaac Hayes,1979-12-22,Isaac Hayes - Don't Let Go,16,17,19,9.0,19,Don't Let Go,26.0,12,0,-3,1,0,stay,1979-09-29
12928,Isaac Hayes,1979-12-29,Isaac Hayes - Don't Let Go,19,16,21,9.0,19,Don't Let Go,26.0,13,-2,0,-3,1,down,1979-09-29
12929,Isaac Hayes,1980-01-05,Isaac Hayes - Don't Let Go,19,19,22,9.0,21,Don't Let Go,26.0,14,-1,-2,0,1,down,1979-09-29
12930,Isaac Hayes,1980-01-12,Isaac Hayes - Don't Let Go,21,19,25,9.0,22,Don't Let Go,26.0,15,-3,-1,-2,1,down,1979-09-29
12931,Isaac Hayes,1980-01-19,Isaac Hayes - Don't Let Go,22,21,28,9.0,25,Don't Let Go,26.0,16,-3,-3,-1,1,down,1979-09-29
12932,Isaac Hayes,1980-01-26,Isaac Hayes - Don't Let Go,25,22,28,9.0,28,Don't Let Go,26.0,17,0,-3,-3,0,stay,1979-09-29
12933,Isaac Hayes,1980-02-02,Isaac Hayes - Don't Let Go,28,25,23,9.0,28,Don't Let Go,26.0,18,5,0,-3,1,up,1979-09-29
12934,Isaac Hayes,1980-02-09,Isaac Hayes - Don't Let Go,28,28,23,9.0,23,Don't Let Go,26.0,19,0,5,0,0,stay,1979-09-29
12935,Isaac Hayes,1980-02-16,Isaac Hayes - Don't Let Go,23,28,30,9.0,23,Don't Let Go,26.0,20,-7,0,5,1,down,1979-09-29
12936,Isaac Hayes,1980-02-23,Isaac Hayes - Don't Let Go,23,23,30,9.0,30,Don't Let Go,26.0,21,0,-7,0,0,stay,1979-09-29
12937,Isaac Hayes,1980-03-01,Isaac Hayes - Don't Let Go,30,23,31,9.0,30,Don't Let Go,26.0,22,-1,0,-7,1,down,1979-09-29
12938,Isaac Hayes,1980-03-08,Isaac Hayes - Don't Let Go,30,30,37,9.0,31,Don't Let Go,26.0,23,-6,-1,0,1,down,1979-09-29
12939,Isaac Hayes,1980-03-15,Isaac Hayes - Don't Let Go,31,30,39,9.0,37,Don't Let Go,26.0,24,-2,-6,-1,1,down,1979-09-29
12940,Isaac Hayes,1980-03-22,Isaac Hayes - Don't Let Go,37,31,43,9.0,39,Don't Let Go,26.0,25,-4,-2,-6,1,down,1979-09-29
12941,Isaac Hayes,1980-03-29,Isaac Hayes - Don't Let Go,39,37,51,9.0,43,Don't Let Go,26.0,26,-8,-4,-2,1,down,1979-09-29
12942,Bobby Bland,1979-09-29,"Bobby Bland - I Feel Good,i Feel Fine",51,51,39,34.0,41,"I Feel Good,i Feel Fine",5.0,0,2,10,0,1,up,1979-09-29
12943,Bobby Bland,1979-10-06,"Bobby Bland - I Feel Good,i Feel Fine",41,51,35,34.0,39,"I Feel Good,i Feel Fine",5.0,1,4,2,10,1,up,1979-09-29
12944,Bobby Bland,1979-10-13,"Bobby Bland - I Feel Good,i Feel Fine",39,41,34,34.0,35,"I Feel Good,i Feel Fine",5.0,2,1,4,2,1,up,1979-09-29
12945,Bobby Bland,1979-10-20,"Bobby Bland - I Feel Good,i Feel Fine",35,39,34,34.0,34,"I Feel Good,i Feel Fine",5.0,3,0,1,4,0,stay,1979-09-29
12946,Bobby Bland,1979-10-27,"Bobby Bland - I Feel Good,i Feel Fine",34,35,34,34.0,34,"I Feel Good,i Feel Fine",5.0,4,0,0,1,0,stay,1979-09-29
12947,Bobby Bland,1979-11-03,"Bobby Bland - I Feel Good,i Feel Fine",34,34,51,34.0,34,"I Feel Good,i Feel Fine",5.0,5,-17,0,0,1,down,1979-09-29
12948,Richard Pryor,1979-09-29,Richard Pryor - Outrageous,51,51,43,41.0,43,Outrageous,4.0,0,0,8,0,0,stay,1979-09-29
12949,Richard Pryor,1979-10-06,Richard Pryor - Outrageous,43,51,41,41.0,43,Outrageous,4.0,1,2,0,8,1,up,1979-09-29
12950,Richard Pryor,1979-10-13,Richard Pryor - Outrageous,43,43,47,41.0,41,Outrageous,4.0,2,-6,2,0,1,down,1979-09-29
12951,Richard Pryor,1979-10-20,Richard Pryor - Outrageous,41,43,49,41.0,47,Outrageous,4.0,3,-2,-6,2,1,down,1979-09-29
12952,Richard Pryor,1979-10-27,Richard Pryor - Outrageous,47,41,51,41.0,49,Outrageous,4.0,4,-2,-2,-6,1,down,1979-09-29
12953,The Fatback Band,1979-09-29,The Fatback Band - Fatback XII,51,51,35,16.0,50,Fatback XII,11.0,0,15,1,0,1,up,1979-09-29
12954,The Fatback Band,1979-10-06,The Fatback Band - Fatback XII,50,51,25,16.0,35,Fatback XII,11.0,1,10,15,1,1,up,1979-09-29
12955,The Fatback Band,1979-10-13,The Fatback Band - Fatback XII,35,50,25,16.0,25,Fatback XII,11.0,2,0,10,15,0,stay,1979-09-29
12956,The Fatback Band,1979-10-20,The Fatback Band - Fatback XII,25,35,21,16.0,25,Fatback XII,11.0,3,4,0,10,1,up,1979-09-29
12957,The Fatback Band,1979-10-27,The Fatback Band - Fatback XII,25,25,21,16.0,21,Fatback XII,11.0,4,0,4,0,0,stay,1979-09-29
12958,The Fatback Band,1979-11-03,The Fatback Band - Fatback XII,21,25,16,16.0,21,Fatback XII,11.0,5,5,0,4,1,up,1979-09-29
12959,The Fatback Band,1979-11-10,The Fatback Band - Fatback XII,21,21,16,16.0,16,Fatback XII,11.0,6,0,5,0,0,stay,1979-09-29
12960,The Fatback Band,1979-11-17,The Fatback Band - Fatback XII,16,21,26,16.0,16,Fatback XII,11.0,7,-10,0,5,1,down,1979-09-29
12961,The Fatback Band,1979-11-24,The Fatback Band - Fatback XII,16,16,29,16.0,26,Fatback XII,11.0,8,-3,-10,0,1,down,1979-09-29
12962,The Fatback Band,1979-12-01,The Fatback Band - Fatback XII,26,16,33,16.0,29,Fatback XII,11.0,9,-4,-3,-10,1,down,1979-09-29
12963,The Fatback Band,1979-12-08,The Fatback Band - Fatback XII,29,26,36,16.0,33,Fatback XII,11.0,10,-3,-4,-3,1,down,1979-09-29
12964,The Fatback Band,1979-12-15,The Fatback Band - Fatback XII,33,29,51,16.0,36,Fatback XII,11.0,11,-15,-3,-4,1,down,1979-09-29
12965,Aretha Franklin,1979-10-06,Aretha Franklin - La Diva,51,51,32,25.0,42,La Diva,6.0,0,10,9,0,1,up,1979-10-06
12966,Aretha Franklin,1979-10-13,Aretha Franklin - La Diva,42,51,26,25.0,32,La Diva,6.0,1,6,10,9,1,up,1979-10-06
12967,Aretha Franklin,1979-10-20,Aretha Franklin - La Diva,32,42,25,25.0,26,La Diva,6.0,2,1,6,10,1,up,1979-10-06
12968,Aretha Franklin,1979-10-27,Aretha Franklin - La Diva,26,32,31,25.0,25,La Diva,6.0,3,-6,1,6,1,down,1979-10-06
12969,Aretha Franklin,1979-11-03,Aretha Franklin - La Diva,25,26,42,25.0,31,La Diva,6.0,4,-11,-6,1,1,down,1979-10-06
12970,Aretha Franklin,1979-11-10,Aretha Franklin - La Diva,31,25,48,25.0,42,La Diva,6.0,5,-6,-11,-6,1,down,1979-10-06
12971,Aretha Franklin,1979-11-17,Aretha Franklin - La Diva,42,31,51,25.0,48,La Diva,6.0,6,-3,-6,-11,1,down,1979-10-06
12972,Pockets,1979-10-06,Pockets - So Delicious,51,51,44,43.0,44,So Delicious,2.0,0,0,7,0,0,stay,1979-10-06
12973,Pockets,1979-10-13,Pockets - So Delicious,44,51,43,43.0,44,So Delicious,2.0,1,1,0,7,1,up,1979-10-06
12974,Pockets,1979-10-20,Pockets - So Delicious,44,44,51,43.0,43,So Delicious,2.0,2,-8,1,0,1,down,1979-10-06
12975,Brenda Russell,1979-10-06,Brenda Russell - Brenda Russell,51,51,37,26.0,47,Brenda Russell,13.0,0,10,4,0,1,up,1979-10-06
12976,Brenda Russell,1979-10-13,Brenda Russell - Brenda Russell,47,51,29,26.0,37,Brenda Russell,13.0,1,8,10,4,1,up,1979-10-06
12977,Brenda Russell,1979-10-20,Brenda Russell - Brenda Russell,37,47,28,26.0,29,Brenda Russell,13.0,2,1,8,10,1,up,1979-10-06
12978,Brenda Russell,1979-10-27,Brenda Russell - Brenda Russell,29,37,26,26.0,28,Brenda Russell,13.0,3,2,1,8,1,up,1979-10-06
12979,Brenda Russell,1979-11-03,Brenda Russell - Brenda Russell,28,29,26,26.0,26,Brenda Russell,13.0,4,0,2,1,0,stay,1979-10-06
12980,Brenda Russell,1979-11-10,Brenda Russell - Brenda Russell,26,28,26,26.0,26,Brenda Russell,13.0,5,0,0,2,0,stay,1979-10-06
12981,Brenda Russell,1979-11-17,Brenda Russell - Brenda Russell,26,26,28,26.0,26,Brenda Russell,13.0,6,-2,0,0,1,down,1979-10-06
12982,Brenda Russell,1979-11-24,Brenda Russell - Brenda Russell,26,26,28,26.0,28,Brenda Russell,13.0,7,0,-2,0,0,stay,1979-10-06
12983,Brenda Russell,1979-12-01,Brenda Russell - Brenda Russell,28,26,28,26.0,28,Brenda Russell,13.0,8,0,0,-2,0,stay,1979-10-06
12984,Brenda Russell,1979-12-08,Brenda Russell - Brenda Russell,28,28,28,26.0,28,Brenda Russell,13.0,9,0,0,0,0,stay,1979-10-06
12985,Brenda Russell,1979-12-15,Brenda Russell - Brenda Russell,28,28,32,26.0,28,Brenda Russell,13.0,10,-4,0,0,1,down,1979-10-06
12986,Brenda Russell,1979-12-22,Brenda Russell - Brenda Russell,28,28,32,26.0,32,Brenda Russell,13.0,11,0,-4,0,0,stay,1979-10-06
12987,Brenda Russell,1979-12-29,Brenda Russell - Brenda Russell,32,28,48,26.0,32,Brenda Russell,13.0,12,-16,0,-4,1,down,1979-10-06
12988,Brenda Russell,1980-01-05,Brenda Russell - Brenda Russell,32,32,51,26.0,48,Brenda Russell,13.0,13,-3,-16,0,1,down,1979-10-06
12989,Jimmy 'Bo' Horne,1979-10-06,Jimmy 'Bo' Horne - Goin' Home For Love,51,51,48,42.0,50,Goin' Home For Love,4.0,0,2,1,0,1,up,1979-10-06
12990,Jimmy 'Bo' Horne,1979-10-13,Jimmy 'Bo' Horne - Goin' Home For Love,50,51,47,42.0,48,Goin' Home For Love,4.0,1,1,2,1,1,up,1979-10-06
12991,Jimmy 'Bo' Horne,1979-10-27,Jimmy 'Bo' Horne - Goin' Home For Love,48,50,42,42.0,47,Goin' Home For Love,4.0,2,5,1,2,1,up,1979-10-06
12992,Jimmy 'Bo' Horne,1979-11-03,Jimmy 'Bo' Horne - Goin' Home For Love,47,48,50,42.0,42,Goin' Home For Love,4.0,3,-8,5,1,1,down,1979-10-06
12993,Jimmy 'Bo' Horne,1979-11-10,Jimmy 'Bo' Horne - Goin' Home For Love,42,47,51,42.0,50,Goin' Home For Love,4.0,4,-1,-8,5,1,down,1979-10-06
12994,David Ruffin,1979-10-13,David Ruffin - So Soon We Change,51,51,27,19.0,34,So Soon We Change,7.0,0,7,17,0,1,up,1979-10-13
12995,David Ruffin,1979-10-20,David Ruffin - So Soon We Change,34,51,23,19.0,27,So Soon We Change,7.0,1,4,7,17,1,up,1979-10-13
12996,David Ruffin,1979-10-27,David Ruffin - So Soon We Change,27,34,19,19.0,23,So Soon We Change,7.0,2,4,4,7,1,up,1979-10-13
12997,David Ruffin,1979-11-03,David Ruffin - So Soon We Change,23,27,19,19.0,19,So Soon We Change,7.0,3,0,4,4,0,stay,1979-10-13
12998,David Ruffin,1979-11-10,David Ruffin - So Soon We Change,19,23,23,19.0,19,So Soon We Change,7.0,4,-4,0,4,1,down,1979-10-13
12999,David Ruffin,1979-11-17,David Ruffin - So Soon We Change,19,19,34,19.0,23,So Soon We Change,7.0,5,-11,-4,0,1,down,1979-10-13
13000,David Ruffin,1979-11-24,David Ruffin - So Soon We Change,23,19,43,19.0,34,So Soon We Change,7.0,6,-9,-11,-4,1,down,1979-10-13
13001,David Ruffin,1979-12-01,David Ruffin - So Soon We Change,34,23,51,19.0,43,So Soon We Change,7.0,7,-8,-9,-11,1,down,1979-10-13
13002,France Joli,1979-10-13,France Joli - France Joli,51,51,32,25.0,40,France Joli,7.0,0,8,11,0,1,up,1979-10-13
13003,France Joli,1979-10-20,France Joli - France Joli,40,51,26,25.0,32,France Joli,7.0,1,6,8,11,1,up,1979-10-13
13004,France Joli,1979-10-27,France Joli - France Joli,32,40,25,25.0,26,France Joli,7.0,2,1,6,8,1,up,1979-10-13
13005,France Joli,1979-11-03,France Joli - France Joli,26,32,31,25.0,25,France Joli,7.0,3,-6,1,6,1,down,1979-10-13
13006,France Joli,1979-11-10,France Joli - France Joli,25,26,33,25.0,31,France Joli,7.0,4,-2,-6,1,1,down,1979-10-13
13007,France Joli,1979-11-17,France Joli - France Joli,31,25,33,25.0,33,France Joli,7.0,5,0,-2,-6,0,stay,1979-10-13
13008,France Joli,1979-11-24,France Joli - France Joli,33,31,42,25.0,33,France Joli,7.0,6,-9,0,-2,1,down,1979-10-13
13009,France Joli,1979-12-01,France Joli - France Joli,33,33,51,25.0,42,France Joli,7.0,7,-9,-9,0,1,down,1979-10-13
13010,Herb Alpert,1979-10-13,Herb Alpert - Rise,51,51,22,6.0,42,Rise,27.0,0,20,9,0,1,up,1979-10-13
13011,Herb Alpert,1979-10-20,Herb Alpert - Rise,42,51,9,6.0,22,Rise,27.0,1,13,20,9,1,up,1979-10-13
13012,Herb Alpert,1979-10-27,Herb Alpert - Rise,22,42,6,6.0,9,Rise,27.0,2,3,13,20,1,up,1979-10-13
13013,Herb Alpert,1979-11-03,Herb Alpert - Rise,9,22,6,6.0,6,Rise,27.0,3,0,3,13,0,stay,1979-10-13
13014,Herb Alpert,1979-11-10,Herb Alpert - Rise,6,9,6,6.0,6,Rise,27.0,4,0,0,3,0,stay,1979-10-13
13015,Herb Alpert,1979-11-17,Herb Alpert - Rise,6,6,9,6.0,6,Rise,27.0,5,-3,0,0,1,down,1979-10-13
13016,Herb Alpert,1979-11-24,Herb Alpert - Rise,6,6,12,6.0,9,Rise,27.0,6,-3,-3,0,1,down,1979-10-13
13017,Herb Alpert,1979-12-01,Herb Alpert - Rise,9,6,12,6.0,12,Rise,27.0,7,0,-3,-3,0,stay,1979-10-13
13018,Herb Alpert,1979-12-08,Herb Alpert - Rise,12,9,15,6.0,12,Rise,27.0,8,-3,0,-3,1,down,1979-10-13
13019,Herb Alpert,1979-12-15,Herb Alpert - Rise,12,12,16,6.0,15,Rise,27.0,9,-1,-3,0,1,down,1979-10-13
13020,Herb Alpert,1979-12-22,Herb Alpert - Rise,15,12,16,6.0,16,Rise,27.0,10,0,-1,-3,0,stay,1979-10-13
13021,Herb Alpert,1979-12-29,Herb Alpert - Rise,16,15,16,6.0,16,Rise,27.0,11,0,0,-1,0,stay,1979-10-13
13022,Herb Alpert,1980-01-05,Herb Alpert - Rise,16,16,19,6.0,16,Rise,27.0,12,-3,0,0,1,down,1979-10-13
13023,Herb Alpert,1980-01-12,Herb Alpert - Rise,16,16,21,6.0,19,Rise,27.0,13,-2,-3,0,1,down,1979-10-13
13024,Herb Alpert,1980-01-19,Herb Alpert - Rise,19,16,26,6.0,21,Rise,27.0,14,-5,-2,-3,1,down,1979-10-13
13025,Herb Alpert,1980-01-26,Herb Alpert - Rise,21,19,26,6.0,26,Rise,27.0,15,0,-5,-2,0,stay,1979-10-13
13026,Herb Alpert,1980-02-02,Herb Alpert - Rise,26,21,29,6.0,26,Rise,27.0,16,-3,0,-5,1,down,1979-10-13
13027,Herb Alpert,1980-02-09,Herb Alpert - Rise,26,26,33,6.0,29,Rise,27.0,17,-4,-3,0,1,down,1979-10-13
13028,Herb Alpert,1980-02-16,Herb Alpert - Rise,29,26,34,6.0,33,Rise,27.0,18,-1,-4,-3,1,down,1979-10-13
13029,Herb Alpert,1980-02-23,Herb Alpert - Rise,33,29,34,6.0,34,Rise,27.0,19,0,-1,-4,0,stay,1979-10-13
13030,Herb Alpert,1980-03-01,Herb Alpert - Rise,34,33,35,6.0,34,Rise,27.0,20,-1,0,-1,1,down,1979-10-13
13031,Herb Alpert,1980-03-08,Herb Alpert - Rise,34,34,38,6.0,35,Rise,27.0,21,-3,-1,0,1,down,1979-10-13
13032,Herb Alpert,1980-03-15,Herb Alpert - Rise,35,34,41,6.0,38,Rise,27.0,22,-3,-3,-1,1,down,1979-10-13
13033,Herb Alpert,1980-03-22,Herb Alpert - Rise,38,35,48,6.0,41,Rise,27.0,23,-7,-3,-3,1,down,1979-10-13
13034,Herb Alpert,1980-03-29,Herb Alpert - Rise,41,38,44,6.0,48,Rise,27.0,24,4,-7,-3,1,up,1979-10-13
13035,Herb Alpert,1980-04-05,Herb Alpert - Rise,48,41,44,6.0,44,Rise,27.0,25,0,4,-7,0,stay,1979-10-13
13036,Herb Alpert,1980-04-12,Herb Alpert - Rise,44,48,49,6.0,44,Rise,27.0,26,-5,0,4,1,down,1979-10-13
13037,Herb Alpert,1980-04-19,Herb Alpert - Rise,44,44,51,6.0,49,Rise,27.0,27,-2,-5,0,1,down,1979-10-13
13038,The Pointer Sisters,1979-10-13,The Pointer Sisters - Priority,51,51,44,44.0,47,Priority,1.0,0,3,4,0,1,up,1979-10-13
13039,The Pointer Sisters,1979-10-20,The Pointer Sisters - Priority,47,51,51,44.0,44,Priority,1.0,1,-7,3,4,1,down,1979-10-13
13040,Archie Bell & The Drells,1979-10-13,Archie Bell & The Drells - Strategy,51,51,40,37.0,49,Strategy,4.0,0,9,2,0,1,up,1979-10-13
13041,Archie Bell & The Drells,1979-10-20,Archie Bell & The Drells - Strategy,49,51,40,37.0,40,Strategy,4.0,1,0,9,2,0,stay,1979-10-13
13042,Archie Bell & The Drells,1979-10-27,Archie Bell & The Drells - Strategy,40,49,37,37.0,40,Strategy,4.0,2,3,0,9,1,up,1979-10-13
13043,Archie Bell & The Drells,1979-11-03,Archie Bell & The Drells - Strategy,40,40,47,37.0,37,Strategy,4.0,3,-10,3,0,1,down,1979-10-13
13044,Archie Bell & The Drells,1979-11-10,Archie Bell & The Drells - Strategy,37,40,51,37.0,47,Strategy,4.0,4,-4,-10,3,1,down,1979-10-13
13045,Funkadelic,1979-10-20,Funkadelic - Uncle Jam Wants You,51,51,3,2.0,30,Uncle Jam Wants You,15.0,0,27,21,0,1,up,1979-10-20
13046,Funkadelic,1979-10-27,Funkadelic - Uncle Jam Wants You,30,51,3,2.0,3,Uncle Jam Wants You,15.0,1,0,27,21,0,stay,1979-10-20
13047,Funkadelic,1979-11-03,Funkadelic - Uncle Jam Wants You,3,30,2,2.0,3,Uncle Jam Wants You,15.0,2,1,0,27,1,up,1979-10-20
13048,Funkadelic,1979-11-10,Funkadelic - Uncle Jam Wants You,3,3,2,2.0,2,Uncle Jam Wants You,15.0,3,0,1,0,0,stay,1979-10-20
13049,Funkadelic,1979-11-17,Funkadelic - Uncle Jam Wants You,2,3,2,2.0,2,Uncle Jam Wants You,15.0,4,0,0,1,0,stay,1979-10-20
13050,Funkadelic,1979-11-24,Funkadelic - Uncle Jam Wants You,2,2,8,2.0,2,Uncle Jam Wants You,15.0,5,-6,0,0,1,down,1979-10-20
13051,Funkadelic,1979-12-01,Funkadelic - Uncle Jam Wants You,2,2,10,2.0,8,Uncle Jam Wants You,15.0,6,-2,-6,0,1,down,1979-10-20
13052,Funkadelic,1979-12-08,Funkadelic - Uncle Jam Wants You,8,2,12,2.0,10,Uncle Jam Wants You,15.0,7,-2,-2,-6,1,down,1979-10-20
13053,Funkadelic,1979-12-15,Funkadelic - Uncle Jam Wants You,10,8,15,2.0,12,Uncle Jam Wants You,15.0,8,-3,-2,-2,1,down,1979-10-20
13054,Funkadelic,1979-12-22,Funkadelic - Uncle Jam Wants You,12,10,15,2.0,15,Uncle Jam Wants You,15.0,9,0,-3,-2,0,stay,1979-10-20
13055,Funkadelic,1979-12-29,Funkadelic - Uncle Jam Wants You,15,12,28,2.0,15,Uncle Jam Wants You,15.0,10,-13,0,-3,1,down,1979-10-20
13056,Funkadelic,1980-01-05,Funkadelic - Uncle Jam Wants You,15,15,32,2.0,28,Uncle Jam Wants You,15.0,11,-4,-13,0,1,down,1979-10-20
13057,Funkadelic,1980-01-12,Funkadelic - Uncle Jam Wants You,28,15,37,2.0,32,Uncle Jam Wants You,15.0,12,-5,-4,-13,1,down,1979-10-20
13058,Funkadelic,1980-01-19,Funkadelic - Uncle Jam Wants You,32,28,39,2.0,37,Uncle Jam Wants You,15.0,13,-2,-5,-4,1,down,1979-10-20
13059,Funkadelic,1980-01-26,Funkadelic - Uncle Jam Wants You,37,32,39,2.0,39,Uncle Jam Wants You,15.0,14,0,-2,-5,0,stay,1979-10-20
13060,Funkadelic,1980-02-02,Funkadelic - Uncle Jam Wants You,39,37,51,2.0,39,Uncle Jam Wants You,15.0,15,-12,0,-2,1,down,1979-10-20
13061,Heaven And Earth,1979-10-20,Heaven And Earth - Fantasy,51,51,45,45.0,45,Fantasy,2.0,0,0,6,0,0,stay,1979-10-20
13062,Heaven And Earth,1979-10-27,Heaven And Earth - Fantasy,45,51,47,45.0,45,Fantasy,2.0,1,-2,0,6,1,down,1979-10-20
13063,Heaven And Earth,1979-11-03,Heaven And Earth - Fantasy,45,45,51,45.0,47,Fantasy,2.0,2,-4,-2,0,1,down,1979-10-20
13064,Faze-O,1979-10-20,Faze-O - Breakin' The Funk,51,51,48,48.0,48,Breakin' The Funk,1.0,0,0,3,0,0,stay,1979-10-20
13065,Faze-O,1979-10-27,Faze-O - Breakin' The Funk,48,51,51,48.0,48,Breakin' The Funk,1.0,1,-3,0,3,1,down,1979-10-20
13066,Nature's Divine,1979-10-20,Nature's Divine - In The Beginning,51,51,33,17.0,49,In The Beginning,10.0,0,16,2,0,1,up,1979-10-20
13067,Nature's Divine,1979-10-27,Nature's Divine - In The Beginning,49,51,27,17.0,33,In The Beginning,10.0,1,6,16,2,1,up,1979-10-20
13068,Nature's Divine,1979-11-03,Nature's Divine - In The Beginning,33,49,17,17.0,27,In The Beginning,10.0,2,10,6,16,1,up,1979-10-20
13069,Nature's Divine,1979-11-10,Nature's Divine - In The Beginning,27,33,17,17.0,17,In The Beginning,10.0,3,0,10,6,0,stay,1979-10-20
13070,Nature's Divine,1979-11-17,Nature's Divine - In The Beginning,17,27,25,17.0,17,In The Beginning,10.0,4,-8,0,10,1,down,1979-10-20
13071,Nature's Divine,1979-11-24,Nature's Divine - In The Beginning,17,17,26,17.0,25,In The Beginning,10.0,5,-1,-8,0,1,down,1979-10-20
13072,Nature's Divine,1979-12-01,Nature's Divine - In The Beginning,25,17,24,17.0,26,In The Beginning,10.0,6,2,-1,-8,1,up,1979-10-20
13073,Nature's Divine,1979-12-08,Nature's Divine - In The Beginning,26,25,29,17.0,24,In The Beginning,10.0,7,-5,2,-1,1,down,1979-10-20
13074,Nature's Divine,1979-12-15,Nature's Divine - In The Beginning,24,26,42,17.0,29,In The Beginning,10.0,8,-13,-5,2,1,down,1979-10-20
13075,Nature's Divine,1979-12-22,Nature's Divine - In The Beginning,29,24,42,17.0,42,In The Beginning,10.0,9,0,-13,-5,0,stay,1979-10-20
13076,Nature's Divine,1979-12-29,Nature's Divine - In The Beginning,42,29,51,17.0,42,In The Beginning,10.0,10,-9,0,-13,1,down,1979-10-20
13077,Millie Jackson And Issac Hayes,1979-10-27,Millie Jackson And Issac Hayes - Royal Rappin's,51,51,32,17.0,42,Royal Rappin's,20.0,0,10,9,0,1,up,1979-10-27
13078,Millie Jackson And Issac Hayes,1979-11-03,Millie Jackson And Issac Hayes - Royal Rappin's,42,51,24,17.0,32,Royal Rappin's,20.0,1,8,10,9,1,up,1979-10-27
13079,Millie Jackson And Issac Hayes,1979-11-10,Millie Jackson And Issac Hayes - Royal Rappin's,32,42,19,17.0,24,Royal Rappin's,20.0,2,5,8,10,1,up,1979-10-27
13080,Millie Jackson And Issac Hayes,1979-11-17,Millie Jackson And Issac Hayes - Royal Rappin's,24,32,18,17.0,19,Royal Rappin's,20.0,3,1,5,8,1,up,1979-10-27
13081,Millie Jackson And Issac Hayes,1979-11-24,Millie Jackson And Issac Hayes - Royal Rappin's,19,24,17,17.0,18,Royal Rappin's,20.0,4,1,1,5,1,up,1979-10-27
13082,Millie Jackson And Issac Hayes,1979-12-01,Millie Jackson And Issac Hayes - Royal Rappin's,18,19,21,17.0,17,Royal Rappin's,20.0,5,-4,1,1,1,down,1979-10-27
13083,Millie Jackson And Issac Hayes,1979-12-08,Millie Jackson And Issac Hayes - Royal Rappin's,17,18,27,17.0,21,Royal Rappin's,20.0,6,-6,-4,1,1,down,1979-10-27
13084,Millie Jackson And Issac Hayes,1979-12-15,Millie Jackson And Issac Hayes - Royal Rappin's,21,17,27,17.0,27,Royal Rappin's,20.0,7,0,-6,-4,0,stay,1979-10-27
13085,Millie Jackson And Issac Hayes,1979-12-22,Millie Jackson And Issac Hayes - Royal Rappin's,27,21,27,17.0,27,Royal Rappin's,20.0,8,0,0,-6,0,stay,1979-10-27
13086,Millie Jackson And Issac Hayes,1979-12-29,Millie Jackson And Issac Hayes - Royal Rappin's,27,27,25,17.0,27,Royal Rappin's,20.0,9,2,0,0,1,up,1979-10-27
13087,Millie Jackson And Issac Hayes,1980-01-05,Millie Jackson And Issac Hayes - Royal Rappin's,27,27,24,17.0,25,Royal Rappin's,20.0,10,1,2,0,1,up,1979-10-27
13088,Millie Jackson And Issac Hayes,1980-01-12,Millie Jackson And Issac Hayes - Royal Rappin's,25,27,28,17.0,24,Royal Rappin's,20.0,11,-4,1,2,1,down,1979-10-27
13089,Millie Jackson And Issac Hayes,1980-01-19,Millie Jackson And Issac Hayes - Royal Rappin's,24,25,30,17.0,28,Royal Rappin's,20.0,12,-2,-4,1,1,down,1979-10-27
13090,Millie Jackson And Issac Hayes,1980-01-26,Millie Jackson And Issac Hayes - Royal Rappin's,28,24,36,17.0,30,Royal Rappin's,20.0,13,-6,-2,-4,1,down,1979-10-27
13091,Millie Jackson And Issac Hayes,1980-02-02,Millie Jackson And Issac Hayes - Royal Rappin's,30,28,37,17.0,36,Royal Rappin's,20.0,14,-1,-6,-2,1,down,1979-10-27
13092,Millie Jackson And Issac Hayes,1980-02-09,Millie Jackson And Issac Hayes - Royal Rappin's,36,30,38,17.0,37,Royal Rappin's,20.0,15,-1,-1,-6,1,down,1979-10-27
13093,Millie Jackson And Issac Hayes,1980-02-16,Millie Jackson And Issac Hayes - Royal Rappin's,37,36,38,17.0,38,Royal Rappin's,20.0,16,0,-1,-1,0,stay,1979-10-27
13094,Millie Jackson And Issac Hayes,1980-02-23,Millie Jackson And Issac Hayes - Royal Rappin's,38,37,38,17.0,38,Royal Rappin's,20.0,17,0,0,-1,0,stay,1979-10-27
13095,Millie Jackson And Issac Hayes,1980-03-01,Millie Jackson And Issac Hayes - Royal Rappin's,38,38,41,17.0,38,Royal Rappin's,20.0,18,-3,0,0,1,down,1979-10-27
13096,Millie Jackson And Issac Hayes,1980-03-08,Millie Jackson And Issac Hayes - Royal Rappin's,38,38,46,17.0,41,Royal Rappin's,20.0,19,-5,-3,0,1,down,1979-10-27
13097,Millie Jackson And Issac Hayes,1980-03-15,Millie Jackson And Issac Hayes - Royal Rappin's,41,38,51,17.0,46,Royal Rappin's,20.0,20,-5,-5,-3,1,down,1979-10-27
13098,Lakeside,1979-10-27,Lakeside - Rough Riders,51,51,33,21.0,43,Rough Riders,19.0,0,10,8,0,1,up,1979-10-27
13099,Lakeside,1979-11-03,Lakeside - Rough Riders,43,51,27,21.0,33,Rough Riders,19.0,1,6,10,8,1,up,1979-10-27
13100,Lakeside,1979-11-10,Lakeside - Rough Riders,33,43,27,21.0,27,Rough Riders,19.0,2,0,6,10,0,stay,1979-10-27
13101,Lakeside,1979-11-17,Lakeside - Rough Riders,27,33,22,21.0,27,Rough Riders,19.0,3,5,0,6,1,up,1979-10-27
13102,Lakeside,1979-11-24,Lakeside - Rough Riders,27,27,21,21.0,22,Rough Riders,19.0,4,1,5,0,1,up,1979-10-27
13103,Lakeside,1979-12-01,Lakeside - Rough Riders,22,27,35,21.0,21,Rough Riders,19.0,5,-14,1,5,1,down,1979-10-27
13104,Lakeside,1979-12-08,Lakeside - Rough Riders,21,22,33,21.0,35,Rough Riders,19.0,6,2,-14,1,1,up,1979-10-27
13105,Lakeside,1979-12-15,Lakeside - Rough Riders,35,21,26,21.0,33,Rough Riders,19.0,7,7,2,-14,1,up,1979-10-27
13106,Lakeside,1979-12-22,Lakeside - Rough Riders,33,35,26,21.0,26,Rough Riders,19.0,8,0,7,2,0,stay,1979-10-27
13107,Lakeside,1979-12-29,Lakeside - Rough Riders,26,33,26,21.0,26,Rough Riders,19.0,9,0,0,7,0,stay,1979-10-27
13108,Lakeside,1980-01-05,Lakeside - Rough Riders,26,26,36,21.0,26,Rough Riders,19.0,10,-10,0,0,1,down,1979-10-27
13109,Lakeside,1980-01-12,Lakeside - Rough Riders,26,26,35,21.0,36,Rough Riders,19.0,11,1,-10,0,1,up,1979-10-27
13110,Lakeside,1980-01-19,Lakeside - Rough Riders,36,26,33,21.0,35,Rough Riders,19.0,12,2,1,-10,1,up,1979-10-27
13111,Lakeside,1980-01-26,Lakeside - Rough Riders,35,36,38,21.0,33,Rough Riders,19.0,13,-5,2,1,1,down,1979-10-27
13112,Lakeside,1980-02-02,Lakeside - Rough Riders,33,35,38,21.0,38,Rough Riders,19.0,14,0,-5,2,0,stay,1979-10-27
13113,Lakeside,1980-02-09,Lakeside - Rough Riders,38,33,37,21.0,38,Rough Riders,19.0,15,1,0,-5,1,up,1979-10-27
13114,Lakeside,1980-02-16,Lakeside - Rough Riders,38,38,41,21.0,37,Rough Riders,19.0,16,-4,1,0,1,down,1979-10-27
13115,Lakeside,1980-02-23,Lakeside - Rough Riders,37,38,41,21.0,41,Rough Riders,19.0,17,0,-4,1,0,stay,1979-10-27
13116,Lakeside,1980-03-01,Lakeside - Rough Riders,41,37,42,21.0,41,Rough Riders,19.0,18,-1,0,-4,1,down,1979-10-27
13117,Lakeside,1980-03-08,Lakeside - Rough Riders,41,41,51,21.0,42,Rough Riders,19.0,19,-9,-1,0,1,down,1979-10-27
13118,Santana,1979-10-27,Santana - Marathon,51,51,40,39.0,50,Marathon,10.0,0,10,1,0,1,up,1979-10-27
13119,Santana,1979-11-03,Santana - Marathon,50,51,39,39.0,40,Marathon,10.0,1,1,10,1,1,up,1979-10-27
13120,Santana,1979-11-10,Santana - Marathon,40,50,42,39.0,39,Marathon,10.0,2,-3,1,10,1,down,1979-10-27
13121,Santana,1979-11-17,Santana - Marathon,39,40,46,39.0,42,Marathon,10.0,3,-4,-3,1,1,down,1979-10-27
13122,Santana,1979-11-24,Santana - Marathon,42,39,49,39.0,46,Marathon,10.0,4,-3,-4,-3,1,down,1979-10-27
13123,Santana,1979-12-01,Santana - Marathon,46,42,39,39.0,49,Marathon,10.0,5,10,-3,-4,1,up,1979-10-27
13124,Santana,1979-12-08,Santana - Marathon,49,46,39,39.0,39,Marathon,10.0,6,0,10,-3,0,stay,1979-10-27
13125,Santana,1979-12-15,Santana - Marathon,39,49,45,39.0,39,Marathon,10.0,7,-6,0,10,1,down,1979-10-27
13126,Santana,1979-12-22,Santana - Marathon,39,39,45,39.0,45,Marathon,10.0,8,0,-6,0,0,stay,1979-10-27
13127,Santana,1979-12-29,Santana - Marathon,45,39,47,39.0,45,Marathon,10.0,9,-2,0,-6,1,down,1979-10-27
13128,Santana,1980-01-05,Santana - Marathon,45,45,51,39.0,47,Marathon,10.0,10,-4,-2,0,1,down,1979-10-27
13129,Mother's Finest,1979-11-03,Mother's Finest - Mother's Finest Live,51,51,33,32.0,43,Mother's Finest Live,2.0,0,10,8,0,1,up,1979-11-03
13130,Mother's Finest,1979-11-10,Mother's Finest - Mother's Finest Live,43,51,32,32.0,33,Mother's Finest Live,2.0,1,1,10,8,1,up,1979-11-03
13131,Mother's Finest,1979-11-17,Mother's Finest - Mother's Finest Live,33,43,51,32.0,32,Mother's Finest Live,2.0,2,-19,1,10,1,down,1979-11-03
13132,Sly & The Family Stone,1979-11-03,Sly & The Family Stone - Back On The Right Track,51,51,34,31.0,44,Back On The Right Track,5.0,0,10,7,0,1,up,1979-11-03
13133,Sly & The Family Stone,1979-11-10,Sly & The Family Stone - Back On The Right Track,44,51,31,31.0,34,Back On The Right Track,5.0,1,3,10,7,1,up,1979-11-03
13134,Sly & The Family Stone,1979-11-17,Sly & The Family Stone - Back On The Right Track,34,44,35,31.0,31,Back On The Right Track,5.0,2,-4,3,10,1,down,1979-11-03
13135,Sly & The Family Stone,1979-11-24,Sly & The Family Stone - Back On The Right Track,31,34,45,31.0,35,Back On The Right Track,5.0,3,-10,-4,3,1,down,1979-11-03
13136,Sly & The Family Stone,1979-12-01,Sly & The Family Stone - Back On The Right Track,35,31,45,31.0,45,Back On The Right Track,5.0,4,0,-10,-4,0,stay,1979-11-03
13137,Sly & The Family Stone,1979-12-08,Sly & The Family Stone - Back On The Right Track,45,35,51,31.0,45,Back On The Right Track,5.0,5,-6,0,-10,1,down,1979-11-03
13138,Bell And James,1979-11-03,Bell And James - Only Make Believe,51,51,36,36.0,46,Only Make Believe,3.0,0,10,5,0,1,up,1979-11-03
13139,Bell And James,1979-11-10,Bell And James - Only Make Believe,46,51,36,36.0,36,Only Make Believe,3.0,1,0,10,5,0,stay,1979-11-03
13140,Bell And James,1979-11-17,Bell And James - Only Make Believe,36,46,44,36.0,36,Only Make Believe,3.0,2,-8,0,10,1,down,1979-11-03
13141,Bell And James,1979-11-24,Bell And James - Only Make Believe,36,36,51,36.0,44,Only Make Believe,3.0,3,-7,-8,0,1,down,1979-11-03
13142,T-Connection,1979-11-03,T-Connection - Totally Connected,51,51,38,38.0,48,Totally Connected,4.0,0,10,3,0,1,up,1979-11-03
13143,T-Connection,1979-11-10,T-Connection - Totally Connected,48,51,38,38.0,38,Totally Connected,4.0,1,0,10,3,0,stay,1979-11-03
13144,T-Connection,1979-11-17,T-Connection - Totally Connected,38,48,47,38.0,38,Totally Connected,4.0,2,-9,0,10,1,down,1979-11-03
13145,T-Connection,1979-11-24,T-Connection - Totally Connected,38,38,48,38.0,47,Totally Connected,4.0,3,-1,-9,0,1,down,1979-11-03
13146,T-Connection,1979-12-01,T-Connection - Totally Connected,47,38,51,38.0,48,Totally Connected,4.0,4,-3,-1,-9,1,down,1979-11-03
13147,Tom Browne,1979-11-03,Tom Browne - Browne Sugar,51,51,51,50.0,50,Browne Sugar,0.0,0,-1,1,0,1,down,1979-11-03
13148,Donna Summer,1979-11-10,Donna Summer - On The Radio: Greatest Hits: Volumes I & II,51,51,11,4.0,14,On The Radio: Greatest Hits: Volumes I & II,25.0,0,3,37,0,1,up,1979-11-10
13149,Donna Summer,1979-11-17,Donna Summer - On The Radio: Greatest Hits: Volumes I & II,14,51,7,4.0,11,On The Radio: Greatest Hits: Volumes I & II,25.0,1,4,3,37,1,up,1979-11-10
13150,Donna Summer,1979-11-24,Donna Summer - On The Radio: Greatest Hits: Volumes I & II,11,14,6,4.0,7,On The Radio: Greatest Hits: Volumes I & II,25.0,2,1,4,3,1,up,1979-11-10
13151,Donna Summer,1979-12-01,Donna Summer - On The Radio: Greatest Hits: Volumes I & II,7,11,4,4.0,6,On The Radio: Greatest Hits: Volumes I & II,25.0,3,2,1,4,1,up,1979-11-10
13152,Donna Summer,1979-12-08,Donna Summer - On The Radio: Greatest Hits: Volumes I & II,6,7,4,4.0,4,On The Radio: Greatest Hits: Volumes I & II,25.0,4,0,2,1,0,stay,1979-11-10
13153,Donna Summer,1979-12-15,Donna Summer - On The Radio: Greatest Hits: Volumes I & II,4,6,7,4.0,4,On The Radio: Greatest Hits: Volumes I & II,25.0,5,-3,0,2,1,down,1979-11-10
13154,Donna Summer,1979-12-22,Donna Summer - On The Radio: Greatest Hits: Volumes I & II,4,4,7,4.0,7,On The Radio: Greatest Hits: Volumes I & II,25.0,6,0,-3,0,0,stay,1979-11-10
13155,Donna Summer,1979-12-29,Donna Summer - On The Radio: Greatest Hits: Volumes I & II,7,4,5,4.0,7,On The Radio: Greatest Hits: Volumes I & II,25.0,7,2,0,-3,1,up,1979-11-10
13156,Donna Summer,1980-01-05,Donna Summer - On The Radio: Greatest Hits: Volumes I & II,7,7,5,4.0,5,On The Radio: Greatest Hits: Volumes I & II,25.0,8,0,2,0,0,stay,1979-11-10
13157,Donna Summer,1980-01-12,Donna Summer - On The Radio: Greatest Hits: Volumes I & II,5,7,5,4.0,5,On The Radio: Greatest Hits: Volumes I & II,25.0,9,0,0,2,0,stay,1979-11-10
13158,Donna Summer,1980-01-19,Donna Summer - On The Radio: Greatest Hits: Volumes I & II,5,5,6,4.0,5,On The Radio: Greatest Hits: Volumes I & II,25.0,10,-1,0,0,1,down,1979-11-10
13159,Donna Summer,1980-01-26,Donna Summer - On The Radio: Greatest Hits: Volumes I & II,5,5,6,4.0,6,On The Radio: Greatest Hits: Volumes I & II,25.0,11,0,-1,0,0,stay,1979-11-10
13160,Donna Summer,1980-02-02,Donna Summer - On The Radio: Greatest Hits: Volumes I & II,6,5,6,4.0,6,On The Radio: Greatest Hits: Volumes I & II,25.0,12,0,0,-1,0,stay,1979-11-10
13161,Donna Summer,1980-02-09,Donna Summer - On The Radio: Greatest Hits: Volumes I & II,6,6,9,4.0,6,On The Radio: Greatest Hits: Volumes I & II,25.0,13,-3,0,0,1,down,1979-11-10
13162,Donna Summer,1980-02-16,Donna Summer - On The Radio: Greatest Hits: Volumes I & II,6,6,12,4.0,9,On The Radio: Greatest Hits: Volumes I & II,25.0,14,-3,-3,0,1,down,1979-11-10
13163,Donna Summer,1980-02-23,Donna Summer - On The Radio: Greatest Hits: Volumes I & II,9,6,14,4.0,12,On The Radio: Greatest Hits: Volumes I & II,25.0,15,-2,-3,-3,1,down,1979-11-10
13164,Donna Summer,1980-03-01,Donna Summer - On The Radio: Greatest Hits: Volumes I & II,12,9,14,4.0,14,On The Radio: Greatest Hits: Volumes I & II,25.0,16,0,-2,-3,0,stay,1979-11-10
13165,Donna Summer,1980-03-08,Donna Summer - On The Radio: Greatest Hits: Volumes I & II,14,12,16,4.0,14,On The Radio: Greatest Hits: Volumes I & II,25.0,17,-2,0,-2,1,down,1979-11-10
13166,Donna Summer,1980-03-15,Donna Summer - On The Radio: Greatest Hits: Volumes I & II,14,14,16,4.0,16,On The Radio: Greatest Hits: Volumes I & II,25.0,18,0,-2,0,0,stay,1979-11-10
13167,Donna Summer,1980-03-22,Donna Summer - On The Radio: Greatest Hits: Volumes I & II,16,14,19,4.0,16,On The Radio: Greatest Hits: Volumes I & II,25.0,19,-3,0,-2,1,down,1979-11-10
13168,Donna Summer,1980-03-29,Donna Summer - On The Radio: Greatest Hits: Volumes I & II,16,16,28,4.0,19,On The Radio: Greatest Hits: Volumes I & II,25.0,20,-9,-3,0,1,down,1979-11-10
13169,Donna Summer,1980-04-05,Donna Summer - On The Radio: Greatest Hits: Volumes I & II,19,16,29,4.0,28,On The Radio: Greatest Hits: Volumes I & II,25.0,21,-1,-9,-3,1,down,1979-11-10
13170,Donna Summer,1980-04-12,Donna Summer - On The Radio: Greatest Hits: Volumes I & II,28,19,44,4.0,29,On The Radio: Greatest Hits: Volumes I & II,25.0,22,-15,-1,-9,1,down,1979-11-10
13171,Donna Summer,1980-04-19,Donna Summer - On The Radio: Greatest Hits: Volumes I & II,29,28,45,4.0,44,On The Radio: Greatest Hits: Volumes I & II,25.0,23,-1,-15,-1,1,down,1979-11-10
13172,Donna Summer,1980-04-26,Donna Summer - On The Radio: Greatest Hits: Volumes I & II,44,29,46,4.0,45,On The Radio: Greatest Hits: Volumes I & II,25.0,24,-1,-1,-15,1,down,1979-11-10
13173,Donna Summer,1980-05-03,Donna Summer - On The Radio: Greatest Hits: Volumes I & II,45,44,51,4.0,46,On The Radio: Greatest Hits: Volumes I & II,25.0,25,-5,-1,-1,1,down,1979-11-10
13174,Rick James,1979-11-10,Rick James - Fire It Up,51,51,7,5.0,21,Fire It Up,19.0,0,14,30,0,1,up,1979-11-10
13175,Rick James,1979-11-17,Rick James - Fire It Up,21,51,6,5.0,7,Fire It Up,19.0,1,1,14,30,1,up,1979-11-10
13176,Rick James,1979-11-24,Rick James - Fire It Up,7,21,5,5.0,6,Fire It Up,19.0,2,1,1,14,1,up,1979-11-10
13177,Rick James,1979-12-01,Rick James - Fire It Up,6,7,5,5.0,5,Fire It Up,19.0,3,0,1,1,0,stay,1979-11-10
13178,Rick James,1979-12-08,Rick James - Fire It Up,5,6,11,5.0,5,Fire It Up,19.0,4,-6,0,1,1,down,1979-11-10
13179,Rick James,1979-12-15,Rick James - Fire It Up,5,5,12,5.0,11,Fire It Up,19.0,5,-1,-6,0,1,down,1979-11-10
13180,Rick James,1979-12-22,Rick James - Fire It Up,11,5,12,5.0,12,Fire It Up,19.0,6,0,-1,-6,0,stay,1979-11-10
13181,Rick James,1979-12-29,Rick James - Fire It Up,12,11,22,5.0,12,Fire It Up,19.0,7,-10,0,-1,1,down,1979-11-10
13182,Rick James,1980-01-05,Rick James - Fire It Up,12,12,28,5.0,22,Fire It Up,19.0,8,-6,-10,0,1,down,1979-11-10
13183,Rick James,1980-01-12,Rick James - Fire It Up,22,12,38,5.0,28,Fire It Up,19.0,9,-10,-6,-10,1,down,1979-11-10
13184,Rick James,1980-01-19,Rick James - Fire It Up,28,22,38,5.0,38,Fire It Up,19.0,10,0,-10,-6,0,stay,1979-11-10
13185,Rick James,1980-01-26,Rick James - Fire It Up,38,28,37,5.0,38,Fire It Up,19.0,11,1,0,-10,1,up,1979-11-10
13186,Rick James,1980-02-02,Rick James - Fire It Up,38,38,36,5.0,37,Fire It Up,19.0,12,1,1,0,1,up,1979-11-10
13187,Rick James,1980-02-09,Rick James - Fire It Up,37,38,36,5.0,36,Fire It Up,19.0,13,0,1,1,0,stay,1979-11-10
13188,Rick James,1980-02-16,Rick James - Fire It Up,36,37,37,5.0,36,Fire It Up,19.0,14,-1,0,1,1,down,1979-11-10
13189,Rick James,1980-02-23,Rick James - Fire It Up,36,36,35,5.0,37,Fire It Up,19.0,15,2,-1,0,1,up,1979-11-10
13190,Rick James,1980-03-01,Rick James - Fire It Up,37,36,36,5.0,35,Fire It Up,19.0,16,-1,2,-1,1,down,1979-11-10
13191,Rick James,1980-03-08,Rick James - Fire It Up,35,37,50,5.0,36,Fire It Up,19.0,17,-14,-1,2,1,down,1979-11-10
13192,Rick James,1980-03-15,Rick James - Fire It Up,36,35,47,5.0,50,Fire It Up,19.0,18,3,-14,-1,1,up,1979-11-10
13193,Rick James,1980-04-12,Rick James - Fire It Up,50,36,51,5.0,47,Fire It Up,19.0,19,-4,3,-14,1,down,1979-11-10
13194,Barkays,1979-11-10,Barkays - Injoy,51,51,8,2.0,23,Injoy,21.0,0,15,28,0,1,up,1979-11-10
13195,Barkays,1979-11-17,Barkays - Injoy,23,51,5,2.0,8,Injoy,21.0,1,3,15,28,1,up,1979-11-10
13196,Barkays,1979-11-24,Barkays - Injoy,8,23,2,2.0,5,Injoy,21.0,2,3,3,15,1,up,1979-11-10
13197,Barkays,1979-12-01,Barkays - Injoy,5,8,2,2.0,2,Injoy,21.0,3,0,3,3,0,stay,1979-11-10
13198,Barkays,1979-12-08,Barkays - Injoy,2,5,2,2.0,2,Injoy,21.0,4,0,0,3,0,stay,1979-11-10
13199,Barkays,1979-12-15,Barkays - Injoy,2,2,5,2.0,2,Injoy,21.0,5,-3,0,0,1,down,1979-11-10
13200,Barkays,1979-12-22,Barkays - Injoy,2,2,5,2.0,5,Injoy,21.0,6,0,-3,0,0,stay,1979-11-10
13201,Barkays,1979-12-29,Barkays - Injoy,5,2,7,2.0,5,Injoy,21.0,7,-2,0,-3,1,down,1979-11-10
13202,Barkays,1980-01-05,Barkays - Injoy,5,5,11,2.0,7,Injoy,21.0,8,-4,-2,0,1,down,1979-11-10
13203,Barkays,1980-01-12,Barkays - Injoy,7,5,10,2.0,11,Injoy,21.0,9,1,-4,-2,1,up,1979-11-10
13204,Barkays,1980-01-19,Barkays - Injoy,11,7,10,2.0,10,Injoy,21.0,10,0,1,-4,0,stay,1979-11-10
13205,Barkays,1980-01-26,Barkays - Injoy,10,11,14,2.0,10,Injoy,21.0,11,-4,0,1,1,down,1979-11-10
13206,Barkays,1980-02-02,Barkays - Injoy,10,10,14,2.0,14,Injoy,21.0,12,0,-4,0,0,stay,1979-11-10
13207,Barkays,1980-02-09,Barkays - Injoy,14,10,19,2.0,14,Injoy,21.0,13,-5,0,-4,1,down,1979-11-10
13208,Barkays,1980-02-16,Barkays - Injoy,14,14,25,2.0,19,Injoy,21.0,14,-6,-5,0,1,down,1979-11-10
13209,Barkays,1980-02-23,Barkays - Injoy,19,14,27,2.0,25,Injoy,21.0,15,-2,-6,-5,1,down,1979-11-10
13210,Barkays,1980-03-01,Barkays - Injoy,25,19,27,2.0,27,Injoy,21.0,16,0,-2,-6,0,stay,1979-11-10
13211,Barkays,1980-03-08,Barkays - Injoy,27,25,32,2.0,27,Injoy,21.0,17,-5,0,-2,1,down,1979-11-10
13212,Barkays,1980-03-15,Barkays - Injoy,27,27,40,2.0,32,Injoy,21.0,18,-8,-5,0,1,down,1979-11-10
13213,Barkays,1980-03-22,Barkays - Injoy,32,27,42,2.0,40,Injoy,21.0,19,-2,-8,-5,1,down,1979-11-10
13214,Barkays,1980-03-29,Barkays - Injoy,40,32,48,2.0,42,Injoy,21.0,20,-6,-2,-8,1,down,1979-11-10
13215,Barkays,1980-04-05,Barkays - Injoy,42,40,51,2.0,48,Injoy,21.0,21,-3,-6,-2,1,down,1979-11-10
13216,Angela Bofill,1979-11-10,Angela Bofill - Angel Of The Night,51,51,20,10.0,37,Angel Of The Night,30.0,0,17,14,0,1,up,1979-11-10
13217,Angela Bofill,1979-11-17,Angela Bofill - Angel Of The Night,37,51,17,10.0,20,Angel Of The Night,30.0,1,3,17,14,1,up,1979-11-10
13218,Angela Bofill,1979-11-24,Angela Bofill - Angel Of The Night,20,37,14,10.0,17,Angel Of The Night,30.0,2,3,3,17,1,up,1979-11-10
13219,Angela Bofill,1979-12-01,Angela Bofill - Angel Of The Night,17,20,14,10.0,14,Angel Of The Night,30.0,3,0,3,3,0,stay,1979-11-10
13220,Angela Bofill,1979-12-08,Angela Bofill - Angel Of The Night,14,17,14,10.0,14,Angel Of The Night,30.0,4,0,0,3,0,stay,1979-11-10
13221,Angela Bofill,1979-12-15,Angela Bofill - Angel Of The Night,14,14,17,10.0,14,Angel Of The Night,30.0,5,-3,0,0,1,down,1979-11-10
13222,Angela Bofill,1979-12-22,Angela Bofill - Angel Of The Night,14,14,17,10.0,17,Angel Of The Night,30.0,6,0,-3,0,0,stay,1979-11-10
13223,Angela Bofill,1979-12-29,Angela Bofill - Angel Of The Night,17,14,19,10.0,17,Angel Of The Night,30.0,7,-2,0,-3,1,down,1979-11-10
13224,Angela Bofill,1980-01-05,Angela Bofill - Angel Of The Night,17,17,20,10.0,19,Angel Of The Night,30.0,8,-1,-2,0,1,down,1979-11-10
13225,Angela Bofill,1980-01-12,Angela Bofill - Angel Of The Night,19,17,19,10.0,20,Angel Of The Night,30.0,9,1,-1,-2,1,up,1979-11-10
13226,Angela Bofill,1980-01-19,Angela Bofill - Angel Of The Night,20,19,16,10.0,19,Angel Of The Night,30.0,10,3,1,-1,1,up,1979-11-10
13227,Angela Bofill,1980-01-26,Angela Bofill - Angel Of The Night,19,20,15,10.0,16,Angel Of The Night,30.0,11,1,3,1,1,up,1979-11-10
13228,Angela Bofill,1980-02-02,Angela Bofill - Angel Of The Night,16,19,12,10.0,15,Angel Of The Night,30.0,12,3,1,3,1,up,1979-11-10
13229,Angela Bofill,1980-02-09,Angela Bofill - Angel Of The Night,15,16,10,10.0,12,Angel Of The Night,30.0,13,2,3,1,1,up,1979-11-10
13230,Angela Bofill,1980-02-16,Angela Bofill - Angel Of The Night,12,15,10,10.0,10,Angel Of The Night,30.0,14,0,2,3,0,stay,1979-11-10
13231,Angela Bofill,1980-02-23,Angela Bofill - Angel Of The Night,10,12,10,10.0,10,Angel Of The Night,30.0,15,0,0,2,0,stay,1979-11-10
13232,Angela Bofill,1980-03-01,Angela Bofill - Angel Of The Night,10,10,11,10.0,10,Angel Of The Night,30.0,16,-1,0,0,1,down,1979-11-10
13233,Angela Bofill,1980-03-08,Angela Bofill - Angel Of The Night,10,10,10,10.0,11,Angel Of The Night,30.0,17,1,-1,0,1,up,1979-11-10
13234,Angela Bofill,1980-03-15,Angela Bofill - Angel Of The Night,11,10,10,10.0,10,Angel Of The Night,30.0,18,0,1,-1,0,stay,1979-11-10
13235,Angela Bofill,1980-03-22,Angela Bofill - Angel Of The Night,10,11,13,10.0,10,Angel Of The Night,30.0,19,-3,0,1,1,down,1979-11-10
13236,Angela Bofill,1980-03-29,Angela Bofill - Angel Of The Night,10,10,15,10.0,13,Angel Of The Night,30.0,20,-2,-3,0,1,down,1979-11-10
13237,Angela Bofill,1980-04-05,Angela Bofill - Angel Of The Night,13,10,15,10.0,15,Angel Of The Night,30.0,21,0,-2,-3,0,stay,1979-11-10
13238,Angela Bofill,1980-04-12,Angela Bofill - Angel Of The Night,15,13,16,10.0,15,Angel Of The Night,30.0,22,-1,0,-2,1,down,1979-11-10
13239,Angela Bofill,1980-04-19,Angela Bofill - Angel Of The Night,15,15,23,10.0,16,Angel Of The Night,30.0,23,-7,-1,0,1,down,1979-11-10
13240,Angela Bofill,1980-04-26,Angela Bofill - Angel Of The Night,16,15,27,10.0,23,Angel Of The Night,30.0,24,-4,-7,-1,1,down,1979-11-10
13241,Angela Bofill,1980-05-03,Angela Bofill - Angel Of The Night,23,16,31,10.0,27,Angel Of The Night,30.0,25,-4,-4,-7,1,down,1979-11-10
13242,Angela Bofill,1980-05-10,Angela Bofill - Angel Of The Night,27,23,37,10.0,31,Angel Of The Night,30.0,26,-6,-4,-4,1,down,1979-11-10
13243,Angela Bofill,1980-05-17,Angela Bofill - Angel Of The Night,31,27,41,10.0,37,Angel Of The Night,30.0,27,-4,-6,-4,1,down,1979-11-10
13244,Angela Bofill,1980-05-24,Angela Bofill - Angel Of The Night,37,31,43,10.0,41,Angel Of The Night,30.0,28,-2,-4,-6,1,down,1979-11-10
13245,Angela Bofill,1980-05-31,Angela Bofill - Angel Of The Night,41,37,48,10.0,43,Angel Of The Night,30.0,29,-5,-2,-4,1,down,1979-11-10
13246,Angela Bofill,1980-06-07,Angela Bofill - Angel Of The Night,43,41,51,10.0,48,Angel Of The Night,30.0,30,-3,-5,-2,1,down,1979-11-10
13247,One Way Featuring Al Hudson,1979-11-10,One Way Featuring Al Hudson - One Way Featuring Al Hudson,51,51,45,25.0,45,One Way Featuring Al Hudson,32.0,0,0,6,0,0,stay,1979-11-10
13248,One Way Featuring Al Hudson,1979-11-17,One Way Featuring Al Hudson - One Way Featuring Al Hudson,45,51,45,25.0,45,One Way Featuring Al Hudson,32.0,1,0,0,6,0,stay,1979-11-10
13249,One Way Featuring Al Hudson,1979-11-24,One Way Featuring Al Hudson - One Way Featuring Al Hudson,45,45,44,25.0,45,One Way Featuring Al Hudson,32.0,2,1,0,0,1,up,1979-11-10
13250,One Way Featuring Al Hudson,1979-12-01,One Way Featuring Al Hudson - One Way Featuring Al Hudson,45,45,46,25.0,44,One Way Featuring Al Hudson,32.0,3,-2,1,0,1,down,1979-11-10
13251,One Way Featuring Al Hudson,1979-12-08,One Way Featuring Al Hudson - One Way Featuring Al Hudson,44,45,46,25.0,46,One Way Featuring Al Hudson,32.0,4,0,-2,1,0,stay,1979-11-10
13252,One Way Featuring Al Hudson,1979-12-15,One Way Featuring Al Hudson - One Way Featuring Al Hudson,46,44,46,25.0,46,One Way Featuring Al Hudson,32.0,5,0,0,-2,0,stay,1979-11-10
13253,One Way Featuring Al Hudson,1979-12-22,One Way Featuring Al Hudson - One Way Featuring Al Hudson,46,46,46,25.0,46,One Way Featuring Al Hudson,32.0,6,0,0,0,0,stay,1979-11-10
13254,One Way Featuring Al Hudson,1979-12-29,One Way Featuring Al Hudson - One Way Featuring Al Hudson,46,46,50,25.0,46,One Way Featuring Al Hudson,32.0,7,-4,0,0,1,down,1979-11-10
13255,One Way Featuring Al Hudson,1980-01-26,One Way Featuring Al Hudson - One Way Featuring Al Hudson,46,46,50,25.0,50,One Way Featuring Al Hudson,32.0,8,0,-4,0,0,stay,1979-11-10
13256,One Way Featuring Al Hudson,1980-02-02,One Way Featuring Al Hudson - One Way Featuring Al Hudson,50,46,47,25.0,50,One Way Featuring Al Hudson,32.0,9,3,0,-4,1,up,1979-11-10
13257,One Way Featuring Al Hudson,1980-02-09,One Way Featuring Al Hudson - One Way Featuring Al Hudson,50,50,46,25.0,47,One Way Featuring Al Hudson,32.0,10,1,3,0,1,up,1979-11-10
13258,One Way Featuring Al Hudson,1980-02-16,One Way Featuring Al Hudson - One Way Featuring Al Hudson,47,50,44,25.0,46,One Way Featuring Al Hudson,32.0,11,2,1,3,1,up,1979-11-10
13259,One Way Featuring Al Hudson,1980-02-23,One Way Featuring Al Hudson - One Way Featuring Al Hudson,46,47,43,25.0,44,One Way Featuring Al Hudson,32.0,12,1,2,1,1,up,1979-11-10
13260,One Way Featuring Al Hudson,1980-03-01,One Way Featuring Al Hudson - One Way Featuring Al Hudson,44,46,46,25.0,43,One Way Featuring Al Hudson,32.0,13,-3,1,2,1,down,1979-11-10
13261,One Way Featuring Al Hudson,1980-03-08,One Way Featuring Al Hudson - One Way Featuring Al Hudson,43,44,49,25.0,46,One Way Featuring Al Hudson,32.0,14,-3,-3,1,1,down,1979-11-10
13262,One Way Featuring Al Hudson,1980-07-12,One Way Featuring Al Hudson - One Way Featuring Al Hudson,46,43,41,25.0,49,One Way Featuring Al Hudson,32.0,15,8,-3,-3,1,up,1979-11-10
13263,One Way Featuring Al Hudson,1980-07-19,One Way Featuring Al Hudson - One Way Featuring Al Hudson,49,46,31,25.0,41,One Way Featuring Al Hudson,32.0,16,10,8,-3,1,up,1979-11-10
13264,One Way Featuring Al Hudson,1980-07-26,One Way Featuring Al Hudson - One Way Featuring Al Hudson,41,49,27,25.0,31,One Way Featuring Al Hudson,32.0,17,4,10,8,1,up,1979-11-10
13265,One Way Featuring Al Hudson,1980-08-02,One Way Featuring Al Hudson - One Way Featuring Al Hudson,31,41,27,25.0,27,One Way Featuring Al Hudson,32.0,18,0,4,10,0,stay,1979-11-10
13266,One Way Featuring Al Hudson,1980-08-09,One Way Featuring Al Hudson - One Way Featuring Al Hudson,27,31,32,25.0,27,One Way Featuring Al Hudson,32.0,19,-5,0,4,1,down,1979-11-10
13267,One Way Featuring Al Hudson,1980-08-16,One Way Featuring Al Hudson - One Way Featuring Al Hudson,27,27,40,25.0,32,One Way Featuring Al Hudson,32.0,20,-8,-5,0,1,down,1979-11-10
13268,One Way Featuring Al Hudson,1980-08-23,One Way Featuring Al Hudson - One Way Featuring Al Hudson,32,27,37,25.0,40,One Way Featuring Al Hudson,32.0,21,3,-8,-5,1,up,1979-11-10
13269,One Way Featuring Al Hudson,1980-08-30,One Way Featuring Al Hudson - One Way Featuring Al Hudson,40,32,35,25.0,37,One Way Featuring Al Hudson,32.0,22,2,3,-8,1,up,1979-11-10
13270,One Way Featuring Al Hudson,1980-09-06,One Way Featuring Al Hudson - One Way Featuring Al Hudson,37,40,32,25.0,35,One Way Featuring Al Hudson,32.0,23,3,2,3,1,up,1979-11-10
13271,One Way Featuring Al Hudson,1980-09-13,One Way Featuring Al Hudson - One Way Featuring Al Hudson,35,37,33,25.0,32,One Way Featuring Al Hudson,32.0,24,-1,3,2,1,down,1979-11-10
13272,One Way Featuring Al Hudson,1980-09-20,One Way Featuring Al Hudson - One Way Featuring Al Hudson,32,35,31,25.0,33,One Way Featuring Al Hudson,32.0,25,2,-1,3,1,up,1979-11-10
13273,One Way Featuring Al Hudson,1980-09-27,One Way Featuring Al Hudson - One Way Featuring Al Hudson,33,32,31,25.0,31,One Way Featuring Al Hudson,32.0,26,0,2,-1,0,stay,1979-11-10
13274,One Way Featuring Al Hudson,1980-10-04,One Way Featuring Al Hudson - One Way Featuring Al Hudson,31,33,25,25.0,31,One Way Featuring Al Hudson,32.0,27,6,0,2,1,up,1979-11-10
13275,One Way Featuring Al Hudson,1980-10-11,One Way Featuring Al Hudson - One Way Featuring Al Hudson,31,31,25,25.0,25,One Way Featuring Al Hudson,32.0,28,0,6,0,0,stay,1979-11-10
13276,One Way Featuring Al Hudson,1980-10-18,One Way Featuring Al Hudson - One Way Featuring Al Hudson,25,31,34,25.0,25,One Way Featuring Al Hudson,32.0,29,-9,0,6,1,down,1979-11-10
13277,One Way Featuring Al Hudson,1980-10-25,One Way Featuring Al Hudson - One Way Featuring Al Hudson,25,25,38,25.0,34,One Way Featuring Al Hudson,32.0,30,-4,-9,0,1,down,1979-11-10
13278,One Way Featuring Al Hudson,1980-11-01,One Way Featuring Al Hudson - One Way Featuring Al Hudson,34,25,49,25.0,38,One Way Featuring Al Hudson,32.0,31,-11,-4,-9,1,down,1979-11-10
13279,One Way Featuring Al Hudson,1980-11-08,One Way Featuring Al Hudson - One Way Featuring Al Hudson,38,34,51,25.0,49,One Way Featuring Al Hudson,32.0,32,-2,-11,-4,1,down,1979-11-10
13280,Shalamar,1979-11-10,Shalamar - Big Fun,51,51,46,4.0,48,Big Fun,31.0,0,2,3,0,1,up,1979-11-10
13281,Shalamar,1979-11-17,Shalamar - Big Fun,48,51,37,4.0,46,Big Fun,31.0,1,9,2,3,1,up,1979-11-10
13282,Shalamar,1979-11-24,Shalamar - Big Fun,46,48,31,4.0,37,Big Fun,31.0,2,6,9,2,1,up,1979-11-10
13283,Shalamar,1979-12-01,Shalamar - Big Fun,37,46,31,4.0,31,Big Fun,31.0,3,0,6,9,0,stay,1979-11-10
13284,Shalamar,1979-12-08,Shalamar - Big Fun,31,37,25,4.0,31,Big Fun,31.0,4,6,0,6,1,up,1979-11-10
13285,Shalamar,1979-12-15,Shalamar - Big Fun,31,31,21,4.0,25,Big Fun,31.0,5,4,6,0,1,up,1979-11-10
13286,Shalamar,1979-12-22,Shalamar - Big Fun,25,31,21,4.0,21,Big Fun,31.0,6,0,4,6,0,stay,1979-11-10
13287,Shalamar,1979-12-29,Shalamar - Big Fun,21,25,20,4.0,21,Big Fun,31.0,7,1,0,4,1,up,1979-11-10
13288,Shalamar,1980-01-05,Shalamar - Big Fun,21,21,21,4.0,20,Big Fun,31.0,8,-1,1,0,1,down,1979-11-10
13289,Shalamar,1980-01-12,Shalamar - Big Fun,20,21,18,4.0,21,Big Fun,31.0,9,3,-1,1,1,up,1979-11-10
13290,Shalamar,1980-01-19,Shalamar - Big Fun,21,20,9,4.0,18,Big Fun,31.0,10,9,3,-1,1,up,1979-11-10
13291,Shalamar,1980-01-26,Shalamar - Big Fun,18,21,7,4.0,9,Big Fun,31.0,11,2,9,3,1,up,1979-11-10
13292,Shalamar,1980-02-02,Shalamar - Big Fun,9,18,5,4.0,7,Big Fun,31.0,12,2,2,9,1,up,1979-11-10
13293,Shalamar,1980-02-09,Shalamar - Big Fun,7,9,4,4.0,5,Big Fun,31.0,13,1,2,2,1,up,1979-11-10
13294,Shalamar,1980-02-16,Shalamar - Big Fun,5,7,4,4.0,4,Big Fun,31.0,14,0,1,2,0,stay,1979-11-10
13295,Shalamar,1980-02-23,Shalamar - Big Fun,4,5,5,4.0,4,Big Fun,31.0,15,-1,0,1,1,down,1979-11-10
13296,Shalamar,1980-03-01,Shalamar - Big Fun,4,4,5,4.0,5,Big Fun,31.0,16,0,-1,0,0,stay,1979-11-10
13297,Shalamar,1980-03-08,Shalamar - Big Fun,5,4,7,4.0,5,Big Fun,31.0,17,-2,0,-1,1,down,1979-11-10
13298,Shalamar,1980-03-15,Shalamar - Big Fun,5,5,7,4.0,7,Big Fun,31.0,18,0,-2,0,0,stay,1979-11-10
13299,Shalamar,1980-03-22,Shalamar - Big Fun,7,5,8,4.0,7,Big Fun,31.0,19,-1,0,-2,1,down,1979-11-10
13300,Shalamar,1980-03-29,Shalamar - Big Fun,7,7,9,4.0,8,Big Fun,31.0,20,-1,-1,0,1,down,1979-11-10
13301,Shalamar,1980-04-05,Shalamar - Big Fun,8,7,10,4.0,9,Big Fun,31.0,21,-1,-1,-1,1,down,1979-11-10
13302,Shalamar,1980-04-12,Shalamar - Big Fun,9,8,12,4.0,10,Big Fun,31.0,22,-2,-1,-1,1,down,1979-11-10
13303,Shalamar,1980-04-19,Shalamar - Big Fun,10,9,17,4.0,12,Big Fun,31.0,23,-5,-2,-1,1,down,1979-11-10
13304,Shalamar,1980-04-26,Shalamar - Big Fun,12,10,18,4.0,17,Big Fun,31.0,24,-1,-5,-2,1,down,1979-11-10
13305,Shalamar,1980-05-03,Shalamar - Big Fun,17,12,24,4.0,18,Big Fun,31.0,25,-6,-1,-5,1,down,1979-11-10
13306,Shalamar,1980-05-10,Shalamar - Big Fun,18,17,31,4.0,24,Big Fun,31.0,26,-7,-6,-1,1,down,1979-11-10
13307,Shalamar,1980-05-17,Shalamar - Big Fun,24,18,31,4.0,31,Big Fun,31.0,27,0,-7,-6,0,stay,1979-11-10
13308,Shalamar,1980-05-24,Shalamar - Big Fun,31,24,33,4.0,31,Big Fun,31.0,28,-2,0,-7,1,down,1979-11-10
13309,Shalamar,1980-05-31,Shalamar - Big Fun,31,31,37,4.0,33,Big Fun,31.0,29,-4,-2,0,1,down,1979-11-10
13310,Shalamar,1980-06-07,Shalamar - Big Fun,33,31,39,4.0,37,Big Fun,31.0,30,-2,-4,-2,1,down,1979-11-10
13311,Shalamar,1980-06-14,Shalamar - Big Fun,37,33,51,4.0,39,Big Fun,31.0,31,-12,-2,-4,1,down,1979-11-10
13312,Stix Hooper,1979-11-10,Stix Hooper - The World Within,51,51,49,49.0,49,The World Within,2.0,0,0,2,0,0,stay,1979-11-10
13313,Stix Hooper,1979-11-17,Stix Hooper - The World Within,49,51,49,49.0,49,The World Within,2.0,1,0,0,2,0,stay,1979-11-10
13314,Stix Hooper,1979-11-24,Stix Hooper - The World Within,49,49,51,49.0,49,The World Within,2.0,2,-2,0,0,1,down,1979-11-10
13315,Prince,1979-11-17,Prince - Prince,51,51,10,3.0,22,Prince,29.0,0,12,29,0,1,up,1979-11-17
13316,Prince,1979-11-24,Prince - Prince,22,51,9,3.0,10,Prince,29.0,1,1,12,29,1,up,1979-11-17
13317,Prince,1979-12-01,Prince - Prince,10,22,7,3.0,9,Prince,29.0,2,2,1,12,1,up,1979-11-17
13318,Prince,1979-12-08,Prince - Prince,9,10,6,3.0,7,Prince,29.0,3,1,2,1,1,up,1979-11-17
13319,Prince,1979-12-15,Prince - Prince,7,9,3,3.0,6,Prince,29.0,4,3,1,2,1,up,1979-11-17
13320,Prince,1979-12-22,Prince - Prince,6,7,3,3.0,3,Prince,29.0,5,0,3,1,0,stay,1979-11-17
13321,Prince,1979-12-29,Prince - Prince,3,6,3,3.0,3,Prince,29.0,6,0,0,3,0,stay,1979-11-17
13322,Prince,1980-01-05,Prince - Prince,3,3,3,3.0,3,Prince,29.0,7,0,0,0,0,stay,1979-11-17
13323,Prince,1980-01-12,Prince - Prince,3,3,3,3.0,3,Prince,29.0,8,0,0,0,0,stay,1979-11-17
13324,Prince,1980-01-19,Prince - Prince,3,3,3,3.0,3,Prince,29.0,9,0,0,0,0,stay,1979-11-17
13325,Prince,1980-01-26,Prince - Prince,3,3,4,3.0,3,Prince,29.0,10,-1,0,0,1,down,1979-11-17
13326,Prince,1980-02-02,Prince - Prince,3,3,7,3.0,4,Prince,29.0,11,-3,-1,0,1,down,1979-11-17
13327,Prince,1980-02-09,Prince - Prince,4,3,7,3.0,7,Prince,29.0,12,0,-3,-1,0,stay,1979-11-17
13328,Prince,1980-02-16,Prince - Prince,7,4,7,3.0,7,Prince,29.0,13,0,0,-3,0,stay,1979-11-17
13329,Prince,1980-02-23,Prince - Prince,7,7,7,3.0,7,Prince,29.0,14,0,0,0,0,stay,1979-11-17
13330,Prince,1980-03-01,Prince - Prince,7,7,7,3.0,7,Prince,29.0,15,0,0,0,0,stay,1979-11-17
13331,Prince,1980-03-08,Prince - Prince,7,7,9,3.0,7,Prince,29.0,16,-2,0,0,1,down,1979-11-17
13332,Prince,1980-03-15,Prince - Prince,7,7,9,3.0,9,Prince,29.0,17,0,-2,0,0,stay,1979-11-17
13333,Prince,1980-03-22,Prince - Prince,9,7,10,3.0,9,Prince,29.0,18,-1,0,-2,1,down,1979-11-17
13334,Prince,1980-03-29,Prince - Prince,9,9,12,3.0,10,Prince,29.0,19,-2,-1,0,1,down,1979-11-17
13335,Prince,1980-04-05,Prince - Prince,10,9,11,3.0,12,Prince,29.0,20,1,-2,-1,1,up,1979-11-17
13336,Prince,1980-04-12,Prince - Prince,12,10,22,3.0,11,Prince,29.0,21,-11,1,-2,1,down,1979-11-17
13337,Prince,1980-04-19,Prince - Prince,11,12,24,3.0,22,Prince,29.0,22,-2,-11,1,1,down,1979-11-17
13338,Prince,1980-04-26,Prince - Prince,22,11,30,3.0,24,Prince,29.0,23,-6,-2,-11,1,down,1979-11-17
13339,Prince,1980-05-03,Prince - Prince,24,22,35,3.0,30,Prince,29.0,24,-5,-6,-2,1,down,1979-11-17
13340,Prince,1980-05-10,Prince - Prince,30,24,46,3.0,35,Prince,29.0,25,-11,-5,-6,1,down,1979-11-17
13341,Prince,1980-05-17,Prince - Prince,35,30,49,3.0,46,Prince,29.0,26,-3,-11,-5,1,down,1979-11-17
13342,Prince,1980-05-24,Prince - Prince,46,35,49,3.0,49,Prince,29.0,27,0,-3,-11,0,stay,1979-11-17
13343,Prince,1980-05-31,Prince - Prince,49,46,50,3.0,49,Prince,29.0,28,-1,0,-3,1,down,1979-11-17
13344,Prince,1980-06-07,Prince - Prince,49,49,51,3.0,50,Prince,29.0,29,-1,-1,0,1,down,1979-11-17
13345,Peaches & Herb,1979-11-17,Peaches & Herb - Twice The Fire,51,51,20,18.0,37,Twice The Fire,6.0,0,17,14,0,1,up,1979-11-17
13346,Peaches & Herb,1979-11-24,Peaches & Herb - Twice The Fire,37,51,18,18.0,20,Twice The Fire,6.0,1,2,17,14,1,up,1979-11-17
13347,Peaches & Herb,1979-12-01,Peaches & Herb - Twice The Fire,20,37,18,18.0,18,Twice The Fire,6.0,2,0,2,17,0,stay,1979-11-17
13348,Peaches & Herb,1979-12-08,Peaches & Herb - Twice The Fire,18,20,30,18.0,18,Twice The Fire,6.0,3,-12,0,2,1,down,1979-11-17
13349,Peaches & Herb,1979-12-15,Peaches & Herb - Twice The Fire,18,18,41,18.0,30,Twice The Fire,6.0,4,-11,-12,0,1,down,1979-11-17
13350,Peaches & Herb,1979-12-22,Peaches & Herb - Twice The Fire,30,18,41,18.0,41,Twice The Fire,6.0,5,0,-11,-12,0,stay,1979-11-17
13351,Peaches & Herb,1979-12-29,Peaches & Herb - Twice The Fire,41,30,51,18.0,41,Twice The Fire,6.0,6,-10,0,-11,1,down,1979-11-17
13352,Rufus And Chaka Khan,1979-11-24,Rufus And Chaka Khan - Masterjam,51,51,10,1.0,11,Masterjam,22.0,0,1,40,0,1,up,1979-11-24
13353,Rufus And Chaka Khan,1979-12-01,Rufus And Chaka Khan - Masterjam,11,51,3,1.0,10,Masterjam,22.0,1,7,1,40,1,up,1979-11-24
13354,Rufus And Chaka Khan,1979-12-08,Rufus And Chaka Khan - Masterjam,10,11,3,1.0,3,Masterjam,22.0,2,0,7,1,0,stay,1979-11-24
13355,Rufus And Chaka Khan,1979-12-15,Rufus And Chaka Khan - Masterjam,3,10,1,1.0,3,Masterjam,22.0,3,2,0,7,1,up,1979-11-24
13356,Rufus And Chaka Khan,1979-12-22,Rufus And Chaka Khan - Masterjam,3,3,1,1.0,1,Masterjam,22.0,4,0,2,0,0,stay,1979-11-24
13357,Rufus And Chaka Khan,1979-12-29,Rufus And Chaka Khan - Masterjam,1,3,2,1.0,1,Masterjam,22.0,5,-1,0,2,1,down,1979-11-24
13358,Rufus And Chaka Khan,1980-01-05,Rufus And Chaka Khan - Masterjam,1,1,2,1.0,2,Masterjam,22.0,6,0,-1,0,0,stay,1979-11-24
13359,Rufus And Chaka Khan,1980-01-12,Rufus And Chaka Khan - Masterjam,2,1,2,1.0,2,Masterjam,22.0,7,0,0,-1,0,stay,1979-11-24
13360,Rufus And Chaka Khan,1980-01-19,Rufus And Chaka Khan - Masterjam,2,2,2,1.0,2,Masterjam,22.0,8,0,0,0,0,stay,1979-11-24
13361,Rufus And Chaka Khan,1980-01-26,Rufus And Chaka Khan - Masterjam,2,2,2,1.0,2,Masterjam,22.0,9,0,0,0,0,stay,1979-11-24
13362,Rufus And Chaka Khan,1980-02-02,Rufus And Chaka Khan - Masterjam,2,2,4,1.0,2,Masterjam,22.0,10,-2,0,0,1,down,1979-11-24
13363,Rufus And Chaka Khan,1980-02-09,Rufus And Chaka Khan - Masterjam,2,2,5,1.0,4,Masterjam,22.0,11,-1,-2,0,1,down,1979-11-24
13364,Rufus And Chaka Khan,1980-02-16,Rufus And Chaka Khan - Masterjam,4,2,8,1.0,5,Masterjam,22.0,12,-3,-1,-2,1,down,1979-11-24
13365,Rufus And Chaka Khan,1980-02-23,Rufus And Chaka Khan - Masterjam,5,4,8,1.0,8,Masterjam,22.0,13,0,-3,-1,0,stay,1979-11-24
13366,Rufus And Chaka Khan,1980-03-01,Rufus And Chaka Khan - Masterjam,8,5,9,1.0,8,Masterjam,22.0,14,-1,0,-3,1,down,1979-11-24
13367,Rufus And Chaka Khan,1980-03-08,Rufus And Chaka Khan - Masterjam,8,8,13,1.0,9,Masterjam,22.0,15,-4,-1,0,1,down,1979-11-24
13368,Rufus And Chaka Khan,1980-03-15,Rufus And Chaka Khan - Masterjam,9,8,17,1.0,13,Masterjam,22.0,16,-4,-4,-1,1,down,1979-11-24
13369,Rufus And Chaka Khan,1980-03-22,Rufus And Chaka Khan - Masterjam,13,9,22,1.0,17,Masterjam,22.0,17,-5,-4,-4,1,down,1979-11-24
13370,Rufus And Chaka Khan,1980-03-29,Rufus And Chaka Khan - Masterjam,17,13,31,1.0,22,Masterjam,22.0,18,-9,-5,-4,1,down,1979-11-24
13371,Rufus And Chaka Khan,1980-04-05,Rufus And Chaka Khan - Masterjam,22,17,33,1.0,31,Masterjam,22.0,19,-2,-9,-5,1,down,1979-11-24
13372,Rufus And Chaka Khan,1980-04-12,Rufus And Chaka Khan - Masterjam,31,22,40,1.0,33,Masterjam,22.0,20,-7,-2,-9,1,down,1979-11-24
13373,Rufus And Chaka Khan,1980-04-19,Rufus And Chaka Khan - Masterjam,33,31,49,1.0,40,Masterjam,22.0,21,-9,-7,-2,1,down,1979-11-24
13374,Rufus And Chaka Khan,1980-04-26,Rufus And Chaka Khan - Masterjam,40,33,51,1.0,49,Masterjam,22.0,22,-2,-9,-7,1,down,1979-11-24
13375,Bob Marley And The Wailers,1979-11-24,Bob Marley And The Wailers - Survival,51,51,32,32.0,38,Survival,3.0,0,6,13,0,1,up,1979-11-24
13376,Bob Marley And The Wailers,1979-12-01,Bob Marley And The Wailers - Survival,38,51,32,32.0,32,Survival,3.0,1,0,6,13,0,stay,1979-11-24
13377,Bob Marley And The Wailers,1979-12-08,Bob Marley And The Wailers - Survival,32,38,35,32.0,32,Survival,3.0,2,-3,0,6,1,down,1979-11-24
13378,Bob Marley And The Wailers,1979-12-15,Bob Marley And The Wailers - Survival,32,32,51,32.0,35,Survival,3.0,3,-16,-3,0,1,down,1979-11-24
13379,Patrice Rushen,1979-11-24,Patrice Rushen - Pizzazz,51,51,30,11.0,42,Pizzazz,20.0,0,12,9,0,1,up,1979-11-24
13380,Patrice Rushen,1979-12-01,Patrice Rushen - Pizzazz,42,51,25,11.0,30,Pizzazz,20.0,1,5,12,9,1,up,1979-11-24
13381,Patrice Rushen,1979-12-08,Patrice Rushen - Pizzazz,30,42,17,11.0,25,Pizzazz,20.0,2,8,5,12,1,up,1979-11-24
13382,Patrice Rushen,1979-12-15,Patrice Rushen - Pizzazz,25,30,14,11.0,17,Pizzazz,20.0,3,3,8,5,1,up,1979-11-24
13383,Patrice Rushen,1979-12-22,Patrice Rushen - Pizzazz,17,25,14,11.0,14,Pizzazz,20.0,4,0,3,8,0,stay,1979-11-24
13384,Patrice Rushen,1979-12-29,Patrice Rushen - Pizzazz,14,17,14,11.0,14,Pizzazz,20.0,5,0,0,3,0,stay,1979-11-24
13385,Patrice Rushen,1980-01-05,Patrice Rushen - Pizzazz,14,14,14,11.0,14,Pizzazz,20.0,6,0,0,0,0,stay,1979-11-24
13386,Patrice Rushen,1980-01-12,Patrice Rushen - Pizzazz,14,14,24,11.0,14,Pizzazz,20.0,7,-10,0,0,1,down,1979-11-24
13387,Patrice Rushen,1980-01-19,Patrice Rushen - Pizzazz,14,14,21,11.0,24,Pizzazz,20.0,8,3,-10,0,1,up,1979-11-24
13388,Patrice Rushen,1980-01-26,Patrice Rushen - Pizzazz,24,14,20,11.0,21,Pizzazz,20.0,9,1,3,-10,1,up,1979-11-24
13389,Patrice Rushen,1980-02-02,Patrice Rushen - Pizzazz,21,24,19,11.0,20,Pizzazz,20.0,10,1,1,3,1,up,1979-11-24
13390,Patrice Rushen,1980-02-09,Patrice Rushen - Pizzazz,20,21,16,11.0,19,Pizzazz,20.0,11,3,1,1,1,up,1979-11-24
13391,Patrice Rushen,1980-02-16,Patrice Rushen - Pizzazz,19,20,11,11.0,16,Pizzazz,20.0,12,5,3,1,1,up,1979-11-24
13392,Patrice Rushen,1980-02-23,Patrice Rushen - Pizzazz,16,19,11,11.0,11,Pizzazz,20.0,13,0,5,3,0,stay,1979-11-24
13393,Patrice Rushen,1980-03-01,Patrice Rushen - Pizzazz,11,16,13,11.0,11,Pizzazz,20.0,14,-2,0,5,1,down,1979-11-24
13394,Patrice Rushen,1980-03-08,Patrice Rushen - Pizzazz,11,11,17,11.0,13,Pizzazz,20.0,15,-4,-2,0,1,down,1979-11-24
13395,Patrice Rushen,1980-03-15,Patrice Rushen - Pizzazz,13,11,25,11.0,17,Pizzazz,20.0,16,-8,-4,-2,1,down,1979-11-24
13396,Patrice Rushen,1980-03-22,Patrice Rushen - Pizzazz,17,13,30,11.0,25,Pizzazz,20.0,17,-5,-8,-4,1,down,1979-11-24
13397,Patrice Rushen,1980-03-29,Patrice Rushen - Pizzazz,25,17,32,11.0,30,Pizzazz,20.0,18,-2,-5,-8,1,down,1979-11-24
13398,Patrice Rushen,1980-04-05,Patrice Rushen - Pizzazz,30,25,34,11.0,32,Pizzazz,20.0,19,-2,-2,-5,1,down,1979-11-24
13399,Patrice Rushen,1980-04-12,Patrice Rushen - Pizzazz,32,30,51,11.0,34,Pizzazz,20.0,20,-17,-2,-2,1,down,1979-11-24
13400,George Duke,1979-11-24,George Duke - Master Of The Game,51,51,35,18.0,48,Master Of The Game,15.0,0,13,3,0,1,up,1979-11-24
13401,George Duke,1979-12-01,George Duke - Master Of The Game,48,51,23,18.0,35,Master Of The Game,15.0,1,12,13,3,1,up,1979-11-24
13402,George Duke,1979-12-08,George Duke - Master Of The Game,35,48,18,18.0,23,Master Of The Game,15.0,2,5,12,13,1,up,1979-11-24
13403,George Duke,1979-12-15,George Duke - Master Of The Game,23,35,18,18.0,18,Master Of The Game,15.0,3,0,5,12,0,stay,1979-11-24
13404,George Duke,1979-12-22,George Duke - Master Of The Game,18,23,18,18.0,18,Master Of The Game,15.0,4,0,0,5,0,stay,1979-11-24
13405,George Duke,1979-12-29,George Duke - Master Of The Game,18,18,29,18.0,18,Master Of The Game,15.0,5,-11,0,0,1,down,1979-11-24
13406,George Duke,1980-01-05,George Duke - Master Of The Game,18,18,33,18.0,29,Master Of The Game,15.0,6,-4,-11,0,1,down,1979-11-24
13407,George Duke,1980-01-12,George Duke - Master Of The Game,29,18,34,18.0,33,Master Of The Game,15.0,7,-1,-4,-11,1,down,1979-11-24
13408,George Duke,1980-01-19,George Duke - Master Of The Game,33,29,35,18.0,34,Master Of The Game,15.0,8,-1,-1,-4,1,down,1979-11-24
13409,George Duke,1980-01-26,George Duke - Master Of The Game,34,33,34,18.0,35,Master Of The Game,15.0,9,1,-1,-1,1,up,1979-11-24
13410,George Duke,1980-02-02,George Duke - Master Of The Game,35,34,34,18.0,34,Master Of The Game,15.0,10,0,1,-1,0,stay,1979-11-24
13411,George Duke,1980-02-09,George Duke - Master Of The Game,34,35,32,18.0,34,Master Of The Game,15.0,11,2,0,1,1,up,1979-11-24
13412,George Duke,1980-02-16,George Duke - Master Of The Game,34,34,32,18.0,32,Master Of The Game,15.0,12,0,2,0,0,stay,1979-11-24
13413,George Duke,1980-02-23,George Duke - Master Of The Game,32,34,33,18.0,32,Master Of The Game,15.0,13,-1,0,2,1,down,1979-11-24
13414,George Duke,1980-03-01,George Duke - Master Of The Game,32,32,44,18.0,33,Master Of The Game,15.0,14,-11,-1,0,1,down,1979-11-24
13415,George Duke,1980-03-08,George Duke - Master Of The Game,33,32,51,18.0,44,Master Of The Game,15.0,15,-7,-11,-1,1,down,1979-11-24
13416,Stevie Wonder,1979-12-01,Stevie Wonder - Journey Through The Secret Life Of Plants,51,51,6,4.0,7,Journey Through The Secret Life Of Plants,15.0,0,1,44,0,1,up,1979-12-01
13417,Stevie Wonder,1979-12-08,Stevie Wonder - Journey Through The Secret Life Of Plants,7,51,5,4.0,6,Journey Through The Secret Life Of Plants,15.0,1,1,1,44,1,up,1979-12-01
13418,Stevie Wonder,1979-12-15,Stevie Wonder - Journey Through The Secret Life Of Plants,6,7,4,4.0,5,Journey Through The Secret Life Of Plants,15.0,2,1,1,1,1,up,1979-12-01
13419,Stevie Wonder,1979-12-22,Stevie Wonder - Journey Through The Secret Life Of Plants,5,6,4,4.0,4,Journey Through The Secret Life Of Plants,15.0,3,0,1,1,0,stay,1979-12-01
13420,Stevie Wonder,1979-12-29,Stevie Wonder - Journey Through The Secret Life Of Plants,4,5,4,4.0,4,Journey Through The Secret Life Of Plants,15.0,4,0,0,1,0,stay,1979-12-01
13421,Stevie Wonder,1980-01-05,Stevie Wonder - Journey Through The Secret Life Of Plants,4,4,4,4.0,4,Journey Through The Secret Life Of Plants,15.0,5,0,0,0,0,stay,1979-12-01
13422,Stevie Wonder,1980-01-12,Stevie Wonder - Journey Through The Secret Life Of Plants,4,4,8,4.0,4,Journey Through The Secret Life Of Plants,15.0,6,-4,0,0,1,down,1979-12-01
13423,Stevie Wonder,1980-01-19,Stevie Wonder - Journey Through The Secret Life Of Plants,4,4,18,4.0,8,Journey Through The Secret Life Of Plants,15.0,7,-10,-4,0,1,down,1979-12-01
13424,Stevie Wonder,1980-01-26,Stevie Wonder - Journey Through The Secret Life Of Plants,8,4,19,4.0,18,Journey Through The Secret Life Of Plants,15.0,8,-1,-10,-4,1,down,1979-12-01
13425,Stevie Wonder,1980-02-02,Stevie Wonder - Journey Through The Secret Life Of Plants,18,8,21,4.0,19,Journey Through The Secret Life Of Plants,15.0,9,-2,-1,-10,1,down,1979-12-01
13426,Stevie Wonder,1980-02-09,Stevie Wonder - Journey Through The Secret Life Of Plants,19,18,31,4.0,21,Journey Through The Secret Life Of Plants,15.0,10,-10,-2,-1,1,down,1979-12-01
13427,Stevie Wonder,1980-02-16,Stevie Wonder - Journey Through The Secret Life Of Plants,21,19,31,4.0,31,Journey Through The Secret Life Of Plants,15.0,11,0,-10,-2,0,stay,1979-12-01
13428,Stevie Wonder,1980-02-23,Stevie Wonder - Journey Through The Secret Life Of Plants,31,21,32,4.0,31,Journey Through The Secret Life Of Plants,15.0,12,-1,0,-10,1,down,1979-12-01
13429,Stevie Wonder,1980-03-01,Stevie Wonder - Journey Through The Secret Life Of Plants,31,31,34,4.0,32,Journey Through The Secret Life Of Plants,15.0,13,-2,-1,0,1,down,1979-12-01
13430,Stevie Wonder,1980-03-08,Stevie Wonder - Journey Through The Secret Life Of Plants,32,31,44,4.0,34,Journey Through The Secret Life Of Plants,15.0,14,-10,-2,-1,1,down,1979-12-01
13431,Stevie Wonder,1980-03-15,Stevie Wonder - Journey Through The Secret Life Of Plants,34,32,51,4.0,44,Journey Through The Secret Life Of Plants,15.0,15,-7,-10,-2,1,down,1979-12-01
13432,Phyllis Hyman,1979-12-01,Phyllis Hyman - You Know How To Love Me,51,51,16,10.0,36,You Know How To Love Me,19.0,0,20,15,0,1,up,1979-12-01
13433,Phyllis Hyman,1979-12-08,Phyllis Hyman - You Know How To Love Me,36,51,13,10.0,16,You Know How To Love Me,19.0,1,3,20,15,1,up,1979-12-01
13434,Phyllis Hyman,1979-12-15,Phyllis Hyman - You Know How To Love Me,16,36,11,10.0,13,You Know How To Love Me,19.0,2,2,3,20,1,up,1979-12-01
13435,Phyllis Hyman,1979-12-22,Phyllis Hyman - You Know How To Love Me,13,16,11,10.0,11,You Know How To Love Me,19.0,3,0,2,3,0,stay,1979-12-01
13436,Phyllis Hyman,1979-12-29,Phyllis Hyman - You Know How To Love Me,11,13,10,10.0,11,You Know How To Love Me,19.0,4,1,0,2,1,up,1979-12-01
13437,Phyllis Hyman,1980-01-05,Phyllis Hyman - You Know How To Love Me,11,11,10,10.0,10,You Know How To Love Me,19.0,5,0,1,0,0,stay,1979-12-01
13438,Phyllis Hyman,1980-01-12,Phyllis Hyman - You Know How To Love Me,10,11,16,10.0,10,You Know How To Love Me,19.0,6,-6,0,1,1,down,1979-12-01
13439,Phyllis Hyman,1980-01-19,Phyllis Hyman - You Know How To Love Me,10,10,11,10.0,16,You Know How To Love Me,19.0,7,5,-6,0,1,up,1979-12-01
13440,Phyllis Hyman,1980-01-26,Phyllis Hyman - You Know How To Love Me,16,10,11,10.0,11,You Know How To Love Me,19.0,8,0,5,-6,0,stay,1979-12-01
13441,Phyllis Hyman,1980-02-02,Phyllis Hyman - You Know How To Love Me,11,16,10,10.0,11,You Know How To Love Me,19.0,9,1,0,5,1,up,1979-12-01
13442,Phyllis Hyman,1980-02-09,Phyllis Hyman - You Know How To Love Me,11,11,14,10.0,10,You Know How To Love Me,19.0,10,-4,1,0,1,down,1979-12-01
13443,Phyllis Hyman,1980-02-16,Phyllis Hyman - You Know How To Love Me,10,11,16,10.0,14,You Know How To Love Me,19.0,11,-2,-4,1,1,down,1979-12-01
13444,Phyllis Hyman,1980-02-23,Phyllis Hyman - You Know How To Love Me,14,10,18,10.0,16,You Know How To Love Me,19.0,12,-2,-2,-4,1,down,1979-12-01
13445,Phyllis Hyman,1980-03-01,Phyllis Hyman - You Know How To Love Me,16,14,21,10.0,18,You Know How To Love Me,19.0,13,-3,-2,-2,1,down,1979-12-01
13446,Phyllis Hyman,1980-03-08,Phyllis Hyman - You Know How To Love Me,18,16,27,10.0,21,You Know How To Love Me,19.0,14,-6,-3,-2,1,down,1979-12-01
13447,Phyllis Hyman,1980-03-15,Phyllis Hyman - You Know How To Love Me,21,18,30,10.0,27,You Know How To Love Me,19.0,15,-3,-6,-3,1,down,1979-12-01
13448,Phyllis Hyman,1980-03-22,Phyllis Hyman - You Know How To Love Me,27,21,34,10.0,30,You Know How To Love Me,19.0,16,-4,-3,-6,1,down,1979-12-01
13449,Phyllis Hyman,1980-03-29,Phyllis Hyman - You Know How To Love Me,30,27,38,10.0,34,You Know How To Love Me,19.0,17,-4,-4,-3,1,down,1979-12-01
13450,Phyllis Hyman,1980-04-05,Phyllis Hyman - You Know How To Love Me,34,30,43,10.0,38,You Know How To Love Me,19.0,18,-5,-4,-4,1,down,1979-12-01
13451,Phyllis Hyman,1980-04-12,Phyllis Hyman - You Know How To Love Me,38,34,51,10.0,43,You Know How To Love Me,19.0,19,-8,-5,-4,1,down,1979-12-01
13452,Instant Funk,1979-12-01,Instant Funk - Witch Doctor,51,51,27,23.0,47,Witch Doctor,11.0,0,20,4,0,1,up,1979-12-01
13453,Instant Funk,1979-12-08,Instant Funk - Witch Doctor,47,51,23,23.0,27,Witch Doctor,11.0,1,4,20,4,1,up,1979-12-01
13454,Instant Funk,1979-12-15,Instant Funk - Witch Doctor,27,47,23,23.0,23,Witch Doctor,11.0,2,0,4,20,0,stay,1979-12-01
13455,Instant Funk,1979-12-22,Instant Funk - Witch Doctor,23,27,23,23.0,23,Witch Doctor,11.0,3,0,0,4,0,stay,1979-12-01
13456,Instant Funk,1979-12-29,Instant Funk - Witch Doctor,23,23,31,23.0,23,Witch Doctor,11.0,4,-8,0,0,1,down,1979-12-01
13457,Instant Funk,1980-01-05,Instant Funk - Witch Doctor,23,23,35,23.0,31,Witch Doctor,11.0,5,-4,-8,0,1,down,1979-12-01
13458,Instant Funk,1980-01-12,Instant Funk - Witch Doctor,31,23,39,23.0,35,Witch Doctor,11.0,6,-4,-4,-8,1,down,1979-12-01
13459,Instant Funk,1980-01-19,Instant Funk - Witch Doctor,35,31,40,23.0,39,Witch Doctor,11.0,7,-1,-4,-4,1,down,1979-12-01
13460,Instant Funk,1980-01-26,Instant Funk - Witch Doctor,39,35,44,23.0,40,Witch Doctor,11.0,8,-4,-1,-4,1,down,1979-12-01
13461,Instant Funk,1980-02-02,Instant Funk - Witch Doctor,40,39,44,23.0,44,Witch Doctor,11.0,9,0,-4,-1,0,stay,1979-12-01
13462,Instant Funk,1980-02-09,Instant Funk - Witch Doctor,44,40,49,23.0,44,Witch Doctor,11.0,10,-5,0,-4,1,down,1979-12-01
13463,Instant Funk,1980-02-16,Instant Funk - Witch Doctor,44,44,51,23.0,49,Witch Doctor,11.0,11,-2,-5,0,1,down,1979-12-01
13464,The Whispers,1979-12-01,The Whispers - Happy Holidays To You,51,51,50,50.0,50,Happy Holidays To You,1.0,0,0,1,0,0,stay,1979-12-01
13465,The Whispers,1979-12-08,The Whispers - Happy Holidays To You,50,51,51,50.0,50,Happy Holidays To You,1.0,1,-1,0,1,1,down,1979-12-01
13466,Slave,1979-12-08,Slave - Just A Touch Of Love,51,51,24,11.0,30,Just A Touch Of Love,17.0,0,6,21,0,1,up,1979-12-08
13467,Slave,1979-12-15,Slave - Just A Touch Of Love,30,51,20,11.0,24,Just A Touch Of Love,17.0,1,4,6,21,1,up,1979-12-08
13468,Slave,1979-12-22,Slave - Just A Touch Of Love,24,30,20,11.0,20,Just A Touch Of Love,17.0,2,0,4,6,0,stay,1979-12-08
13469,Slave,1979-12-29,Slave - Just A Touch Of Love,20,24,18,11.0,20,Just A Touch Of Love,17.0,3,2,0,4,1,up,1979-12-08
13470,Slave,1980-01-05,Slave - Just A Touch Of Love,20,20,16,11.0,18,Just A Touch Of Love,17.0,4,2,2,0,1,up,1979-12-08
13471,Slave,1980-01-12,Slave - Just A Touch Of Love,18,20,14,11.0,16,Just A Touch Of Love,17.0,5,2,2,2,1,up,1979-12-08
13472,Slave,1980-01-19,Slave - Just A Touch Of Love,16,18,13,11.0,14,Just A Touch Of Love,17.0,6,1,2,2,1,up,1979-12-08
13473,Slave,1980-01-26,Slave - Just A Touch Of Love,14,16,13,11.0,13,Just A Touch Of Love,17.0,7,0,1,2,0,stay,1979-12-08
13474,Slave,1980-02-02,Slave - Just A Touch Of Love,13,14,11,11.0,13,Just A Touch Of Love,17.0,8,2,0,1,1,up,1979-12-08
13475,Slave,1980-02-09,Slave - Just A Touch Of Love,13,13,11,11.0,11,Just A Touch Of Love,17.0,9,0,2,0,0,stay,1979-12-08
13476,Slave,1980-02-16,Slave - Just A Touch Of Love,11,13,14,11.0,11,Just A Touch Of Love,17.0,10,-3,0,2,1,down,1979-12-08
13477,Slave,1980-02-23,Slave - Just A Touch Of Love,11,11,16,11.0,14,Just A Touch Of Love,17.0,11,-2,-3,0,1,down,1979-12-08
13478,Slave,1980-03-01,Slave - Just A Touch Of Love,14,11,17,11.0,16,Just A Touch Of Love,17.0,12,-1,-2,-3,1,down,1979-12-08
13479,Slave,1980-03-08,Slave - Just A Touch Of Love,16,14,24,11.0,17,Just A Touch Of Love,17.0,13,-7,-1,-2,1,down,1979-12-08
13480,Slave,1980-03-15,Slave - Just A Touch Of Love,17,16,37,11.0,24,Just A Touch Of Love,17.0,14,-13,-7,-1,1,down,1979-12-08
13481,Slave,1980-03-22,Slave - Just A Touch Of Love,24,17,37,11.0,37,Just A Touch Of Love,17.0,15,0,-13,-7,0,stay,1979-12-08
13482,Slave,1980-03-29,Slave - Just A Touch Of Love,37,24,47,11.0,37,Just A Touch Of Love,17.0,16,-10,0,-13,1,down,1979-12-08
13483,Slave,1980-04-05,Slave - Just A Touch Of Love,37,37,51,11.0,47,Just A Touch Of Love,17.0,17,-4,-10,0,1,down,1979-12-08
13484,Sylvester,1979-12-08,Sylvester - Living Proof,51,51,45,45.0,47,Living Proof,1.0,0,2,4,0,1,up,1979-12-08
13485,Sylvester,1979-12-15,Sylvester - Living Proof,47,51,51,45.0,45,Living Proof,1.0,1,-6,2,4,1,down,1979-12-08
13486,Linda Clifford,1979-12-08,Linda Clifford - Here's My Love,51,51,47,47.0,48,Here's My Love,1.0,0,1,3,0,1,up,1979-12-08
13487,Linda Clifford,1979-12-15,Linda Clifford - Here's My Love,48,51,51,47.0,47,Here's My Love,1.0,1,-4,1,3,1,down,1979-12-08
13488,Captain Sky,1979-12-08,Captain Sky - Pop Goes The Captain,51,51,49,49.0,49,Pop Goes The Captain,1.0,0,0,2,0,0,stay,1979-12-08
13489,Captain Sky,1979-12-15,Captain Sky - Pop Goes The Captain,49,51,51,49.0,49,Pop Goes The Captain,1.0,1,-2,0,2,1,down,1979-12-08
13490,Natalie Cole And Peabo Bryson,1979-12-15,Natalie Cole And Peabo Bryson - We're The Best Of Friends,51,51,13,7.0,32,We're The Best Of Friends,16.0,0,19,19,0,1,up,1979-12-15
13491,Natalie Cole And Peabo Bryson,1979-12-22,Natalie Cole And Peabo Bryson - We're The Best Of Friends,32,51,13,7.0,13,We're The Best Of Friends,16.0,1,0,19,19,0,stay,1979-12-15
13492,Natalie Cole And Peabo Bryson,1979-12-29,Natalie Cole And Peabo Bryson - We're The Best Of Friends,13,32,9,7.0,13,We're The Best Of Friends,16.0,2,4,0,19,1,up,1979-12-15
13493,Natalie Cole And Peabo Bryson,1980-01-05,Natalie Cole And Peabo Bryson - We're The Best Of Friends,13,13,8,7.0,9,We're The Best Of Friends,16.0,3,1,4,0,1,up,1979-12-15
13494,Natalie Cole And Peabo Bryson,1980-01-12,Natalie Cole And Peabo Bryson - We're The Best Of Friends,9,13,7,7.0,8,We're The Best Of Friends,16.0,4,1,1,4,1,up,1979-12-15
13495,Natalie Cole And Peabo Bryson,1980-01-19,Natalie Cole And Peabo Bryson - We're The Best Of Friends,8,9,7,7.0,7,We're The Best Of Friends,16.0,5,0,1,1,0,stay,1979-12-15
13496,Natalie Cole And Peabo Bryson,1980-01-26,Natalie Cole And Peabo Bryson - We're The Best Of Friends,7,8,10,7.0,7,We're The Best Of Friends,16.0,6,-3,0,1,1,down,1979-12-15
13497,Natalie Cole And Peabo Bryson,1980-02-02,Natalie Cole And Peabo Bryson - We're The Best Of Friends,7,7,20,7.0,10,We're The Best Of Friends,16.0,7,-10,-3,0,1,down,1979-12-15
13498,Natalie Cole And Peabo Bryson,1980-02-09,Natalie Cole And Peabo Bryson - We're The Best Of Friends,10,7,20,7.0,20,We're The Best Of Friends,16.0,8,0,-10,-3,0,stay,1979-12-15
13499,Natalie Cole And Peabo Bryson,1980-02-16,Natalie Cole And Peabo Bryson - We're The Best Of Friends,20,10,17,7.0,20,We're The Best Of Friends,16.0,9,3,0,-10,1,up,1979-12-15
13500,Natalie Cole And Peabo Bryson,1980-02-23,Natalie Cole And Peabo Bryson - We're The Best Of Friends,20,20,17,7.0,17,We're The Best Of Friends,16.0,10,0,3,0,0,stay,1979-12-15
13501,Natalie Cole And Peabo Bryson,1980-03-01,Natalie Cole And Peabo Bryson - We're The Best Of Friends,17,20,18,7.0,17,We're The Best Of Friends,16.0,11,-1,0,3,1,down,1979-12-15
13502,Natalie Cole And Peabo Bryson,1980-03-08,Natalie Cole And Peabo Bryson - We're The Best Of Friends,17,17,20,7.0,18,We're The Best Of Friends,16.0,12,-2,-1,0,1,down,1979-12-15
13503,Natalie Cole And Peabo Bryson,1980-03-15,Natalie Cole And Peabo Bryson - We're The Best Of Friends,18,17,29,7.0,20,We're The Best Of Friends,16.0,13,-9,-2,-1,1,down,1979-12-15
13504,Natalie Cole And Peabo Bryson,1980-03-22,Natalie Cole And Peabo Bryson - We're The Best Of Friends,20,18,31,7.0,29,We're The Best Of Friends,16.0,14,-2,-9,-2,1,down,1979-12-15
13505,Natalie Cole And Peabo Bryson,1980-03-29,Natalie Cole And Peabo Bryson - We're The Best Of Friends,29,20,34,7.0,31,We're The Best Of Friends,16.0,15,-3,-2,-9,1,down,1979-12-15
13506,Natalie Cole And Peabo Bryson,1980-04-05,Natalie Cole And Peabo Bryson - We're The Best Of Friends,31,29,51,7.0,34,We're The Best Of Friends,16.0,16,-17,-3,-2,1,down,1979-12-15
13507,Brass Construction,1979-12-15,Brass Construction - Brass Construction 5,51,51,34,18.0,44,Brass Construction 5,22.0,0,10,7,0,1,up,1979-12-15
13508,Brass Construction,1979-12-22,Brass Construction - Brass Construction 5,44,51,34,18.0,34,Brass Construction 5,22.0,1,0,10,7,0,stay,1979-12-15
13509,Brass Construction,1979-12-29,Brass Construction - Brass Construction 5,34,44,24,18.0,34,Brass Construction 5,22.0,2,10,0,10,1,up,1979-12-15
13510,Brass Construction,1980-01-05,Brass Construction - Brass Construction 5,34,34,23,18.0,24,Brass Construction 5,22.0,3,1,10,0,1,up,1979-12-15
13511,Brass Construction,1980-01-12,Brass Construction - Brass Construction 5,24,34,27,18.0,23,Brass Construction 5,22.0,4,-4,1,10,1,down,1979-12-15
13512,Brass Construction,1980-01-19,Brass Construction - Brass Construction 5,23,24,29,18.0,27,Brass Construction 5,22.0,5,-2,-4,1,1,down,1979-12-15
13513,Brass Construction,1980-01-26,Brass Construction - Brass Construction 5,27,23,29,18.0,29,Brass Construction 5,22.0,6,0,-2,-4,0,stay,1979-12-15
13514,Brass Construction,1980-02-02,Brass Construction - Brass Construction 5,29,27,28,18.0,29,Brass Construction 5,22.0,7,1,0,-2,1,up,1979-12-15
13515,Brass Construction,1980-02-09,Brass Construction - Brass Construction 5,29,29,26,18.0,28,Brass Construction 5,22.0,8,2,1,0,1,up,1979-12-15
13516,Brass Construction,1980-02-16,Brass Construction - Brass Construction 5,28,29,21,18.0,26,Brass Construction 5,22.0,9,5,2,1,1,up,1979-12-15
13517,Brass Construction,1980-02-23,Brass Construction - Brass Construction 5,26,28,20,18.0,21,Brass Construction 5,22.0,10,1,5,2,1,up,1979-12-15
13518,Brass Construction,1980-03-01,Brass Construction - Brass Construction 5,21,26,19,18.0,20,Brass Construction 5,22.0,11,1,1,5,1,up,1979-12-15
13519,Brass Construction,1980-03-08,Brass Construction - Brass Construction 5,20,21,18,18.0,19,Brass Construction 5,22.0,12,1,1,1,1,up,1979-12-15
13520,Brass Construction,1980-03-15,Brass Construction - Brass Construction 5,19,20,19,18.0,18,Brass Construction 5,22.0,13,-1,1,1,1,down,1979-12-15
13521,Brass Construction,1980-03-22,Brass Construction - Brass Construction 5,18,19,21,18.0,19,Brass Construction 5,22.0,14,-2,-1,1,1,down,1979-12-15
13522,Brass Construction,1980-03-29,Brass Construction - Brass Construction 5,19,18,30,18.0,21,Brass Construction 5,22.0,15,-9,-2,-1,1,down,1979-12-15
13523,Brass Construction,1980-04-05,Brass Construction - Brass Construction 5,21,19,31,18.0,30,Brass Construction 5,22.0,16,-1,-9,-2,1,down,1979-12-15
13524,Brass Construction,1980-04-12,Brass Construction - Brass Construction 5,30,21,35,18.0,31,Brass Construction 5,22.0,17,-4,-1,-9,1,down,1979-12-15
13525,Brass Construction,1980-04-19,Brass Construction - Brass Construction 5,31,30,36,18.0,35,Brass Construction 5,22.0,18,-1,-4,-1,1,down,1979-12-15
13526,Brass Construction,1980-04-26,Brass Construction - Brass Construction 5,35,31,39,18.0,36,Brass Construction 5,22.0,19,-3,-1,-4,1,down,1979-12-15
13527,Brass Construction,1980-05-03,Brass Construction - Brass Construction 5,36,35,45,18.0,39,Brass Construction 5,22.0,20,-6,-3,-1,1,down,1979-12-15
13528,Brass Construction,1980-05-10,Brass Construction - Brass Construction 5,39,36,47,18.0,45,Brass Construction 5,22.0,21,-2,-6,-3,1,down,1979-12-15
13529,Brass Construction,1980-05-17,Brass Construction - Brass Construction 5,45,39,51,18.0,47,Brass Construction 5,22.0,22,-4,-2,-6,1,down,1979-12-15
13530,The Emotions,1979-12-15,The Emotions - Come Into My World,51,51,35,35.0,50,Come Into My World,8.0,0,15,1,0,1,up,1979-12-15
13531,The Emotions,1979-12-22,The Emotions - Come Into My World,50,51,35,35.0,35,Come Into My World,8.0,1,0,15,1,0,stay,1979-12-15
13532,The Emotions,1979-12-29,The Emotions - Come Into My World,35,50,35,35.0,35,Come Into My World,8.0,2,0,0,15,0,stay,1979-12-15
13533,The Emotions,1980-01-05,The Emotions - Come Into My World,35,35,39,35.0,35,Come Into My World,8.0,3,-4,0,0,1,down,1979-12-15
13534,The Emotions,1980-01-12,The Emotions - Come Into My World,35,35,41,35.0,39,Come Into My World,8.0,4,-2,-4,0,1,down,1979-12-15
13535,The Emotions,1980-01-19,The Emotions - Come Into My World,39,35,41,35.0,41,Come Into My World,8.0,5,0,-2,-4,0,stay,1979-12-15
13536,The Emotions,1980-01-26,The Emotions - Come Into My World,41,39,43,35.0,41,Come Into My World,8.0,6,-2,0,-2,1,down,1979-12-15
13537,The Emotions,1980-02-02,The Emotions - Come Into My World,41,41,45,35.0,43,Come Into My World,8.0,7,-2,-2,0,1,down,1979-12-15
13538,The Emotions,1980-02-09,The Emotions - Come Into My World,43,41,51,35.0,45,Come Into My World,8.0,8,-6,-2,-2,1,down,1979-12-15
13539,Teddy Pendergrass,1979-12-22,Teddy Pendergrass - Teddy Live! Coast To Coast,51,51,29,5.0,29,Teddy Live! Coast To Coast,15.0,0,0,22,0,0,stay,1979-12-22
13540,Teddy Pendergrass,1979-12-29,Teddy Pendergrass - Teddy Live! Coast To Coast,29,51,8,5.0,29,Teddy Live! Coast To Coast,15.0,1,21,0,22,1,up,1979-12-22
13541,Teddy Pendergrass,1980-01-05,Teddy Pendergrass - Teddy Live! Coast To Coast,29,29,7,5.0,8,Teddy Live! Coast To Coast,15.0,2,1,21,0,1,up,1979-12-22
13542,Teddy Pendergrass,1980-01-12,Teddy Pendergrass - Teddy Live! Coast To Coast,8,29,6,5.0,7,Teddy Live! Coast To Coast,15.0,3,1,1,21,1,up,1979-12-22
13543,Teddy Pendergrass,1980-01-19,Teddy Pendergrass - Teddy Live! Coast To Coast,7,8,5,5.0,6,Teddy Live! Coast To Coast,15.0,4,1,1,1,1,up,1979-12-22
13544,Teddy Pendergrass,1980-01-26,Teddy Pendergrass - Teddy Live! Coast To Coast,6,7,5,5.0,5,Teddy Live! Coast To Coast,15.0,5,0,1,1,0,stay,1979-12-22
13545,Teddy Pendergrass,1980-02-02,Teddy Pendergrass - Teddy Live! Coast To Coast,5,6,13,5.0,5,Teddy Live! Coast To Coast,15.0,6,-8,0,1,1,down,1979-12-22
13546,Teddy Pendergrass,1980-02-09,Teddy Pendergrass - Teddy Live! Coast To Coast,5,5,17,5.0,13,Teddy Live! Coast To Coast,15.0,7,-4,-8,0,1,down,1979-12-22
13547,Teddy Pendergrass,1980-02-16,Teddy Pendergrass - Teddy Live! Coast To Coast,13,5,24,5.0,17,Teddy Live! Coast To Coast,15.0,8,-7,-4,-8,1,down,1979-12-22
13548,Teddy Pendergrass,1980-02-23,Teddy Pendergrass - Teddy Live! Coast To Coast,17,13,24,5.0,24,Teddy Live! Coast To Coast,15.0,9,0,-7,-4,0,stay,1979-12-22
13549,Teddy Pendergrass,1980-03-01,Teddy Pendergrass - Teddy Live! Coast To Coast,24,17,25,5.0,24,Teddy Live! Coast To Coast,15.0,10,-1,0,-7,1,down,1979-12-22
13550,Teddy Pendergrass,1980-03-08,Teddy Pendergrass - Teddy Live! Coast To Coast,24,24,28,5.0,25,Teddy Live! Coast To Coast,15.0,11,-3,-1,0,1,down,1979-12-22
13551,Teddy Pendergrass,1980-03-15,Teddy Pendergrass - Teddy Live! Coast To Coast,25,24,36,5.0,28,Teddy Live! Coast To Coast,15.0,12,-8,-3,-1,1,down,1979-12-22
13552,Teddy Pendergrass,1980-03-22,Teddy Pendergrass - Teddy Live! Coast To Coast,28,25,39,5.0,36,Teddy Live! Coast To Coast,15.0,13,-3,-8,-3,1,down,1979-12-22
13553,Teddy Pendergrass,1980-03-29,Teddy Pendergrass - Teddy Live! Coast To Coast,36,28,42,5.0,39,Teddy Live! Coast To Coast,15.0,14,-3,-3,-8,1,down,1979-12-22
13554,Teddy Pendergrass,1980-04-05,Teddy Pendergrass - Teddy Live! Coast To Coast,39,36,51,5.0,42,Teddy Live! Coast To Coast,15.0,15,-9,-3,-3,1,down,1979-12-22
13555,Twennynine Featuring Lenny White,1979-12-22,Twennynine Featuring Lenny White - Best Of Friends,51,51,30,15.0,30,Best Of Friends,14.0,0,0,21,0,0,stay,1979-12-22
13556,Twennynine Featuring Lenny White,1979-12-29,Twennynine Featuring Lenny White - Best Of Friends,30,51,15,15.0,30,Best Of Friends,14.0,1,15,0,21,1,up,1979-12-22
13557,Twennynine Featuring Lenny White,1980-01-05,Twennynine Featuring Lenny White - Best Of Friends,30,30,15,15.0,15,Best Of Friends,14.0,2,0,15,0,0,stay,1979-12-22
13558,Twennynine Featuring Lenny White,1980-01-12,Twennynine Featuring Lenny White - Best Of Friends,15,30,15,15.0,15,Best Of Friends,14.0,3,0,0,15,0,stay,1979-12-22
13559,Twennynine Featuring Lenny White,1980-01-19,Twennynine Featuring Lenny White - Best Of Friends,15,15,15,15.0,15,Best Of Friends,14.0,4,0,0,0,0,stay,1979-12-22
13560,Twennynine Featuring Lenny White,1980-01-26,Twennynine Featuring Lenny White - Best Of Friends,15,15,22,15.0,15,Best Of Friends,14.0,5,-7,0,0,1,down,1979-12-22
13561,Twennynine Featuring Lenny White,1980-02-02,Twennynine Featuring Lenny White - Best Of Friends,15,15,22,15.0,22,Best Of Friends,14.0,6,0,-7,0,0,stay,1979-12-22
13562,Twennynine Featuring Lenny White,1980-02-09,Twennynine Featuring Lenny White - Best Of Friends,22,15,22,15.0,22,Best Of Friends,14.0,7,0,0,-7,0,stay,1979-12-22
13563,Twennynine Featuring Lenny White,1980-02-16,Twennynine Featuring Lenny White - Best Of Friends,22,22,26,15.0,22,Best Of Friends,14.0,8,-4,0,0,1,down,1979-12-22
13564,Twennynine Featuring Lenny White,1980-02-23,Twennynine Featuring Lenny White - Best Of Friends,22,22,28,15.0,26,Best Of Friends,14.0,9,-2,-4,0,1,down,1979-12-22
13565,Twennynine Featuring Lenny White,1980-03-01,Twennynine Featuring Lenny White - Best Of Friends,26,22,28,15.0,28,Best Of Friends,14.0,10,0,-2,-4,0,stay,1979-12-22
13566,Twennynine Featuring Lenny White,1980-03-08,Twennynine Featuring Lenny White - Best Of Friends,28,26,35,15.0,28,Best Of Friends,14.0,11,-7,0,-2,1,down,1979-12-22
13567,Twennynine Featuring Lenny White,1980-03-15,Twennynine Featuring Lenny White - Best Of Friends,28,28,42,15.0,35,Best Of Friends,14.0,12,-7,-7,0,1,down,1979-12-22
13568,Twennynine Featuring Lenny White,1980-03-22,Twennynine Featuring Lenny White - Best Of Friends,35,28,49,15.0,42,Best Of Friends,14.0,13,-7,-7,-7,1,down,1979-12-22
13569,Twennynine Featuring Lenny White,1980-03-29,Twennynine Featuring Lenny White - Best Of Friends,42,35,51,15.0,49,Best Of Friends,14.0,14,-2,-7,-7,1,down,1979-12-22
13570,War,1979-12-22,War - The Music Band 2,51,51,36,34.0,36,The Music Band 2,11.0,0,0,15,0,0,stay,1979-12-22
13571,War,1979-12-29,War - The Music Band 2,36,51,34,34.0,36,The Music Band 2,11.0,1,2,0,15,1,up,1979-12-22
13572,War,1980-01-05,War - The Music Band 2,36,36,38,34.0,34,The Music Band 2,11.0,2,-4,2,0,1,down,1979-12-22
13573,War,1980-01-12,War - The Music Band 2,34,36,42,34.0,38,The Music Band 2,11.0,3,-4,-4,2,1,down,1979-12-22
13574,War,1980-01-19,War - The Music Band 2,38,34,42,34.0,42,The Music Band 2,11.0,4,0,-4,-4,0,stay,1979-12-22
13575,War,1980-01-26,War - The Music Band 2,42,38,49,34.0,42,The Music Band 2,11.0,5,-7,0,-4,1,down,1979-12-22
13576,War,1980-02-02,War - The Music Band 2,42,42,46,34.0,49,The Music Band 2,11.0,6,3,-7,0,1,up,1979-12-22
13577,War,1980-02-09,War - The Music Band 2,49,42,45,34.0,46,The Music Band 2,11.0,7,1,3,-7,1,up,1979-12-22
13578,War,1980-02-16,War - The Music Band 2,46,49,43,34.0,45,The Music Band 2,11.0,8,2,1,3,1,up,1979-12-22
13579,War,1980-02-23,War - The Music Band 2,45,46,45,34.0,43,The Music Band 2,11.0,9,-2,2,1,1,down,1979-12-22
13580,War,1980-03-01,War - The Music Band 2,43,45,47,34.0,45,The Music Band 2,11.0,10,-2,-2,2,1,down,1979-12-22
13581,War,1980-03-08,War - The Music Band 2,45,43,51,34.0,47,The Music Band 2,11.0,11,-4,-2,-2,1,down,1979-12-22
13582,Parliament,1979-12-22,Parliament - Gloryhallastoopid(pin The Tail On The Funky),51,51,38,3.0,38,Gloryhallastoopid(pin The Tail On The Funky),20.0,0,0,13,0,0,stay,1979-12-22
13583,Parliament,1979-12-29,Parliament - Gloryhallastoopid(pin The Tail On The Funky),38,51,12,3.0,38,Gloryhallastoopid(pin The Tail On The Funky),20.0,1,26,0,13,1,up,1979-12-22
13584,Parliament,1980-01-05,Parliament - Gloryhallastoopid(pin The Tail On The Funky),38,38,6,3.0,12,Gloryhallastoopid(pin The Tail On The Funky),20.0,2,6,26,0,1,up,1979-12-22
13585,Parliament,1980-01-12,Parliament - Gloryhallastoopid(pin The Tail On The Funky),12,38,4,3.0,6,Gloryhallastoopid(pin The Tail On The Funky),20.0,3,2,6,26,1,up,1979-12-22
13586,Parliament,1980-01-19,Parliament - Gloryhallastoopid(pin The Tail On The Funky),6,12,4,3.0,4,Gloryhallastoopid(pin The Tail On The Funky),20.0,4,0,2,6,0,stay,1979-12-22
13587,Parliament,1980-01-26,Parliament - Gloryhallastoopid(pin The Tail On The Funky),4,6,3,3.0,4,Gloryhallastoopid(pin The Tail On The Funky),20.0,5,1,0,2,1,up,1979-12-22
13588,Parliament,1980-02-02,Parliament - Gloryhallastoopid(pin The Tail On The Funky),4,4,3,3.0,3,Gloryhallastoopid(pin The Tail On The Funky),20.0,6,0,1,0,0,stay,1979-12-22
13589,Parliament,1980-02-09,Parliament - Gloryhallastoopid(pin The Tail On The Funky),3,4,3,3.0,3,Gloryhallastoopid(pin The Tail On The Funky),20.0,7,0,0,1,0,stay,1979-12-22
13590,Parliament,1980-02-16,Parliament - Gloryhallastoopid(pin The Tail On The Funky),3,3,6,3.0,3,Gloryhallastoopid(pin The Tail On The Funky),20.0,8,-3,0,0,1,down,1979-12-22
13591,Parliament,1980-02-23,Parliament - Gloryhallastoopid(pin The Tail On The Funky),3,3,6,3.0,6,Gloryhallastoopid(pin The Tail On The Funky),20.0,9,0,-3,0,0,stay,1979-12-22
13592,Parliament,1980-03-01,Parliament - Gloryhallastoopid(pin The Tail On The Funky),6,3,6,3.0,6,Gloryhallastoopid(pin The Tail On The Funky),20.0,10,0,0,-3,0,stay,1979-12-22
13593,Parliament,1980-03-08,Parliament - Gloryhallastoopid(pin The Tail On The Funky),6,6,8,3.0,6,Gloryhallastoopid(pin The Tail On The Funky),20.0,11,-2,0,0,1,down,1979-12-22
13594,Parliament,1980-03-15,Parliament - Gloryhallastoopid(pin The Tail On The Funky),6,6,12,3.0,8,Gloryhallastoopid(pin The Tail On The Funky),20.0,12,-4,-2,0,1,down,1979-12-22
13595,Parliament,1980-03-22,Parliament - Gloryhallastoopid(pin The Tail On The Funky),8,6,16,3.0,12,Gloryhallastoopid(pin The Tail On The Funky),20.0,13,-4,-4,-2,1,down,1979-12-22
13596,Parliament,1980-03-29,Parliament - Gloryhallastoopid(pin The Tail On The Funky),12,8,17,3.0,16,Gloryhallastoopid(pin The Tail On The Funky),20.0,14,-1,-4,-4,1,down,1979-12-22
13597,Parliament,1980-04-05,Parliament - Gloryhallastoopid(pin The Tail On The Funky),16,12,19,3.0,17,Gloryhallastoopid(pin The Tail On The Funky),20.0,15,-2,-1,-4,1,down,1979-12-22
13598,Parliament,1980-04-12,Parliament - Gloryhallastoopid(pin The Tail On The Funky),17,16,24,3.0,19,Gloryhallastoopid(pin The Tail On The Funky),20.0,16,-5,-2,-1,1,down,1979-12-22
13599,Parliament,1980-04-19,Parliament - Gloryhallastoopid(pin The Tail On The Funky),19,17,39,3.0,24,Gloryhallastoopid(pin The Tail On The Funky),20.0,17,-15,-5,-2,1,down,1979-12-22
13600,Parliament,1980-04-26,Parliament - Gloryhallastoopid(pin The Tail On The Funky),24,19,45,3.0,39,Gloryhallastoopid(pin The Tail On The Funky),20.0,18,-6,-15,-5,1,down,1979-12-22
13601,Parliament,1980-05-03,Parliament - Gloryhallastoopid(pin The Tail On The Funky),39,24,50,3.0,45,Gloryhallastoopid(pin The Tail On The Funky),20.0,19,-5,-6,-15,1,down,1979-12-22
13602,Parliament,1980-05-10,Parliament - Gloryhallastoopid(pin The Tail On The Funky),45,39,51,3.0,50,Gloryhallastoopid(pin The Tail On The Funky),20.0,20,-1,-5,-6,1,down,1979-12-22
13603,Roy Ayers,1979-12-22,Roy Ayers - No Stranger To Love,51,51,44,22.0,44,No Stranger To Love,16.0,0,0,7,0,0,stay,1979-12-22
13604,Roy Ayers,1979-12-29,Roy Ayers - No Stranger To Love,44,51,33,22.0,44,No Stranger To Love,16.0,1,11,0,7,1,up,1979-12-22
13605,Roy Ayers,1980-01-05,Roy Ayers - No Stranger To Love,44,44,27,22.0,33,No Stranger To Love,16.0,2,6,11,0,1,up,1979-12-22
13606,Roy Ayers,1980-01-12,Roy Ayers - No Stranger To Love,33,44,22,22.0,27,No Stranger To Love,16.0,3,5,6,11,1,up,1979-12-22
13607,Roy Ayers,1980-01-19,Roy Ayers - No Stranger To Love,27,33,22,22.0,22,No Stranger To Love,16.0,4,0,5,6,0,stay,1979-12-22
13608,Roy Ayers,1980-01-26,Roy Ayers - No Stranger To Love,22,27,24,22.0,22,No Stranger To Love,16.0,5,-2,0,5,1,down,1979-12-22
13609,Roy Ayers,1980-02-02,Roy Ayers - No Stranger To Love,22,22,24,22.0,24,No Stranger To Love,16.0,6,0,-2,0,0,stay,1979-12-22
13610,Roy Ayers,1980-02-09,Roy Ayers - No Stranger To Love,24,22,28,22.0,24,No Stranger To Love,16.0,7,-4,0,-2,1,down,1979-12-22
13611,Roy Ayers,1980-02-16,Roy Ayers - No Stranger To Love,24,24,27,22.0,28,No Stranger To Love,16.0,8,1,-4,0,1,up,1979-12-22
13612,Roy Ayers,1980-02-23,Roy Ayers - No Stranger To Love,28,24,23,22.0,27,No Stranger To Love,16.0,9,4,1,-4,1,up,1979-12-22
13613,Roy Ayers,1980-03-01,Roy Ayers - No Stranger To Love,27,28,22,22.0,23,No Stranger To Love,16.0,10,1,4,1,1,up,1979-12-22
13614,Roy Ayers,1980-03-08,Roy Ayers - No Stranger To Love,23,27,36,22.0,22,No Stranger To Love,16.0,11,-14,1,4,1,down,1979-12-22
13615,Roy Ayers,1980-03-15,Roy Ayers - No Stranger To Love,22,23,33,22.0,36,No Stranger To Love,16.0,12,3,-14,1,1,up,1979-12-22
13616,Roy Ayers,1980-03-22,Roy Ayers - No Stranger To Love,36,22,35,22.0,33,No Stranger To Love,16.0,13,-2,3,-14,1,down,1979-12-22
13617,Roy Ayers,1980-03-29,Roy Ayers - No Stranger To Love,33,36,39,22.0,35,No Stranger To Love,16.0,14,-4,-2,3,1,down,1979-12-22
13618,Roy Ayers,1980-04-05,Roy Ayers - No Stranger To Love,35,33,45,22.0,39,No Stranger To Love,16.0,15,-6,-4,-2,1,down,1979-12-22
13619,Roy Ayers,1980-04-12,Roy Ayers - No Stranger To Love,39,35,51,22.0,45,No Stranger To Love,16.0,16,-6,-6,-4,1,down,1979-12-22
13620,Millie Jackson,1979-12-22,Millie Jackson - Live And Uncensored,51,51,47,22.0,47,Live And Uncensored,21.0,0,0,4,0,0,stay,1979-12-22
13621,Millie Jackson,1979-12-29,Millie Jackson - Live And Uncensored,47,51,36,22.0,47,Live And Uncensored,21.0,1,11,0,4,1,up,1979-12-22
13622,Millie Jackson,1980-01-05,Millie Jackson - Live And Uncensored,47,47,34,22.0,36,Live And Uncensored,21.0,2,2,11,0,1,up,1979-12-22
13623,Millie Jackson,1980-01-12,Millie Jackson - Live And Uncensored,36,47,32,22.0,34,Live And Uncensored,21.0,3,2,2,11,1,up,1979-12-22
13624,Millie Jackson,1980-01-19,Millie Jackson - Live And Uncensored,34,36,31,22.0,32,Live And Uncensored,21.0,4,1,2,2,1,up,1979-12-22
13625,Millie Jackson,1980-01-26,Millie Jackson - Live And Uncensored,32,34,30,22.0,31,Live And Uncensored,21.0,5,1,1,2,1,up,1979-12-22
13626,Millie Jackson,1980-02-02,Millie Jackson - Live And Uncensored,31,32,25,22.0,30,Live And Uncensored,21.0,6,5,1,1,1,up,1979-12-22
13627,Millie Jackson,1980-02-09,Millie Jackson - Live And Uncensored,30,31,24,22.0,25,Live And Uncensored,21.0,7,1,5,1,1,up,1979-12-22
13628,Millie Jackson,1980-02-16,Millie Jackson - Live And Uncensored,25,30,22,22.0,24,Live And Uncensored,21.0,8,2,1,5,1,up,1979-12-22
13629,Millie Jackson,1980-02-23,Millie Jackson - Live And Uncensored,24,25,25,22.0,22,Live And Uncensored,21.0,9,-3,2,1,1,down,1979-12-22
13630,Millie Jackson,1980-03-01,Millie Jackson - Live And Uncensored,22,24,23,22.0,25,Live And Uncensored,21.0,10,2,-3,2,1,up,1979-12-22
13631,Millie Jackson,1980-03-08,Millie Jackson - Live And Uncensored,25,22,23,22.0,23,Live And Uncensored,21.0,11,0,2,-3,0,stay,1979-12-22
13632,Millie Jackson,1980-03-15,Millie Jackson - Live And Uncensored,23,25,23,22.0,23,Live And Uncensored,21.0,12,0,0,2,0,stay,1979-12-22
13633,Millie Jackson,1980-03-22,Millie Jackson - Live And Uncensored,23,23,24,22.0,23,Live And Uncensored,21.0,13,-1,0,0,1,down,1979-12-22
13634,Millie Jackson,1980-03-29,Millie Jackson - Live And Uncensored,23,23,24,22.0,24,Live And Uncensored,21.0,14,0,-1,0,0,stay,1979-12-22
13635,Millie Jackson,1980-04-05,Millie Jackson - Live And Uncensored,24,23,24,22.0,24,Live And Uncensored,21.0,15,0,0,-1,0,stay,1979-12-22
13636,Millie Jackson,1980-04-12,Millie Jackson - Live And Uncensored,24,24,38,22.0,24,Live And Uncensored,21.0,16,-14,0,0,1,down,1979-12-22
13637,Millie Jackson,1980-04-19,Millie Jackson - Live And Uncensored,24,24,38,22.0,38,Live And Uncensored,21.0,17,0,-14,0,0,stay,1979-12-22
13638,Millie Jackson,1980-04-26,Millie Jackson - Live And Uncensored,38,24,43,22.0,38,Live And Uncensored,21.0,18,-5,0,-14,1,down,1979-12-22
13639,Millie Jackson,1980-05-03,Millie Jackson - Live And Uncensored,38,38,43,22.0,43,Live And Uncensored,21.0,19,0,-5,0,0,stay,1979-12-22
13640,Millie Jackson,1980-05-10,Millie Jackson - Live And Uncensored,43,38,49,22.0,43,Live And Uncensored,21.0,20,-6,0,-5,1,down,1979-12-22
13641,Millie Jackson,1980-05-17,Millie Jackson - Live And Uncensored,43,43,51,22.0,49,Live And Uncensored,21.0,21,-2,-6,0,1,down,1979-12-22
13642,Tyrone Davis,1979-12-22,Tyrone Davis - Can't You Tell It's Me,51,51,50,40.0,50,Can't You Tell It's Me,3.0,0,0,1,0,0,stay,1979-12-22
13643,Tyrone Davis,1979-12-29,Tyrone Davis - Can't You Tell It's Me,50,51,40,40.0,50,Can't You Tell It's Me,3.0,1,10,0,1,1,up,1979-12-22
13644,Tyrone Davis,1980-01-05,Tyrone Davis - Can't You Tell It's Me,50,50,40,40.0,40,Can't You Tell It's Me,3.0,2,0,10,0,0,stay,1979-12-22
13645,Tyrone Davis,1980-01-12,Tyrone Davis - Can't You Tell It's Me,40,50,51,40.0,40,Can't You Tell It's Me,3.0,3,-11,0,10,1,down,1979-12-22
13646,The Gap Band,1980-01-05,The Gap Band - The Gap Band Ii,51,51,18,3.0,23,The Gap Band Ii,23.0,0,5,28,0,1,up,1980-01-05
13647,The Gap Band,1980-01-12,The Gap Band - The Gap Band Ii,23,51,13,3.0,18,The Gap Band Ii,23.0,1,5,5,28,1,up,1980-01-05
13648,The Gap Band,1980-01-19,The Gap Band - The Gap Band Ii,18,23,12,3.0,13,The Gap Band Ii,23.0,2,1,5,5,1,up,1980-01-05
13649,The Gap Band,1980-01-26,The Gap Band - The Gap Band Ii,13,18,12,3.0,12,The Gap Band Ii,23.0,3,0,1,5,0,stay,1980-01-05
13650,The Gap Band,1980-02-02,The Gap Band - The Gap Band Ii,12,13,9,3.0,12,The Gap Band Ii,23.0,4,3,0,1,1,up,1980-01-05
13651,The Gap Band,1980-02-09,The Gap Band - The Gap Band Ii,12,12,6,3.0,9,The Gap Band Ii,23.0,5,3,3,0,1,up,1980-01-05
13652,The Gap Band,1980-02-16,The Gap Band - The Gap Band Ii,9,12,3,3.0,6,The Gap Band Ii,23.0,6,3,3,3,1,up,1980-01-05
13653,The Gap Band,1980-02-23,The Gap Band - The Gap Band Ii,6,9,3,3.0,3,The Gap Band Ii,23.0,7,0,3,3,0,stay,1980-01-05
13654,The Gap Band,1980-03-01,The Gap Band - The Gap Band Ii,3,6,3,3.0,3,The Gap Band Ii,23.0,8,0,0,3,0,stay,1980-01-05
13655,The Gap Band,1980-03-08,The Gap Band - The Gap Band Ii,3,3,3,3.0,3,The Gap Band Ii,23.0,9,0,0,0,0,stay,1980-01-05
13656,The Gap Band,1980-03-15,The Gap Band - The Gap Band Ii,3,3,3,3.0,3,The Gap Band Ii,23.0,10,0,0,0,0,stay,1980-01-05
13657,The Gap Band,1980-03-22,The Gap Band - The Gap Band Ii,3,3,3,3.0,3,The Gap Band Ii,23.0,11,0,0,0,0,stay,1980-01-05
13658,The Gap Band,1980-03-29,The Gap Band - The Gap Band Ii,3,3,3,3.0,3,The Gap Band Ii,23.0,12,0,0,0,0,stay,1980-01-05
13659,The Gap Band,1980-04-05,The Gap Band - The Gap Band Ii,3,3,3,3.0,3,The Gap Band Ii,23.0,13,0,0,0,0,stay,1980-01-05
13660,The Gap Band,1980-04-12,The Gap Band - The Gap Band Ii,3,3,3,3.0,3,The Gap Band Ii,23.0,14,0,0,0,0,stay,1980-01-05
13661,The Gap Band,1980-04-19,The Gap Band - The Gap Band Ii,3,3,6,3.0,3,The Gap Band Ii,23.0,15,-3,0,0,1,down,1980-01-05
13662,The Gap Band,1980-04-26,The Gap Band - The Gap Band Ii,3,3,10,3.0,6,The Gap Band Ii,23.0,16,-4,-3,0,1,down,1980-01-05
13663,The Gap Band,1980-05-03,The Gap Band - The Gap Band Ii,6,3,13,3.0,10,The Gap Band Ii,23.0,17,-3,-4,-3,1,down,1980-01-05
13664,The Gap Band,1980-05-10,The Gap Band - The Gap Band Ii,10,6,16,3.0,13,The Gap Band Ii,23.0,18,-3,-3,-4,1,down,1980-01-05
13665,The Gap Band,1980-05-17,The Gap Band - The Gap Band Ii,13,10,27,3.0,16,The Gap Band Ii,23.0,19,-11,-3,-3,1,down,1980-01-05
13666,The Gap Band,1980-05-24,The Gap Band - The Gap Band Ii,16,13,27,3.0,27,The Gap Band Ii,23.0,20,0,-11,-3,0,stay,1980-01-05
13667,The Gap Band,1980-05-31,The Gap Band - The Gap Band Ii,27,16,32,3.0,27,The Gap Band Ii,23.0,21,-5,0,-11,1,down,1980-01-05
13668,The Gap Band,1980-06-07,The Gap Band - The Gap Band Ii,27,27,38,3.0,32,The Gap Band Ii,23.0,22,-6,-5,0,1,down,1980-01-05
13669,The Gap Band,1980-06-14,The Gap Band - The Gap Band Ii,32,27,51,3.0,38,The Gap Band Ii,23.0,23,-13,-6,-5,1,down,1980-01-05
13670,Bob James And Earl Klugh,1980-01-05,Bob James And Earl Klugh - One On One,51,51,26,26.0,32,One On One,11.0,0,6,19,0,1,up,1980-01-05
13671,Bob James And Earl Klugh,1980-01-12,Bob James And Earl Klugh - One On One,32,51,26,26.0,26,One On One,11.0,1,0,6,19,0,stay,1980-01-05
13672,Bob James And Earl Klugh,1980-01-19,Bob James And Earl Klugh - One On One,26,32,27,26.0,26,One On One,11.0,2,-1,0,6,1,down,1980-01-05
13673,Bob James And Earl Klugh,1980-01-26,Bob James And Earl Klugh - One On One,26,26,31,26.0,27,One On One,11.0,3,-4,-1,0,1,down,1980-01-05
13674,Bob James And Earl Klugh,1980-02-02,Bob James And Earl Klugh - One On One,27,26,31,26.0,31,One On One,11.0,4,0,-4,-1,0,stay,1980-01-05
13675,Bob James And Earl Klugh,1980-02-09,Bob James And Earl Klugh - One On One,31,27,30,26.0,31,One On One,11.0,5,1,0,-4,1,up,1980-01-05
13676,Bob James And Earl Klugh,1980-02-16,Bob James And Earl Klugh - One On One,31,31,33,26.0,30,One On One,11.0,6,-3,1,0,1,down,1980-01-05
13677,Bob James And Earl Klugh,1980-02-23,Bob James And Earl Klugh - One On One,30,31,31,26.0,33,One On One,11.0,7,2,-3,1,1,up,1980-01-05
13678,Bob James And Earl Klugh,1980-03-01,Bob James And Earl Klugh - One On One,33,30,32,26.0,31,One On One,11.0,8,-1,2,-3,1,down,1980-01-05
13679,Bob James And Earl Klugh,1980-03-08,Bob James And Earl Klugh - One On One,31,33,41,26.0,32,One On One,11.0,9,-9,-1,2,1,down,1980-01-05
13680,Bob James And Earl Klugh,1980-03-15,Bob James And Earl Klugh - One On One,32,31,49,26.0,41,One On One,11.0,10,-8,-9,-1,1,down,1980-01-05
13681,Bob James And Earl Klugh,1980-03-22,Bob James And Earl Klugh - One On One,41,32,51,26.0,49,One On One,11.0,11,-2,-8,-9,1,down,1980-01-05
13682,Bonnie Pointer,1980-01-05,Bonnie Pointer - Bonnie Pointer (II),51,51,41,40.0,41,Bonnie Pointer (II),8.0,0,0,10,0,0,stay,1980-01-05
13683,Bonnie Pointer,1980-01-12,Bonnie Pointer - Bonnie Pointer (II),41,51,43,40.0,41,Bonnie Pointer (II),8.0,1,-2,0,10,1,down,1980-01-05
13684,Bonnie Pointer,1980-01-19,Bonnie Pointer - Bonnie Pointer (II),41,41,43,40.0,43,Bonnie Pointer (II),8.0,2,0,-2,0,0,stay,1980-01-05
13685,Bonnie Pointer,1980-01-26,Bonnie Pointer - Bonnie Pointer (II),43,41,41,40.0,43,Bonnie Pointer (II),8.0,3,2,0,-2,1,up,1980-01-05
13686,Bonnie Pointer,1980-02-02,Bonnie Pointer - Bonnie Pointer (II),43,43,40,40.0,41,Bonnie Pointer (II),8.0,4,1,2,0,1,up,1980-01-05
13687,Bonnie Pointer,1980-02-09,Bonnie Pointer - Bonnie Pointer (II),41,43,40,40.0,40,Bonnie Pointer (II),8.0,5,0,1,2,0,stay,1980-01-05
13688,Bonnie Pointer,1980-02-16,Bonnie Pointer - Bonnie Pointer (II),40,41,46,40.0,40,Bonnie Pointer (II),8.0,6,-6,0,1,1,down,1980-01-05
13689,Bonnie Pointer,1980-02-23,Bonnie Pointer - Bonnie Pointer (II),40,40,46,40.0,46,Bonnie Pointer (II),8.0,7,0,-6,0,0,stay,1980-01-05
13690,Bonnie Pointer,1980-03-01,Bonnie Pointer - Bonnie Pointer (II),46,40,51,40.0,46,Bonnie Pointer (II),8.0,8,-5,0,-6,1,down,1980-01-05
13691,Narada,1980-01-05,Narada - The Dance Of Life,51,51,30,9.0,43,The Dance Of Life,18.0,0,13,8,0,1,up,1980-01-05
13692,Narada,1980-01-12,Narada - The Dance Of Life,43,51,23,9.0,30,The Dance Of Life,18.0,1,7,13,8,1,up,1980-01-05
13693,Narada,1980-01-19,Narada - The Dance Of Life,30,43,20,9.0,23,The Dance Of Life,18.0,2,3,7,13,1,up,1980-01-05
13694,Narada,1980-01-26,Narada - The Dance Of Life,23,30,17,9.0,20,The Dance Of Life,18.0,3,3,3,7,1,up,1980-01-05
13695,Narada,1980-02-02,Narada - The Dance Of Life,20,23,17,9.0,17,The Dance Of Life,18.0,4,0,3,3,0,stay,1980-01-05
13696,Narada,1980-02-09,Narada - The Dance Of Life,17,20,15,9.0,17,The Dance Of Life,18.0,5,2,0,3,1,up,1980-01-05
13697,Narada,1980-02-16,Narada - The Dance Of Life,17,17,9,9.0,15,The Dance Of Life,18.0,6,6,2,0,1,up,1980-01-05
13698,Narada,1980-02-23,Narada - The Dance Of Life,15,17,9,9.0,9,The Dance Of Life,18.0,7,0,6,2,0,stay,1980-01-05
13699,Narada,1980-03-01,Narada - The Dance Of Life,9,15,10,9.0,9,The Dance Of Life,18.0,8,-1,0,6,1,down,1980-01-05
13700,Narada,1980-03-08,Narada - The Dance Of Life,9,9,14,9.0,10,The Dance Of Life,18.0,9,-4,-1,0,1,down,1980-01-05
13701,Narada,1980-03-15,Narada - The Dance Of Life,10,9,15,9.0,14,The Dance Of Life,18.0,10,-1,-4,-1,1,down,1980-01-05
13702,Narada,1980-03-22,Narada - The Dance Of Life,14,10,18,9.0,15,The Dance Of Life,18.0,11,-3,-1,-4,1,down,1980-01-05
13703,Narada,1980-03-29,Narada - The Dance Of Life,15,14,27,9.0,18,The Dance Of Life,18.0,12,-9,-3,-1,1,down,1980-01-05
13704,Narada,1980-04-05,Narada - The Dance Of Life,18,15,28,9.0,27,The Dance Of Life,18.0,13,-1,-9,-3,1,down,1980-01-05
13705,Narada,1980-04-12,Narada - The Dance Of Life,27,18,37,9.0,28,The Dance Of Life,18.0,14,-9,-1,-9,1,down,1980-01-05
13706,Narada,1980-04-19,Narada - The Dance Of Life,28,27,47,9.0,37,The Dance Of Life,18.0,15,-10,-9,-1,1,down,1980-01-05
13707,Narada,1980-04-26,Narada - The Dance Of Life,37,28,48,9.0,47,The Dance Of Life,18.0,16,-1,-10,-9,1,down,1980-01-05
13708,Narada,1980-05-03,Narada - The Dance Of Life,47,37,49,9.0,48,The Dance Of Life,18.0,17,-1,-1,-10,1,down,1980-01-05
13709,Narada,1980-05-10,Narada - The Dance Of Life,48,47,51,9.0,49,The Dance Of Life,18.0,18,-2,-1,-1,1,down,1980-01-05
13710,The Whispers,1980-01-05,The Whispers - The Whispers,51,51,25,1.0,45,The Whispers,30.0,0,20,6,0,1,up,1980-01-05
13711,The Whispers,1980-01-12,The Whispers - The Whispers,45,51,20,1.0,25,The Whispers,30.0,1,5,20,6,1,up,1980-01-05
13712,The Whispers,1980-01-19,The Whispers - The Whispers,25,45,14,1.0,20,The Whispers,30.0,2,6,5,20,1,up,1980-01-05
13713,The Whispers,1980-01-26,The Whispers - The Whispers,20,25,9,1.0,14,The Whispers,30.0,3,5,6,5,1,up,1980-01-05
13714,The Whispers,1980-02-02,The Whispers - The Whispers,14,20,2,1.0,9,The Whispers,30.0,4,7,5,6,1,up,1980-01-05
13715,The Whispers,1980-02-09,The Whispers - The Whispers,9,14,2,1.0,2,The Whispers,30.0,5,0,7,5,0,stay,1980-01-05
13716,The Whispers,1980-02-16,The Whispers - The Whispers,2,9,1,1.0,2,The Whispers,30.0,6,1,0,7,1,up,1980-01-05
13717,The Whispers,1980-02-23,The Whispers - The Whispers,2,2,1,1.0,1,The Whispers,30.0,7,0,1,0,0,stay,1980-01-05
13718,The Whispers,1980-03-01,The Whispers - The Whispers,1,2,1,1.0,1,The Whispers,30.0,8,0,0,1,0,stay,1980-01-05
13719,The Whispers,1980-03-08,The Whispers - The Whispers,1,1,1,1.0,1,The Whispers,30.0,9,0,0,0,0,stay,1980-01-05
13720,The Whispers,1980-03-15,The Whispers - The Whispers,1,1,1,1.0,1,The Whispers,30.0,10,0,0,0,0,stay,1980-01-05
13721,The Whispers,1980-03-22,The Whispers - The Whispers,1,1,1,1.0,1,The Whispers,30.0,11,0,0,0,0,stay,1980-01-05
13722,The Whispers,1980-03-29,The Whispers - The Whispers,1,1,1,1.0,1,The Whispers,30.0,12,0,0,0,0,stay,1980-01-05
13723,The Whispers,1980-04-05,The Whispers - The Whispers,1,1,1,1.0,1,The Whispers,30.0,13,0,0,0,0,stay,1980-01-05
13724,The Whispers,1980-04-12,The Whispers - The Whispers,1,1,2,1.0,1,The Whispers,30.0,14,-1,0,0,1,down,1980-01-05
13725,The Whispers,1980-04-19,The Whispers - The Whispers,1,1,3,1.0,2,The Whispers,30.0,15,-1,-1,0,1,down,1980-01-05
13726,The Whispers,1980-04-26,The Whispers - The Whispers,2,1,3,1.0,3,The Whispers,30.0,16,0,-1,-1,0,stay,1980-01-05
13727,The Whispers,1980-05-03,The Whispers - The Whispers,3,2,3,1.0,3,The Whispers,30.0,17,0,0,-1,0,stay,1980-01-05
13728,The Whispers,1980-05-10,The Whispers - The Whispers,3,3,5,1.0,3,The Whispers,30.0,18,-2,0,0,1,down,1980-01-05
13729,The Whispers,1980-05-17,The Whispers - The Whispers,3,3,9,1.0,5,The Whispers,30.0,19,-4,-2,0,1,down,1980-01-05
13730,The Whispers,1980-05-24,The Whispers - The Whispers,5,3,12,1.0,9,The Whispers,30.0,20,-3,-4,-2,1,down,1980-01-05
13731,The Whispers,1980-05-31,The Whispers - The Whispers,9,5,15,1.0,12,The Whispers,30.0,21,-3,-3,-4,1,down,1980-01-05
13732,The Whispers,1980-06-07,The Whispers - The Whispers,12,9,16,1.0,15,The Whispers,30.0,22,-1,-3,-3,1,down,1980-01-05
13733,The Whispers,1980-06-14,The Whispers - The Whispers,15,12,16,1.0,16,The Whispers,30.0,23,0,-1,-3,0,stay,1980-01-05
13734,The Whispers,1980-06-21,The Whispers - The Whispers,16,15,25,1.0,16,The Whispers,30.0,24,-9,0,-1,1,down,1980-01-05
13735,The Whispers,1980-06-28,The Whispers - The Whispers,16,16,26,1.0,25,The Whispers,30.0,25,-1,-9,0,1,down,1980-01-05
13736,The Whispers,1980-07-05,The Whispers - The Whispers,25,16,27,1.0,26,The Whispers,30.0,26,-1,-1,-9,1,down,1980-01-05
13737,The Whispers,1980-07-12,The Whispers - The Whispers,26,25,33,1.0,27,The Whispers,30.0,27,-6,-1,-1,1,down,1980-01-05
13738,The Whispers,1980-07-19,The Whispers - The Whispers,27,26,45,1.0,33,The Whispers,30.0,28,-12,-6,-1,1,down,1980-01-05
13739,The Whispers,1980-07-26,The Whispers - The Whispers,33,27,50,1.0,45,The Whispers,30.0,29,-5,-12,-6,1,down,1980-01-05
13740,The Whispers,1980-08-02,The Whispers - The Whispers,45,33,51,1.0,50,The Whispers,30.0,30,-1,-5,-12,1,down,1980-01-05
13741,"Ray, Goodman & Brown",1980-01-12,"Ray, Goodman & Brown - Ray, Goodman & Brown",51,51,30,2.0,42,"Ray, Goodman & Brown",24.0,0,12,9,0,1,up,1980-01-12
13742,"Ray, Goodman & Brown",1980-01-19,"Ray, Goodman & Brown - Ray, Goodman & Brown",42,51,24,2.0,30,"Ray, Goodman & Brown",24.0,1,6,12,9,1,up,1980-01-12
13743,"Ray, Goodman & Brown",1980-01-26,"Ray, Goodman & Brown - Ray, Goodman & Brown",30,42,21,2.0,24,"Ray, Goodman & Brown",24.0,2,3,6,12,1,up,1980-01-12
13744,"Ray, Goodman & Brown",1980-02-02,"Ray, Goodman & Brown - Ray, Goodman & Brown",24,30,18,2.0,21,"Ray, Goodman & Brown",24.0,3,3,3,6,1,up,1980-01-12
13745,"Ray, Goodman & Brown",1980-02-09,"Ray, Goodman & Brown - Ray, Goodman & Brown",21,24,12,2.0,18,"Ray, Goodman & Brown",24.0,4,6,3,3,1,up,1980-01-12
13746,"Ray, Goodman & Brown",1980-02-16,"Ray, Goodman & Brown - Ray, Goodman & Brown",18,21,5,2.0,12,"Ray, Goodman & Brown",24.0,5,7,6,3,1,up,1980-01-12
13747,"Ray, Goodman & Brown",1980-02-23,"Ray, Goodman & Brown - Ray, Goodman & Brown",12,18,4,2.0,5,"Ray, Goodman & Brown",24.0,6,1,7,6,1,up,1980-01-12
13748,"Ray, Goodman & Brown",1980-03-01,"Ray, Goodman & Brown - Ray, Goodman & Brown",5,12,2,2.0,4,"Ray, Goodman & Brown",24.0,7,2,1,7,1,up,1980-01-12
13749,"Ray, Goodman & Brown",1980-03-08,"Ray, Goodman & Brown - Ray, Goodman & Brown",4,5,2,2.0,2,"Ray, Goodman & Brown",24.0,8,0,2,1,0,stay,1980-01-12
13750,"Ray, Goodman & Brown",1980-03-15,"Ray, Goodman & Brown - Ray, Goodman & Brown",2,4,6,2.0,2,"Ray, Goodman & Brown",24.0,9,-4,0,2,1,down,1980-01-12
13751,"Ray, Goodman & Brown",1980-03-22,"Ray, Goodman & Brown - Ray, Goodman & Brown",2,2,6,2.0,6,"Ray, Goodman & Brown",24.0,10,0,-4,0,0,stay,1980-01-12
13752,"Ray, Goodman & Brown",1980-03-29,"Ray, Goodman & Brown - Ray, Goodman & Brown",6,2,6,2.0,6,"Ray, Goodman & Brown",24.0,11,0,0,-4,0,stay,1980-01-12
13753,"Ray, Goodman & Brown",1980-04-05,"Ray, Goodman & Brown - Ray, Goodman & Brown",6,6,5,2.0,6,"Ray, Goodman & Brown",24.0,12,1,0,0,1,up,1980-01-12
13754,"Ray, Goodman & Brown",1980-04-12,"Ray, Goodman & Brown - Ray, Goodman & Brown",6,6,6,2.0,5,"Ray, Goodman & Brown",24.0,13,-1,1,0,1,down,1980-01-12
13755,"Ray, Goodman & Brown",1980-04-19,"Ray, Goodman & Brown - Ray, Goodman & Brown",5,6,8,2.0,6,"Ray, Goodman & Brown",24.0,14,-2,-1,1,1,down,1980-01-12
13756,"Ray, Goodman & Brown",1980-04-26,"Ray, Goodman & Brown - Ray, Goodman & Brown",6,5,11,2.0,8,"Ray, Goodman & Brown",24.0,15,-3,-2,-1,1,down,1980-01-12
13757,"Ray, Goodman & Brown",1980-05-03,"Ray, Goodman & Brown - Ray, Goodman & Brown",8,6,12,2.0,11,"Ray, Goodman & Brown",24.0,16,-1,-3,-2,1,down,1980-01-12
13758,"Ray, Goodman & Brown",1980-05-10,"Ray, Goodman & Brown - Ray, Goodman & Brown",11,8,15,2.0,12,"Ray, Goodman & Brown",24.0,17,-3,-1,-3,1,down,1980-01-12
13759,"Ray, Goodman & Brown",1980-05-17,"Ray, Goodman & Brown - Ray, Goodman & Brown",12,11,18,2.0,15,"Ray, Goodman & Brown",24.0,18,-3,-3,-1,1,down,1980-01-12
13760,"Ray, Goodman & Brown",1980-05-24,"Ray, Goodman & Brown - Ray, Goodman & Brown",15,12,19,2.0,18,"Ray, Goodman & Brown",24.0,19,-1,-3,-3,1,down,1980-01-12
13761,"Ray, Goodman & Brown",1980-05-31,"Ray, Goodman & Brown - Ray, Goodman & Brown",18,15,23,2.0,19,"Ray, Goodman & Brown",24.0,20,-4,-1,-3,1,down,1980-01-12
13762,"Ray, Goodman & Brown",1980-06-07,"Ray, Goodman & Brown - Ray, Goodman & Brown",19,18,27,2.0,23,"Ray, Goodman & Brown",24.0,21,-4,-4,-1,1,down,1980-01-12
13763,"Ray, Goodman & Brown",1980-06-14,"Ray, Goodman & Brown - Ray, Goodman & Brown",23,19,33,2.0,27,"Ray, Goodman & Brown",24.0,22,-6,-4,-4,1,down,1980-01-12
13764,"Ray, Goodman & Brown",1980-06-21,"Ray, Goodman & Brown - Ray, Goodman & Brown",27,23,47,2.0,33,"Ray, Goodman & Brown",24.0,23,-14,-6,-4,1,down,1980-01-12
13765,"Ray, Goodman & Brown",1980-06-28,"Ray, Goodman & Brown - Ray, Goodman & Brown",33,27,51,2.0,47,"Ray, Goodman & Brown",24.0,24,-4,-14,-6,1,down,1980-01-12
13766,Chic,1980-01-12,Chic - Les Plus Grands Succes De Chic - Chic's Greatest Hits,51,51,44,44.0,44,Les Plus Grands Succes De Chic - Chic's Greatest Hits,2.0,0,0,7,0,0,stay,1980-01-12
13767,Chic,1980-01-19,Chic - Les Plus Grands Succes De Chic - Chic's Greatest Hits,44,51,44,44.0,44,Les Plus Grands Succes De Chic - Chic's Greatest Hits,2.0,1,0,0,7,0,stay,1980-01-12
13768,Chic,1980-01-26,Chic - Les Plus Grands Succes De Chic - Chic's Greatest Hits,44,44,51,44.0,44,Les Plus Grands Succes De Chic - Chic's Greatest Hits,2.0,2,-7,0,0,1,down,1980-01-12
13769,Lou Rawls,1980-01-12,Lou Rawls - Sit Down And Talk To Me,51,51,40,19.0,50,Sit Down And Talk To Me,17.0,0,10,1,0,1,up,1980-01-12
13770,Lou Rawls,1980-01-19,Lou Rawls - Sit Down And Talk To Me,50,51,37,19.0,40,Sit Down And Talk To Me,17.0,1,3,10,1,1,up,1980-01-12
13771,Lou Rawls,1980-01-26,Lou Rawls - Sit Down And Talk To Me,40,50,27,19.0,37,Sit Down And Talk To Me,17.0,2,10,3,10,1,up,1980-01-12
13772,Lou Rawls,1980-02-02,Lou Rawls - Sit Down And Talk To Me,37,40,26,19.0,27,Sit Down And Talk To Me,17.0,3,1,10,3,1,up,1980-01-12
13773,Lou Rawls,1980-02-09,Lou Rawls - Sit Down And Talk To Me,27,37,25,19.0,26,Sit Down And Talk To Me,17.0,4,1,1,10,1,up,1980-01-12
13774,Lou Rawls,1980-02-16,Lou Rawls - Sit Down And Talk To Me,26,27,23,19.0,25,Sit Down And Talk To Me,17.0,5,2,1,1,1,up,1980-01-12
13775,Lou Rawls,1980-02-23,Lou Rawls - Sit Down And Talk To Me,25,26,21,19.0,23,Sit Down And Talk To Me,17.0,6,2,2,1,1,up,1980-01-12
13776,Lou Rawls,1980-03-01,Lou Rawls - Sit Down And Talk To Me,23,25,20,19.0,21,Sit Down And Talk To Me,17.0,7,1,2,2,1,up,1980-01-12
13777,Lou Rawls,1980-03-08,Lou Rawls - Sit Down And Talk To Me,21,23,19,19.0,20,Sit Down And Talk To Me,17.0,8,1,1,2,1,up,1980-01-12
13778,Lou Rawls,1980-03-15,Lou Rawls - Sit Down And Talk To Me,20,21,20,19.0,19,Sit Down And Talk To Me,17.0,9,-1,1,1,1,down,1980-01-12
13779,Lou Rawls,1980-03-22,Lou Rawls - Sit Down And Talk To Me,19,20,23,19.0,20,Sit Down And Talk To Me,17.0,10,-3,-1,1,1,down,1980-01-12
13780,Lou Rawls,1980-03-29,Lou Rawls - Sit Down And Talk To Me,20,19,21,19.0,23,Sit Down And Talk To Me,17.0,11,2,-3,-1,1,up,1980-01-12
13781,Lou Rawls,1980-04-05,Lou Rawls - Sit Down And Talk To Me,23,20,20,19.0,21,Sit Down And Talk To Me,17.0,12,1,2,-3,1,up,1980-01-12
13782,Lou Rawls,1980-04-12,Lou Rawls - Sit Down And Talk To Me,21,23,27,19.0,20,Sit Down And Talk To Me,17.0,13,-7,1,2,1,down,1980-01-12
13783,Lou Rawls,1980-04-19,Lou Rawls - Sit Down And Talk To Me,20,21,32,19.0,27,Sit Down And Talk To Me,17.0,14,-5,-7,1,1,down,1980-01-12
13784,Lou Rawls,1980-04-26,Lou Rawls - Sit Down And Talk To Me,27,20,37,19.0,32,Sit Down And Talk To Me,17.0,15,-5,-5,-7,1,down,1980-01-12
13785,Lou Rawls,1980-05-03,Lou Rawls - Sit Down And Talk To Me,32,27,44,19.0,37,Sit Down And Talk To Me,17.0,16,-7,-5,-5,1,down,1980-01-12
13786,Lou Rawls,1980-05-10,Lou Rawls - Sit Down And Talk To Me,37,32,51,19.0,44,Sit Down And Talk To Me,17.0,17,-7,-7,-5,1,down,1980-01-12
13787,The Spinners,1980-01-19,The Spinners - Dancin' And Lovin',51,51,48,11.0,48,Dancin' And Lovin',16.0,0,0,3,0,0,stay,1980-01-19
13788,The Spinners,1980-01-26,The Spinners - Dancin' And Lovin',48,51,45,11.0,48,Dancin' And Lovin',16.0,1,3,0,3,1,up,1980-01-19
13789,The Spinners,1980-02-02,The Spinners - Dancin' And Lovin',48,48,35,11.0,45,Dancin' And Lovin',16.0,2,10,3,0,1,up,1980-01-19
13790,The Spinners,1980-02-09,The Spinners - Dancin' And Lovin',45,48,29,11.0,35,Dancin' And Lovin',16.0,3,6,10,3,1,up,1980-01-19
13791,The Spinners,1980-02-16,The Spinners - Dancin' And Lovin',35,45,28,11.0,29,Dancin' And Lovin',16.0,4,1,6,10,1,up,1980-01-19
13792,The Spinners,1980-02-23,The Spinners - Dancin' And Lovin',29,35,22,11.0,28,Dancin' And Lovin',16.0,5,6,1,6,1,up,1980-01-19
13793,The Spinners,1980-03-01,The Spinners - Dancin' And Lovin',28,29,15,11.0,22,Dancin' And Lovin',16.0,6,7,6,1,1,up,1980-01-19
13794,The Spinners,1980-03-08,The Spinners - Dancin' And Lovin',22,28,15,11.0,15,Dancin' And Lovin',16.0,7,0,7,6,0,stay,1980-01-19
13795,The Spinners,1980-03-15,The Spinners - Dancin' And Lovin',15,22,14,11.0,15,Dancin' And Lovin',16.0,8,1,0,7,1,up,1980-01-19
13796,The Spinners,1980-03-22,The Spinners - Dancin' And Lovin',15,15,11,11.0,14,Dancin' And Lovin',16.0,9,3,1,0,1,up,1980-01-19
13797,The Spinners,1980-03-29,The Spinners - Dancin' And Lovin',14,15,11,11.0,11,Dancin' And Lovin',16.0,10,0,3,1,0,stay,1980-01-19
13798,The Spinners,1980-04-05,The Spinners - Dancin' And Lovin',11,14,18,11.0,11,Dancin' And Lovin',16.0,11,-7,0,3,1,down,1980-01-19
13799,The Spinners,1980-04-12,The Spinners - Dancin' And Lovin',11,11,26,11.0,18,Dancin' And Lovin',16.0,12,-8,-7,0,1,down,1980-01-19
13800,The Spinners,1980-04-19,The Spinners - Dancin' And Lovin',18,11,33,11.0,26,Dancin' And Lovin',16.0,13,-7,-8,-7,1,down,1980-01-19
13801,The Spinners,1980-04-26,The Spinners - Dancin' And Lovin',26,18,33,11.0,33,Dancin' And Lovin',16.0,14,0,-7,-8,0,stay,1980-01-19
13802,The Spinners,1980-05-03,The Spinners - Dancin' And Lovin',33,26,40,11.0,33,Dancin' And Lovin',16.0,15,-7,0,-7,1,down,1980-01-19
13803,The Spinners,1980-05-10,The Spinners - Dancin' And Lovin',33,33,51,11.0,40,Dancin' And Lovin',16.0,16,-11,-7,0,1,down,1980-01-19
13804,Cheryl Lynn,1980-01-19,Cheryl Lynn - In Love,51,51,49,47.0,49,In Love,4.0,0,0,2,0,0,stay,1980-01-19
13805,Cheryl Lynn,1980-01-26,Cheryl Lynn - In Love,49,51,47,47.0,49,In Love,4.0,1,2,0,2,1,up,1980-01-19
13806,Cheryl Lynn,1980-02-02,Cheryl Lynn - In Love,49,49,48,47.0,47,In Love,4.0,2,-1,2,0,1,down,1980-01-19
13807,Cheryl Lynn,1980-02-09,Cheryl Lynn - In Love,47,49,48,47.0,48,In Love,4.0,3,0,-1,2,0,stay,1980-01-19
13808,Cheryl Lynn,1980-02-16,Cheryl Lynn - In Love,48,47,51,47.0,48,In Love,4.0,4,-3,0,-1,1,down,1980-01-19
13809,Hiroshima,1980-02-02,Hiroshima - Hiroshima,51,51,30,20.0,40,Hiroshima,13.0,0,10,11,0,1,up,1980-02-02
13810,Hiroshima,1980-02-09,Hiroshima - Hiroshima,40,51,21,20.0,30,Hiroshima,13.0,1,9,10,11,1,up,1980-02-02
13811,Hiroshima,1980-02-16,Hiroshima - Hiroshima,30,40,20,20.0,21,Hiroshima,13.0,2,1,9,10,1,up,1980-02-02
13812,Hiroshima,1980-02-23,Hiroshima - Hiroshima,21,30,26,20.0,20,Hiroshima,13.0,3,-6,1,9,1,down,1980-02-02
13813,Hiroshima,1980-03-01,Hiroshima - Hiroshima,20,21,26,20.0,26,Hiroshima,13.0,4,0,-6,1,0,stay,1980-02-02
13814,Hiroshima,1980-03-08,Hiroshima - Hiroshima,26,20,26,20.0,26,Hiroshima,13.0,5,0,0,-6,0,stay,1980-02-02
13815,Hiroshima,1980-03-15,Hiroshima - Hiroshima,26,26,27,20.0,26,Hiroshima,13.0,6,-1,0,0,1,down,1980-02-02
13816,Hiroshima,1980-03-22,Hiroshima - Hiroshima,26,26,29,20.0,27,Hiroshima,13.0,7,-2,-1,0,1,down,1980-02-02
13817,Hiroshima,1980-03-29,Hiroshima - Hiroshima,27,26,29,20.0,29,Hiroshima,13.0,8,0,-2,-1,0,stay,1980-02-02
13818,Hiroshima,1980-04-05,Hiroshima - Hiroshima,29,27,32,20.0,29,Hiroshima,13.0,9,-3,0,-2,1,down,1980-02-02
13819,Hiroshima,1980-04-12,Hiroshima - Hiroshima,29,29,34,20.0,32,Hiroshima,13.0,10,-2,-3,0,1,down,1980-02-02
13820,Hiroshima,1980-04-19,Hiroshima - Hiroshima,32,29,37,20.0,34,Hiroshima,13.0,11,-3,-2,-3,1,down,1980-02-02
13821,Hiroshima,1980-04-26,Hiroshima - Hiroshima,34,32,41,20.0,37,Hiroshima,13.0,12,-4,-3,-2,1,down,1980-02-02
13822,Hiroshima,1980-05-03,Hiroshima - Hiroshima,37,34,51,20.0,41,Hiroshima,13.0,13,-10,-4,-3,1,down,1980-02-02
13823,Ronnie Laws,1980-02-16,Ronnie Laws - Every Generation,51,51,19,4.0,39,Every Generation,17.0,0,20,12,0,1,up,1980-02-16
13824,Ronnie Laws,1980-02-23,Ronnie Laws - Every Generation,39,51,12,4.0,19,Every Generation,17.0,1,7,20,12,1,up,1980-02-16
13825,Ronnie Laws,1980-03-01,Ronnie Laws - Every Generation,19,39,8,4.0,12,Every Generation,17.0,2,4,7,20,1,up,1980-02-16
13826,Ronnie Laws,1980-03-08,Ronnie Laws - Every Generation,12,19,6,4.0,8,Every Generation,17.0,3,2,4,7,1,up,1980-02-16
13827,Ronnie Laws,1980-03-15,Ronnie Laws - Every Generation,8,12,5,4.0,6,Every Generation,17.0,4,1,2,4,1,up,1980-02-16
13828,Ronnie Laws,1980-03-22,Ronnie Laws - Every Generation,6,8,4,4.0,5,Every Generation,17.0,5,1,1,2,1,up,1980-02-16
13829,Ronnie Laws,1980-03-29,Ronnie Laws - Every Generation,5,6,4,4.0,4,Every Generation,17.0,6,0,1,1,0,stay,1980-02-16
13830,Ronnie Laws,1980-04-05,Ronnie Laws - Every Generation,4,5,9,4.0,4,Every Generation,17.0,7,-5,0,1,1,down,1980-02-16
13831,Ronnie Laws,1980-04-12,Ronnie Laws - Every Generation,4,4,9,4.0,9,Every Generation,17.0,8,0,-5,0,0,stay,1980-02-16
13832,Ronnie Laws,1980-04-19,Ronnie Laws - Every Generation,9,4,12,4.0,9,Every Generation,17.0,9,-3,0,-5,1,down,1980-02-16
13833,Ronnie Laws,1980-04-26,Ronnie Laws - Every Generation,9,9,17,4.0,12,Every Generation,17.0,10,-5,-3,0,1,down,1980-02-16
13834,Ronnie Laws,1980-05-03,Ronnie Laws - Every Generation,12,9,21,4.0,17,Every Generation,17.0,11,-4,-5,-3,1,down,1980-02-16
13835,Ronnie Laws,1980-05-10,Ronnie Laws - Every Generation,17,12,30,4.0,21,Every Generation,17.0,12,-9,-4,-5,1,down,1980-02-16
13836,Ronnie Laws,1980-05-17,Ronnie Laws - Every Generation,21,17,30,4.0,30,Every Generation,17.0,13,0,-9,-4,0,stay,1980-02-16
13837,Ronnie Laws,1980-05-24,Ronnie Laws - Every Generation,30,21,37,4.0,30,Every Generation,17.0,14,-7,0,-9,1,down,1980-02-16
13838,Ronnie Laws,1980-05-31,Ronnie Laws - Every Generation,30,30,41,4.0,37,Every Generation,17.0,15,-4,-7,0,1,down,1980-02-16
13839,Ronnie Laws,1980-06-07,Ronnie Laws - Every Generation,37,30,43,4.0,41,Every Generation,17.0,16,-2,-4,-7,1,down,1980-02-16
13840,Ronnie Laws,1980-06-14,Ronnie Laws - Every Generation,41,37,51,4.0,43,Every Generation,17.0,17,-8,-2,-4,1,down,1980-02-16
13841,Yellow Magic Orchestra,1980-02-16,Yellow Magic Orchestra - Yellow Magic Orchestra,51,51,39,37.0,47,Yellow Magic Orchestra,9.0,0,8,4,0,1,up,1980-02-16
13842,Yellow Magic Orchestra,1980-02-23,Yellow Magic Orchestra - Yellow Magic Orchestra,47,51,37,37.0,39,Yellow Magic Orchestra,9.0,1,2,8,4,1,up,1980-02-16
13843,Yellow Magic Orchestra,1980-03-01,Yellow Magic Orchestra - Yellow Magic Orchestra,39,47,37,37.0,37,Yellow Magic Orchestra,9.0,2,0,2,8,0,stay,1980-02-16
13844,Yellow Magic Orchestra,1980-03-08,Yellow Magic Orchestra - Yellow Magic Orchestra,37,39,43,37.0,37,Yellow Magic Orchestra,9.0,3,-6,0,2,1,down,1980-02-16
13845,Yellow Magic Orchestra,1980-03-15,Yellow Magic Orchestra - Yellow Magic Orchestra,37,37,43,37.0,43,Yellow Magic Orchestra,9.0,4,0,-6,0,0,stay,1980-02-16
13846,Yellow Magic Orchestra,1980-03-22,Yellow Magic Orchestra - Yellow Magic Orchestra,43,37,41,37.0,43,Yellow Magic Orchestra,9.0,5,2,0,-6,1,up,1980-02-16
13847,Yellow Magic Orchestra,1980-03-29,Yellow Magic Orchestra - Yellow Magic Orchestra,43,43,41,37.0,41,Yellow Magic Orchestra,9.0,6,0,2,0,0,stay,1980-02-16
13848,Yellow Magic Orchestra,1980-04-05,Yellow Magic Orchestra - Yellow Magic Orchestra,41,43,46,37.0,41,Yellow Magic Orchestra,9.0,7,-5,0,2,1,down,1980-02-16
13849,Yellow Magic Orchestra,1980-04-12,Yellow Magic Orchestra - Yellow Magic Orchestra,41,41,48,37.0,46,Yellow Magic Orchestra,9.0,8,-2,-5,0,1,down,1980-02-16
13850,Yellow Magic Orchestra,1980-04-19,Yellow Magic Orchestra - Yellow Magic Orchestra,46,41,51,37.0,48,Yellow Magic Orchestra,9.0,9,-3,-2,-5,1,down,1980-02-16
13851,Jean Cairn,1980-02-23,Jean Cairn - When I Find You Love,51,51,42,42.0,42,When I Find You Love,1.0,0,0,9,0,0,stay,1980-02-23
13852,Jean Cairn,1980-03-01,Jean Cairn - When I Find You Love,42,51,51,42.0,42,When I Find You Love,1.0,1,-9,0,9,1,down,1980-02-23
13853,Inner Life,1980-02-23,Inner Life - I'm Caught Up,51,51,47,47.0,48,I'm Caught Up,2.0,0,1,3,0,1,up,1980-02-23
13854,Inner Life,1980-03-01,Inner Life - I'm Caught Up,48,51,48,47.0,47,I'm Caught Up,2.0,1,-1,1,3,1,down,1980-02-23
13855,Inner Life,1980-03-08,Inner Life - I'm Caught Up,47,48,51,47.0,48,I'm Caught Up,2.0,2,-3,-1,1,1,down,1980-02-23
13856,Chuck Cissel,1980-02-23,Chuck Cissel - Just For You,51,51,40,39.0,50,Just For You,4.0,0,10,1,0,1,up,1980-02-23
13857,Chuck Cissel,1980-03-01,Chuck Cissel - Just For You,50,51,39,39.0,40,Just For You,4.0,1,1,10,1,1,up,1980-02-23
13858,Chuck Cissel,1980-03-08,Chuck Cissel - Just For You,40,50,45,39.0,39,Just For You,4.0,2,-6,1,10,1,down,1980-02-23
13859,Chuck Cissel,1980-03-15,Chuck Cissel - Just For You,39,40,48,39.0,45,Just For You,4.0,3,-3,-6,1,1,down,1980-02-23
13860,Chuck Cissel,1980-03-22,Chuck Cissel - Just For You,45,39,51,39.0,48,Just For You,4.0,4,-3,-3,-6,1,down,1980-02-23
13861,The Brothers Johnson,1980-03-08,The Brothers Johnson - Light Up The Night,51,51,5,1.0,30,Light Up The Night,25.0,0,25,21,0,1,up,1980-03-08
13862,The Brothers Johnson,1980-03-15,The Brothers Johnson - Light Up The Night,30,51,2,1.0,5,Light Up The Night,25.0,1,3,25,21,1,up,1980-03-08
13863,The Brothers Johnson,1980-03-22,The Brothers Johnson - Light Up The Night,5,30,2,1.0,2,Light Up The Night,25.0,2,0,3,25,0,stay,1980-03-08
13864,The Brothers Johnson,1980-03-29,The Brothers Johnson - Light Up The Night,2,5,2,1.0,2,Light Up The Night,25.0,3,0,0,3,0,stay,1980-03-08
13865,The Brothers Johnson,1980-04-05,The Brothers Johnson - Light Up The Night,2,2,2,1.0,2,Light Up The Night,25.0,4,0,0,0,0,stay,1980-03-08
13866,The Brothers Johnson,1980-04-12,The Brothers Johnson - Light Up The Night,2,2,1,1.0,2,Light Up The Night,25.0,5,1,0,0,1,up,1980-03-08
13867,The Brothers Johnson,1980-04-19,The Brothers Johnson - Light Up The Night,2,2,1,1.0,1,Light Up The Night,25.0,6,0,1,0,0,stay,1980-03-08
13868,The Brothers Johnson,1980-04-26,The Brothers Johnson - Light Up The Night,1,2,2,1.0,1,Light Up The Night,25.0,7,-1,0,1,1,down,1980-03-08
13869,The Brothers Johnson,1980-05-03,The Brothers Johnson - Light Up The Night,1,1,2,1.0,2,Light Up The Night,25.0,8,0,-1,0,0,stay,1980-03-08
13870,The Brothers Johnson,1980-05-10,The Brothers Johnson - Light Up The Night,2,1,2,1.0,2,Light Up The Night,25.0,9,0,0,-1,0,stay,1980-03-08
13871,The Brothers Johnson,1980-05-17,The Brothers Johnson - Light Up The Night,2,2,5,1.0,2,Light Up The Night,25.0,10,-3,0,0,1,down,1980-03-08
13872,The Brothers Johnson,1980-05-24,The Brothers Johnson - Light Up The Night,2,2,6,1.0,5,Light Up The Night,25.0,11,-1,-3,0,1,down,1980-03-08
13873,The Brothers Johnson,1980-05-31,The Brothers Johnson - Light Up The Night,5,2,10,1.0,6,Light Up The Night,25.0,12,-4,-1,-3,1,down,1980-03-08
13874,The Brothers Johnson,1980-06-07,The Brothers Johnson - Light Up The Night,6,5,12,1.0,10,Light Up The Night,25.0,13,-2,-4,-1,1,down,1980-03-08
13875,The Brothers Johnson,1980-06-14,The Brothers Johnson - Light Up The Night,10,6,12,1.0,12,Light Up The Night,25.0,14,0,-2,-4,0,stay,1980-03-08
13876,The Brothers Johnson,1980-06-21,The Brothers Johnson - Light Up The Night,12,10,16,1.0,12,Light Up The Night,25.0,15,-4,0,-2,1,down,1980-03-08
13877,The Brothers Johnson,1980-06-28,The Brothers Johnson - Light Up The Night,12,12,20,1.0,16,Light Up The Night,25.0,16,-4,-4,0,1,down,1980-03-08
13878,The Brothers Johnson,1980-07-05,The Brothers Johnson - Light Up The Night,16,12,21,1.0,20,Light Up The Night,25.0,17,-1,-4,-4,1,down,1980-03-08
13879,The Brothers Johnson,1980-07-12,The Brothers Johnson - Light Up The Night,20,16,29,1.0,21,Light Up The Night,25.0,18,-8,-1,-4,1,down,1980-03-08
13880,The Brothers Johnson,1980-07-19,The Brothers Johnson - Light Up The Night,21,20,30,1.0,29,Light Up The Night,25.0,19,-1,-8,-1,1,down,1980-03-08
13881,The Brothers Johnson,1980-07-26,The Brothers Johnson - Light Up The Night,29,21,42,1.0,30,Light Up The Night,25.0,20,-12,-1,-8,1,down,1980-03-08
13882,The Brothers Johnson,1980-08-02,The Brothers Johnson - Light Up The Night,30,29,48,1.0,42,Light Up The Night,25.0,21,-6,-12,-1,1,down,1980-03-08
13883,The Brothers Johnson,1980-08-09,The Brothers Johnson - Light Up The Night,42,30,48,1.0,48,Light Up The Night,25.0,22,0,-6,-12,0,stay,1980-03-08
13884,The Brothers Johnson,1980-08-16,The Brothers Johnson - Light Up The Night,48,42,48,1.0,48,Light Up The Night,25.0,23,0,0,-6,0,stay,1980-03-08
13885,The Brothers Johnson,1980-08-23,The Brothers Johnson - Light Up The Night,48,48,49,1.0,48,Light Up The Night,25.0,24,-1,0,0,1,down,1980-03-08
13886,The Brothers Johnson,1980-08-30,The Brothers Johnson - Light Up The Night,48,48,51,1.0,49,Light Up The Night,25.0,25,-2,-1,0,1,down,1980-03-08
13887,Sister Sledge,1980-03-08,Sister Sledge - Love Somebody Today,51,51,12,7.0,33,Love Somebody Today,14.0,0,21,18,0,1,up,1980-03-08
13888,Sister Sledge,1980-03-15,Sister Sledge - Love Somebody Today,33,51,8,7.0,12,Love Somebody Today,14.0,1,4,21,18,1,up,1980-03-08
13889,Sister Sledge,1980-03-22,Sister Sledge - Love Somebody Today,12,33,7,7.0,8,Love Somebody Today,14.0,2,1,4,21,1,up,1980-03-08
13890,Sister Sledge,1980-03-29,Sister Sledge - Love Somebody Today,8,12,7,7.0,7,Love Somebody Today,14.0,3,0,1,4,0,stay,1980-03-08
13891,Sister Sledge,1980-04-05,Sister Sledge - Love Somebody Today,7,8,7,7.0,7,Love Somebody Today,14.0,4,0,0,1,0,stay,1980-03-08
13892,Sister Sledge,1980-04-12,Sister Sledge - Love Somebody Today,7,7,11,7.0,7,Love Somebody Today,14.0,5,-4,0,0,1,down,1980-03-08
13893,Sister Sledge,1980-04-19,Sister Sledge - Love Somebody Today,7,7,14,7.0,11,Love Somebody Today,14.0,6,-3,-4,0,1,down,1980-03-08
13894,Sister Sledge,1980-04-26,Sister Sledge - Love Somebody Today,11,7,16,7.0,14,Love Somebody Today,14.0,7,-2,-3,-4,1,down,1980-03-08
13895,Sister Sledge,1980-05-03,Sister Sledge - Love Somebody Today,14,11,20,7.0,16,Love Somebody Today,14.0,8,-4,-2,-3,1,down,1980-03-08
13896,Sister Sledge,1980-05-10,Sister Sledge - Love Somebody Today,16,14,29,7.0,20,Love Somebody Today,14.0,9,-9,-4,-2,1,down,1980-03-08
13897,Sister Sledge,1980-05-17,Sister Sledge - Love Somebody Today,20,16,29,7.0,29,Love Somebody Today,14.0,10,0,-9,-4,0,stay,1980-03-08
13898,Sister Sledge,1980-05-24,Sister Sledge - Love Somebody Today,29,20,38,7.0,29,Love Somebody Today,14.0,11,-9,0,-9,1,down,1980-03-08
13899,Sister Sledge,1980-05-31,Sister Sledge - Love Somebody Today,29,29,38,7.0,38,Love Somebody Today,14.0,12,0,-9,0,0,stay,1980-03-08
13900,Sister Sledge,1980-06-07,Sister Sledge - Love Somebody Today,38,29,42,7.0,38,Love Somebody Today,14.0,13,-4,0,-9,1,down,1980-03-08
13901,Sister Sledge,1980-06-14,Sister Sledge - Love Somebody Today,38,38,51,7.0,42,Love Somebody Today,14.0,14,-9,-4,0,1,down,1980-03-08
13902,Chuck Mangione,1980-03-08,Chuck Mangione - Fun And Games,51,51,22,13.0,38,Fun And Games,12.0,0,16,13,0,1,up,1980-03-08
13903,Chuck Mangione,1980-03-15,Chuck Mangione - Fun And Games,38,51,18,13.0,22,Fun And Games,12.0,1,4,16,13,1,up,1980-03-08
13904,Chuck Mangione,1980-03-22,Chuck Mangione - Fun And Games,22,38,17,13.0,18,Fun And Games,12.0,2,1,4,16,1,up,1980-03-08
13905,Chuck Mangione,1980-03-29,Chuck Mangione - Fun And Games,18,22,13,13.0,17,Fun And Games,12.0,3,4,1,4,1,up,1980-03-08
13906,Chuck Mangione,1980-04-05,Chuck Mangione - Fun And Games,17,18,13,13.0,13,Fun And Games,12.0,4,0,4,1,0,stay,1980-03-08
13907,Chuck Mangione,1980-04-12,Chuck Mangione - Fun And Games,13,17,19,13.0,13,Fun And Games,12.0,5,-6,0,4,1,down,1980-03-08
13908,Chuck Mangione,1980-04-19,Chuck Mangione - Fun And Games,13,13,21,13.0,19,Fun And Games,12.0,6,-2,-6,0,1,down,1980-03-08
13909,Chuck Mangione,1980-04-26,Chuck Mangione - Fun And Games,19,13,22,13.0,21,Fun And Games,12.0,7,-1,-2,-6,1,down,1980-03-08
13910,Chuck Mangione,1980-05-03,Chuck Mangione - Fun And Games,21,19,29,13.0,22,Fun And Games,12.0,8,-7,-1,-2,1,down,1980-03-08
13911,Chuck Mangione,1980-05-10,Chuck Mangione - Fun And Games,22,21,41,13.0,29,Fun And Games,12.0,9,-12,-7,-1,1,down,1980-03-08
13912,Chuck Mangione,1980-05-17,Chuck Mangione - Fun And Games,29,22,45,13.0,41,Fun And Games,12.0,10,-4,-12,-7,1,down,1980-03-08
13913,Chuck Mangione,1980-05-24,Chuck Mangione - Fun And Games,41,29,48,13.0,45,Fun And Games,12.0,11,-3,-4,-12,1,down,1980-03-08
13914,Chuck Mangione,1980-05-31,Chuck Mangione - Fun And Games,45,41,51,13.0,48,Fun And Games,12.0,12,-3,-3,-4,1,down,1980-03-08
13915,Tavares,1980-03-08,Tavares - Supercharged,51,51,25,20.0,40,Supercharged,8.0,0,15,11,0,1,up,1980-03-08
13916,Tavares,1980-03-15,Tavares - Supercharged,40,51,21,20.0,25,Supercharged,8.0,1,4,15,11,1,up,1980-03-08
13917,Tavares,1980-03-22,Tavares - Supercharged,25,40,20,20.0,21,Supercharged,8.0,2,1,4,15,1,up,1980-03-08
13918,Tavares,1980-03-29,Tavares - Supercharged,21,25,20,20.0,20,Supercharged,8.0,3,0,1,4,0,stay,1980-03-08
13919,Tavares,1980-04-05,Tavares - Supercharged,20,21,35,20.0,20,Supercharged,8.0,4,-15,0,1,1,down,1980-03-08
13920,Tavares,1980-04-12,Tavares - Supercharged,20,20,45,20.0,35,Supercharged,8.0,5,-10,-15,0,1,down,1980-03-08
13921,Tavares,1980-04-19,Tavares - Supercharged,35,20,46,20.0,45,Supercharged,8.0,6,-1,-10,-15,1,down,1980-03-08
13922,Tavares,1980-04-26,Tavares - Supercharged,45,35,47,20.0,46,Supercharged,8.0,7,-1,-1,-10,1,down,1980-03-08
13923,Tavares,1980-05-03,Tavares - Supercharged,46,45,51,20.0,47,Supercharged,8.0,8,-4,-1,-1,1,down,1980-03-08
13924,Webster Lewis,1980-03-08,Webster Lewis - 8 For The 80's,51,51,33,21.0,43,8 For The 80's,10.0,0,10,8,0,1,up,1980-03-08
13925,Webster Lewis,1980-03-15,Webster Lewis - 8 For The 80's,43,51,26,21.0,33,8 For The 80's,10.0,1,7,10,8,1,up,1980-03-08
13926,Webster Lewis,1980-03-22,Webster Lewis - 8 For The 80's,33,43,26,21.0,26,8 For The 80's,10.0,2,0,7,10,0,stay,1980-03-08
13927,Webster Lewis,1980-03-29,Webster Lewis - 8 For The 80's,26,33,22,21.0,26,8 For The 80's,10.0,3,4,0,7,1,up,1980-03-08
13928,Webster Lewis,1980-04-05,Webster Lewis - 8 For The 80's,26,26,21,21.0,22,8 For The 80's,10.0,4,1,4,0,1,up,1980-03-08
13929,Webster Lewis,1980-04-12,Webster Lewis - 8 For The 80's,22,26,28,21.0,21,8 For The 80's,10.0,5,-7,1,4,1,down,1980-03-08
13930,Webster Lewis,1980-04-19,Webster Lewis - 8 For The 80's,21,22,28,21.0,28,8 For The 80's,10.0,6,0,-7,1,0,stay,1980-03-08
13931,Webster Lewis,1980-04-26,Webster Lewis - 8 For The 80's,28,21,36,21.0,28,8 For The 80's,10.0,7,-8,0,-7,1,down,1980-03-08
13932,Webster Lewis,1980-05-03,Webster Lewis - 8 For The 80's,28,28,36,21.0,36,8 For The 80's,10.0,8,0,-8,0,0,stay,1980-03-08
13933,Webster Lewis,1980-05-10,Webster Lewis - 8 For The 80's,36,28,42,21.0,36,8 For The 80's,10.0,9,-6,0,-8,1,down,1980-03-08
13934,Webster Lewis,1980-05-17,Webster Lewis - 8 For The 80's,36,36,51,21.0,42,8 For The 80's,10.0,10,-9,-6,0,1,down,1980-03-08
13935,Brides Of Funkenstein,1980-03-08,Brides Of Funkenstein - Never Buy Texas From A Cowboy,51,51,49,49.0,49,Never Buy Texas From A Cowboy,1.0,0,0,2,0,0,stay,1980-03-08
13936,Brides Of Funkenstein,1980-03-15,Brides Of Funkenstein - Never Buy Texas From A Cowboy,49,51,51,49.0,49,Never Buy Texas From A Cowboy,1.0,1,-2,0,2,1,down,1980-03-08
13937,Skyy,1980-03-08,Skyy - Skyway,51,51,40,17.0,50,Skyway,18.0,0,10,1,0,1,up,1980-03-08
13938,Skyy,1980-03-15,Skyy - Skyway,50,51,31,17.0,40,Skyway,18.0,1,9,10,1,1,up,1980-03-08
13939,Skyy,1980-03-22,Skyy - Skyway,40,50,25,17.0,31,Skyway,18.0,2,6,9,10,1,up,1980-03-08
13940,Skyy,1980-03-29,Skyy - Skyway,31,40,18,17.0,25,Skyway,18.0,3,7,6,9,1,up,1980-03-08
13941,Skyy,1980-04-05,Skyy - Skyway,25,31,17,17.0,18,Skyway,18.0,4,1,7,6,1,up,1980-03-08
13942,Skyy,1980-04-12,Skyy - Skyway,18,25,17,17.0,17,Skyway,18.0,5,0,1,7,0,stay,1980-03-08
13943,Skyy,1980-04-19,Skyy - Skyway,17,18,19,17.0,17,Skyway,18.0,6,-2,0,1,1,down,1980-03-08
13944,Skyy,1980-04-26,Skyy - Skyway,17,17,19,17.0,19,Skyway,18.0,7,0,-2,0,0,stay,1980-03-08
13945,Skyy,1980-05-03,Skyy - Skyway,19,17,18,17.0,19,Skyway,18.0,8,1,0,-2,1,up,1980-03-08
13946,Skyy,1980-05-10,Skyy - Skyway,19,19,17,17.0,18,Skyway,18.0,9,1,1,0,1,up,1980-03-08
13947,Skyy,1980-05-17,Skyy - Skyway,18,19,19,17.0,17,Skyway,18.0,10,-2,1,1,1,down,1980-03-08
13948,Skyy,1980-05-24,Skyy - Skyway,17,18,20,17.0,19,Skyway,18.0,11,-1,-2,1,1,down,1980-03-08
13949,Skyy,1980-05-31,Skyy - Skyway,19,17,24,17.0,20,Skyway,18.0,12,-4,-1,-2,1,down,1980-03-08
13950,Skyy,1980-06-07,Skyy - Skyway,20,19,31,17.0,24,Skyway,18.0,13,-7,-4,-1,1,down,1980-03-08
13951,Skyy,1980-06-14,Skyy - Skyway,24,20,40,17.0,31,Skyway,18.0,14,-9,-7,-4,1,down,1980-03-08
13952,Skyy,1980-06-21,Skyy - Skyway,31,24,40,17.0,40,Skyway,18.0,15,0,-9,-7,0,stay,1980-03-08
13953,Skyy,1980-06-28,Skyy - Skyway,40,31,45,17.0,40,Skyway,18.0,16,-5,0,-9,1,down,1980-03-08
13954,Skyy,1980-07-05,Skyy - Skyway,40,40,46,17.0,45,Skyway,18.0,17,-1,-5,0,1,down,1980-03-08
13955,Skyy,1980-07-12,Skyy - Skyway,45,40,51,17.0,46,Skyway,18.0,18,-5,-1,-5,1,down,1980-03-08
13956,"Grover Washington, Jr.",1980-03-15,"Grover Washington, Jr. - Skylarkin'",51,51,13,8.0,29,Skylarkin',14.0,0,16,22,0,1,up,1980-03-15
13957,"Grover Washington, Jr.",1980-03-22,"Grover Washington, Jr. - Skylarkin'",29,51,9,8.0,13,Skylarkin',14.0,1,4,16,22,1,up,1980-03-15
13958,"Grover Washington, Jr.",1980-03-29,"Grover Washington, Jr. - Skylarkin'",13,29,8,8.0,9,Skylarkin',14.0,2,1,4,16,1,up,1980-03-15
13959,"Grover Washington, Jr.",1980-04-05,"Grover Washington, Jr. - Skylarkin'",9,13,8,8.0,8,Skylarkin',14.0,3,0,1,4,0,stay,1980-03-15
13960,"Grover Washington, Jr.",1980-04-12,"Grover Washington, Jr. - Skylarkin'",8,9,8,8.0,8,Skylarkin',14.0,4,0,0,1,0,stay,1980-03-15
13961,"Grover Washington, Jr.",1980-04-19,"Grover Washington, Jr. - Skylarkin'",8,8,9,8.0,8,Skylarkin',14.0,5,-1,0,0,1,down,1980-03-15
13962,"Grover Washington, Jr.",1980-04-26,"Grover Washington, Jr. - Skylarkin'",8,8,14,8.0,9,Skylarkin',14.0,6,-5,-1,0,1,down,1980-03-15
13963,"Grover Washington, Jr.",1980-05-03,"Grover Washington, Jr. - Skylarkin'",9,8,17,8.0,14,Skylarkin',14.0,7,-3,-5,-1,1,down,1980-03-15
13964,"Grover Washington, Jr.",1980-05-10,"Grover Washington, Jr. - Skylarkin'",14,9,19,8.0,17,Skylarkin',14.0,8,-2,-3,-5,1,down,1980-03-15
13965,"Grover Washington, Jr.",1980-05-17,"Grover Washington, Jr. - Skylarkin'",17,14,22,8.0,19,Skylarkin',14.0,9,-3,-2,-3,1,down,1980-03-15
13966,"Grover Washington, Jr.",1980-05-24,"Grover Washington, Jr. - Skylarkin'",19,17,22,8.0,22,Skylarkin',14.0,10,0,-3,-2,0,stay,1980-03-15
13967,"Grover Washington, Jr.",1980-05-31,"Grover Washington, Jr. - Skylarkin'",22,19,34,8.0,22,Skylarkin',14.0,11,-12,0,-3,1,down,1980-03-15
13968,"Grover Washington, Jr.",1980-06-07,"Grover Washington, Jr. - Skylarkin'",22,22,37,8.0,34,Skylarkin',14.0,12,-3,-12,0,1,down,1980-03-15
13969,"Grover Washington, Jr.",1980-06-14,"Grover Washington, Jr. - Skylarkin'",34,22,47,8.0,37,Skylarkin',14.0,13,-10,-3,-12,1,down,1980-03-15
13970,"Grover Washington, Jr.",1980-06-21,"Grover Washington, Jr. - Skylarkin'",37,34,51,8.0,47,Skylarkin',14.0,14,-4,-10,-3,1,down,1980-03-15
13971,The Dramatics,1980-03-15,The Dramatics - 10 1/2,51,51,22,14.0,30,10 1/2,11.0,0,8,21,0,1,up,1980-03-15
13972,The Dramatics,1980-03-22,The Dramatics - 10 1/2,30,51,14,14.0,22,10 1/2,11.0,1,8,8,21,1,up,1980-03-15
13973,The Dramatics,1980-03-29,The Dramatics - 10 1/2,22,30,14,14.0,14,10 1/2,11.0,2,0,8,8,0,stay,1980-03-15
13974,The Dramatics,1980-04-05,The Dramatics - 10 1/2,14,22,14,14.0,14,10 1/2,11.0,3,0,0,8,0,stay,1980-03-15
13975,The Dramatics,1980-04-12,The Dramatics - 10 1/2,14,14,14,14.0,14,10 1/2,11.0,4,0,0,0,0,stay,1980-03-15
13976,The Dramatics,1980-04-19,The Dramatics - 10 1/2,14,14,20,14.0,14,10 1/2,11.0,5,-6,0,0,1,down,1980-03-15
13977,The Dramatics,1980-04-26,The Dramatics - 10 1/2,14,14,21,14.0,20,10 1/2,11.0,6,-1,-6,0,1,down,1980-03-15
13978,The Dramatics,1980-05-03,The Dramatics - 10 1/2,20,14,28,14.0,21,10 1/2,11.0,7,-7,-1,-6,1,down,1980-03-15
13979,The Dramatics,1980-05-10,The Dramatics - 10 1/2,21,20,32,14.0,28,10 1/2,11.0,8,-4,-7,-1,1,down,1980-03-15
13980,The Dramatics,1980-05-17,The Dramatics - 10 1/2,28,21,42,14.0,32,10 1/2,11.0,9,-10,-4,-7,1,down,1980-03-15
13981,The Dramatics,1980-05-24,The Dramatics - 10 1/2,32,28,46,14.0,42,10 1/2,11.0,10,-4,-10,-4,1,down,1980-03-15
13982,The Dramatics,1980-05-31,The Dramatics - 10 1/2,42,32,51,14.0,46,10 1/2,11.0,11,-5,-4,-10,1,down,1980-03-15
13983,Gil Scott-Heron & Brian Jackson,1980-03-15,Gil Scott-Heron & Brian Jackson - 1980,51,51,32,22.0,39,1980,9.0,0,7,12,0,1,up,1980-03-15
13984,Gil Scott-Heron & Brian Jackson,1980-03-22,Gil Scott-Heron & Brian Jackson - 1980,39,51,27,22.0,32,1980,9.0,1,5,7,12,1,up,1980-03-15
13985,Gil Scott-Heron & Brian Jackson,1980-03-29,Gil Scott-Heron & Brian Jackson - 1980,32,39,23,22.0,27,1980,9.0,2,4,5,7,1,up,1980-03-15
13986,Gil Scott-Heron & Brian Jackson,1980-04-05,Gil Scott-Heron & Brian Jackson - 1980,27,32,22,22.0,23,1980,9.0,3,1,4,5,1,up,1980-03-15
13987,Gil Scott-Heron & Brian Jackson,1980-04-12,Gil Scott-Heron & Brian Jackson - 1980,23,27,31,22.0,22,1980,9.0,4,-9,1,4,1,down,1980-03-15
13988,Gil Scott-Heron & Brian Jackson,1980-04-19,Gil Scott-Heron & Brian Jackson - 1980,22,23,35,22.0,31,1980,9.0,5,-4,-9,1,1,down,1980-03-15
13989,Gil Scott-Heron & Brian Jackson,1980-04-26,Gil Scott-Heron & Brian Jackson - 1980,31,22,38,22.0,35,1980,9.0,6,-3,-4,-9,1,down,1980-03-15
13990,Gil Scott-Heron & Brian Jackson,1980-05-03,Gil Scott-Heron & Brian Jackson - 1980,35,31,39,22.0,38,1980,9.0,7,-1,-3,-4,1,down,1980-03-15
13991,Gil Scott-Heron & Brian Jackson,1980-05-10,Gil Scott-Heron & Brian Jackson - 1980,38,35,44,22.0,39,1980,9.0,8,-5,-1,-3,1,down,1980-03-15
13992,Gil Scott-Heron & Brian Jackson,1980-05-17,Gil Scott-Heron & Brian Jackson - 1980,39,38,51,22.0,44,1980,9.0,9,-7,-5,-1,1,down,1980-03-15
13993,L.A.Boppers,1980-03-15,L.A.Boppers - L.a. Boppers,51,51,35,25.0,42,L.a. Boppers,8.0,0,7,9,0,1,up,1980-03-15
13994,L.A.Boppers,1980-03-22,L.A.Boppers - L.a. Boppers,42,51,28,25.0,35,L.a. Boppers,8.0,1,7,7,9,1,up,1980-03-15
13995,L.A.Boppers,1980-03-29,L.A.Boppers - L.a. Boppers,35,42,25,25.0,28,L.a. Boppers,8.0,2,3,7,7,1,up,1980-03-15
13996,L.A.Boppers,1980-04-05,L.A.Boppers - L.a. Boppers,28,35,25,25.0,25,L.a. Boppers,8.0,3,0,3,7,0,stay,1980-03-15
13997,L.A.Boppers,1980-04-12,L.A.Boppers - L.a. Boppers,25,28,25,25.0,25,L.a. Boppers,8.0,4,0,0,3,0,stay,1980-03-15
13998,L.A.Boppers,1980-04-19,L.A.Boppers - L.a. Boppers,25,25,26,25.0,25,L.a. Boppers,8.0,5,-1,0,0,1,down,1980-03-15
13999,L.A.Boppers,1980-04-26,L.A.Boppers - L.a. Boppers,25,25,35,25.0,26,L.a. Boppers,8.0,6,-9,-1,0,1,down,1980-03-15
14000,L.A.Boppers,1980-05-03,L.A.Boppers - L.a. Boppers,26,25,42,25.0,35,L.a. Boppers,8.0,7,-7,-9,-1,1,down,1980-03-15
14001,L.A.Boppers,1980-05-10,L.A.Boppers - L.a. Boppers,35,26,51,25.0,42,L.a. Boppers,8.0,8,-9,-7,-9,1,down,1980-03-15
14002,Andrae Crouch,1980-03-15,Andrae Crouch - I'll Be Thinking Of You,51,51,46,46.0,47,I'll Be Thinking Of You,2.0,0,1,4,0,1,up,1980-03-15
14003,Andrae Crouch,1980-03-22,Andrae Crouch - I'll Be Thinking Of You,47,51,46,46.0,46,I'll Be Thinking Of You,2.0,1,0,1,4,0,stay,1980-03-15
14004,Andrae Crouch,1980-03-29,Andrae Crouch - I'll Be Thinking Of You,46,47,51,46.0,46,I'll Be Thinking Of You,2.0,2,-5,0,1,1,down,1980-03-15
14005,Smokey Robinson,1980-03-22,Smokey Robinson - Warm Thoughts,51,51,12,4.0,24,Warm Thoughts,15.0,0,12,27,0,1,up,1980-03-22
14006,Smokey Robinson,1980-03-29,Smokey Robinson - Warm Thoughts,24,51,10,4.0,12,Warm Thoughts,15.0,1,2,12,27,1,up,1980-03-22
14007,Smokey Robinson,1980-04-05,Smokey Robinson - Warm Thoughts,12,24,6,4.0,10,Warm Thoughts,15.0,2,4,2,12,1,up,1980-03-22
14008,Smokey Robinson,1980-04-12,Smokey Robinson - Warm Thoughts,10,12,5,4.0,6,Warm Thoughts,15.0,3,1,4,2,1,up,1980-03-22
14009,Smokey Robinson,1980-04-19,Smokey Robinson - Warm Thoughts,6,10,5,4.0,5,Warm Thoughts,15.0,4,0,1,4,0,stay,1980-03-22
14010,Smokey Robinson,1980-04-26,Smokey Robinson - Warm Thoughts,5,6,4,4.0,5,Warm Thoughts,15.0,5,1,0,1,1,up,1980-03-22
14011,Smokey Robinson,1980-05-03,Smokey Robinson - Warm Thoughts,5,5,4,4.0,4,Warm Thoughts,15.0,6,0,1,0,0,stay,1980-03-22
14012,Smokey Robinson,1980-05-10,Smokey Robinson - Warm Thoughts,4,5,7,4.0,4,Warm Thoughts,15.0,7,-3,0,1,1,down,1980-03-22
14013,Smokey Robinson,1980-05-17,Smokey Robinson - Warm Thoughts,4,4,13,4.0,7,Warm Thoughts,15.0,8,-6,-3,0,1,down,1980-03-22
14014,Smokey Robinson,1980-05-24,Smokey Robinson - Warm Thoughts,7,4,14,4.0,13,Warm Thoughts,15.0,9,-1,-6,-3,1,down,1980-03-22
14015,Smokey Robinson,1980-05-31,Smokey Robinson - Warm Thoughts,13,7,17,4.0,14,Warm Thoughts,15.0,10,-3,-1,-6,1,down,1980-03-22
14016,Smokey Robinson,1980-06-07,Smokey Robinson - Warm Thoughts,14,13,19,4.0,17,Warm Thoughts,15.0,11,-2,-3,-1,1,down,1980-03-22
14017,Smokey Robinson,1980-06-14,Smokey Robinson - Warm Thoughts,17,14,27,4.0,19,Warm Thoughts,15.0,12,-8,-2,-3,1,down,1980-03-22
14018,Smokey Robinson,1980-06-21,Smokey Robinson - Warm Thoughts,19,17,50,4.0,27,Warm Thoughts,15.0,13,-23,-8,-2,1,down,1980-03-22
14019,Smokey Robinson,1980-06-28,Smokey Robinson - Warm Thoughts,27,19,50,4.0,50,Warm Thoughts,15.0,14,0,-23,-8,0,stay,1980-03-22
14020,Smokey Robinson,1980-07-05,Smokey Robinson - Warm Thoughts,50,27,51,4.0,50,Warm Thoughts,15.0,15,-1,0,-23,1,down,1980-03-22
14021,Teena Marie,1980-03-22,Teena Marie - Lady T,51,51,45,18.0,45,Lady T,19.0,0,0,6,0,0,stay,1980-03-22
14022,Teena Marie,1980-03-29,Teena Marie - Lady T,45,51,46,18.0,45,Lady T,19.0,1,-1,0,6,1,down,1980-03-22
14023,Teena Marie,1980-04-05,Teena Marie - Lady T,45,45,42,18.0,46,Lady T,19.0,2,4,-1,0,1,up,1980-03-22
14024,Teena Marie,1980-04-12,Teena Marie - Lady T,46,45,46,18.0,42,Lady T,19.0,3,-4,4,-1,1,down,1980-03-22
14025,Teena Marie,1980-04-19,Teena Marie - Lady T,42,46,44,18.0,46,Lady T,19.0,4,2,-4,4,1,up,1980-03-22
14026,Teena Marie,1980-04-26,Teena Marie - Lady T,46,42,44,18.0,44,Lady T,19.0,5,0,2,-4,0,stay,1980-03-22
14027,Teena Marie,1980-05-03,Teena Marie - Lady T,44,46,37,18.0,44,Lady T,19.0,6,7,0,2,1,up,1980-03-22
14028,Teena Marie,1980-05-10,Teena Marie - Lady T,44,44,28,18.0,37,Lady T,19.0,7,9,7,0,1,up,1980-03-22
14029,Teena Marie,1980-05-17,Teena Marie - Lady T,37,44,21,18.0,28,Lady T,19.0,8,7,9,7,1,up,1980-03-22
14030,Teena Marie,1980-05-24,Teena Marie - Lady T,28,37,21,18.0,21,Lady T,19.0,9,0,7,9,0,stay,1980-03-22
14031,Teena Marie,1980-05-31,Teena Marie - Lady T,21,28,18,18.0,21,Lady T,19.0,10,3,0,7,1,up,1980-03-22
14032,Teena Marie,1980-06-07,Teena Marie - Lady T,21,21,18,18.0,18,Lady T,19.0,11,0,3,0,0,stay,1980-03-22
14033,Teena Marie,1980-06-14,Teena Marie - Lady T,18,21,23,18.0,18,Lady T,19.0,12,-5,0,3,1,down,1980-03-22
14034,Teena Marie,1980-06-21,Teena Marie - Lady T,18,18,36,18.0,23,Lady T,19.0,13,-13,-5,0,1,down,1980-03-22
14035,Teena Marie,1980-06-28,Teena Marie - Lady T,23,18,35,18.0,36,Lady T,19.0,14,1,-13,-5,1,up,1980-03-22
14036,Teena Marie,1980-07-05,Teena Marie - Lady T,36,23,35,18.0,35,Lady T,19.0,15,0,1,-13,0,stay,1980-03-22
14037,Teena Marie,1980-07-12,Teena Marie - Lady T,35,36,36,18.0,35,Lady T,19.0,16,-1,0,1,1,down,1980-03-22
14038,Teena Marie,1980-07-19,Teena Marie - Lady T,35,35,37,18.0,36,Lady T,19.0,17,-1,-1,0,1,down,1980-03-22
14039,Teena Marie,1980-07-26,Teena Marie - Lady T,36,35,43,18.0,37,Lady T,19.0,18,-6,-1,-1,1,down,1980-03-22
14040,Teena Marie,1980-08-02,Teena Marie - Lady T,37,36,51,18.0,43,Lady T,19.0,19,-8,-6,-1,1,down,1980-03-22
14041,The Controllers,1980-03-22,The Controllers - Next In Line,51,51,47,47.0,47,Next In Line,1.0,0,0,4,0,0,stay,1980-03-22
14042,The Controllers,1980-03-29,The Controllers - Next In Line,47,51,51,47.0,47,Next In Line,1.0,1,-4,0,4,1,down,1980-03-22
14043,Stone City Band,1980-03-22,Stone City Band - In 'n' Out,51,51,40,30.0,50,In 'n' Out,5.0,0,10,1,0,1,up,1980-03-22
14044,Stone City Band,1980-03-29,Stone City Band - In 'n' Out,50,51,40,30.0,40,In 'n' Out,5.0,1,0,10,1,0,stay,1980-03-22
14045,Stone City Band,1980-04-05,Stone City Band - In 'n' Out,40,50,30,30.0,40,In 'n' Out,5.0,2,10,0,10,1,up,1980-03-22
14046,Stone City Band,1980-04-12,Stone City Band - In 'n' Out,40,40,30,30.0,30,In 'n' Out,5.0,3,0,10,0,0,stay,1980-03-22
14047,Stone City Band,1980-04-19,Stone City Band - In 'n' Out,30,40,48,30.0,30,In 'n' Out,5.0,4,-18,0,10,1,down,1980-03-22
14048,Stone City Band,1980-04-26,Stone City Band - In 'n' Out,30,30,51,30.0,48,In 'n' Out,5.0,5,-3,-18,0,1,down,1980-03-22
14049,Harold Melvin And The Blue Notes,1980-03-29,Harold Melvin And The Blue Notes - The Blue Album,51,51,26,15.0,32,The Blue Album,19.0,0,6,19,0,1,up,1980-03-29
14050,Harold Melvin And The Blue Notes,1980-04-05,Harold Melvin And The Blue Notes - The Blue Album,32,51,23,15.0,26,The Blue Album,19.0,1,3,6,19,1,up,1980-03-29
14051,Harold Melvin And The Blue Notes,1980-04-12,Harold Melvin And The Blue Notes - The Blue Album,26,32,18,15.0,23,The Blue Album,19.0,2,5,3,6,1,up,1980-03-29
14052,Harold Melvin And The Blue Notes,1980-04-19,Harold Melvin And The Blue Notes - The Blue Album,23,26,15,15.0,18,The Blue Album,19.0,3,3,5,3,1,up,1980-03-29
14053,Harold Melvin And The Blue Notes,1980-04-26,Harold Melvin And The Blue Notes - The Blue Album,18,23,15,15.0,15,The Blue Album,19.0,4,0,3,5,0,stay,1980-03-29
14054,Harold Melvin And The Blue Notes,1980-05-03,Harold Melvin And The Blue Notes - The Blue Album,15,18,19,15.0,15,The Blue Album,19.0,5,-4,0,3,1,down,1980-03-29
14055,Harold Melvin And The Blue Notes,1980-05-10,Harold Melvin And The Blue Notes - The Blue Album,15,15,20,15.0,19,The Blue Album,19.0,6,-1,-4,0,1,down,1980-03-29
14056,Harold Melvin And The Blue Notes,1980-05-17,Harold Melvin And The Blue Notes - The Blue Album,19,15,28,15.0,20,The Blue Album,19.0,7,-8,-1,-4,1,down,1980-03-29
14057,Harold Melvin And The Blue Notes,1980-05-24,Harold Melvin And The Blue Notes - The Blue Album,20,19,26,15.0,28,The Blue Album,19.0,8,2,-8,-1,1,up,1980-03-29
14058,Harold Melvin And The Blue Notes,1980-05-31,Harold Melvin And The Blue Notes - The Blue Album,28,20,26,15.0,26,The Blue Album,19.0,9,0,2,-8,0,stay,1980-03-29
14059,Harold Melvin And The Blue Notes,1980-06-07,Harold Melvin And The Blue Notes - The Blue Album,26,28,26,15.0,26,The Blue Album,19.0,10,0,0,2,0,stay,1980-03-29
14060,Harold Melvin And The Blue Notes,1980-06-14,Harold Melvin And The Blue Notes - The Blue Album,26,26,25,15.0,26,The Blue Album,19.0,11,1,0,0,1,up,1980-03-29
14061,Harold Melvin And The Blue Notes,1980-06-21,Harold Melvin And The Blue Notes - The Blue Album,26,26,39,15.0,25,The Blue Album,19.0,12,-14,1,0,1,down,1980-03-29
14062,Harold Melvin And The Blue Notes,1980-06-28,Harold Melvin And The Blue Notes - The Blue Album,25,26,39,15.0,39,The Blue Album,19.0,13,0,-14,1,0,stay,1980-03-29
14063,Harold Melvin And The Blue Notes,1980-07-05,Harold Melvin And The Blue Notes - The Blue Album,39,25,38,15.0,39,The Blue Album,19.0,14,1,0,-14,1,up,1980-03-29
14064,Harold Melvin And The Blue Notes,1980-07-12,Harold Melvin And The Blue Notes - The Blue Album,39,39,37,15.0,38,The Blue Album,19.0,15,1,1,0,1,up,1980-03-29
14065,Harold Melvin And The Blue Notes,1980-07-19,Harold Melvin And The Blue Notes - The Blue Album,38,39,36,15.0,37,The Blue Album,19.0,16,1,1,1,1,up,1980-03-29
14066,Harold Melvin And The Blue Notes,1980-07-26,Harold Melvin And The Blue Notes - The Blue Album,37,38,36,15.0,36,The Blue Album,19.0,17,0,1,1,0,stay,1980-03-29
14067,Harold Melvin And The Blue Notes,1980-08-02,Harold Melvin And The Blue Notes - The Blue Album,36,37,39,15.0,36,The Blue Album,19.0,18,-3,0,1,1,down,1980-03-29
14068,Harold Melvin And The Blue Notes,1980-08-09,Harold Melvin And The Blue Notes - The Blue Album,36,36,51,15.0,39,The Blue Album,19.0,19,-12,-3,0,1,down,1980-03-29
14069,Roberta Flack Featuring Donny Hathaway,1980-03-29,Roberta Flack Featuring Donny Hathaway - Roberta Flack Featuring Donny Hathaway,51,51,19,4.0,50,Roberta Flack Featuring Donny Hathaway,22.0,0,31,1,0,1,up,1980-03-29
14070,Roberta Flack Featuring Donny Hathaway,1980-04-05,Roberta Flack Featuring Donny Hathaway - Roberta Flack Featuring Donny Hathaway,50,51,12,4.0,19,Roberta Flack Featuring Donny Hathaway,22.0,1,7,31,1,1,up,1980-03-29
14071,Roberta Flack Featuring Donny Hathaway,1980-04-12,Roberta Flack Featuring Donny Hathaway - Roberta Flack Featuring Donny Hathaway,19,50,10,4.0,12,Roberta Flack Featuring Donny Hathaway,22.0,2,2,7,31,1,up,1980-03-29
14072,Roberta Flack Featuring Donny Hathaway,1980-04-19,Roberta Flack Featuring Donny Hathaway - Roberta Flack Featuring Donny Hathaway,12,19,7,4.0,10,Roberta Flack Featuring Donny Hathaway,22.0,3,3,2,7,1,up,1980-03-29
14073,Roberta Flack Featuring Donny Hathaway,1980-04-26,Roberta Flack Featuring Donny Hathaway - Roberta Flack Featuring Donny Hathaway,10,12,6,4.0,7,Roberta Flack Featuring Donny Hathaway,22.0,4,1,3,2,1,up,1980-03-29
14074,Roberta Flack Featuring Donny Hathaway,1980-05-03,Roberta Flack Featuring Donny Hathaway - Roberta Flack Featuring Donny Hathaway,7,10,5,4.0,6,Roberta Flack Featuring Donny Hathaway,22.0,5,1,1,3,1,up,1980-03-29
14075,Roberta Flack Featuring Donny Hathaway,1980-05-10,Roberta Flack Featuring Donny Hathaway - Roberta Flack Featuring Donny Hathaway,6,7,4,4.0,5,Roberta Flack Featuring Donny Hathaway,22.0,6,1,1,1,1,up,1980-03-29
14076,Roberta Flack Featuring Donny Hathaway,1980-05-17,Roberta Flack Featuring Donny Hathaway - Roberta Flack Featuring Donny Hathaway,5,6,4,4.0,4,Roberta Flack Featuring Donny Hathaway,22.0,7,0,1,1,0,stay,1980-03-29
14077,Roberta Flack Featuring Donny Hathaway,1980-05-24,Roberta Flack Featuring Donny Hathaway - Roberta Flack Featuring Donny Hathaway,4,5,4,4.0,4,Roberta Flack Featuring Donny Hathaway,22.0,8,0,0,1,0,stay,1980-03-29
14078,Roberta Flack Featuring Donny Hathaway,1980-05-31,Roberta Flack Featuring Donny Hathaway - Roberta Flack Featuring Donny Hathaway,4,4,4,4.0,4,Roberta Flack Featuring Donny Hathaway,22.0,9,0,0,0,0,stay,1980-03-29
14079,Roberta Flack Featuring Donny Hathaway,1980-06-07,Roberta Flack Featuring Donny Hathaway - Roberta Flack Featuring Donny Hathaway,4,4,4,4.0,4,Roberta Flack Featuring Donny Hathaway,22.0,10,0,0,0,0,stay,1980-03-29
14080,Roberta Flack Featuring Donny Hathaway,1980-06-14,Roberta Flack Featuring Donny Hathaway - Roberta Flack Featuring Donny Hathaway,4,4,4,4.0,4,Roberta Flack Featuring Donny Hathaway,22.0,11,0,0,0,0,stay,1980-03-29
14081,Roberta Flack Featuring Donny Hathaway,1980-06-21,Roberta Flack Featuring Donny Hathaway - Roberta Flack Featuring Donny Hathaway,4,4,8,4.0,4,Roberta Flack Featuring Donny Hathaway,22.0,12,-4,0,0,1,down,1980-03-29
14082,Roberta Flack Featuring Donny Hathaway,1980-06-28,Roberta Flack Featuring Donny Hathaway - Roberta Flack Featuring Donny Hathaway,4,4,14,4.0,8,Roberta Flack Featuring Donny Hathaway,22.0,13,-6,-4,0,1,down,1980-03-29
14083,Roberta Flack Featuring Donny Hathaway,1980-07-05,Roberta Flack Featuring Donny Hathaway - Roberta Flack Featuring Donny Hathaway,8,4,14,4.0,14,Roberta Flack Featuring Donny Hathaway,22.0,14,0,-6,-4,0,stay,1980-03-29
14084,Roberta Flack Featuring Donny Hathaway,1980-07-12,Roberta Flack Featuring Donny Hathaway - Roberta Flack Featuring Donny Hathaway,14,8,19,4.0,14,Roberta Flack Featuring Donny Hathaway,22.0,15,-5,0,-6,1,down,1980-03-29
14085,Roberta Flack Featuring Donny Hathaway,1980-07-19,Roberta Flack Featuring Donny Hathaway - Roberta Flack Featuring Donny Hathaway,14,14,21,4.0,19,Roberta Flack Featuring Donny Hathaway,22.0,16,-2,-5,0,1,down,1980-03-29
14086,Roberta Flack Featuring Donny Hathaway,1980-07-26,Roberta Flack Featuring Donny Hathaway - Roberta Flack Featuring Donny Hathaway,19,14,22,4.0,21,Roberta Flack Featuring Donny Hathaway,22.0,17,-1,-2,-5,1,down,1980-03-29
14087,Roberta Flack Featuring Donny Hathaway,1980-08-02,Roberta Flack Featuring Donny Hathaway - Roberta Flack Featuring Donny Hathaway,21,19,33,4.0,22,Roberta Flack Featuring Donny Hathaway,22.0,18,-11,-1,-2,1,down,1980-03-29
14088,Roberta Flack Featuring Donny Hathaway,1980-08-09,Roberta Flack Featuring Donny Hathaway - Roberta Flack Featuring Donny Hathaway,22,21,37,4.0,33,Roberta Flack Featuring Donny Hathaway,22.0,19,-4,-11,-1,1,down,1980-03-29
14089,Roberta Flack Featuring Donny Hathaway,1980-08-16,Roberta Flack Featuring Donny Hathaway - Roberta Flack Featuring Donny Hathaway,33,22,46,4.0,37,Roberta Flack Featuring Donny Hathaway,22.0,20,-9,-4,-11,1,down,1980-03-29
14090,Roberta Flack Featuring Donny Hathaway,1980-08-23,Roberta Flack Featuring Donny Hathaway - Roberta Flack Featuring Donny Hathaway,37,33,48,4.0,46,Roberta Flack Featuring Donny Hathaway,22.0,21,-2,-9,-4,1,down,1980-03-29
14091,Roberta Flack Featuring Donny Hathaway,1980-08-30,Roberta Flack Featuring Donny Hathaway - Roberta Flack Featuring Donny Hathaway,46,37,51,4.0,48,Roberta Flack Featuring Donny Hathaway,22.0,22,-3,-2,-9,1,down,1980-03-29
14092,Lipps Inc.,1980-04-05,Lipps Inc. - Mouth To Mouth,51,51,26,5.0,33,Mouth To Mouth,20.0,0,7,18,0,1,up,1980-04-05
14093,Lipps Inc.,1980-04-12,Lipps Inc. - Mouth To Mouth,33,51,21,5.0,26,Mouth To Mouth,20.0,1,5,7,18,1,up,1980-04-05
14094,Lipps Inc.,1980-04-19,Lipps Inc. - Mouth To Mouth,26,33,18,5.0,21,Mouth To Mouth,20.0,2,3,5,7,1,up,1980-04-05
14095,Lipps Inc.,1980-04-26,Lipps Inc. - Mouth To Mouth,21,26,13,5.0,18,Mouth To Mouth,20.0,3,5,3,5,1,up,1980-04-05
14096,Lipps Inc.,1980-05-03,Lipps Inc. - Mouth To Mouth,18,21,11,5.0,13,Mouth To Mouth,20.0,4,2,5,3,1,up,1980-04-05
14097,Lipps Inc.,1980-05-10,Lipps Inc. - Mouth To Mouth,13,18,10,5.0,11,Mouth To Mouth,20.0,5,1,2,5,1,up,1980-04-05
14098,Lipps Inc.,1980-05-17,Lipps Inc. - Mouth To Mouth,11,13,7,5.0,10,Mouth To Mouth,20.0,6,3,1,2,1,up,1980-04-05
14099,Lipps Inc.,1980-05-24,Lipps Inc. - Mouth To Mouth,10,11,5,5.0,7,Mouth To Mouth,20.0,7,2,3,1,1,up,1980-04-05
14100,Lipps Inc.,1980-05-31,Lipps Inc. - Mouth To Mouth,7,10,5,5.0,5,Mouth To Mouth,20.0,8,0,2,3,0,stay,1980-04-05
14101,Lipps Inc.,1980-06-07,Lipps Inc. - Mouth To Mouth,5,7,5,5.0,5,Mouth To Mouth,20.0,9,0,0,2,0,stay,1980-04-05
14102,Lipps Inc.,1980-06-14,Lipps Inc. - Mouth To Mouth,5,5,9,5.0,5,Mouth To Mouth,20.0,10,-4,0,0,1,down,1980-04-05
14103,Lipps Inc.,1980-06-21,Lipps Inc. - Mouth To Mouth,5,5,9,5.0,9,Mouth To Mouth,20.0,11,0,-4,0,0,stay,1980-04-05
14104,Lipps Inc.,1980-06-28,Lipps Inc. - Mouth To Mouth,9,5,13,5.0,9,Mouth To Mouth,20.0,12,-4,0,-4,1,down,1980-04-05
14105,Lipps Inc.,1980-07-05,Lipps Inc. - Mouth To Mouth,9,9,15,5.0,13,Mouth To Mouth,20.0,13,-2,-4,0,1,down,1980-04-05
14106,Lipps Inc.,1980-07-12,Lipps Inc. - Mouth To Mouth,13,9,20,5.0,15,Mouth To Mouth,20.0,14,-5,-2,-4,1,down,1980-04-05
14107,Lipps Inc.,1980-07-19,Lipps Inc. - Mouth To Mouth,15,13,28,5.0,20,Mouth To Mouth,20.0,15,-8,-5,-2,1,down,1980-04-05
14108,Lipps Inc.,1980-07-26,Lipps Inc. - Mouth To Mouth,20,15,29,5.0,28,Mouth To Mouth,20.0,16,-1,-8,-5,1,down,1980-04-05
14109,Lipps Inc.,1980-08-02,Lipps Inc. - Mouth To Mouth,28,20,42,5.0,29,Mouth To Mouth,20.0,17,-13,-1,-8,1,down,1980-04-05
14110,Lipps Inc.,1980-08-09,Lipps Inc. - Mouth To Mouth,29,28,46,5.0,42,Mouth To Mouth,20.0,18,-4,-13,-1,1,down,1980-04-05
14111,Lipps Inc.,1980-08-16,Lipps Inc. - Mouth To Mouth,42,29,49,5.0,46,Mouth To Mouth,20.0,19,-3,-4,-13,1,down,1980-04-05
14112,Lipps Inc.,1980-08-23,Lipps Inc. - Mouth To Mouth,46,42,51,5.0,49,Mouth To Mouth,20.0,20,-2,-3,-4,1,down,1980-04-05
14113,Kleeer,1980-04-05,Kleeer - Winners,51,51,37,24.0,43,Winners,13.0,0,6,8,0,1,up,1980-04-05
14114,Kleeer,1980-04-12,Kleeer - Winners,43,51,36,24.0,37,Winners,13.0,1,1,6,8,1,up,1980-04-05
14115,Kleeer,1980-04-19,Kleeer - Winners,37,43,41,24.0,36,Winners,13.0,2,-5,1,6,1,down,1980-04-05
14116,Kleeer,1980-04-26,Kleeer - Winners,36,37,42,24.0,41,Winners,13.0,3,-1,-5,1,1,down,1980-04-05
14117,Kleeer,1980-05-03,Kleeer - Winners,41,36,41,24.0,42,Winners,13.0,4,1,-1,-5,1,up,1980-04-05
14118,Kleeer,1980-05-10,Kleeer - Winners,42,41,39,24.0,41,Winners,13.0,5,2,1,-1,1,up,1980-04-05
14119,Kleeer,1980-05-17,Kleeer - Winners,41,42,33,24.0,39,Winners,13.0,6,6,2,1,1,up,1980-04-05
14120,Kleeer,1980-05-24,Kleeer - Winners,39,41,31,24.0,33,Winners,13.0,7,2,6,2,1,up,1980-04-05
14121,Kleeer,1980-05-31,Kleeer - Winners,33,39,25,24.0,31,Winners,13.0,8,6,2,6,1,up,1980-04-05
14122,Kleeer,1980-06-07,Kleeer - Winners,31,33,24,24.0,25,Winners,13.0,9,1,6,2,1,up,1980-04-05
14123,Kleeer,1980-06-14,Kleeer - Winners,25,31,30,24.0,24,Winners,13.0,10,-6,1,6,1,down,1980-04-05
14124,Kleeer,1980-06-21,Kleeer - Winners,24,25,46,24.0,30,Winners,13.0,11,-16,-6,1,1,down,1980-04-05
14125,Kleeer,1980-06-28,Kleeer - Winners,30,24,49,24.0,46,Winners,13.0,12,-3,-16,-6,1,down,1980-04-05
14126,Kleeer,1980-07-05,Kleeer - Winners,46,30,51,24.0,49,Winners,13.0,13,-2,-3,-16,1,down,1980-04-05
14127,Mass Production,1980-04-05,Mass Production - Massterpiece,51,51,38,24.0,45,Massterpiece,11.0,0,7,6,0,1,up,1980-04-05
14128,Mass Production,1980-04-12,Mass Production - Massterpiece,45,51,32,24.0,38,Massterpiece,11.0,1,6,7,6,1,up,1980-04-05
14129,Mass Production,1980-04-19,Mass Production - Massterpiece,38,45,30,24.0,32,Massterpiece,11.0,2,2,6,7,1,up,1980-04-05
14130,Mass Production,1980-04-26,Mass Production - Massterpiece,32,38,28,24.0,30,Massterpiece,11.0,3,2,2,6,1,up,1980-04-05
14131,Mass Production,1980-05-03,Mass Production - Massterpiece,30,32,27,24.0,28,Massterpiece,11.0,4,1,2,2,1,up,1980-04-05
14132,Mass Production,1980-05-10,Mass Production - Massterpiece,28,30,26,24.0,27,Massterpiece,11.0,5,1,1,2,1,up,1980-04-05
14133,Mass Production,1980-05-17,Mass Production - Massterpiece,27,28,24,24.0,26,Massterpiece,11.0,6,2,1,1,1,up,1980-04-05
14134,Mass Production,1980-05-24,Mass Production - Massterpiece,26,27,24,24.0,24,Massterpiece,11.0,7,0,2,1,0,stay,1980-04-05
14135,Mass Production,1980-05-31,Mass Production - Massterpiece,24,26,27,24.0,24,Massterpiece,11.0,8,-3,0,2,1,down,1980-04-05
14136,Mass Production,1980-06-07,Mass Production - Massterpiece,24,24,32,24.0,27,Massterpiece,11.0,9,-5,-3,0,1,down,1980-04-05
14137,Mass Production,1980-06-14,Mass Production - Massterpiece,27,24,42,24.0,32,Massterpiece,11.0,10,-10,-5,-3,1,down,1980-04-05
14138,Mass Production,1980-06-21,Mass Production - Massterpiece,32,27,51,24.0,42,Massterpiece,11.0,11,-9,-10,-5,1,down,1980-04-05
14139,Spyro Gyra,1980-04-05,Spyro Gyra - Catching The Sun,51,51,39,23.0,49,Catching The Sun,11.0,0,10,2,0,1,up,1980-04-05
14140,Spyro Gyra,1980-04-12,Spyro Gyra - Catching The Sun,49,51,33,23.0,39,Catching The Sun,11.0,1,6,10,2,1,up,1980-04-05
14141,Spyro Gyra,1980-04-19,Spyro Gyra - Catching The Sun,39,49,27,23.0,33,Catching The Sun,11.0,2,6,6,10,1,up,1980-04-05
14142,Spyro Gyra,1980-04-26,Spyro Gyra - Catching The Sun,33,39,23,23.0,27,Catching The Sun,11.0,3,4,6,6,1,up,1980-04-05
14143,Spyro Gyra,1980-05-03,Spyro Gyra - Catching The Sun,27,33,23,23.0,23,Catching The Sun,11.0,4,0,4,6,0,stay,1980-04-05
14144,Spyro Gyra,1980-05-10,Spyro Gyra - Catching The Sun,23,27,35,23.0,23,Catching The Sun,11.0,5,-12,0,4,1,down,1980-04-05
14145,Spyro Gyra,1980-05-17,Spyro Gyra - Catching The Sun,23,23,39,23.0,35,Catching The Sun,11.0,6,-4,-12,0,1,down,1980-04-05
14146,Spyro Gyra,1980-05-24,Spyro Gyra - Catching The Sun,35,23,40,23.0,39,Catching The Sun,11.0,7,-1,-4,-12,1,down,1980-04-05
14147,Spyro Gyra,1980-05-31,Spyro Gyra - Catching The Sun,39,35,42,23.0,40,Catching The Sun,11.0,8,-2,-1,-4,1,down,1980-04-05
14148,Spyro Gyra,1980-06-07,Spyro Gyra - Catching The Sun,40,39,41,23.0,42,Catching The Sun,11.0,9,1,-2,-1,1,up,1980-04-05
14149,Spyro Gyra,1980-06-14,Spyro Gyra - Catching The Sun,42,40,43,23.0,41,Catching The Sun,11.0,10,-2,1,-2,1,down,1980-04-05
14150,Spyro Gyra,1980-06-21,Spyro Gyra - Catching The Sun,41,42,51,23.0,43,Catching The Sun,11.0,11,-8,-2,1,1,down,1980-04-05
14151,Randy Brown,1980-04-05,Randy Brown - Midnight Desire,51,51,50,50.0,50,Midnight Desire,1.0,0,0,1,0,0,stay,1980-04-05
14152,Randy Brown,1980-04-12,Randy Brown - Midnight Desire,50,51,51,50.0,50,Midnight Desire,1.0,1,-1,0,1,1,down,1980-04-05
14153,GQ,1980-04-12,GQ - Two,51,51,13,9.0,27,Two,18.0,0,14,24,0,1,up,1980-04-12
14154,GQ,1980-04-19,GQ - Two,27,51,11,9.0,13,Two,18.0,1,2,14,24,1,up,1980-04-12
14155,GQ,1980-04-26,GQ - Two,13,27,9,9.0,11,Two,18.0,2,2,2,14,1,up,1980-04-12
14156,GQ,1980-05-03,GQ - Two,11,13,9,9.0,9,Two,18.0,3,0,2,2,0,stay,1980-04-12
14157,GQ,1980-05-10,GQ - Two,9,11,9,9.0,9,Two,18.0,4,0,0,2,0,stay,1980-04-12
14158,GQ,1980-05-17,GQ - Two,9,9,16,9.0,9,Two,18.0,5,-7,0,0,1,down,1980-04-12
14159,GQ,1980-05-24,GQ - Two,9,9,17,9.0,16,Two,18.0,6,-1,-7,0,1,down,1980-04-12
14160,GQ,1980-05-31,GQ - Two,16,9,19,9.0,17,Two,18.0,7,-2,-1,-7,1,down,1980-04-12
14161,GQ,1980-06-07,GQ - Two,17,16,21,9.0,19,Two,18.0,8,-2,-2,-1,1,down,1980-04-12
14162,GQ,1980-06-14,GQ - Two,19,17,20,9.0,21,Two,18.0,9,1,-2,-2,1,up,1980-04-12
14163,GQ,1980-06-21,GQ - Two,21,19,20,9.0,20,Two,18.0,10,0,1,-2,0,stay,1980-04-12
14164,GQ,1980-06-28,GQ - Two,20,21,27,9.0,20,Two,18.0,11,-7,0,1,1,down,1980-04-12
14165,GQ,1980-07-05,GQ - Two,20,20,28,9.0,27,Two,18.0,12,-1,-7,0,1,down,1980-04-12
14166,GQ,1980-07-12,GQ - Two,27,20,32,9.0,28,Two,18.0,13,-4,-1,-7,1,down,1980-04-12
14167,GQ,1980-07-19,GQ - Two,28,27,33,9.0,32,Two,18.0,14,-1,-4,-1,1,down,1980-04-12
14168,GQ,1980-07-26,GQ - Two,32,28,38,9.0,33,Two,18.0,15,-5,-1,-4,1,down,1980-04-12
14169,GQ,1980-08-02,GQ - Two,33,32,43,9.0,38,Two,18.0,16,-5,-5,-1,1,down,1980-04-12
14170,GQ,1980-08-09,GQ - Two,38,33,47,9.0,43,Two,18.0,17,-4,-5,-5,1,down,1980-04-12
14171,GQ,1980-08-16,GQ - Two,43,38,51,9.0,47,Two,18.0,18,-4,-4,-5,1,down,1980-04-12
14172,Jermaine Jackson,1980-04-12,Jermaine Jackson - Let's Get Serious,51,51,23,1.0,41,Let's Get Serious,25.0,0,18,10,0,1,up,1980-04-12
14173,Jermaine Jackson,1980-04-19,Jermaine Jackson - Let's Get Serious,41,51,13,1.0,23,Let's Get Serious,25.0,1,10,18,10,1,up,1980-04-12
14174,Jermaine Jackson,1980-04-26,Jermaine Jackson - Let's Get Serious,23,41,7,1.0,13,Let's Get Serious,25.0,2,6,10,18,1,up,1980-04-12
14175,Jermaine Jackson,1980-05-03,Jermaine Jackson - Let's Get Serious,13,23,6,1.0,7,Let's Get Serious,25.0,3,1,6,10,1,up,1980-04-12
14176,Jermaine Jackson,1980-05-10,Jermaine Jackson - Let's Get Serious,7,13,3,1.0,6,Let's Get Serious,25.0,4,3,1,6,1,up,1980-04-12
14177,Jermaine Jackson,1980-05-17,Jermaine Jackson - Let's Get Serious,6,7,2,1.0,3,Let's Get Serious,25.0,5,1,3,1,1,up,1980-04-12
14178,Jermaine Jackson,1980-05-24,Jermaine Jackson - Let's Get Serious,3,6,2,1.0,2,Let's Get Serious,25.0,6,0,1,3,0,stay,1980-04-12
14179,Jermaine Jackson,1980-05-31,Jermaine Jackson - Let's Get Serious,2,3,1,1.0,2,Let's Get Serious,25.0,7,1,0,1,1,up,1980-04-12
14180,Jermaine Jackson,1980-06-07,Jermaine Jackson - Let's Get Serious,2,2,1,1.0,1,Let's Get Serious,25.0,8,0,1,0,0,stay,1980-04-12
14181,Jermaine Jackson,1980-06-14,Jermaine Jackson - Let's Get Serious,1,2,1,1.0,1,Let's Get Serious,25.0,9,0,0,1,0,stay,1980-04-12
14182,Jermaine Jackson,1980-06-21,Jermaine Jackson - Let's Get Serious,1,1,1,1.0,1,Let's Get Serious,25.0,10,0,0,0,0,stay,1980-04-12
14183,Jermaine Jackson,1980-06-28,Jermaine Jackson - Let's Get Serious,1,1,1,1.0,1,Let's Get Serious,25.0,11,0,0,0,0,stay,1980-04-12
14184,Jermaine Jackson,1980-07-05,Jermaine Jackson - Let's Get Serious,1,1,2,1.0,1,Let's Get Serious,25.0,12,-1,0,0,1,down,1980-04-12
14185,Jermaine Jackson,1980-07-12,Jermaine Jackson - Let's Get Serious,1,1,5,1.0,2,Let's Get Serious,25.0,13,-3,-1,0,1,down,1980-04-12
14186,Jermaine Jackson,1980-07-19,Jermaine Jackson - Let's Get Serious,2,1,5,1.0,5,Let's Get Serious,25.0,14,0,-3,-1,0,stay,1980-04-12
14187,Jermaine Jackson,1980-07-26,Jermaine Jackson - Let's Get Serious,5,2,7,1.0,5,Let's Get Serious,25.0,15,-2,0,-3,1,down,1980-04-12
14188,Jermaine Jackson,1980-08-02,Jermaine Jackson - Let's Get Serious,5,5,10,1.0,7,Let's Get Serious,25.0,16,-3,-2,0,1,down,1980-04-12
14189,Jermaine Jackson,1980-08-09,Jermaine Jackson - Let's Get Serious,7,5,15,1.0,10,Let's Get Serious,25.0,17,-5,-3,-2,1,down,1980-04-12
14190,Jermaine Jackson,1980-08-16,Jermaine Jackson - Let's Get Serious,10,7,15,1.0,15,Let's Get Serious,25.0,18,0,-5,-3,0,stay,1980-04-12
14191,Jermaine Jackson,1980-08-23,Jermaine Jackson - Let's Get Serious,15,10,24,1.0,15,Let's Get Serious,25.0,19,-9,0,-5,1,down,1980-04-12
14192,Jermaine Jackson,1980-08-30,Jermaine Jackson - Let's Get Serious,15,15,30,1.0,24,Let's Get Serious,25.0,20,-6,-9,0,1,down,1980-04-12
14193,Jermaine Jackson,1980-09-06,Jermaine Jackson - Let's Get Serious,24,15,35,1.0,30,Let's Get Serious,25.0,21,-5,-6,-9,1,down,1980-04-12
14194,Jermaine Jackson,1980-09-13,Jermaine Jackson - Let's Get Serious,30,24,36,1.0,35,Let's Get Serious,25.0,22,-1,-5,-6,1,down,1980-04-12
14195,Jermaine Jackson,1980-09-20,Jermaine Jackson - Let's Get Serious,35,30,38,1.0,36,Let's Get Serious,25.0,23,-2,-1,-5,1,down,1980-04-12
14196,Jermaine Jackson,1980-09-27,Jermaine Jackson - Let's Get Serious,36,35,45,1.0,38,Let's Get Serious,25.0,24,-7,-2,-1,1,down,1980-04-12
14197,Jermaine Jackson,1980-10-04,Jermaine Jackson - Let's Get Serious,38,36,51,1.0,45,Let's Get Serious,25.0,25,-6,-7,-2,1,down,1980-04-12
14198,David Sanborn,1980-04-12,David Sanborn - Hideaway,51,51,41,33.0,48,Hideaway,9.0,0,7,3,0,1,up,1980-04-12
14199,David Sanborn,1980-04-19,David Sanborn - Hideaway,48,51,40,33.0,41,Hideaway,9.0,1,1,7,3,1,up,1980-04-12
14200,David Sanborn,1980-04-26,David Sanborn - Hideaway,41,48,34,33.0,40,Hideaway,9.0,2,6,1,7,1,up,1980-04-12
14201,David Sanborn,1980-05-03,David Sanborn - Hideaway,40,41,33,33.0,34,Hideaway,9.0,3,1,6,1,1,up,1980-04-12
14202,David Sanborn,1980-05-10,David Sanborn - Hideaway,34,40,33,33.0,33,Hideaway,9.0,4,0,1,6,0,stay,1980-04-12
14203,David Sanborn,1980-05-17,David Sanborn - Hideaway,33,34,40,33.0,33,Hideaway,9.0,5,-7,0,1,1,down,1980-04-12
14204,David Sanborn,1980-05-24,David Sanborn - Hideaway,33,33,41,33.0,40,Hideaway,9.0,6,-1,-7,0,1,down,1980-04-12
14205,David Sanborn,1980-05-31,David Sanborn - Hideaway,40,33,44,33.0,41,Hideaway,9.0,7,-3,-1,-7,1,down,1980-04-12
14206,David Sanborn,1980-06-07,David Sanborn - Hideaway,41,40,44,33.0,44,Hideaway,9.0,8,0,-3,-1,0,stay,1980-04-12
14207,David Sanborn,1980-06-14,David Sanborn - Hideaway,44,41,51,33.0,44,Hideaway,9.0,9,-7,0,-3,1,down,1980-04-12
14208,The Fatback Band,1980-04-12,The Fatback Band - Hot Box,51,51,42,7.0,49,Hot Box,26.0,0,7,2,0,1,up,1980-04-12
14209,The Fatback Band,1980-04-19,The Fatback Band - Hot Box,49,51,31,7.0,42,Hot Box,26.0,1,11,7,2,1,up,1980-04-12
14210,The Fatback Band,1980-04-26,The Fatback Band - Hot Box,42,49,25,7.0,31,Hot Box,26.0,2,6,11,7,1,up,1980-04-12
14211,The Fatback Band,1980-05-03,The Fatback Band - Hot Box,31,42,16,7.0,25,Hot Box,26.0,3,9,6,11,1,up,1980-04-12
14212,The Fatback Band,1980-05-10,The Fatback Band - Hot Box,25,31,14,7.0,16,Hot Box,26.0,4,2,9,6,1,up,1980-04-12
14213,The Fatback Band,1980-05-17,The Fatback Band - Hot Box,16,25,10,7.0,14,Hot Box,26.0,5,4,2,9,1,up,1980-04-12
14214,The Fatback Band,1980-05-24,The Fatback Band - Hot Box,14,16,10,7.0,10,Hot Box,26.0,6,0,4,2,0,stay,1980-04-12
14215,The Fatback Band,1980-05-31,The Fatback Band - Hot Box,10,14,9,7.0,10,Hot Box,26.0,7,1,0,4,1,up,1980-04-12
14216,The Fatback Band,1980-06-07,The Fatback Band - Hot Box,10,10,8,7.0,9,Hot Box,26.0,8,1,1,0,1,up,1980-04-12
14217,The Fatback Band,1980-06-14,The Fatback Band - Hot Box,9,10,7,7.0,8,Hot Box,26.0,9,1,1,1,1,up,1980-04-12
14218,The Fatback Band,1980-06-21,The Fatback Band - Hot Box,8,9,7,7.0,7,Hot Box,26.0,10,0,1,1,0,stay,1980-04-12
14219,The Fatback Band,1980-06-28,The Fatback Band - Hot Box,7,8,11,7.0,7,Hot Box,26.0,11,-4,0,1,1,down,1980-04-12
14220,The Fatback Band,1980-07-05,The Fatback Band - Hot Box,7,7,12,7.0,11,Hot Box,26.0,12,-1,-4,0,1,down,1980-04-12
14221,The Fatback Band,1980-07-12,The Fatback Band - Hot Box,11,7,13,7.0,12,Hot Box,26.0,13,-1,-1,-4,1,down,1980-04-12
14222,The Fatback Band,1980-07-19,The Fatback Band - Hot Box,12,11,13,7.0,13,Hot Box,26.0,14,0,-1,-1,0,stay,1980-04-12
14223,The Fatback Band,1980-07-26,The Fatback Band - Hot Box,13,12,13,7.0,13,Hot Box,26.0,15,0,0,-1,0,stay,1980-04-12
14224,The Fatback Band,1980-08-02,The Fatback Band - Hot Box,13,13,13,7.0,13,Hot Box,26.0,16,0,0,0,0,stay,1980-04-12
14225,The Fatback Band,1980-08-09,The Fatback Band - Hot Box,13,13,12,7.0,13,Hot Box,26.0,17,1,0,0,1,up,1980-04-12
14226,The Fatback Band,1980-08-16,The Fatback Band - Hot Box,13,13,10,7.0,12,Hot Box,26.0,18,2,1,0,1,up,1980-04-12
14227,The Fatback Band,1980-08-23,The Fatback Band - Hot Box,12,13,10,7.0,10,Hot Box,26.0,19,0,2,1,0,stay,1980-04-12
14228,The Fatback Band,1980-08-30,The Fatback Band - Hot Box,10,12,15,7.0,10,Hot Box,26.0,20,-5,0,2,1,down,1980-04-12
14229,The Fatback Band,1980-09-06,The Fatback Band - Hot Box,10,10,20,7.0,15,Hot Box,26.0,21,-5,-5,0,1,down,1980-04-12
14230,The Fatback Band,1980-09-13,The Fatback Band - Hot Box,15,10,20,7.0,20,Hot Box,26.0,22,0,-5,-5,0,stay,1980-04-12
14231,The Fatback Band,1980-09-20,The Fatback Band - Hot Box,20,15,30,7.0,20,Hot Box,26.0,23,-10,0,-5,1,down,1980-04-12
14232,The Fatback Band,1980-09-27,The Fatback Band - Hot Box,20,20,32,7.0,30,Hot Box,26.0,24,-2,-10,0,1,down,1980-04-12
14233,The Fatback Band,1980-10-04,The Fatback Band - Hot Box,30,20,33,7.0,32,Hot Box,26.0,25,-1,-2,-10,1,down,1980-04-12
14234,The Fatback Band,1980-10-11,The Fatback Band - Hot Box,32,30,51,7.0,33,Hot Box,26.0,26,-18,-1,-2,1,down,1980-04-12
14235,The Isley Brothers,1980-04-19,The Isley Brothers - Go All The Way,51,51,2,1.0,7,Go All The Way,24.0,0,5,44,0,1,up,1980-04-19
14236,The Isley Brothers,1980-04-26,The Isley Brothers - Go All The Way,7,51,1,1.0,2,Go All The Way,24.0,1,1,5,44,1,up,1980-04-19
14237,The Isley Brothers,1980-05-03,The Isley Brothers - Go All The Way,2,7,1,1.0,1,Go All The Way,24.0,2,0,1,5,0,stay,1980-04-19
14238,The Isley Brothers,1980-05-10,The Isley Brothers - Go All The Way,1,2,1,1.0,1,Go All The Way,24.0,3,0,0,1,0,stay,1980-04-19
14239,The Isley Brothers,1980-05-17,The Isley Brothers - Go All The Way,1,1,1,1.0,1,Go All The Way,24.0,4,0,0,0,0,stay,1980-04-19
14240,The Isley Brothers,1980-05-24,The Isley Brothers - Go All The Way,1,1,1,1.0,1,Go All The Way,24.0,5,0,0,0,0,stay,1980-04-19
14241,The Isley Brothers,1980-05-31,The Isley Brothers - Go All The Way,1,1,2,1.0,1,Go All The Way,24.0,6,-1,0,0,1,down,1980-04-19
14242,The Isley Brothers,1980-06-07,The Isley Brothers - Go All The Way,1,1,2,1.0,2,Go All The Way,24.0,7,0,-1,0,0,stay,1980-04-19
14243,The Isley Brothers,1980-06-14,The Isley Brothers - Go All The Way,2,1,2,1.0,2,Go All The Way,24.0,8,0,0,-1,0,stay,1980-04-19
14244,The Isley Brothers,1980-06-21,The Isley Brothers - Go All The Way,2,2,6,1.0,2,Go All The Way,24.0,9,-4,0,0,1,down,1980-04-19
14245,The Isley Brothers,1980-06-28,The Isley Brothers - Go All The Way,2,2,6,1.0,6,Go All The Way,24.0,10,0,-4,0,0,stay,1980-04-19
14246,The Isley Brothers,1980-07-05,The Isley Brothers - Go All The Way,6,2,10,1.0,6,Go All The Way,24.0,11,-4,0,-4,1,down,1980-04-19
14247,The Isley Brothers,1980-07-12,The Isley Brothers - Go All The Way,6,6,11,1.0,10,Go All The Way,24.0,12,-1,-4,0,1,down,1980-04-19
14248,The Isley Brothers,1980-07-19,The Isley Brothers - Go All The Way,10,6,11,1.0,11,Go All The Way,24.0,13,0,-1,-4,0,stay,1980-04-19
14249,The Isley Brothers,1980-07-26,The Isley Brothers - Go All The Way,11,10,14,1.0,11,Go All The Way,24.0,14,-3,0,-1,1,down,1980-04-19
14250,The Isley Brothers,1980-08-02,The Isley Brothers - Go All The Way,11,11,17,1.0,14,Go All The Way,24.0,15,-3,-3,0,1,down,1980-04-19
14251,The Isley Brothers,1980-08-09,The Isley Brothers - Go All The Way,14,11,24,1.0,17,Go All The Way,24.0,16,-7,-3,-3,1,down,1980-04-19
14252,The Isley Brothers,1980-08-16,The Isley Brothers - Go All The Way,17,14,39,1.0,24,Go All The Way,24.0,17,-15,-7,-3,1,down,1980-04-19
14253,The Isley Brothers,1980-08-23,The Isley Brothers - Go All The Way,24,17,39,1.0,39,Go All The Way,24.0,18,0,-15,-7,0,stay,1980-04-19
14254,The Isley Brothers,1980-08-30,The Isley Brothers - Go All The Way,39,24,39,1.0,39,Go All The Way,24.0,19,0,0,-15,0,stay,1980-04-19
14255,The Isley Brothers,1980-09-06,The Isley Brothers - Go All The Way,39,39,41,1.0,39,Go All The Way,24.0,20,-2,0,0,1,down,1980-04-19
14256,The Isley Brothers,1980-09-13,The Isley Brothers - Go All The Way,39,39,42,1.0,41,Go All The Way,24.0,21,-1,-2,0,1,down,1980-04-19
14257,The Isley Brothers,1980-09-20,The Isley Brothers - Go All The Way,41,39,46,1.0,42,Go All The Way,24.0,22,-4,-1,-2,1,down,1980-04-19
14258,The Isley Brothers,1980-09-27,The Isley Brothers - Go All The Way,42,41,47,1.0,46,Go All The Way,24.0,23,-1,-4,-1,1,down,1980-04-19
14259,The Isley Brothers,1980-10-04,The Isley Brothers - Go All The Way,46,42,51,1.0,47,Go All The Way,24.0,24,-4,-1,-4,1,down,1980-04-19
14260,Ray Parker Jr. & Raydio,1980-04-19,Ray Parker Jr. & Raydio - Two Places At The Same Time,51,51,10,6.0,15,Two Places At The Same Time,22.0,0,5,36,0,1,up,1980-04-19
14261,Ray Parker Jr. & Raydio,1980-04-26,Ray Parker Jr. & Raydio - Two Places At The Same Time,15,51,8,6.0,10,Two Places At The Same Time,22.0,1,2,5,36,1,up,1980-04-19
14262,Ray Parker Jr. & Raydio,1980-05-03,Ray Parker Jr. & Raydio - Two Places At The Same Time,10,15,7,6.0,8,Two Places At The Same Time,22.0,2,1,2,5,1,up,1980-04-19
14263,Ray Parker Jr. & Raydio,1980-05-10,Ray Parker Jr. & Raydio - Two Places At The Same Time,8,10,6,6.0,7,Two Places At The Same Time,22.0,3,1,1,2,1,up,1980-04-19
14264,Ray Parker Jr. & Raydio,1980-05-17,Ray Parker Jr. & Raydio - Two Places At The Same Time,7,8,6,6.0,6,Two Places At The Same Time,22.0,4,0,1,1,0,stay,1980-04-19
14265,Ray Parker Jr. & Raydio,1980-05-24,Ray Parker Jr. & Raydio - Two Places At The Same Time,6,7,8,6.0,6,Two Places At The Same Time,22.0,5,-2,0,1,1,down,1980-04-19
14266,Ray Parker Jr. & Raydio,1980-05-31,Ray Parker Jr. & Raydio - Two Places At The Same Time,6,6,11,6.0,8,Two Places At The Same Time,22.0,6,-3,-2,0,1,down,1980-04-19
14267,Ray Parker Jr. & Raydio,1980-06-07,Ray Parker Jr. & Raydio - Two Places At The Same Time,8,6,14,6.0,11,Two Places At The Same Time,22.0,7,-3,-3,-2,1,down,1980-04-19
14268,Ray Parker Jr. & Raydio,1980-06-14,Ray Parker Jr. & Raydio - Two Places At The Same Time,11,8,14,6.0,14,Two Places At The Same Time,22.0,8,0,-3,-3,0,stay,1980-04-19
14269,Ray Parker Jr. & Raydio,1980-06-21,Ray Parker Jr. & Raydio - Two Places At The Same Time,14,11,14,6.0,14,Two Places At The Same Time,22.0,9,0,0,-3,0,stay,1980-04-19
14270,Ray Parker Jr. & Raydio,1980-06-28,Ray Parker Jr. & Raydio - Two Places At The Same Time,14,14,15,6.0,14,Two Places At The Same Time,22.0,10,-1,0,0,1,down,1980-04-19
14271,Ray Parker Jr. & Raydio,1980-07-05,Ray Parker Jr. & Raydio - Two Places At The Same Time,14,14,16,6.0,15,Two Places At The Same Time,22.0,11,-1,-1,0,1,down,1980-04-19
14272,Ray Parker Jr. & Raydio,1980-07-12,Ray Parker Jr. & Raydio - Two Places At The Same Time,15,14,16,6.0,16,Two Places At The Same Time,22.0,12,0,-1,-1,0,stay,1980-04-19
14273,Ray Parker Jr. & Raydio,1980-07-19,Ray Parker Jr. & Raydio - Two Places At The Same Time,16,15,17,6.0,16,Two Places At The Same Time,22.0,13,-1,0,-1,1,down,1980-04-19
14274,Ray Parker Jr. & Raydio,1980-07-26,Ray Parker Jr. & Raydio - Two Places At The Same Time,16,16,20,6.0,17,Two Places At The Same Time,22.0,14,-3,-1,0,1,down,1980-04-19
14275,Ray Parker Jr. & Raydio,1980-08-02,Ray Parker Jr. & Raydio - Two Places At The Same Time,17,16,23,6.0,20,Two Places At The Same Time,22.0,15,-3,-3,-1,1,down,1980-04-19
14276,Ray Parker Jr. & Raydio,1980-08-09,Ray Parker Jr. & Raydio - Two Places At The Same Time,20,17,25,6.0,23,Two Places At The Same Time,22.0,16,-2,-3,-3,1,down,1980-04-19
14277,Ray Parker Jr. & Raydio,1980-08-16,Ray Parker Jr. & Raydio - Two Places At The Same Time,23,20,38,6.0,25,Two Places At The Same Time,22.0,17,-13,-2,-3,1,down,1980-04-19
14278,Ray Parker Jr. & Raydio,1980-08-23,Ray Parker Jr. & Raydio - Two Places At The Same Time,25,23,46,6.0,38,Two Places At The Same Time,22.0,18,-8,-13,-2,1,down,1980-04-19
14279,Ray Parker Jr. & Raydio,1980-08-30,Ray Parker Jr. & Raydio - Two Places At The Same Time,38,25,48,6.0,46,Two Places At The Same Time,22.0,19,-2,-8,-13,1,down,1980-04-19
14280,Ray Parker Jr. & Raydio,1980-09-06,Ray Parker Jr. & Raydio - Two Places At The Same Time,46,38,48,6.0,48,Two Places At The Same Time,22.0,20,0,-2,-8,0,stay,1980-04-19
14281,Ray Parker Jr. & Raydio,1980-09-13,Ray Parker Jr. & Raydio - Two Places At The Same Time,48,46,49,6.0,48,Two Places At The Same Time,22.0,21,-1,0,-2,1,down,1980-04-19
14282,Ray Parker Jr. & Raydio,1980-09-20,Ray Parker Jr. & Raydio - Two Places At The Same Time,48,48,51,6.0,49,Two Places At The Same Time,22.0,22,-2,-1,0,1,down,1980-04-19
14283,ConFunkShun,1980-04-19,ConFunkShun - Spirit Of Love,51,51,16,7.0,29,Spirit Of Love,16.0,0,13,22,0,1,up,1980-04-19
14284,ConFunkShun,1980-04-26,ConFunkShun - Spirit Of Love,29,51,12,7.0,16,Spirit Of Love,16.0,1,4,13,22,1,up,1980-04-19
14285,ConFunkShun,1980-05-03,ConFunkShun - Spirit Of Love,16,29,10,7.0,12,Spirit Of Love,16.0,2,2,4,13,1,up,1980-04-19
14286,ConFunkShun,1980-05-10,ConFunkShun - Spirit Of Love,12,16,8,7.0,10,Spirit Of Love,16.0,3,2,2,4,1,up,1980-04-19
14287,ConFunkShun,1980-05-17,ConFunkShun - Spirit Of Love,10,12,8,7.0,8,Spirit Of Love,16.0,4,0,2,2,0,stay,1980-04-19
14288,ConFunkShun,1980-05-24,ConFunkShun - Spirit Of Love,8,10,7,7.0,8,Spirit Of Love,16.0,5,1,0,2,1,up,1980-04-19
14289,ConFunkShun,1980-05-31,ConFunkShun - Spirit Of Love,8,8,7,7.0,7,Spirit Of Love,16.0,6,0,1,0,0,stay,1980-04-19
14290,ConFunkShun,1980-06-07,ConFunkShun - Spirit Of Love,7,8,9,7.0,7,Spirit Of Love,16.0,7,-2,0,1,1,down,1980-04-19
14291,ConFunkShun,1980-06-14,ConFunkShun - Spirit Of Love,7,7,10,7.0,9,Spirit Of Love,16.0,8,-1,-2,0,1,down,1980-04-19
14292,ConFunkShun,1980-06-21,ConFunkShun - Spirit Of Love,9,7,15,7.0,10,Spirit Of Love,16.0,9,-5,-1,-2,1,down,1980-04-19
14293,ConFunkShun,1980-06-28,ConFunkShun - Spirit Of Love,10,9,16,7.0,15,Spirit Of Love,16.0,10,-1,-5,-1,1,down,1980-04-19
14294,ConFunkShun,1980-07-05,ConFunkShun - Spirit Of Love,15,10,24,7.0,16,Spirit Of Love,16.0,11,-8,-1,-5,1,down,1980-04-19
14295,ConFunkShun,1980-07-12,ConFunkShun - Spirit Of Love,16,15,22,7.0,24,Spirit Of Love,16.0,12,2,-8,-1,1,up,1980-04-19
14296,ConFunkShun,1980-07-19,ConFunkShun - Spirit Of Love,24,16,25,7.0,22,Spirit Of Love,16.0,13,-3,2,-8,1,down,1980-04-19
14297,ConFunkShun,1980-07-26,ConFunkShun - Spirit Of Love,22,24,33,7.0,25,Spirit Of Love,16.0,14,-8,-3,2,1,down,1980-04-19
14298,ConFunkShun,1980-08-02,ConFunkShun - Spirit Of Love,25,22,45,7.0,33,Spirit Of Love,16.0,15,-12,-8,-3,1,down,1980-04-19
14299,ConFunkShun,1980-08-09,ConFunkShun - Spirit Of Love,33,25,51,7.0,45,Spirit Of Love,16.0,16,-6,-12,-8,1,down,1980-04-19
14300,Switch,1980-04-19,Switch - Reaching For Tomorrow,51,51,29,23.0,39,Reaching For Tomorrow,9.0,0,10,12,0,1,up,1980-04-19
14301,Switch,1980-04-26,Switch - Reaching For Tomorrow,39,51,29,23.0,29,Reaching For Tomorrow,9.0,1,0,10,12,0,stay,1980-04-19
14302,Switch,1980-05-03,Switch - Reaching For Tomorrow,29,39,25,23.0,29,Reaching For Tomorrow,9.0,2,4,0,10,1,up,1980-04-19
14303,Switch,1980-05-10,Switch - Reaching For Tomorrow,29,29,24,23.0,25,Reaching For Tomorrow,9.0,3,1,4,0,1,up,1980-04-19
14304,Switch,1980-05-17,Switch - Reaching For Tomorrow,25,29,23,23.0,24,Reaching For Tomorrow,9.0,4,1,1,4,1,up,1980-04-19
14305,Switch,1980-05-24,Switch - Reaching For Tomorrow,24,25,35,23.0,23,Reaching For Tomorrow,9.0,5,-12,1,1,1,down,1980-04-19
14306,Switch,1980-05-31,Switch - Reaching For Tomorrow,23,24,33,23.0,35,Reaching For Tomorrow,9.0,6,2,-12,1,1,up,1980-04-19
14307,Switch,1980-06-07,Switch - Reaching For Tomorrow,35,23,34,23.0,33,Reaching For Tomorrow,9.0,7,-1,2,-12,1,down,1980-04-19
14308,Switch,1980-06-14,Switch - Reaching For Tomorrow,33,35,44,23.0,34,Reaching For Tomorrow,9.0,8,-10,-1,2,1,down,1980-04-19
14309,Switch,1980-06-21,Switch - Reaching For Tomorrow,34,33,51,23.0,44,Reaching For Tomorrow,9.0,9,-7,-10,-1,1,down,1980-04-19
14310,The Manhattans,1980-04-19,The Manhattans - After Midnight,51,51,25,4.0,43,After Midnight,27.0,0,18,8,0,1,up,1980-04-19
14311,The Manhattans,1980-04-26,The Manhattans - After Midnight,43,51,20,4.0,25,After Midnight,27.0,1,5,18,8,1,up,1980-04-19
14312,The Manhattans,1980-05-03,The Manhattans - After Midnight,25,43,15,4.0,20,After Midnight,27.0,2,5,5,18,1,up,1980-04-19
14313,The Manhattans,1980-05-10,The Manhattans - After Midnight,20,25,13,4.0,15,After Midnight,27.0,3,2,5,5,1,up,1980-04-19
14314,The Manhattans,1980-05-17,The Manhattans - After Midnight,15,20,11,4.0,13,After Midnight,27.0,4,2,2,5,1,up,1980-04-19
14315,The Manhattans,1980-05-24,The Manhattans - After Midnight,13,15,9,4.0,11,After Midnight,27.0,5,2,2,2,1,up,1980-04-19
14316,The Manhattans,1980-05-31,The Manhattans - After Midnight,11,13,6,4.0,9,After Midnight,27.0,6,3,2,2,1,up,1980-04-19
14317,The Manhattans,1980-06-07,The Manhattans - After Midnight,9,11,6,4.0,6,After Midnight,27.0,7,0,3,2,0,stay,1980-04-19
14318,The Manhattans,1980-06-14,The Manhattans - After Midnight,6,9,5,4.0,6,After Midnight,27.0,8,1,0,3,1,up,1980-04-19
14319,The Manhattans,1980-06-21,The Manhattans - After Midnight,6,6,4,4.0,5,After Midnight,27.0,9,1,1,0,1,up,1980-04-19
14320,The Manhattans,1980-06-28,The Manhattans - After Midnight,5,6,4,4.0,4,After Midnight,27.0,10,0,1,1,0,stay,1980-04-19
14321,The Manhattans,1980-07-05,The Manhattans - After Midnight,4,5,8,4.0,4,After Midnight,27.0,11,-4,0,1,1,down,1980-04-19
14322,The Manhattans,1980-07-12,The Manhattans - After Midnight,4,4,8,4.0,8,After Midnight,27.0,12,0,-4,0,0,stay,1980-04-19
14323,The Manhattans,1980-07-19,The Manhattans - After Midnight,8,4,10,4.0,8,After Midnight,27.0,13,-2,0,-4,1,down,1980-04-19
14324,The Manhattans,1980-07-26,The Manhattans - After Midnight,8,8,12,4.0,10,After Midnight,27.0,14,-2,-2,0,1,down,1980-04-19
14325,The Manhattans,1980-08-02,The Manhattans - After Midnight,10,8,14,4.0,12,After Midnight,27.0,15,-2,-2,-2,1,down,1980-04-19
14326,The Manhattans,1980-08-09,The Manhattans - After Midnight,12,10,17,4.0,14,After Midnight,27.0,16,-3,-2,-2,1,down,1980-04-19
14327,The Manhattans,1980-08-16,The Manhattans - After Midnight,14,12,17,4.0,17,After Midnight,27.0,17,0,-3,-2,0,stay,1980-04-19
14328,The Manhattans,1980-08-23,The Manhattans - After Midnight,17,14,17,4.0,17,After Midnight,27.0,18,0,0,-3,0,stay,1980-04-19
14329,The Manhattans,1980-08-30,The Manhattans - After Midnight,17,17,21,4.0,17,After Midnight,27.0,19,-4,0,0,1,down,1980-04-19
14330,The Manhattans,1980-09-06,The Manhattans - After Midnight,17,17,24,4.0,21,After Midnight,27.0,20,-3,-4,0,1,down,1980-04-19
14331,The Manhattans,1980-09-13,The Manhattans - After Midnight,21,17,25,4.0,24,After Midnight,27.0,21,-1,-3,-4,1,down,1980-04-19
14332,The Manhattans,1980-09-20,The Manhattans - After Midnight,24,21,34,4.0,25,After Midnight,27.0,22,-9,-1,-3,1,down,1980-04-19
14333,The Manhattans,1980-09-27,The Manhattans - After Midnight,25,24,34,4.0,34,After Midnight,27.0,23,0,-9,-1,0,stay,1980-04-19
14334,The Manhattans,1980-10-04,The Manhattans - After Midnight,34,25,34,4.0,34,After Midnight,27.0,24,0,0,-9,0,stay,1980-04-19
14335,The Manhattans,1980-10-11,The Manhattans - After Midnight,34,34,36,4.0,34,After Midnight,27.0,25,-2,0,0,1,down,1980-04-19
14336,The Manhattans,1980-10-18,The Manhattans - After Midnight,34,34,48,4.0,36,After Midnight,27.0,26,-12,-2,0,1,down,1980-04-19
14337,The Manhattans,1980-10-25,The Manhattans - After Midnight,36,34,51,4.0,48,After Midnight,27.0,27,-3,-12,-2,1,down,1980-04-19
14338,Sugarhill Gang,1980-04-19,Sugarhill Gang - Sugarhill Gang,51,51,34,32.0,47,Sugarhill Gang,7.0,0,13,4,0,1,up,1980-04-19
14339,Sugarhill Gang,1980-04-26,Sugarhill Gang - Sugarhill Gang,47,51,32,32.0,34,Sugarhill Gang,7.0,1,2,13,4,1,up,1980-04-19
14340,Sugarhill Gang,1980-05-03,Sugarhill Gang - Sugarhill Gang,34,47,32,32.0,32,Sugarhill Gang,7.0,2,0,2,13,0,stay,1980-04-19
14341,Sugarhill Gang,1980-05-10,Sugarhill Gang - Sugarhill Gang,32,34,34,32.0,32,Sugarhill Gang,7.0,3,-2,0,2,1,down,1980-04-19
14342,Sugarhill Gang,1980-05-17,Sugarhill Gang - Sugarhill Gang,32,32,34,32.0,34,Sugarhill Gang,7.0,4,0,-2,0,0,stay,1980-04-19
14343,Sugarhill Gang,1980-05-24,Sugarhill Gang - Sugarhill Gang,34,32,45,32.0,34,Sugarhill Gang,7.0,5,-11,0,-2,1,down,1980-04-19
14344,Sugarhill Gang,1980-05-31,Sugarhill Gang - Sugarhill Gang,34,34,47,32.0,45,Sugarhill Gang,7.0,6,-2,-11,0,1,down,1980-04-19
14345,Sugarhill Gang,1980-06-07,Sugarhill Gang - Sugarhill Gang,45,34,51,32.0,47,Sugarhill Gang,7.0,7,-4,-2,-11,1,down,1980-04-19
14346,Crown Heights Affair,1980-04-19,Crown Heights Affair - Sure Shot,51,51,51,50.0,50,Sure Shot,0.0,0,-1,1,0,1,down,1980-04-19
14347,Rodney Franklin,1980-04-26,Rodney Franklin - You'll Never Know,51,51,31,25.0,42,You'll Never Know,12.0,0,11,9,0,1,up,1980-04-26
14348,Rodney Franklin,1980-05-03,Rodney Franklin - You'll Never Know,42,51,26,25.0,31,You'll Never Know,12.0,1,5,11,9,1,up,1980-04-26
14349,Rodney Franklin,1980-05-10,Rodney Franklin - You'll Never Know,31,42,25,25.0,26,You'll Never Know,12.0,2,1,5,11,1,up,1980-04-26
14350,Rodney Franklin,1980-05-17,Rodney Franklin - You'll Never Know,26,31,25,25.0,25,You'll Never Know,12.0,3,0,1,5,0,stay,1980-04-26
14351,Rodney Franklin,1980-05-24,Rodney Franklin - You'll Never Know,25,26,25,25.0,25,You'll Never Know,12.0,4,0,0,1,0,stay,1980-04-26
14352,Rodney Franklin,1980-05-31,Rodney Franklin - You'll Never Know,25,25,35,25.0,25,You'll Never Know,12.0,5,-10,0,0,1,down,1980-04-26
14353,Rodney Franklin,1980-06-07,Rodney Franklin - You'll Never Know,25,25,35,25.0,35,You'll Never Know,12.0,6,0,-10,0,0,stay,1980-04-26
14354,Rodney Franklin,1980-06-14,Rodney Franklin - You'll Never Know,35,25,34,25.0,35,You'll Never Know,12.0,7,1,0,-10,1,up,1980-04-26
14355,Rodney Franklin,1980-06-21,Rodney Franklin - You'll Never Know,35,35,41,25.0,34,You'll Never Know,12.0,8,-7,1,0,1,down,1980-04-26
14356,Rodney Franklin,1980-06-28,Rodney Franklin - You'll Never Know,34,35,47,25.0,41,You'll Never Know,12.0,9,-6,-7,1,1,down,1980-04-26
14357,Rodney Franklin,1980-07-05,Rodney Franklin - You'll Never Know,41,34,48,25.0,47,You'll Never Know,12.0,10,-1,-6,-7,1,down,1980-04-26
14358,Rodney Franklin,1980-07-12,Rodney Franklin - You'll Never Know,47,41,50,25.0,48,You'll Never Know,12.0,11,-2,-1,-6,1,down,1980-04-26
14359,Rodney Franklin,1980-07-19,Rodney Franklin - You'll Never Know,48,47,51,25.0,50,You'll Never Know,12.0,12,-1,-2,-1,1,down,1980-04-26
14360,Earl Klugh,1980-04-26,Earl Klugh - Dream Come True,51,51,26,22.0,43,Dream Come True,8.0,0,17,8,0,1,up,1980-04-26
14361,Earl Klugh,1980-05-03,Earl Klugh - Dream Come True,43,51,22,22.0,26,Dream Come True,8.0,1,4,17,8,1,up,1980-04-26
14362,Earl Klugh,1980-05-10,Earl Klugh - Dream Come True,26,43,22,22.0,22,Dream Come True,8.0,2,0,4,17,0,stay,1980-04-26
14363,Earl Klugh,1980-05-17,Earl Klugh - Dream Come True,22,26,26,22.0,22,Dream Come True,8.0,3,-4,0,4,1,down,1980-04-26
14364,Earl Klugh,1980-05-24,Earl Klugh - Dream Come True,22,22,36,22.0,26,Dream Come True,8.0,4,-10,-4,0,1,down,1980-04-26
14365,Earl Klugh,1980-05-31,Earl Klugh - Dream Come True,26,22,40,22.0,36,Dream Come True,8.0,5,-4,-10,-4,1,down,1980-04-26
14366,Earl Klugh,1980-06-07,Earl Klugh - Dream Come True,36,26,40,22.0,40,Dream Come True,8.0,6,0,-4,-10,0,stay,1980-04-26
14367,Earl Klugh,1980-06-14,Earl Klugh - Dream Come True,40,36,48,22.0,40,Dream Come True,8.0,7,-8,0,-4,1,down,1980-04-26
14368,Earl Klugh,1980-06-21,Earl Klugh - Dream Come True,40,40,51,22.0,48,Dream Come True,8.0,8,-3,-8,0,1,down,1980-04-26
14369,Two Tons Of Fun,1980-04-26,Two Tons Of Fun - Two Tons Of Fun,51,51,49,28.0,50,Two Tons Of Fun,8.0,0,1,1,0,1,up,1980-04-26
14370,Two Tons Of Fun,1980-05-03,Two Tons Of Fun - Two Tons Of Fun,50,51,46,28.0,49,Two Tons Of Fun,8.0,1,3,1,1,1,up,1980-04-26
14371,Two Tons Of Fun,1980-05-10,Two Tons Of Fun - Two Tons Of Fun,49,50,36,28.0,46,Two Tons Of Fun,8.0,2,10,3,1,1,up,1980-04-26
14372,Two Tons Of Fun,1980-05-17,Two Tons Of Fun - Two Tons Of Fun,46,49,36,28.0,36,Two Tons Of Fun,8.0,3,0,10,3,0,stay,1980-04-26
14373,Two Tons Of Fun,1980-05-24,Two Tons Of Fun - Two Tons Of Fun,36,46,34,28.0,36,Two Tons Of Fun,8.0,4,2,0,10,1,up,1980-04-26
14374,Two Tons Of Fun,1980-05-31,Two Tons Of Fun - Two Tons Of Fun,36,36,30,28.0,34,Two Tons Of Fun,8.0,5,4,2,0,1,up,1980-04-26
14375,Two Tons Of Fun,1980-06-07,Two Tons Of Fun - Two Tons Of Fun,34,36,28,28.0,30,Two Tons Of Fun,8.0,6,2,4,2,1,up,1980-04-26
14376,Two Tons Of Fun,1980-06-14,Two Tons Of Fun - Two Tons Of Fun,30,34,28,28.0,28,Two Tons Of Fun,8.0,7,0,2,4,0,stay,1980-04-26
14377,Two Tons Of Fun,1980-06-21,Two Tons Of Fun - Two Tons Of Fun,28,30,51,28.0,28,Two Tons Of Fun,8.0,8,-23,0,2,1,down,1980-04-26
14378,Stephanie Mills,1980-05-03,Stephanie Mills - Sweet Sensation,51,51,14,3.0,40,Sweet Sensation,41.0,0,26,11,0,1,up,1980-05-03
14379,Stephanie Mills,1980-05-10,Stephanie Mills - Sweet Sensation,40,51,11,3.0,14,Sweet Sensation,41.0,1,3,26,11,1,up,1980-05-03
14380,Stephanie Mills,1980-05-17,Stephanie Mills - Sweet Sensation,14,40,3,3.0,11,Sweet Sensation,41.0,2,8,3,26,1,up,1980-05-03
14381,Stephanie Mills,1980-05-24,Stephanie Mills - Sweet Sensation,11,14,3,3.0,3,Sweet Sensation,41.0,3,0,8,3,0,stay,1980-05-03
14382,Stephanie Mills,1980-05-31,Stephanie Mills - Sweet Sensation,3,11,3,3.0,3,Sweet Sensation,41.0,4,0,0,8,0,stay,1980-05-03
14383,Stephanie Mills,1980-06-07,Stephanie Mills - Sweet Sensation,3,3,3,3.0,3,Sweet Sensation,41.0,5,0,0,0,0,stay,1980-05-03
14384,Stephanie Mills,1980-06-14,Stephanie Mills - Sweet Sensation,3,3,3,3.0,3,Sweet Sensation,41.0,6,0,0,0,0,stay,1980-05-03
14385,Stephanie Mills,1980-06-21,Stephanie Mills - Sweet Sensation,3,3,3,3.0,3,Sweet Sensation,41.0,7,0,0,0,0,stay,1980-05-03
14386,Stephanie Mills,1980-06-28,Stephanie Mills - Sweet Sensation,3,3,3,3.0,3,Sweet Sensation,41.0,8,0,0,0,0,stay,1980-05-03
14387,Stephanie Mills,1980-07-05,Stephanie Mills - Sweet Sensation,3,3,6,3.0,3,Sweet Sensation,41.0,9,-3,0,0,1,down,1980-05-03
14388,Stephanie Mills,1980-07-12,Stephanie Mills - Sweet Sensation,3,3,7,3.0,6,Sweet Sensation,41.0,10,-1,-3,0,1,down,1980-05-03
14389,Stephanie Mills,1980-07-19,Stephanie Mills - Sweet Sensation,6,3,7,3.0,7,Sweet Sensation,41.0,11,0,-1,-3,0,stay,1980-05-03
14390,Stephanie Mills,1980-07-26,Stephanie Mills - Sweet Sensation,7,6,9,3.0,7,Sweet Sensation,41.0,12,-2,0,-1,1,down,1980-05-03
14391,Stephanie Mills,1980-08-02,Stephanie Mills - Sweet Sensation,7,7,9,3.0,9,Sweet Sensation,41.0,13,0,-2,0,0,stay,1980-05-03
14392,Stephanie Mills,1980-08-09,Stephanie Mills - Sweet Sensation,9,7,11,3.0,9,Sweet Sensation,41.0,14,-2,0,-2,1,down,1980-05-03
14393,Stephanie Mills,1980-08-16,Stephanie Mills - Sweet Sensation,9,9,20,3.0,11,Sweet Sensation,41.0,15,-9,-2,0,1,down,1980-05-03
14394,Stephanie Mills,1980-08-23,Stephanie Mills - Sweet Sensation,11,9,26,3.0,20,Sweet Sensation,41.0,16,-6,-9,-2,1,down,1980-05-03
14395,Stephanie Mills,1980-08-30,Stephanie Mills - Sweet Sensation,20,11,25,3.0,26,Sweet Sensation,41.0,17,1,-6,-9,1,up,1980-05-03
14396,Stephanie Mills,1980-09-06,Stephanie Mills - Sweet Sensation,26,20,27,3.0,25,Sweet Sensation,41.0,18,-2,1,-6,1,down,1980-05-03
14397,Stephanie Mills,1980-09-13,Stephanie Mills - Sweet Sensation,25,26,26,3.0,27,Sweet Sensation,41.0,19,1,-2,1,1,up,1980-05-03
14398,Stephanie Mills,1980-09-20,Stephanie Mills - Sweet Sensation,27,25,26,3.0,26,Sweet Sensation,41.0,20,0,1,-2,0,stay,1980-05-03
14399,Stephanie Mills,1980-09-27,Stephanie Mills - Sweet Sensation,26,27,20,3.0,26,Sweet Sensation,41.0,21,6,0,1,1,up,1980-05-03
14400,Stephanie Mills,1980-10-04,Stephanie Mills - Sweet Sensation,26,26,18,3.0,20,Sweet Sensation,41.0,22,2,6,0,1,up,1980-05-03
14401,Stephanie Mills,1980-10-11,Stephanie Mills - Sweet Sensation,20,26,17,3.0,18,Sweet Sensation,41.0,23,1,2,6,1,up,1980-05-03
14402,Stephanie Mills,1980-10-18,Stephanie Mills - Sweet Sensation,18,20,14,3.0,17,Sweet Sensation,41.0,24,3,1,2,1,up,1980-05-03
14403,Stephanie Mills,1980-10-25,Stephanie Mills - Sweet Sensation,17,18,14,3.0,14,Sweet Sensation,41.0,25,0,3,1,0,stay,1980-05-03
14404,Stephanie Mills,1980-11-01,Stephanie Mills - Sweet Sensation,14,17,13,3.0,14,Sweet Sensation,41.0,26,1,0,3,1,up,1980-05-03
14405,Stephanie Mills,1980-11-08,Stephanie Mills - Sweet Sensation,14,14,13,3.0,13,Sweet Sensation,41.0,27,0,1,0,0,stay,1980-05-03
14406,Stephanie Mills,1980-11-15,Stephanie Mills - Sweet Sensation,13,14,20,3.0,13,Sweet Sensation,41.0,28,-7,0,1,1,down,1980-05-03
14407,Stephanie Mills,1980-11-22,Stephanie Mills - Sweet Sensation,13,13,29,3.0,20,Sweet Sensation,41.0,29,-9,-7,0,1,down,1980-05-03
14408,Stephanie Mills,1980-11-29,Stephanie Mills - Sweet Sensation,20,13,29,3.0,29,Sweet Sensation,41.0,30,0,-9,-7,0,stay,1980-05-03
14409,Stephanie Mills,1980-12-06,Stephanie Mills - Sweet Sensation,29,20,31,3.0,29,Sweet Sensation,41.0,31,-2,0,-9,1,down,1980-05-03
14410,Stephanie Mills,1980-12-13,Stephanie Mills - Sweet Sensation,29,29,33,3.0,31,Sweet Sensation,41.0,32,-2,-2,0,1,down,1980-05-03
14411,Stephanie Mills,1980-12-20,Stephanie Mills - Sweet Sensation,31,29,36,3.0,33,Sweet Sensation,41.0,33,-3,-2,-2,1,down,1980-05-03
14412,Stephanie Mills,1980-12-27,Stephanie Mills - Sweet Sensation,33,31,36,3.0,36,Sweet Sensation,41.0,34,0,-3,-2,0,stay,1980-05-03
14413,Stephanie Mills,1981-01-03,Stephanie Mills - Sweet Sensation,36,33,36,3.0,36,Sweet Sensation,41.0,35,0,0,-3,0,stay,1980-05-03
14414,Stephanie Mills,1981-01-10,Stephanie Mills - Sweet Sensation,36,36,36,3.0,36,Sweet Sensation,41.0,36,0,0,0,0,stay,1980-05-03
14415,Stephanie Mills,1981-01-17,Stephanie Mills - Sweet Sensation,36,36,37,3.0,36,Sweet Sensation,41.0,37,-1,0,0,1,down,1980-05-03
14416,Stephanie Mills,1981-01-24,Stephanie Mills - Sweet Sensation,36,36,39,3.0,37,Sweet Sensation,41.0,38,-2,-1,0,1,down,1980-05-03
14417,Stephanie Mills,1981-01-31,Stephanie Mills - Sweet Sensation,37,36,47,3.0,39,Sweet Sensation,41.0,39,-8,-2,-1,1,down,1980-05-03
14418,Stephanie Mills,1981-02-07,Stephanie Mills - Sweet Sensation,39,37,50,3.0,47,Sweet Sensation,41.0,40,-3,-8,-2,1,down,1980-05-03
14419,Stephanie Mills,1981-02-14,Stephanie Mills - Sweet Sensation,47,39,51,3.0,50,Sweet Sensation,41.0,41,-1,-3,-8,1,down,1980-05-03
14420,Herbie Hancock,1980-05-03,Herbie Hancock - Monster,51,51,48,19.0,50,Monster,14.0,0,2,1,0,1,up,1980-05-03
14421,Herbie Hancock,1980-05-10,Herbie Hancock - Monster,50,51,40,19.0,48,Monster,14.0,1,8,2,1,1,up,1980-05-03
14422,Herbie Hancock,1980-05-17,Herbie Hancock - Monster,48,50,32,19.0,40,Monster,14.0,2,8,8,2,1,up,1980-05-03
14423,Herbie Hancock,1980-05-24,Herbie Hancock - Monster,40,48,23,19.0,32,Monster,14.0,3,9,8,8,1,up,1980-05-03
14424,Herbie Hancock,1980-05-31,Herbie Hancock - Monster,32,40,21,19.0,23,Monster,14.0,4,2,9,8,1,up,1980-05-03
14425,Herbie Hancock,1980-06-07,Herbie Hancock - Monster,23,32,20,19.0,21,Monster,14.0,5,1,2,9,1,up,1980-05-03
14426,Herbie Hancock,1980-06-14,Herbie Hancock - Monster,21,23,19,19.0,20,Monster,14.0,6,1,1,2,1,up,1980-05-03
14427,Herbie Hancock,1980-06-21,Herbie Hancock - Monster,20,21,24,19.0,19,Monster,14.0,7,-5,1,1,1,down,1980-05-03
14428,Herbie Hancock,1980-06-28,Herbie Hancock - Monster,19,20,32,19.0,24,Monster,14.0,8,-8,-5,1,1,down,1980-05-03
14429,Herbie Hancock,1980-07-05,Herbie Hancock - Monster,24,19,37,19.0,32,Monster,14.0,9,-5,-8,-5,1,down,1980-05-03
14430,Herbie Hancock,1980-07-12,Herbie Hancock - Monster,32,24,38,19.0,37,Monster,14.0,10,-1,-5,-8,1,down,1980-05-03
14431,Herbie Hancock,1980-07-19,Herbie Hancock - Monster,37,32,39,19.0,38,Monster,14.0,11,-1,-1,-5,1,down,1980-05-03
14432,Herbie Hancock,1980-07-26,Herbie Hancock - Monster,38,37,41,19.0,39,Monster,14.0,12,-2,-1,-1,1,down,1980-05-03
14433,Herbie Hancock,1980-08-02,Herbie Hancock - Monster,39,38,41,19.0,41,Monster,14.0,13,0,-2,-1,0,stay,1980-05-03
14434,Herbie Hancock,1980-08-09,Herbie Hancock - Monster,41,39,51,19.0,41,Monster,14.0,14,-10,0,-2,1,down,1980-05-03
14435,Peabo Bryson,1980-05-10,Peabo Bryson - Paradise,51,51,18,13.0,34,Paradise,14.0,0,16,17,0,1,up,1980-05-10
14436,Peabo Bryson,1980-05-17,Peabo Bryson - Paradise,34,51,14,13.0,18,Paradise,14.0,1,4,16,17,1,up,1980-05-10
14437,Peabo Bryson,1980-05-24,Peabo Bryson - Paradise,18,34,13,13.0,14,Paradise,14.0,2,1,4,16,1,up,1980-05-10
14438,Peabo Bryson,1980-05-31,Peabo Bryson - Paradise,14,18,13,13.0,13,Paradise,14.0,3,0,1,4,0,stay,1980-05-10
14439,Peabo Bryson,1980-06-07,Peabo Bryson - Paradise,13,14,17,13.0,13,Paradise,14.0,4,-4,0,1,1,down,1980-05-10
14440,Peabo Bryson,1980-06-14,Peabo Bryson - Paradise,13,13,17,13.0,17,Paradise,14.0,5,0,-4,0,0,stay,1980-05-10
14441,Peabo Bryson,1980-06-21,Peabo Bryson - Paradise,17,13,18,13.0,17,Paradise,14.0,6,-1,0,-4,1,down,1980-05-10
14442,Peabo Bryson,1980-06-28,Peabo Bryson - Paradise,17,17,28,13.0,18,Paradise,14.0,7,-10,-1,0,1,down,1980-05-10
14443,Peabo Bryson,1980-07-05,Peabo Bryson - Paradise,18,17,34,13.0,28,Paradise,14.0,8,-6,-10,-1,1,down,1980-05-10
14444,Peabo Bryson,1980-07-12,Peabo Bryson - Paradise,28,18,34,13.0,34,Paradise,14.0,9,0,-6,-10,0,stay,1980-05-10
14445,Peabo Bryson,1980-07-19,Peabo Bryson - Paradise,34,28,35,13.0,34,Paradise,14.0,10,-1,0,-6,1,down,1980-05-10
14446,Peabo Bryson,1980-07-26,Peabo Bryson - Paradise,34,34,37,13.0,35,Paradise,14.0,11,-2,-1,0,1,down,1980-05-10
14447,Peabo Bryson,1980-08-02,Peabo Bryson - Paradise,35,34,44,13.0,37,Paradise,14.0,12,-7,-2,-1,1,down,1980-05-10
14448,Peabo Bryson,1980-08-09,Peabo Bryson - Paradise,37,35,50,13.0,44,Paradise,14.0,13,-6,-7,-2,1,down,1980-05-10
14449,Peabo Bryson,1980-08-16,Peabo Bryson - Paradise,44,37,51,13.0,50,Paradise,14.0,14,-1,-6,-7,1,down,1980-05-10
14450,Change,1980-05-10,Change - The Glow Of Love,51,51,27,10.0,38,The Glow Of Love,28.0,0,11,13,0,1,up,1980-05-10
14451,Change,1980-05-17,Change - The Glow Of Love,38,51,20,10.0,27,The Glow Of Love,28.0,1,7,11,13,1,up,1980-05-10
14452,Change,1980-05-24,Change - The Glow Of Love,27,38,18,10.0,20,The Glow Of Love,28.0,2,2,7,11,1,up,1980-05-10
14453,Change,1980-05-31,Change - The Glow Of Love,20,27,12,10.0,18,The Glow Of Love,28.0,3,6,2,7,1,up,1980-05-10
14454,Change,1980-06-07,Change - The Glow Of Love,18,20,11,10.0,12,The Glow Of Love,28.0,4,1,6,2,1,up,1980-05-10
14455,Change,1980-06-14,Change - The Glow Of Love,12,18,11,10.0,11,The Glow Of Love,28.0,5,0,1,6,0,stay,1980-05-10
14456,Change,1980-06-21,Change - The Glow Of Love,11,12,10,10.0,11,The Glow Of Love,28.0,6,1,0,1,1,up,1980-05-10
14457,Change,1980-06-28,Change - The Glow Of Love,11,11,10,10.0,10,The Glow Of Love,28.0,7,0,1,0,0,stay,1980-05-10
14458,Change,1980-07-05,Change - The Glow Of Love,10,11,11,10.0,10,The Glow Of Love,28.0,8,-1,0,1,1,down,1980-05-10
14459,Change,1980-07-12,Change - The Glow Of Love,10,10,12,10.0,11,The Glow Of Love,28.0,9,-1,-1,0,1,down,1980-05-10
14460,Change,1980-07-19,Change - The Glow Of Love,11,10,15,10.0,12,The Glow Of Love,28.0,10,-3,-1,-1,1,down,1980-05-10
14461,Change,1980-07-26,Change - The Glow Of Love,12,11,15,10.0,15,The Glow Of Love,28.0,11,0,-3,-1,0,stay,1980-05-10
14462,Change,1980-08-02,Change - The Glow Of Love,15,12,18,10.0,15,The Glow Of Love,28.0,12,-3,0,-3,1,down,1980-05-10
14463,Change,1980-08-09,Change - The Glow Of Love,15,15,30,10.0,18,The Glow Of Love,28.0,13,-12,-3,0,1,down,1980-05-10
14464,Change,1980-08-16,Change - The Glow Of Love,18,15,29,10.0,30,The Glow Of Love,28.0,14,1,-12,-3,1,up,1980-05-10
14465,Change,1980-08-23,Change - The Glow Of Love,30,18,29,10.0,29,The Glow Of Love,28.0,15,0,1,-12,0,stay,1980-05-10
14466,Change,1980-08-30,Change - The Glow Of Love,29,30,29,10.0,29,The Glow Of Love,28.0,16,0,0,1,0,stay,1980-05-10
14467,Change,1980-09-06,Change - The Glow Of Love,29,29,31,10.0,29,The Glow Of Love,28.0,17,-2,0,0,1,down,1980-05-10
14468,Change,1980-09-13,Change - The Glow Of Love,29,29,37,10.0,31,The Glow Of Love,28.0,18,-6,-2,0,1,down,1980-05-10
14469,Change,1980-09-20,Change - The Glow Of Love,31,29,37,10.0,37,The Glow Of Love,28.0,19,0,-6,-2,0,stay,1980-05-10
14470,Change,1980-09-27,Change - The Glow Of Love,37,31,38,10.0,37,The Glow Of Love,28.0,20,-1,0,-6,1,down,1980-05-10
14471,Change,1980-10-04,Change - The Glow Of Love,37,37,41,10.0,38,The Glow Of Love,28.0,21,-3,-1,0,1,down,1980-05-10
14472,Change,1980-10-11,Change - The Glow Of Love,38,37,43,10.0,41,The Glow Of Love,28.0,22,-2,-3,-1,1,down,1980-05-10
14473,Change,1980-10-18,Change - The Glow Of Love,41,38,41,10.0,43,The Glow Of Love,28.0,23,2,-2,-3,1,up,1980-05-10
14474,Change,1980-10-25,Change - The Glow Of Love,43,41,40,10.0,41,The Glow Of Love,28.0,24,1,2,-2,1,up,1980-05-10
14475,Change,1980-11-01,Change - The Glow Of Love,41,43,39,10.0,40,The Glow Of Love,28.0,25,1,1,2,1,up,1980-05-10
14476,Change,1980-11-08,Change - The Glow Of Love,40,41,40,10.0,39,The Glow Of Love,28.0,26,-1,1,1,1,down,1980-05-10
14477,Change,1980-11-15,Change - The Glow Of Love,39,40,43,10.0,40,The Glow Of Love,28.0,27,-3,-1,1,1,down,1980-05-10
14478,Change,1980-11-22,Change - The Glow Of Love,40,39,51,10.0,43,The Glow Of Love,28.0,28,-8,-3,-1,1,down,1980-05-10
14479,B.B. King,1980-05-10,B.B. King - Now Appearing At Ole' Miss,51,51,45,45.0,47,Now Appearing At Ole' Miss,2.0,0,2,4,0,1,up,1980-05-10
14480,B.B. King,1980-05-17,B.B. King - Now Appearing At Ole' Miss,47,51,50,45.0,45,Now Appearing At Ole' Miss,2.0,1,-5,2,4,1,down,1980-05-10
14481,B.B. King,1980-05-24,B.B. King - Now Appearing At Ole' Miss,45,47,51,45.0,50,Now Appearing At Ole' Miss,2.0,2,-1,-5,2,1,down,1980-05-10
14482,The Temptations,1980-05-17,The Temptations - Power,51,51,17,13.0,21,Power,13.0,0,4,30,0,1,up,1980-05-17
14483,The Temptations,1980-05-24,The Temptations - Power,21,51,15,13.0,17,Power,13.0,1,2,4,30,1,up,1980-05-17
14484,The Temptations,1980-05-31,The Temptations - Power,17,21,14,13.0,15,Power,13.0,2,1,2,4,1,up,1980-05-17
14485,The Temptations,1980-06-07,The Temptations - Power,15,17,13,13.0,14,Power,13.0,3,1,1,2,1,up,1980-05-17
14486,The Temptations,1980-06-14,The Temptations - Power,14,15,13,13.0,13,Power,13.0,4,0,1,1,0,stay,1980-05-17
14487,The Temptations,1980-06-21,The Temptations - Power,13,14,13,13.0,13,Power,13.0,5,0,0,1,0,stay,1980-05-17
14488,The Temptations,1980-06-28,The Temptations - Power,13,13,17,13.0,13,Power,13.0,6,-4,0,0,1,down,1980-05-17
14489,The Temptations,1980-07-05,The Temptations - Power,13,13,22,13.0,17,Power,13.0,7,-5,-4,0,1,down,1980-05-17
14490,The Temptations,1980-07-12,The Temptations - Power,17,13,21,13.0,22,Power,13.0,8,1,-5,-4,1,up,1980-05-17
14491,The Temptations,1980-07-19,The Temptations - Power,22,17,24,13.0,21,Power,13.0,9,-3,1,-5,1,down,1980-05-17
14492,The Temptations,1980-07-26,The Temptations - Power,21,22,34,13.0,24,Power,13.0,10,-10,-3,1,1,down,1980-05-17
14493,The Temptations,1980-08-02,The Temptations - Power,24,21,38,13.0,34,Power,13.0,11,-4,-10,-3,1,down,1980-05-17
14494,The Temptations,1980-08-09,The Temptations - Power,34,24,43,13.0,38,Power,13.0,12,-5,-4,-10,1,down,1980-05-17
14495,The Temptations,1980-08-16,The Temptations - Power,38,34,51,13.0,43,Power,13.0,13,-8,-5,-4,1,down,1980-05-17
14496,Cameo,1980-05-17,Cameo - Cameosis,51,51,12,1.0,23,Cameosis,26.0,0,11,28,0,1,up,1980-05-17
14497,Cameo,1980-05-24,Cameo - Cameosis,23,51,11,1.0,12,Cameosis,26.0,1,1,11,28,1,up,1980-05-17
14498,Cameo,1980-05-31,Cameo - Cameosis,12,23,8,1.0,11,Cameosis,26.0,2,3,1,11,1,up,1980-05-17
14499,Cameo,1980-06-07,Cameo - Cameosis,11,12,7,1.0,8,Cameosis,26.0,3,1,3,1,1,up,1980-05-17
14500,Cameo,1980-06-14,Cameo - Cameosis,8,11,6,1.0,7,Cameosis,26.0,4,1,1,3,1,up,1980-05-17
14501,Cameo,1980-06-21,Cameo - Cameosis,7,8,2,1.0,6,Cameosis,26.0,5,4,1,1,1,up,1980-05-17
14502,Cameo,1980-06-28,Cameo - Cameosis,6,7,2,1.0,2,Cameosis,26.0,6,0,4,1,0,stay,1980-05-17
14503,Cameo,1980-07-05,Cameo - Cameosis,2,6,1,1.0,2,Cameosis,26.0,7,1,0,4,1,up,1980-05-17
14504,Cameo,1980-07-12,Cameo - Cameosis,2,2,1,1.0,1,Cameosis,26.0,8,0,1,0,0,stay,1980-05-17
14505,Cameo,1980-07-19,Cameo - Cameosis,1,2,2,1.0,1,Cameosis,26.0,9,-1,0,1,1,down,1980-05-17
14506,Cameo,1980-07-26,Cameo - Cameosis,1,1,4,1.0,2,Cameosis,26.0,10,-2,-1,0,1,down,1980-05-17
14507,Cameo,1980-08-02,Cameo - Cameosis,2,1,5,1.0,4,Cameosis,26.0,11,-1,-2,-1,1,down,1980-05-17
14508,Cameo,1980-08-09,Cameo - Cameosis,4,2,5,1.0,5,Cameosis,26.0,12,0,-1,-2,0,stay,1980-05-17
14509,Cameo,1980-08-16,Cameo - Cameosis,5,4,5,1.0,5,Cameosis,26.0,13,0,0,-1,0,stay,1980-05-17
14510,Cameo,1980-08-23,Cameo - Cameosis,5,5,9,1.0,5,Cameosis,26.0,14,-4,0,0,1,down,1980-05-17
14511,Cameo,1980-08-30,Cameo - Cameosis,5,5,8,1.0,9,Cameosis,26.0,15,1,-4,0,1,up,1980-05-17
14512,Cameo,1980-09-06,Cameo - Cameosis,9,5,12,1.0,8,Cameosis,26.0,16,-4,1,-4,1,down,1980-05-17
14513,Cameo,1980-09-13,Cameo - Cameosis,8,9,13,1.0,12,Cameosis,26.0,17,-1,-4,1,1,down,1980-05-17
14514,Cameo,1980-09-20,Cameo - Cameosis,12,8,15,1.0,13,Cameosis,26.0,18,-2,-1,-4,1,down,1980-05-17
14515,Cameo,1980-09-27,Cameo - Cameosis,13,12,16,1.0,15,Cameosis,26.0,19,-1,-2,-1,1,down,1980-05-17
14516,Cameo,1980-10-04,Cameo - Cameosis,15,13,16,1.0,16,Cameosis,26.0,20,0,-1,-2,0,stay,1980-05-17
14517,Cameo,1980-10-11,Cameo - Cameosis,16,15,19,1.0,16,Cameosis,26.0,21,-3,0,-1,1,down,1980-05-17
14518,Cameo,1980-10-18,Cameo - Cameosis,16,16,19,1.0,19,Cameosis,26.0,22,0,-3,0,0,stay,1980-05-17
14519,Cameo,1980-10-25,Cameo - Cameosis,19,16,22,1.0,19,Cameosis,26.0,23,-3,0,-3,1,down,1980-05-17
14520,Cameo,1980-11-01,Cameo - Cameosis,19,19,27,1.0,22,Cameosis,26.0,24,-5,-3,0,1,down,1980-05-17
14521,Cameo,1980-11-08,Cameo - Cameosis,22,19,45,1.0,27,Cameosis,26.0,25,-18,-5,-3,1,down,1980-05-17
14522,Cameo,1980-11-15,Cameo - Cameosis,27,22,51,1.0,45,Cameosis,26.0,26,-6,-18,-5,1,down,1980-05-17
14523,Patti LaBelle,1980-05-17,Patti LaBelle - Released,51,51,35,21.0,43,Released,11.0,0,8,8,0,1,up,1980-05-17
14524,Patti LaBelle,1980-05-24,Patti LaBelle - Released,43,51,29,21.0,35,Released,11.0,1,6,8,8,1,up,1980-05-17
14525,Patti LaBelle,1980-05-31,Patti LaBelle - Released,35,43,28,21.0,29,Released,11.0,2,1,6,8,1,up,1980-05-17
14526,Patti LaBelle,1980-06-07,Patti LaBelle - Released,29,35,23,21.0,28,Released,11.0,3,5,1,6,1,up,1980-05-17
14527,Patti LaBelle,1980-06-14,Patti LaBelle - Released,28,29,21,21.0,23,Released,11.0,4,2,5,1,1,up,1980-05-17
14528,Patti LaBelle,1980-06-21,Patti LaBelle - Released,23,28,21,21.0,21,Released,11.0,5,0,2,5,0,stay,1980-05-17
14529,Patti LaBelle,1980-06-28,Patti LaBelle - Released,21,23,44,21.0,21,Released,11.0,6,-23,0,2,1,down,1980-05-17
14530,Patti LaBelle,1980-07-05,Patti LaBelle - Released,21,21,44,21.0,44,Released,11.0,7,0,-23,0,0,stay,1980-05-17
14531,Patti LaBelle,1980-07-12,Patti LaBelle - Released,44,21,48,21.0,44,Released,11.0,8,-4,0,-23,1,down,1980-05-17
14532,Patti LaBelle,1980-07-19,Patti LaBelle - Released,44,44,48,21.0,48,Released,11.0,9,0,-4,0,0,stay,1980-05-17
14533,Patti LaBelle,1980-07-26,Patti LaBelle - Released,48,44,45,21.0,48,Released,11.0,10,3,0,-4,1,up,1980-05-17
14534,Patti LaBelle,1980-08-02,Patti LaBelle - Released,48,48,51,21.0,45,Released,11.0,11,-6,3,0,1,down,1980-05-17
14535,Al Johnson,1980-05-17,Al Johnson - Back For More,51,51,48,48.0,48,Back For More,1.0,0,0,3,0,0,stay,1980-05-17
14536,Al Johnson,1980-05-24,Al Johnson - Back For More,48,51,51,48.0,48,Back For More,1.0,1,-3,0,3,1,down,1980-05-17
14537,B.T. Express,1980-05-17,B.T. Express - B.t.express 1980,51,51,37,29.0,50,B.t.express 1980,10.0,0,13,1,0,1,up,1980-05-17
14538,B.T. Express,1980-05-24,B.T. Express - B.t.express 1980,50,51,32,29.0,37,B.t.express 1980,10.0,1,5,13,1,1,up,1980-05-17
14539,B.T. Express,1980-05-31,B.T. Express - B.t.express 1980,37,50,31,29.0,32,B.t.express 1980,10.0,2,1,5,13,1,up,1980-05-17
14540,B.T. Express,1980-06-07,B.T. Express - B.t.express 1980,32,37,30,29.0,31,B.t.express 1980,10.0,3,1,1,5,1,up,1980-05-17
14541,B.T. Express,1980-06-14,B.T. Express - B.t.express 1980,31,32,29,29.0,30,B.t.express 1980,10.0,4,1,1,1,1,up,1980-05-17
14542,B.T. Express,1980-06-21,B.T. Express - B.t.express 1980,30,31,43,29.0,29,B.t.express 1980,10.0,5,-14,1,1,1,down,1980-05-17
14543,B.T. Express,1980-06-28,B.T. Express - B.t.express 1980,29,30,43,29.0,43,B.t.express 1980,10.0,6,0,-14,1,0,stay,1980-05-17
14544,B.T. Express,1980-07-05,B.T. Express - B.t.express 1980,43,29,43,29.0,43,B.t.express 1980,10.0,7,0,0,-14,0,stay,1980-05-17
14545,B.T. Express,1980-07-12,B.T. Express - B.t.express 1980,43,43,42,29.0,43,B.t.express 1980,10.0,8,1,0,0,1,up,1980-05-17
14546,B.T. Express,1980-07-19,B.T. Express - B.t.express 1980,43,43,44,29.0,42,B.t.express 1980,10.0,9,-2,1,0,1,down,1980-05-17
14547,B.T. Express,1980-07-26,B.T. Express - B.t.express 1980,42,43,51,29.0,44,B.t.express 1980,10.0,10,-7,-2,1,1,down,1980-05-17
14548,Leon Haywood,1980-05-24,Leon Haywood - Naturally,51,51,28,22.0,38,Naturally,7.0,0,10,13,0,1,up,1980-05-24
14549,Leon Haywood,1980-05-31,Leon Haywood - Naturally,38,51,22,22.0,28,Naturally,7.0,1,6,10,13,1,up,1980-05-24
14550,Leon Haywood,1980-06-07,Leon Haywood - Naturally,28,38,22,22.0,22,Naturally,7.0,2,0,6,10,0,stay,1980-05-24
14551,Leon Haywood,1980-06-14,Leon Haywood - Naturally,22,28,22,22.0,22,Naturally,7.0,3,0,0,6,0,stay,1980-05-24
14552,Leon Haywood,1980-06-21,Leon Haywood - Naturally,22,22,37,22.0,22,Naturally,7.0,4,-15,0,0,1,down,1980-05-24
14553,Leon Haywood,1980-06-28,Leon Haywood - Naturally,22,22,48,22.0,37,Naturally,7.0,5,-11,-15,0,1,down,1980-05-24
14554,Leon Haywood,1980-07-05,Leon Haywood - Naturally,37,22,50,22.0,48,Naturally,7.0,6,-2,-11,-15,1,down,1980-05-24
14555,Leon Haywood,1980-07-12,Leon Haywood - Naturally,48,37,51,22.0,50,Naturally,7.0,7,-1,-2,-11,1,down,1980-05-24
14556,Isaac Hayes,1980-05-24,Isaac Hayes - And Once Again,51,51,30,26.0,43,And Once Again,9.0,0,13,8,0,1,up,1980-05-24
14557,Isaac Hayes,1980-05-31,Isaac Hayes - And Once Again,43,51,29,26.0,30,And Once Again,9.0,1,1,13,8,1,up,1980-05-24
14558,Isaac Hayes,1980-06-07,Isaac Hayes - And Once Again,30,43,29,26.0,29,And Once Again,9.0,2,0,1,13,0,stay,1980-05-24
14559,Isaac Hayes,1980-06-14,Isaac Hayes - And Once Again,29,30,26,26.0,29,And Once Again,9.0,3,3,0,1,1,up,1980-05-24
14560,Isaac Hayes,1980-06-21,Isaac Hayes - And Once Again,29,29,27,26.0,26,And Once Again,9.0,4,-1,3,0,1,down,1980-05-24
14561,Isaac Hayes,1980-06-28,Isaac Hayes - And Once Again,26,29,30,26.0,27,And Once Again,9.0,5,-3,-1,3,1,down,1980-05-24
14562,Isaac Hayes,1980-07-05,Isaac Hayes - And Once Again,27,26,30,26.0,30,And Once Again,9.0,6,0,-3,-1,0,stay,1980-05-24
14563,Isaac Hayes,1980-07-12,Isaac Hayes - And Once Again,30,27,39,26.0,30,And Once Again,9.0,7,-9,0,-3,1,down,1980-05-24
14564,Isaac Hayes,1980-07-19,Isaac Hayes - And Once Again,30,30,47,26.0,39,And Once Again,9.0,8,-8,-9,0,1,down,1980-05-24
14565,Isaac Hayes,1980-07-26,Isaac Hayes - And Once Again,39,30,51,26.0,47,And Once Again,9.0,9,-4,-8,-9,1,down,1980-05-24
14566,Syreeta,1980-05-24,Syreeta - Syreeta,51,51,39,39.0,46,Syreeta,4.0,0,7,5,0,1,up,1980-05-24
14567,Syreeta,1980-05-31,Syreeta - Syreeta,46,51,39,39.0,39,Syreeta,4.0,1,0,7,5,0,stay,1980-05-24
14568,Syreeta,1980-06-07,Syreeta - Syreeta,39,46,45,39.0,39,Syreeta,4.0,2,-6,0,7,1,down,1980-05-24
14569,Syreeta,1980-06-14,Syreeta - Syreeta,39,39,45,39.0,45,Syreeta,4.0,3,0,-6,0,0,stay,1980-05-24
14570,Syreeta,1980-06-21,Syreeta - Syreeta,45,39,51,39.0,45,Syreeta,4.0,4,-6,0,-6,1,down,1980-05-24
14571,Breakwater,1980-05-24,Breakwater - Splashdown,51,51,47,33.0,47,Splashdown,9.0,0,0,4,0,0,stay,1980-05-24
14572,Breakwater,1980-05-31,Breakwater - Splashdown,47,51,45,33.0,47,Splashdown,9.0,1,2,0,4,1,up,1980-05-24
14573,Breakwater,1980-06-07,Breakwater - Splashdown,47,47,36,33.0,45,Splashdown,9.0,2,9,2,0,1,up,1980-05-24
14574,Breakwater,1980-06-14,Breakwater - Splashdown,45,47,36,33.0,36,Splashdown,9.0,3,0,9,2,0,stay,1980-05-24
14575,Breakwater,1980-06-21,Breakwater - Splashdown,36,45,35,33.0,36,Splashdown,9.0,4,1,0,9,1,up,1980-05-24
14576,Breakwater,1980-06-28,Breakwater - Splashdown,36,36,34,33.0,35,Splashdown,9.0,5,1,1,0,1,up,1980-05-24
14577,Breakwater,1980-07-05,Breakwater - Splashdown,35,36,33,33.0,34,Splashdown,9.0,6,1,1,1,1,up,1980-05-24
14578,Breakwater,1980-07-12,Breakwater - Splashdown,34,35,35,33.0,33,Splashdown,9.0,7,-2,1,1,1,down,1980-05-24
14579,Breakwater,1980-07-19,Breakwater - Splashdown,33,34,46,33.0,35,Splashdown,9.0,8,-11,-2,1,1,down,1980-05-24
14580,Breakwater,1980-07-26,Breakwater - Splashdown,35,33,51,33.0,46,Splashdown,9.0,9,-5,-11,-2,1,down,1980-05-24
14581,Gladys Knight And The Pips,1980-05-31,Gladys Knight And The Pips - About Love,51,51,20,5.0,42,About Love,18.0,0,22,9,0,1,up,1980-05-31
14582,Gladys Knight And The Pips,1980-06-07,Gladys Knight And The Pips - About Love,42,51,10,5.0,20,About Love,18.0,1,10,22,9,1,up,1980-05-31
14583,Gladys Knight And The Pips,1980-06-14,Gladys Knight And The Pips - About Love,20,42,8,5.0,10,About Love,18.0,2,2,10,22,1,up,1980-05-31
14584,Gladys Knight And The Pips,1980-06-21,Gladys Knight And The Pips - About Love,10,20,5,5.0,8,About Love,18.0,3,3,2,10,1,up,1980-05-31
14585,Gladys Knight And The Pips,1980-06-28,Gladys Knight And The Pips - About Love,8,10,5,5.0,5,About Love,18.0,4,0,3,2,0,stay,1980-05-31
14586,Gladys Knight And The Pips,1980-07-05,Gladys Knight And The Pips - About Love,5,8,9,5.0,5,About Love,18.0,5,-4,0,3,1,down,1980-05-31
14587,Gladys Knight And The Pips,1980-07-12,Gladys Knight And The Pips - About Love,5,5,10,5.0,9,About Love,18.0,6,-1,-4,0,1,down,1980-05-31
14588,Gladys Knight And The Pips,1980-07-19,Gladys Knight And The Pips - About Love,9,5,9,5.0,10,About Love,18.0,7,1,-1,-4,1,up,1980-05-31
14589,Gladys Knight And The Pips,1980-07-26,Gladys Knight And The Pips - About Love,10,9,8,5.0,9,About Love,18.0,8,1,1,-1,1,up,1980-05-31
14590,Gladys Knight And The Pips,1980-08-02,Gladys Knight And The Pips - About Love,9,10,8,5.0,8,About Love,18.0,9,0,1,1,0,stay,1980-05-31
14591,Gladys Knight And The Pips,1980-08-09,Gladys Knight And The Pips - About Love,8,9,8,5.0,8,About Love,18.0,10,0,0,1,0,stay,1980-05-31
14592,Gladys Knight And The Pips,1980-08-16,Gladys Knight And The Pips - About Love,8,8,18,5.0,8,About Love,18.0,11,-10,0,0,1,down,1980-05-31
14593,Gladys Knight And The Pips,1980-08-23,Gladys Knight And The Pips - About Love,8,8,22,5.0,18,About Love,18.0,12,-4,-10,0,1,down,1980-05-31
14594,Gladys Knight And The Pips,1980-08-30,Gladys Knight And The Pips - About Love,18,8,27,5.0,22,About Love,18.0,13,-5,-4,-10,1,down,1980-05-31
14595,Gladys Knight And The Pips,1980-09-06,Gladys Knight And The Pips - About Love,22,18,33,5.0,27,About Love,18.0,14,-6,-5,-4,1,down,1980-05-31
14596,Gladys Knight And The Pips,1980-09-13,Gladys Knight And The Pips - About Love,27,22,40,5.0,33,About Love,18.0,15,-7,-6,-5,1,down,1980-05-31
14597,Gladys Knight And The Pips,1980-09-20,Gladys Knight And The Pips - About Love,33,27,44,5.0,40,About Love,18.0,16,-4,-7,-6,1,down,1980-05-31
14598,Gladys Knight And The Pips,1980-09-27,Gladys Knight And The Pips - About Love,40,33,46,5.0,44,About Love,18.0,17,-2,-4,-7,1,down,1980-05-31
14599,Gladys Knight And The Pips,1980-10-04,Gladys Knight And The Pips - About Love,44,40,51,5.0,46,About Love,18.0,18,-5,-2,-4,1,down,1980-05-31
14600,Bobby Caldwell,1980-05-31,Bobby Caldwell - Cat In The Hat,51,51,46,46.0,50,Cat In The Hat,3.0,0,4,1,0,1,up,1980-05-31
14601,Bobby Caldwell,1980-06-07,Bobby Caldwell - Cat In The Hat,50,51,46,46.0,46,Cat In The Hat,3.0,1,0,4,1,0,stay,1980-05-31
14602,Bobby Caldwell,1980-06-14,Bobby Caldwell - Cat In The Hat,46,50,46,46.0,46,Cat In The Hat,3.0,2,0,0,4,0,stay,1980-05-31
14603,Bobby Caldwell,1980-06-21,Bobby Caldwell - Cat In The Hat,46,46,51,46.0,46,Cat In The Hat,3.0,3,-5,0,0,1,down,1980-05-31
14604,The Invisible Man's Band,1980-06-07,The Invisible Man's Band - The Invisible Man's Band,51,51,25,19.0,36,The Invisible Man's Band,12.0,0,11,15,0,1,up,1980-06-07
14605,The Invisible Man's Band,1980-06-14,The Invisible Man's Band - The Invisible Man's Band,36,51,24,19.0,25,The Invisible Man's Band,12.0,1,1,11,15,1,up,1980-06-07
14606,The Invisible Man's Band,1980-06-21,The Invisible Man's Band - The Invisible Man's Band,25,36,19,19.0,24,The Invisible Man's Band,12.0,2,5,1,11,1,up,1980-06-07
14607,The Invisible Man's Band,1980-06-28,The Invisible Man's Band - The Invisible Man's Band,24,25,19,19.0,19,The Invisible Man's Band,12.0,3,0,5,1,0,stay,1980-06-07
14608,The Invisible Man's Band,1980-07-05,The Invisible Man's Band - The Invisible Man's Band,19,24,25,19.0,19,The Invisible Man's Band,12.0,4,-6,0,5,1,down,1980-06-07
14609,The Invisible Man's Band,1980-07-12,The Invisible Man's Band - The Invisible Man's Band,19,19,31,19.0,25,The Invisible Man's Band,12.0,5,-6,-6,0,1,down,1980-06-07
14610,The Invisible Man's Band,1980-07-19,The Invisible Man's Band - The Invisible Man's Band,25,19,32,19.0,31,The Invisible Man's Band,12.0,6,-1,-6,-6,1,down,1980-06-07
14611,The Invisible Man's Band,1980-07-26,The Invisible Man's Band - The Invisible Man's Band,31,25,32,19.0,32,The Invisible Man's Band,12.0,7,0,-1,-6,0,stay,1980-06-07
14612,The Invisible Man's Band,1980-08-02,The Invisible Man's Band - The Invisible Man's Band,32,31,34,19.0,32,The Invisible Man's Band,12.0,8,-2,0,-1,1,down,1980-06-07
14613,The Invisible Man's Band,1980-08-09,The Invisible Man's Band - The Invisible Man's Band,32,32,42,19.0,34,The Invisible Man's Band,12.0,9,-8,-2,0,1,down,1980-06-07
14614,The Invisible Man's Band,1980-08-16,The Invisible Man's Band - The Invisible Man's Band,34,32,44,19.0,42,The Invisible Man's Band,12.0,10,-2,-8,-2,1,down,1980-06-07
14615,The Invisible Man's Band,1980-08-23,The Invisible Man's Band - The Invisible Man's Band,42,34,50,19.0,44,The Invisible Man's Band,12.0,11,-6,-2,-8,1,down,1980-06-07
14616,The Invisible Man's Band,1980-08-30,The Invisible Man's Band - The Invisible Man's Band,44,42,51,19.0,50,The Invisible Man's Band,12.0,12,-1,-6,-2,1,down,1980-06-07
14617,Randy Crawford,1980-06-07,Randy Crawford - Now We May Begin,51,51,33,30.0,43,Now We May Begin,7.0,0,10,8,0,1,up,1980-06-07
14618,Randy Crawford,1980-06-14,Randy Crawford - Now We May Begin,43,51,32,30.0,33,Now We May Begin,7.0,1,1,10,8,1,up,1980-06-07
14619,Randy Crawford,1980-06-21,Randy Crawford - Now We May Begin,33,43,30,30.0,32,Now We May Begin,7.0,2,2,1,10,1,up,1980-06-07
14620,Randy Crawford,1980-06-28,Randy Crawford - Now We May Begin,32,33,41,30.0,30,Now We May Begin,7.0,3,-11,2,1,1,down,1980-06-07
14621,Randy Crawford,1980-07-05,Randy Crawford - Now We May Begin,30,32,42,30.0,41,Now We May Begin,7.0,4,-1,-11,2,1,down,1980-06-07
14622,Randy Crawford,1980-07-12,Randy Crawford - Now We May Begin,41,30,47,30.0,42,Now We May Begin,7.0,5,-5,-1,-11,1,down,1980-06-07
14623,Randy Crawford,1980-07-19,Randy Crawford - Now We May Begin,42,41,50,30.0,47,Now We May Begin,7.0,6,-3,-5,-1,1,down,1980-06-07
14624,Randy Crawford,1980-07-26,Randy Crawford - Now We May Begin,47,42,51,30.0,50,Now We May Begin,7.0,7,-1,-3,-5,1,down,1980-06-07
14625,Stacy Lattisaw,1980-06-14,Stacy Lattisaw - Let Me Be Your Angel,51,51,37,9.0,47,Let Me Be Your Angel,31.0,0,10,4,0,1,up,1980-06-14
14626,Stacy Lattisaw,1980-06-21,Stacy Lattisaw - Let Me Be Your Angel,47,51,29,9.0,37,Let Me Be Your Angel,31.0,1,8,10,4,1,up,1980-06-14
14627,Stacy Lattisaw,1980-06-28,Stacy Lattisaw - Let Me Be Your Angel,37,47,29,9.0,29,Let Me Be Your Angel,31.0,2,0,8,10,0,stay,1980-06-14
14628,Stacy Lattisaw,1980-07-05,Stacy Lattisaw - Let Me Be Your Angel,29,37,23,9.0,29,Let Me Be Your Angel,31.0,3,6,0,8,1,up,1980-06-14
14629,Stacy Lattisaw,1980-07-12,Stacy Lattisaw - Let Me Be Your Angel,29,29,23,9.0,23,Let Me Be Your Angel,31.0,4,0,6,0,0,stay,1980-06-14
14630,Stacy Lattisaw,1980-07-19,Stacy Lattisaw - Let Me Be Your Angel,23,29,18,9.0,23,Let Me Be Your Angel,31.0,5,5,0,6,1,up,1980-06-14
14631,Stacy Lattisaw,1980-07-26,Stacy Lattisaw - Let Me Be Your Angel,23,23,18,9.0,18,Let Me Be Your Angel,31.0,6,0,5,0,0,stay,1980-06-14
14632,Stacy Lattisaw,1980-08-02,Stacy Lattisaw - Let Me Be Your Angel,18,23,16,9.0,18,Let Me Be Your Angel,31.0,7,2,0,5,1,up,1980-06-14
14633,Stacy Lattisaw,1980-08-09,Stacy Lattisaw - Let Me Be Your Angel,18,18,13,9.0,16,Let Me Be Your Angel,31.0,8,3,2,0,1,up,1980-06-14
14634,Stacy Lattisaw,1980-08-16,Stacy Lattisaw - Let Me Be Your Angel,16,18,12,9.0,13,Let Me Be Your Angel,31.0,9,1,3,2,1,up,1980-06-14
14635,Stacy Lattisaw,1980-08-23,Stacy Lattisaw - Let Me Be Your Angel,13,16,11,9.0,12,Let Me Be Your Angel,31.0,10,1,1,3,1,up,1980-06-14
14636,Stacy Lattisaw,1980-08-30,Stacy Lattisaw - Let Me Be Your Angel,12,13,10,9.0,11,Let Me Be Your Angel,31.0,11,1,1,1,1,up,1980-06-14
14637,Stacy Lattisaw,1980-09-06,Stacy Lattisaw - Let Me Be Your Angel,11,12,10,9.0,10,Let Me Be Your Angel,31.0,12,0,1,1,0,stay,1980-06-14
14638,Stacy Lattisaw,1980-09-13,Stacy Lattisaw - Let Me Be Your Angel,10,11,10,9.0,10,Let Me Be Your Angel,31.0,13,0,0,1,0,stay,1980-06-14
14639,Stacy Lattisaw,1980-09-20,Stacy Lattisaw - Let Me Be Your Angel,10,10,10,9.0,10,Let Me Be Your Angel,31.0,14,0,0,0,0,stay,1980-06-14
14640,Stacy Lattisaw,1980-09-27,Stacy Lattisaw - Let Me Be Your Angel,10,10,10,9.0,10,Let Me Be Your Angel,31.0,15,0,0,0,0,stay,1980-06-14
14641,Stacy Lattisaw,1980-10-04,Stacy Lattisaw - Let Me Be Your Angel,10,10,10,9.0,10,Let Me Be Your Angel,31.0,16,0,0,0,0,stay,1980-06-14
14642,Stacy Lattisaw,1980-10-11,Stacy Lattisaw - Let Me Be Your Angel,10,10,9,9.0,10,Let Me Be Your Angel,31.0,17,1,0,0,1,up,1980-06-14
14643,Stacy Lattisaw,1980-10-18,Stacy Lattisaw - Let Me Be Your Angel,10,10,9,9.0,9,Let Me Be Your Angel,31.0,18,0,1,0,0,stay,1980-06-14
14644,Stacy Lattisaw,1980-10-25,Stacy Lattisaw - Let Me Be Your Angel,9,10,9,9.0,9,Let Me Be Your Angel,31.0,19,0,0,1,0,stay,1980-06-14
14645,Stacy Lattisaw,1980-11-01,Stacy Lattisaw - Let Me Be Your Angel,9,9,11,9.0,9,Let Me Be Your Angel,31.0,20,-2,0,0,1,down,1980-06-14
14646,Stacy Lattisaw,1980-11-08,Stacy Lattisaw - Let Me Be Your Angel,9,9,17,9.0,11,Let Me Be Your Angel,31.0,21,-6,-2,0,1,down,1980-06-14
14647,Stacy Lattisaw,1980-11-15,Stacy Lattisaw - Let Me Be Your Angel,11,9,24,9.0,17,Let Me Be Your Angel,31.0,22,-7,-6,-2,1,down,1980-06-14
14648,Stacy Lattisaw,1980-11-22,Stacy Lattisaw - Let Me Be Your Angel,17,11,30,9.0,24,Let Me Be Your Angel,31.0,23,-6,-7,-6,1,down,1980-06-14
14649,Stacy Lattisaw,1980-11-29,Stacy Lattisaw - Let Me Be Your Angel,24,17,32,9.0,30,Let Me Be Your Angel,31.0,24,-2,-6,-7,1,down,1980-06-14
14650,Stacy Lattisaw,1980-12-06,Stacy Lattisaw - Let Me Be Your Angel,30,24,37,9.0,32,Let Me Be Your Angel,31.0,25,-5,-2,-6,1,down,1980-06-14
14651,Stacy Lattisaw,1980-12-13,Stacy Lattisaw - Let Me Be Your Angel,32,30,45,9.0,37,Let Me Be Your Angel,31.0,26,-8,-5,-2,1,down,1980-06-14
14652,Stacy Lattisaw,1980-12-20,Stacy Lattisaw - Let Me Be Your Angel,37,32,46,9.0,45,Let Me Be Your Angel,31.0,27,-1,-8,-5,1,down,1980-06-14
14653,Stacy Lattisaw,1980-12-27,Stacy Lattisaw - Let Me Be Your Angel,45,37,46,9.0,46,Let Me Be Your Angel,31.0,28,0,-1,-8,0,stay,1980-06-14
14654,Stacy Lattisaw,1981-01-03,Stacy Lattisaw - Let Me Be Your Angel,46,45,50,9.0,46,Let Me Be Your Angel,31.0,29,-4,0,-1,1,down,1980-06-14
14655,Stacy Lattisaw,1981-01-10,Stacy Lattisaw - Let Me Be Your Angel,46,46,72,9.0,50,Let Me Be Your Angel,31.0,30,-22,-4,0,1,down,1980-06-14
14656,Stacy Lattisaw,1981-01-31,Stacy Lattisaw - Let Me Be Your Angel,50,46,51,9.0,72,Let Me Be Your Angel,31.0,31,21,-22,-4,1,up,1980-06-14
14657,Rockie Robbins,1980-06-14,Rockie Robbins - You And Me,51,51,38,19.0,48,You And Me,14.0,0,10,3,0,1,up,1980-06-14
14658,Rockie Robbins,1980-06-21,Rockie Robbins - You And Me,48,51,33,19.0,38,You And Me,14.0,1,5,10,3,1,up,1980-06-14
14659,Rockie Robbins,1980-06-28,Rockie Robbins - You And Me,38,48,31,19.0,33,You And Me,14.0,2,2,5,10,1,up,1980-06-14
14660,Rockie Robbins,1980-07-05,Rockie Robbins - You And Me,33,38,32,19.0,31,You And Me,14.0,3,-1,2,5,1,down,1980-06-14
14661,Rockie Robbins,1980-07-12,Rockie Robbins - You And Me,31,33,25,19.0,32,You And Me,14.0,4,7,-1,2,1,up,1980-06-14
14662,Rockie Robbins,1980-07-19,Rockie Robbins - You And Me,32,31,19,19.0,25,You And Me,14.0,5,6,7,-1,1,up,1980-06-14
14663,Rockie Robbins,1980-07-26,Rockie Robbins - You And Me,25,32,19,19.0,19,You And Me,14.0,6,0,6,7,0,stay,1980-06-14
14664,Rockie Robbins,1980-08-02,Rockie Robbins - You And Me,19,25,29,19.0,19,You And Me,14.0,7,-10,0,6,1,down,1980-06-14
14665,Rockie Robbins,1980-08-09,Rockie Robbins - You And Me,19,19,34,19.0,29,You And Me,14.0,8,-5,-10,0,1,down,1980-06-14
14666,Rockie Robbins,1980-08-16,Rockie Robbins - You And Me,29,19,34,19.0,34,You And Me,14.0,9,0,-5,-10,0,stay,1980-06-14
14667,Rockie Robbins,1980-08-23,Rockie Robbins - You And Me,34,29,40,19.0,34,You And Me,14.0,10,-6,0,-5,1,down,1980-06-14
14668,Rockie Robbins,1980-08-30,Rockie Robbins - You And Me,34,34,40,19.0,40,You And Me,14.0,11,0,-6,0,0,stay,1980-06-14
14669,Rockie Robbins,1980-09-06,Rockie Robbins - You And Me,40,34,44,19.0,40,You And Me,14.0,12,-4,0,-6,1,down,1980-06-14
14670,Rockie Robbins,1980-09-13,Rockie Robbins - You And Me,40,40,50,19.0,44,You And Me,14.0,13,-6,-4,0,1,down,1980-06-14
14671,Rockie Robbins,1980-09-20,Rockie Robbins - You And Me,44,40,51,19.0,50,You And Me,14.0,14,-1,-6,-4,1,down,1980-06-14
14672,Average White Band,1980-06-14,Average White Band - Shine,51,51,39,38.0,49,Shine,6.0,0,10,2,0,1,up,1980-06-14
14673,Average White Band,1980-06-21,Average White Band - Shine,49,51,38,38.0,39,Shine,6.0,1,1,10,2,1,up,1980-06-14
14674,Average White Band,1980-06-28,Average White Band - Shine,39,49,38,38.0,38,Shine,6.0,2,0,1,10,0,stay,1980-06-14
14675,Average White Band,1980-07-05,Average White Band - Shine,38,39,39,38.0,38,Shine,6.0,3,-1,0,1,1,down,1980-06-14
14676,Average White Band,1980-07-12,Average White Band - Shine,38,38,43,38.0,39,Shine,6.0,4,-4,-1,0,1,down,1980-06-14
14677,Average White Band,1980-07-19,Average White Band - Shine,39,38,40,38.0,43,Shine,6.0,5,3,-4,-1,1,up,1980-06-14
14678,Average White Band,1980-07-26,Average White Band - Shine,43,39,51,38.0,40,Shine,6.0,6,-11,3,-4,1,down,1980-06-14
14679,5 Special,1980-06-14,5 Special - Special Edition,51,51,50,46.0,50,Special Edition,4.0,0,0,1,0,0,stay,1980-06-14
14680,5 Special,1980-06-21,5 Special - Special Edition,50,51,49,46.0,50,Special Edition,4.0,1,1,0,1,1,up,1980-06-14
14681,5 Special,1980-06-28,5 Special - Special Edition,50,50,46,46.0,49,Special Edition,4.0,2,3,1,0,1,up,1980-06-14
14682,5 Special,1980-07-05,5 Special - Special Edition,49,50,47,46.0,46,Special Edition,4.0,3,-1,3,1,1,down,1980-06-14
14683,5 Special,1980-07-12,5 Special - Special Edition,46,49,51,46.0,47,Special Edition,4.0,4,-4,-1,3,1,down,1980-06-14
14684,Diana Ross,1980-06-21,Diana Ross - Diana,51,51,12,1.0,15,Diana,38.0,0,3,36,0,1,up,1980-06-21
14685,Diana Ross,1980-06-28,Diana Ross - Diana,15,51,7,1.0,12,Diana,38.0,1,5,3,36,1,up,1980-06-21
14686,Diana Ross,1980-07-05,Diana Ross - Diana,12,15,4,1.0,7,Diana,38.0,2,3,5,3,1,up,1980-06-21
14687,Diana Ross,1980-07-12,Diana Ross - Diana,7,12,2,1.0,4,Diana,38.0,3,2,3,5,1,up,1980-06-21
14688,Diana Ross,1980-07-19,Diana Ross - Diana,4,7,1,1.0,2,Diana,38.0,4,1,2,3,1,up,1980-06-21
14689,Diana Ross,1980-07-26,Diana Ross - Diana,2,4,1,1.0,1,Diana,38.0,5,0,1,2,0,stay,1980-06-21
14690,Diana Ross,1980-08-02,Diana Ross - Diana,1,2,1,1.0,1,Diana,38.0,6,0,0,1,0,stay,1980-06-21
14691,Diana Ross,1980-08-09,Diana Ross - Diana,1,1,1,1.0,1,Diana,38.0,7,0,0,0,0,stay,1980-06-21
14692,Diana Ross,1980-08-16,Diana Ross - Diana,1,1,1,1.0,1,Diana,38.0,8,0,0,0,0,stay,1980-06-21
14693,Diana Ross,1980-08-23,Diana Ross - Diana,1,1,1,1.0,1,Diana,38.0,9,0,0,0,0,stay,1980-06-21
14694,Diana Ross,1980-08-30,Diana Ross - Diana,1,1,1,1.0,1,Diana,38.0,10,0,0,0,0,stay,1980-06-21
14695,Diana Ross,1980-09-06,Diana Ross - Diana,1,1,1,1.0,1,Diana,38.0,11,0,0,0,0,stay,1980-06-21
14696,Diana Ross,1980-09-13,Diana Ross - Diana,1,1,2,1.0,1,Diana,38.0,12,-1,0,0,1,down,1980-06-21
14697,Diana Ross,1980-09-20,Diana Ross - Diana,1,1,2,1.0,2,Diana,38.0,13,0,-1,0,0,stay,1980-06-21
14698,Diana Ross,1980-09-27,Diana Ross - Diana,2,1,2,1.0,2,Diana,38.0,14,0,0,-1,0,stay,1980-06-21
14699,Diana Ross,1980-10-04,Diana Ross - Diana,2,2,2,1.0,2,Diana,38.0,15,0,0,0,0,stay,1980-06-21
14700,Diana Ross,1980-10-11,Diana Ross - Diana,2,2,2,1.0,2,Diana,38.0,16,0,0,0,0,stay,1980-06-21
14701,Diana Ross,1980-10-18,Diana Ross - Diana,2,2,4,1.0,2,Diana,38.0,17,-2,0,0,1,down,1980-06-21
14702,Diana Ross,1980-10-25,Diana Ross - Diana,2,2,5,1.0,4,Diana,38.0,18,-1,-2,0,1,down,1980-06-21
14703,Diana Ross,1980-11-01,Diana Ross - Diana,4,2,8,1.0,5,Diana,38.0,19,-3,-1,-2,1,down,1980-06-21
14704,Diana Ross,1980-11-08,Diana Ross - Diana,5,4,8,1.0,8,Diana,38.0,20,0,-3,-1,0,stay,1980-06-21
14705,Diana Ross,1980-11-15,Diana Ross - Diana,8,5,8,1.0,8,Diana,38.0,21,0,0,-3,0,stay,1980-06-21
14706,Diana Ross,1980-11-22,Diana Ross - Diana,8,8,18,1.0,8,Diana,38.0,22,-10,0,0,1,down,1980-06-21
14707,Diana Ross,1980-11-29,Diana Ross - Diana,8,8,18,1.0,18,Diana,38.0,23,0,-10,0,0,stay,1980-06-21
14708,Diana Ross,1980-12-06,Diana Ross - Diana,18,8,18,1.0,18,Diana,38.0,24,0,0,-10,0,stay,1980-06-21
14709,Diana Ross,1980-12-13,Diana Ross - Diana,18,18,26,1.0,18,Diana,38.0,25,-8,0,0,1,down,1980-06-21
14710,Diana Ross,1980-12-20,Diana Ross - Diana,18,18,27,1.0,26,Diana,38.0,26,-1,-8,0,1,down,1980-06-21
14711,Diana Ross,1980-12-27,Diana Ross - Diana,26,18,27,1.0,27,Diana,38.0,27,0,-1,-8,0,stay,1980-06-21
14712,Diana Ross,1981-01-03,Diana Ross - Diana,27,26,28,1.0,27,Diana,38.0,28,-1,0,-1,1,down,1980-06-21
14713,Diana Ross,1981-01-10,Diana Ross - Diana,27,27,35,1.0,28,Diana,38.0,29,-7,-1,0,1,down,1980-06-21
14714,Diana Ross,1981-01-17,Diana Ross - Diana,28,27,35,1.0,35,Diana,38.0,30,0,-7,-1,0,stay,1980-06-21
14715,Diana Ross,1981-01-24,Diana Ross - Diana,35,28,40,1.0,35,Diana,38.0,31,-5,0,-7,1,down,1980-06-21
14716,Diana Ross,1981-02-07,Diana Ross - Diana,35,35,40,1.0,40,Diana,38.0,32,0,-5,0,0,stay,1980-06-21
14717,Diana Ross,1981-02-14,Diana Ross - Diana,40,35,41,1.0,40,Diana,38.0,33,-1,0,-5,1,down,1980-06-21
14718,Diana Ross,1981-02-21,Diana Ross - Diana,40,40,42,1.0,41,Diana,38.0,34,-1,-1,0,1,down,1980-06-21
14719,Diana Ross,1981-02-28,Diana Ross - Diana,41,40,43,1.0,42,Diana,38.0,35,-1,-1,-1,1,down,1980-06-21
14720,Diana Ross,1981-03-07,Diana Ross - Diana,42,41,46,1.0,43,Diana,38.0,36,-3,-1,-1,1,down,1980-06-21
14721,Diana Ross,1981-03-14,Diana Ross - Diana,43,42,48,1.0,46,Diana,38.0,37,-2,-3,-1,1,down,1980-06-21
14722,Diana Ross,1981-03-21,Diana Ross - Diana,46,43,51,1.0,48,Diana,38.0,38,-3,-2,-3,1,down,1980-06-21
14723,Chaka Khan,1980-06-21,Chaka Khan - Naughty,51,51,11,6.0,31,Naughty,18.0,0,20,20,0,1,up,1980-06-21
14724,Chaka Khan,1980-06-28,Chaka Khan - Naughty,31,51,9,6.0,11,Naughty,18.0,1,2,20,20,1,up,1980-06-21
14725,Chaka Khan,1980-07-05,Chaka Khan - Naughty,11,31,7,6.0,9,Naughty,18.0,2,2,2,20,1,up,1980-06-21
14726,Chaka Khan,1980-07-12,Chaka Khan - Naughty,9,11,6,6.0,7,Naughty,18.0,3,1,2,2,1,up,1980-06-21
14727,Chaka Khan,1980-07-19,Chaka Khan - Naughty,7,9,6,6.0,6,Naughty,18.0,4,0,1,2,0,stay,1980-06-21
14728,Chaka Khan,1980-07-26,Chaka Khan - Naughty,6,7,6,6.0,6,Naughty,18.0,5,0,0,1,0,stay,1980-06-21
14729,Chaka Khan,1980-08-02,Chaka Khan - Naughty,6,6,7,6.0,6,Naughty,18.0,6,-1,0,0,1,down,1980-06-21
14730,Chaka Khan,1980-08-09,Chaka Khan - Naughty,6,6,7,6.0,7,Naughty,18.0,7,0,-1,0,0,stay,1980-06-21
14731,Chaka Khan,1980-08-16,Chaka Khan - Naughty,7,6,16,6.0,7,Naughty,18.0,8,-9,0,-1,1,down,1980-06-21
14732,Chaka Khan,1980-08-23,Chaka Khan - Naughty,7,7,23,6.0,16,Naughty,18.0,9,-7,-9,0,1,down,1980-06-21
14733,Chaka Khan,1980-08-30,Chaka Khan - Naughty,16,7,22,6.0,23,Naughty,18.0,10,1,-7,-9,1,up,1980-06-21
14734,Chaka Khan,1980-09-06,Chaka Khan - Naughty,23,16,21,6.0,22,Naughty,18.0,11,1,1,-7,1,up,1980-06-21
14735,Chaka Khan,1980-09-13,Chaka Khan - Naughty,22,23,23,6.0,21,Naughty,18.0,12,-2,1,1,1,down,1980-06-21
14736,Chaka Khan,1980-09-20,Chaka Khan - Naughty,21,22,28,6.0,23,Naughty,18.0,13,-5,-2,1,1,down,1980-06-21
14737,Chaka Khan,1980-09-27,Chaka Khan - Naughty,23,21,28,6.0,28,Naughty,18.0,14,0,-5,-2,0,stay,1980-06-21
14738,Chaka Khan,1980-10-04,Chaka Khan - Naughty,28,23,29,6.0,28,Naughty,18.0,15,-1,0,-5,1,down,1980-06-21
14739,Chaka Khan,1980-10-11,Chaka Khan - Naughty,28,28,30,6.0,29,Naughty,18.0,16,-1,-1,0,1,down,1980-06-21
14740,Chaka Khan,1980-10-18,Chaka Khan - Naughty,29,28,43,6.0,30,Naughty,18.0,17,-13,-1,-1,1,down,1980-06-21
14741,Chaka Khan,1980-10-25,Chaka Khan - Naughty,30,29,51,6.0,43,Naughty,18.0,18,-8,-13,-1,1,down,1980-06-21
14742,Natalie Cole,1980-06-21,Natalie Cole - Don't Look Back,51,51,26,17.0,35,Don't Look Back,15.0,0,9,16,0,1,up,1980-06-21
14743,Natalie Cole,1980-06-28,Natalie Cole - Don't Look Back,35,51,21,17.0,26,Don't Look Back,15.0,1,5,9,16,1,up,1980-06-21
14744,Natalie Cole,1980-07-05,Natalie Cole - Don't Look Back,26,35,17,17.0,21,Don't Look Back,15.0,2,4,5,9,1,up,1980-06-21
14745,Natalie Cole,1980-07-12,Natalie Cole - Don't Look Back,21,26,17,17.0,17,Don't Look Back,15.0,3,0,4,5,0,stay,1980-06-21
14746,Natalie Cole,1980-07-19,Natalie Cole - Don't Look Back,17,21,22,17.0,17,Don't Look Back,15.0,4,-5,0,4,1,down,1980-06-21
14747,Natalie Cole,1980-07-26,Natalie Cole - Don't Look Back,17,17,26,17.0,22,Don't Look Back,15.0,5,-4,-5,0,1,down,1980-06-21
14748,Natalie Cole,1980-08-02,Natalie Cole - Don't Look Back,22,17,28,17.0,26,Don't Look Back,15.0,6,-2,-4,-5,1,down,1980-06-21
14749,Natalie Cole,1980-08-09,Natalie Cole - Don't Look Back,26,22,31,17.0,28,Don't Look Back,15.0,7,-3,-2,-4,1,down,1980-06-21
14750,Natalie Cole,1980-08-16,Natalie Cole - Don't Look Back,28,26,31,17.0,31,Don't Look Back,15.0,8,0,-3,-2,0,stay,1980-06-21
14751,Natalie Cole,1980-08-23,Natalie Cole - Don't Look Back,31,28,32,17.0,31,Don't Look Back,15.0,9,-1,0,-3,1,down,1980-06-21
14752,Natalie Cole,1980-08-30,Natalie Cole - Don't Look Back,31,31,36,17.0,32,Don't Look Back,15.0,10,-4,-1,0,1,down,1980-06-21
14753,Natalie Cole,1980-09-06,Natalie Cole - Don't Look Back,32,31,39,17.0,36,Don't Look Back,15.0,11,-3,-4,-1,1,down,1980-06-21
14754,Natalie Cole,1980-09-13,Natalie Cole - Don't Look Back,36,32,39,17.0,39,Don't Look Back,15.0,12,0,-3,-4,0,stay,1980-06-21
14755,Natalie Cole,1980-09-20,Natalie Cole - Don't Look Back,39,36,41,17.0,39,Don't Look Back,15.0,13,-2,0,-3,1,down,1980-06-21
14756,Natalie Cole,1980-09-27,Natalie Cole - Don't Look Back,39,39,41,17.0,41,Don't Look Back,15.0,14,0,-2,0,0,stay,1980-06-21
14757,Natalie Cole,1980-10-04,Natalie Cole - Don't Look Back,41,39,51,17.0,41,Don't Look Back,15.0,15,-10,0,-2,1,down,1980-06-21
14758,Gene Chandler,1980-06-21,Gene Chandler - Gene Chandler '80,51,51,31,11.0,41,Gene Chandler '80,18.0,0,10,10,0,1,up,1980-06-21
14759,Gene Chandler,1980-06-28,Gene Chandler - Gene Chandler '80,41,51,22,11.0,31,Gene Chandler '80,18.0,1,9,10,10,1,up,1980-06-21
14760,Gene Chandler,1980-07-05,Gene Chandler - Gene Chandler '80,31,41,18,11.0,22,Gene Chandler '80,18.0,2,4,9,10,1,up,1980-06-21
14761,Gene Chandler,1980-07-12,Gene Chandler - Gene Chandler '80,22,31,14,11.0,18,Gene Chandler '80,18.0,3,4,4,9,1,up,1980-06-21
14762,Gene Chandler,1980-07-19,Gene Chandler - Gene Chandler '80,18,22,12,11.0,14,Gene Chandler '80,18.0,4,2,4,4,1,up,1980-06-21
14763,Gene Chandler,1980-07-26,Gene Chandler - Gene Chandler '80,14,18,11,11.0,12,Gene Chandler '80,18.0,5,1,2,4,1,up,1980-06-21
14764,Gene Chandler,1980-08-02,Gene Chandler - Gene Chandler '80,12,14,11,11.0,11,Gene Chandler '80,18.0,6,0,1,2,0,stay,1980-06-21
14765,Gene Chandler,1980-08-09,Gene Chandler - Gene Chandler '80,11,12,18,11.0,11,Gene Chandler '80,18.0,7,-7,0,1,1,down,1980-06-21
14766,Gene Chandler,1980-08-16,Gene Chandler - Gene Chandler '80,11,11,21,11.0,18,Gene Chandler '80,18.0,8,-3,-7,0,1,down,1980-06-21
14767,Gene Chandler,1980-08-23,Gene Chandler - Gene Chandler '80,18,11,21,11.0,21,Gene Chandler '80,18.0,9,0,-3,-7,0,stay,1980-06-21
14768,Gene Chandler,1980-08-30,Gene Chandler - Gene Chandler '80,21,18,31,11.0,21,Gene Chandler '80,18.0,10,-10,0,-3,1,down,1980-06-21
14769,Gene Chandler,1980-09-06,Gene Chandler - Gene Chandler '80,21,21,29,11.0,31,Gene Chandler '80,18.0,11,2,-10,0,1,up,1980-06-21
14770,Gene Chandler,1980-09-13,Gene Chandler - Gene Chandler '80,31,21,27,11.0,29,Gene Chandler '80,18.0,12,2,2,-10,1,up,1980-06-21
14771,Gene Chandler,1980-09-20,Gene Chandler - Gene Chandler '80,29,31,27,11.0,27,Gene Chandler '80,18.0,13,0,2,2,0,stay,1980-06-21
14772,Gene Chandler,1980-09-27,Gene Chandler - Gene Chandler '80,27,29,29,11.0,27,Gene Chandler '80,18.0,14,-2,0,2,1,down,1980-06-21
14773,Gene Chandler,1980-10-04,Gene Chandler - Gene Chandler '80,27,27,30,11.0,29,Gene Chandler '80,18.0,15,-1,-2,0,1,down,1980-06-21
14774,Gene Chandler,1980-10-11,Gene Chandler - Gene Chandler '80,29,27,33,11.0,30,Gene Chandler '80,18.0,16,-3,-1,-2,1,down,1980-06-21
14775,Gene Chandler,1980-10-18,Gene Chandler - Gene Chandler '80,30,29,46,11.0,33,Gene Chandler '80,18.0,17,-13,-3,-1,1,down,1980-06-21
14776,Gene Chandler,1980-10-25,Gene Chandler - Gene Chandler '80,33,30,51,11.0,46,Gene Chandler '80,18.0,18,-5,-13,-3,1,down,1980-06-21
14777,The Spinners,1980-06-21,The Spinners - Love Trippin,51,51,28,16.0,49,Love Trippin,11.0,0,21,2,0,1,up,1980-06-21
14778,The Spinners,1980-06-28,The Spinners - Love Trippin,49,51,23,16.0,28,Love Trippin,11.0,1,5,21,2,1,up,1980-06-21
14779,The Spinners,1980-07-05,The Spinners - Love Trippin,28,49,19,16.0,23,Love Trippin,11.0,2,4,5,21,1,up,1980-06-21
14780,The Spinners,1980-07-12,The Spinners - Love Trippin,23,28,18,16.0,19,Love Trippin,11.0,3,1,4,5,1,up,1980-06-21
14781,The Spinners,1980-07-19,The Spinners - Love Trippin,19,23,16,16.0,18,Love Trippin,11.0,4,2,1,4,1,up,1980-06-21
14782,The Spinners,1980-07-26,The Spinners - Love Trippin,18,19,16,16.0,16,Love Trippin,11.0,5,0,2,1,0,stay,1980-06-21
14783,The Spinners,1980-08-02,The Spinners - Love Trippin,16,18,19,16.0,16,Love Trippin,11.0,6,-3,0,2,1,down,1980-06-21
14784,The Spinners,1980-08-09,The Spinners - Love Trippin,16,16,22,16.0,19,Love Trippin,11.0,7,-3,-3,0,1,down,1980-06-21
14785,The Spinners,1980-08-16,The Spinners - Love Trippin,19,16,27,16.0,22,Love Trippin,11.0,8,-5,-3,-3,1,down,1980-06-21
14786,The Spinners,1980-08-23,The Spinners - Love Trippin,22,19,47,16.0,27,Love Trippin,11.0,9,-20,-5,-3,1,down,1980-06-21
14787,The Spinners,1980-08-30,The Spinners - Love Trippin,27,22,47,16.0,47,Love Trippin,11.0,10,0,-20,-5,0,stay,1980-06-21
14788,The Spinners,1980-09-06,The Spinners - Love Trippin,47,27,51,16.0,47,Love Trippin,11.0,11,-4,0,-20,1,down,1980-06-21
14789,Commodores,1980-06-28,Commodores - Heroes,51,51,8,3.0,17,Heroes,28.0,0,9,34,0,1,up,1980-06-28
14790,Commodores,1980-07-05,Commodores - Heroes,17,51,5,3.0,8,Heroes,28.0,1,3,9,34,1,up,1980-06-28
14791,Commodores,1980-07-12,Commodores - Heroes,8,17,4,3.0,5,Heroes,28.0,2,1,3,9,1,up,1980-06-28
14792,Commodores,1980-07-19,Commodores - Heroes,5,8,4,3.0,4,Heroes,28.0,3,0,1,3,0,stay,1980-06-28
14793,Commodores,1980-07-26,Commodores - Heroes,4,5,3,3.0,4,Heroes,28.0,4,1,0,1,1,up,1980-06-28
14794,Commodores,1980-08-02,Commodores - Heroes,4,4,3,3.0,3,Heroes,28.0,5,0,1,0,0,stay,1980-06-28
14795,Commodores,1980-08-09,Commodores - Heroes,3,4,4,3.0,3,Heroes,28.0,6,-1,0,1,1,down,1980-06-28
14796,Commodores,1980-08-16,Commodores - Heroes,3,3,6,3.0,4,Heroes,28.0,7,-2,-1,0,1,down,1980-06-28
14797,Commodores,1980-08-23,Commodores - Heroes,4,3,5,3.0,6,Heroes,28.0,8,1,-2,-1,1,up,1980-06-28
14798,Commodores,1980-08-30,Commodores - Heroes,6,4,5,3.0,5,Heroes,28.0,9,0,1,-2,0,stay,1980-06-28
14799,Commodores,1980-09-06,Commodores - Heroes,5,6,9,3.0,5,Heroes,28.0,10,-4,0,1,1,down,1980-06-28
14800,Commodores,1980-09-13,Commodores - Heroes,5,5,9,3.0,9,Heroes,28.0,11,0,-4,0,0,stay,1980-06-28
14801,Commodores,1980-09-20,Commodores - Heroes,9,5,9,3.0,9,Heroes,28.0,12,0,0,-4,0,stay,1980-06-28
14802,Commodores,1980-09-27,Commodores - Heroes,9,9,13,3.0,9,Heroes,28.0,13,-4,0,0,1,down,1980-06-28
14803,Commodores,1980-10-04,Commodores - Heroes,9,9,13,3.0,13,Heroes,28.0,14,0,-4,0,0,stay,1980-06-28
14804,Commodores,1980-10-11,Commodores - Heroes,13,9,13,3.0,13,Heroes,28.0,15,0,0,-4,0,stay,1980-06-28
14805,Commodores,1980-10-18,Commodores - Heroes,13,13,13,3.0,13,Heroes,28.0,16,0,0,0,0,stay,1980-06-28
14806,Commodores,1980-10-25,Commodores - Heroes,13,13,16,3.0,13,Heroes,28.0,17,-3,0,0,1,down,1980-06-28
14807,Commodores,1980-11-01,Commodores - Heroes,13,13,18,3.0,16,Heroes,28.0,18,-2,-3,0,1,down,1980-06-28
14808,Commodores,1980-11-08,Commodores - Heroes,16,13,28,3.0,18,Heroes,28.0,19,-10,-2,-3,1,down,1980-06-28
14809,Commodores,1980-11-15,Commodores - Heroes,18,16,36,3.0,28,Heroes,28.0,20,-8,-10,-2,1,down,1980-06-28
14810,Commodores,1980-11-22,Commodores - Heroes,28,18,41,3.0,36,Heroes,28.0,21,-5,-8,-10,1,down,1980-06-28
14811,Commodores,1980-11-29,Commodores - Heroes,36,28,44,3.0,41,Heroes,28.0,22,-3,-5,-8,1,down,1980-06-28
14812,Commodores,1980-12-06,Commodores - Heroes,41,36,49,3.0,44,Heroes,28.0,23,-5,-3,-5,1,down,1980-06-28
14813,Commodores,1980-12-13,Commodores - Heroes,44,41,49,3.0,49,Heroes,28.0,24,0,-5,-3,0,stay,1980-06-28
14814,Commodores,1981-01-10,Commodores - Heroes,49,44,50,3.0,49,Heroes,28.0,25,-1,0,-5,1,down,1980-06-28
14815,Commodores,1981-01-17,Commodores - Heroes,49,49,50,3.0,50,Heroes,28.0,26,0,-1,0,0,stay,1980-06-28
14816,Commodores,1981-01-24,Commodores - Heroes,50,49,54,3.0,50,Heroes,28.0,27,-4,0,-1,1,down,1980-06-28
14817,Commodores,1981-01-31,Commodores - Heroes,50,50,51,3.0,54,Heroes,28.0,28,3,-4,0,1,up,1980-06-28
14818,The S.O.S. Band,1980-06-28,The S.O.S. Band - S.o.s.,51,51,12,2.0,22,S.o.s.,20.0,0,10,29,0,1,up,1980-06-28
14819,The S.O.S. Band,1980-07-05,The S.O.S. Band - S.o.s.,22,51,3,2.0,12,S.o.s.,20.0,1,9,10,29,1,up,1980-06-28
14820,The S.O.S. Band,1980-07-12,The S.O.S. Band - S.o.s.,12,22,3,2.0,3,S.o.s.,20.0,2,0,9,10,0,stay,1980-06-28
14821,The S.O.S. Band,1980-07-19,The S.O.S. Band - S.o.s.,3,12,3,2.0,3,S.o.s.,20.0,3,0,0,9,0,stay,1980-06-28
14822,The S.O.S. Band,1980-07-26,The S.O.S. Band - S.o.s.,3,3,2,2.0,3,S.o.s.,20.0,4,1,0,0,1,up,1980-06-28
14823,The S.O.S. Band,1980-08-02,The S.O.S. Band - S.o.s.,3,3,2,2.0,2,S.o.s.,20.0,5,0,1,0,0,stay,1980-06-28
14824,The S.O.S. Band,1980-08-09,The S.O.S. Band - S.o.s.,2,3,2,2.0,2,S.o.s.,20.0,6,0,0,1,0,stay,1980-06-28
14825,The S.O.S. Band,1980-08-16,The S.O.S. Band - S.o.s.,2,2,4,2.0,2,S.o.s.,20.0,7,-2,0,0,1,down,1980-06-28
14826,The S.O.S. Band,1980-08-23,The S.O.S. Band - S.o.s.,2,2,6,2.0,4,S.o.s.,20.0,8,-2,-2,0,1,down,1980-06-28
14827,The S.O.S. Band,1980-08-30,The S.O.S. Band - S.o.s.,4,2,13,2.0,6,S.o.s.,20.0,9,-7,-2,-2,1,down,1980-06-28
14828,The S.O.S. Band,1980-09-06,The S.O.S. Band - S.o.s.,6,4,14,2.0,13,S.o.s.,20.0,10,-1,-7,-2,1,down,1980-06-28
14829,The S.O.S. Band,1980-09-13,The S.O.S. Band - S.o.s.,13,6,14,2.0,14,S.o.s.,20.0,11,0,-1,-7,0,stay,1980-06-28
14830,The S.O.S. Band,1980-09-20,The S.O.S. Band - S.o.s.,14,13,18,2.0,14,S.o.s.,20.0,12,-4,0,-1,1,down,1980-06-28
14831,The S.O.S. Band,1980-09-27,The S.O.S. Band - S.o.s.,14,14,21,2.0,18,S.o.s.,20.0,13,-3,-4,0,1,down,1980-06-28
14832,The S.O.S. Band,1980-10-04,The S.O.S. Band - S.o.s.,18,14,22,2.0,21,S.o.s.,20.0,14,-1,-3,-4,1,down,1980-06-28
14833,The S.O.S. Band,1980-10-11,The S.O.S. Band - S.o.s.,21,18,21,2.0,22,S.o.s.,20.0,15,1,-1,-3,1,up,1980-06-28
14834,The S.O.S. Band,1980-10-18,The S.O.S. Band - S.o.s.,22,21,25,2.0,21,S.o.s.,20.0,16,-4,1,-1,1,down,1980-06-28
14835,The S.O.S. Band,1980-10-25,The S.O.S. Band - S.o.s.,21,22,26,2.0,25,S.o.s.,20.0,17,-1,-4,1,1,down,1980-06-28
14836,The S.O.S. Band,1980-11-01,The S.O.S. Band - S.o.s.,25,21,29,2.0,26,S.o.s.,20.0,18,-3,-1,-4,1,down,1980-06-28
14837,The S.O.S. Band,1980-11-08,The S.O.S. Band - S.o.s.,26,25,46,2.0,29,S.o.s.,20.0,19,-17,-3,-1,1,down,1980-06-28
14838,The S.O.S. Band,1980-11-15,The S.O.S. Band - S.o.s.,29,26,51,2.0,46,S.o.s.,20.0,20,-5,-17,-3,1,down,1980-06-28
14839,Al Jarreau,1980-06-28,Al Jarreau - This Time,51,51,24,6.0,32,This Time,24.0,0,8,19,0,1,up,1980-06-28
14840,Al Jarreau,1980-07-05,Al Jarreau - This Time,32,51,20,6.0,24,This Time,24.0,1,4,8,19,1,up,1980-06-28
14841,Al Jarreau,1980-07-12,Al Jarreau - This Time,24,32,15,6.0,20,This Time,24.0,2,5,4,8,1,up,1980-06-28
14842,Al Jarreau,1980-07-19,Al Jarreau - This Time,20,24,14,6.0,15,This Time,24.0,3,1,5,4,1,up,1980-06-28
14843,Al Jarreau,1980-07-26,Al Jarreau - This Time,15,20,10,6.0,14,This Time,24.0,4,4,1,5,1,up,1980-06-28
14844,Al Jarreau,1980-08-02,Al Jarreau - This Time,14,15,6,6.0,10,This Time,24.0,5,4,4,1,1,up,1980-06-28
14845,Al Jarreau,1980-08-09,Al Jarreau - This Time,10,14,6,6.0,6,This Time,24.0,6,0,4,4,0,stay,1980-06-28
14846,Al Jarreau,1980-08-16,Al Jarreau - This Time,6,10,11,6.0,6,This Time,24.0,7,-5,0,4,1,down,1980-06-28
14847,Al Jarreau,1980-08-23,Al Jarreau - This Time,6,6,14,6.0,11,This Time,24.0,8,-3,-5,0,1,down,1980-06-28
14848,Al Jarreau,1980-08-30,Al Jarreau - This Time,11,6,16,6.0,14,This Time,24.0,9,-2,-3,-5,1,down,1980-06-28
14849,Al Jarreau,1980-09-06,Al Jarreau - This Time,14,11,16,6.0,16,This Time,24.0,10,0,-2,-3,0,stay,1980-06-28
14850,Al Jarreau,1980-09-13,Al Jarreau - This Time,16,14,21,6.0,16,This Time,24.0,11,-5,0,-2,1,down,1980-06-28
14851,Al Jarreau,1980-09-20,Al Jarreau - This Time,16,16,20,6.0,21,This Time,24.0,12,1,-5,0,1,up,1980-06-28
14852,Al Jarreau,1980-09-27,Al Jarreau - This Time,21,16,23,6.0,20,This Time,24.0,13,-3,1,-5,1,down,1980-06-28
14853,Al Jarreau,1980-10-04,Al Jarreau - This Time,20,21,23,6.0,23,This Time,24.0,14,0,-3,1,0,stay,1980-06-28
14854,Al Jarreau,1980-10-11,Al Jarreau - This Time,23,20,22,6.0,23,This Time,24.0,15,1,0,-3,1,up,1980-06-28
14855,Al Jarreau,1980-10-18,Al Jarreau - This Time,23,23,22,6.0,22,This Time,24.0,16,0,1,0,0,stay,1980-06-28
14856,Al Jarreau,1980-10-25,Al Jarreau - This Time,22,23,24,6.0,22,This Time,24.0,17,-2,0,1,1,down,1980-06-28
14857,Al Jarreau,1980-11-01,Al Jarreau - This Time,22,22,24,6.0,24,This Time,24.0,18,0,-2,0,0,stay,1980-06-28
14858,Al Jarreau,1980-11-08,Al Jarreau - This Time,24,22,44,6.0,24,This Time,24.0,19,-20,0,-2,1,down,1980-06-28
14859,Al Jarreau,1980-11-15,Al Jarreau - This Time,24,24,44,6.0,44,This Time,24.0,20,0,-20,0,0,stay,1980-06-28
14860,Al Jarreau,1980-11-22,Al Jarreau - This Time,44,24,46,6.0,44,This Time,24.0,21,-2,0,-20,1,down,1980-06-28
14861,Al Jarreau,1980-11-29,Al Jarreau - This Time,44,44,46,6.0,46,This Time,24.0,22,0,-2,0,0,stay,1980-06-28
14862,Al Jarreau,1980-12-06,Al Jarreau - This Time,46,44,60,6.0,46,This Time,24.0,23,-14,0,-2,1,down,1980-06-28
14863,Al Jarreau,1981-01-31,Al Jarreau - This Time,46,46,51,6.0,60,This Time,24.0,24,9,-14,0,1,up,1980-06-28
14864,Larry Graham,1980-06-28,Larry Graham - One In A Million You,51,51,18,2.0,34,One In A Million You,31.0,0,16,17,0,1,up,1980-06-28
14865,Larry Graham,1980-07-05,Larry Graham - One In A Million You,34,51,13,2.0,18,One In A Million You,31.0,1,5,16,17,1,up,1980-06-28
14866,Larry Graham,1980-07-12,Larry Graham - One In A Million You,18,34,9,2.0,13,One In A Million You,31.0,2,4,5,16,1,up,1980-06-28
14867,Larry Graham,1980-07-19,Larry Graham - One In A Million You,13,18,8,2.0,9,One In A Million You,31.0,3,1,4,5,1,up,1980-06-28
14868,Larry Graham,1980-07-26,Larry Graham - One In A Million You,9,13,5,2.0,8,One In A Million You,31.0,4,3,1,4,1,up,1980-06-28
14869,Larry Graham,1980-08-02,Larry Graham - One In A Million You,8,9,4,2.0,5,One In A Million You,31.0,5,1,3,1,1,up,1980-06-28
14870,Larry Graham,1980-08-09,Larry Graham - One In A Million You,5,8,3,2.0,4,One In A Million You,31.0,6,1,1,3,1,up,1980-06-28
14871,Larry Graham,1980-08-16,Larry Graham - One In A Million You,4,5,2,2.0,3,One In A Million You,31.0,7,1,1,1,1,up,1980-06-28
14872,Larry Graham,1980-08-23,Larry Graham - One In A Million You,3,4,2,2.0,2,One In A Million You,31.0,8,0,1,1,0,stay,1980-06-28
14873,Larry Graham,1980-08-30,Larry Graham - One In A Million You,2,3,4,2.0,2,One In A Million You,31.0,9,-2,0,1,1,down,1980-06-28
14874,Larry Graham,1980-09-06,Larry Graham - One In A Million You,2,2,4,2.0,4,One In A Million You,31.0,10,0,-2,0,0,stay,1980-06-28
14875,Larry Graham,1980-09-13,Larry Graham - One In A Million You,4,2,7,2.0,4,One In A Million You,31.0,11,-3,0,-2,1,down,1980-06-28
14876,Larry Graham,1980-09-20,Larry Graham - One In A Million You,4,4,8,2.0,7,One In A Million You,31.0,12,-1,-3,0,1,down,1980-06-28
14877,Larry Graham,1980-09-27,Larry Graham - One In A Million You,7,4,14,2.0,8,One In A Million You,31.0,13,-6,-1,-3,1,down,1980-06-28
14878,Larry Graham,1980-10-04,Larry Graham - One In A Million You,8,7,14,2.0,14,One In A Million You,31.0,14,0,-6,-1,0,stay,1980-06-28
14879,Larry Graham,1980-10-11,Larry Graham - One In A Million You,14,8,15,2.0,14,One In A Million You,31.0,15,-1,0,-6,1,down,1980-06-28
14880,Larry Graham,1980-10-18,Larry Graham - One In A Million You,14,14,18,2.0,15,One In A Million You,31.0,16,-3,-1,0,1,down,1980-06-28
14881,Larry Graham,1980-10-25,Larry Graham - One In A Million You,15,14,19,2.0,18,One In A Million You,31.0,17,-1,-3,-1,1,down,1980-06-28
14882,Larry Graham,1980-11-01,Larry Graham - One In A Million You,18,15,20,2.0,19,One In A Million You,31.0,18,-1,-1,-3,1,down,1980-06-28
14883,Larry Graham,1980-11-08,Larry Graham - One In A Million You,19,18,33,2.0,20,One In A Million You,31.0,19,-13,-1,-1,1,down,1980-06-28
14884,Larry Graham,1980-11-15,Larry Graham - One In A Million You,20,19,33,2.0,33,One In A Million You,31.0,20,0,-13,-1,0,stay,1980-06-28
14885,Larry Graham,1980-11-22,Larry Graham - One In A Million You,33,20,34,2.0,33,One In A Million You,31.0,21,-1,0,-13,1,down,1980-06-28
14886,Larry Graham,1980-11-29,Larry Graham - One In A Million You,33,33,37,2.0,34,One In A Million You,31.0,22,-3,-1,0,1,down,1980-06-28
14887,Larry Graham,1980-12-06,Larry Graham - One In A Million You,34,33,39,2.0,37,One In A Million You,31.0,23,-2,-3,-1,1,down,1980-06-28
14888,Larry Graham,1980-12-13,Larry Graham - One In A Million You,37,34,46,2.0,39,One In A Million You,31.0,24,-7,-2,-3,1,down,1980-06-28
14889,Larry Graham,1980-12-20,Larry Graham - One In A Million You,39,37,47,2.0,46,One In A Million You,31.0,25,-1,-7,-2,1,down,1980-06-28
14890,Larry Graham,1980-12-27,Larry Graham - One In A Million You,46,39,47,2.0,47,One In A Million You,31.0,26,0,-1,-7,0,stay,1980-06-28
14891,Larry Graham,1981-01-03,Larry Graham - One In A Million You,47,46,43,2.0,47,One In A Million You,31.0,27,4,0,-1,1,up,1980-06-28
14892,Larry Graham,1981-01-10,Larry Graham - One In A Million You,47,47,45,2.0,43,One In A Million You,31.0,28,-2,4,0,1,down,1980-06-28
14893,Larry Graham,1981-01-17,Larry Graham - One In A Million You,43,47,47,2.0,45,One In A Million You,31.0,29,-2,-2,4,1,down,1980-06-28
14894,Larry Graham,1981-01-24,Larry Graham - One In A Million You,45,43,53,2.0,47,One In A Million You,31.0,30,-6,-2,-2,1,down,1980-06-28
14895,Larry Graham,1981-01-31,Larry Graham - One In A Million You,47,45,51,2.0,53,One In A Million You,31.0,31,2,-6,-2,1,up,1980-06-28
14896,Stanley Clarke,1980-06-28,"Stanley Clarke - Rock, Pebbles And Sand",51,51,40,40.0,42,"Rock, Pebbles And Sand",6.0,0,2,9,0,1,up,1980-06-28
14897,Stanley Clarke,1980-07-05,"Stanley Clarke - Rock, Pebbles And Sand",42,51,40,40.0,40,"Rock, Pebbles And Sand",6.0,1,0,2,9,0,stay,1980-06-28
14898,Stanley Clarke,1980-07-12,"Stanley Clarke - Rock, Pebbles And Sand",40,42,44,40.0,40,"Rock, Pebbles And Sand",6.0,2,-4,0,2,1,down,1980-06-28
14899,Stanley Clarke,1980-07-19,"Stanley Clarke - Rock, Pebbles And Sand",40,40,49,40.0,44,"Rock, Pebbles And Sand",6.0,3,-5,-4,0,1,down,1980-06-28
14900,Stanley Clarke,1980-07-26,"Stanley Clarke - Rock, Pebbles And Sand",44,40,49,40.0,49,"Rock, Pebbles And Sand",6.0,4,0,-5,-4,0,stay,1980-06-28
14901,Stanley Clarke,1980-08-02,"Stanley Clarke - Rock, Pebbles And Sand",49,44,50,40.0,49,"Rock, Pebbles And Sand",6.0,5,-1,0,-5,1,down,1980-06-28
14902,Stanley Clarke,1980-08-09,"Stanley Clarke - Rock, Pebbles And Sand",49,49,51,40.0,50,"Rock, Pebbles And Sand",6.0,6,-1,-1,0,1,down,1980-06-28
14903,George Duke,1980-06-28,George Duke - A Brazilian Love Affair,51,51,42,40.0,44,A Brazilian Love Affair,3.0,0,2,7,0,1,up,1980-06-28
14904,George Duke,1980-07-05,George Duke - A Brazilian Love Affair,44,51,41,40.0,42,A Brazilian Love Affair,3.0,1,1,2,7,1,up,1980-06-28
14905,George Duke,1980-07-12,George Duke - A Brazilian Love Affair,42,44,40,40.0,41,A Brazilian Love Affair,3.0,2,1,1,2,1,up,1980-06-28
14906,George Duke,1980-07-19,George Duke - A Brazilian Love Affair,41,42,51,40.0,40,A Brazilian Love Affair,3.0,3,-11,1,1,1,down,1980-06-28
14907,Johnny Guitar Watson,1980-06-28,Johnny Guitar Watson - Love Jones,51,51,37,20.0,45,Love Jones,15.0,0,8,6,0,1,up,1980-06-28
14908,Johnny Guitar Watson,1980-07-05,Johnny Guitar Watson - Love Jones,45,51,31,20.0,37,Love Jones,15.0,1,6,8,6,1,up,1980-06-28
14909,Johnny Guitar Watson,1980-07-12,Johnny Guitar Watson - Love Jones,37,45,26,20.0,31,Love Jones,15.0,2,5,6,8,1,up,1980-06-28
14910,Johnny Guitar Watson,1980-07-19,Johnny Guitar Watson - Love Jones,31,37,26,20.0,26,Love Jones,15.0,3,0,5,6,0,stay,1980-06-28
14911,Johnny Guitar Watson,1980-07-26,Johnny Guitar Watson - Love Jones,26,31,23,20.0,26,Love Jones,15.0,4,3,0,5,1,up,1980-06-28
14912,Johnny Guitar Watson,1980-08-02,Johnny Guitar Watson - Love Jones,26,26,20,20.0,23,Love Jones,15.0,5,3,3,0,1,up,1980-06-28
14913,Johnny Guitar Watson,1980-08-09,Johnny Guitar Watson - Love Jones,23,26,20,20.0,20,Love Jones,15.0,6,0,3,3,0,stay,1980-06-28
14914,Johnny Guitar Watson,1980-08-16,Johnny Guitar Watson - Love Jones,20,23,22,20.0,20,Love Jones,15.0,7,-2,0,3,1,down,1980-06-28
14915,Johnny Guitar Watson,1980-08-23,Johnny Guitar Watson - Love Jones,20,20,35,20.0,22,Love Jones,15.0,8,-13,-2,0,1,down,1980-06-28
14916,Johnny Guitar Watson,1980-08-30,Johnny Guitar Watson - Love Jones,22,20,37,20.0,35,Love Jones,15.0,9,-2,-13,-2,1,down,1980-06-28
14917,Johnny Guitar Watson,1980-09-06,Johnny Guitar Watson - Love Jones,35,22,38,20.0,37,Love Jones,15.0,10,-1,-2,-13,1,down,1980-06-28
14918,Johnny Guitar Watson,1980-09-13,Johnny Guitar Watson - Love Jones,37,35,34,20.0,38,Love Jones,15.0,11,4,-1,-2,1,up,1980-06-28
14919,Johnny Guitar Watson,1980-09-20,Johnny Guitar Watson - Love Jones,38,37,35,20.0,34,Love Jones,15.0,12,-1,4,-1,1,down,1980-06-28
14920,Johnny Guitar Watson,1980-09-27,Johnny Guitar Watson - Love Jones,34,38,35,20.0,35,Love Jones,15.0,13,0,-1,4,0,stay,1980-06-28
14921,Johnny Guitar Watson,1980-10-04,Johnny Guitar Watson - Love Jones,35,34,49,20.0,35,Love Jones,15.0,14,-14,0,-1,1,down,1980-06-28
14922,Johnny Guitar Watson,1980-10-11,Johnny Guitar Watson - Love Jones,35,35,51,20.0,49,Love Jones,15.0,15,-2,-14,0,1,down,1980-06-28
14923,Vaughn Mason And Crew,1980-06-28,Vaughn Mason And Crew - Bounce Rock Skate Roll,51,51,36,25.0,48,Bounce Rock Skate Roll,9.0,0,12,3,0,1,up,1980-06-28
14924,Vaughn Mason And Crew,1980-07-05,Vaughn Mason And Crew - Bounce Rock Skate Roll,48,51,36,25.0,36,Bounce Rock Skate Roll,9.0,1,0,12,3,0,stay,1980-06-28
14925,Vaughn Mason And Crew,1980-07-12,Vaughn Mason And Crew - Bounce Rock Skate Roll,36,48,27,25.0,36,Bounce Rock Skate Roll,9.0,2,9,0,12,1,up,1980-06-28
14926,Vaughn Mason And Crew,1980-07-19,Vaughn Mason And Crew - Bounce Rock Skate Roll,36,36,27,25.0,27,Bounce Rock Skate Roll,9.0,3,0,9,0,0,stay,1980-06-28
14927,Vaughn Mason And Crew,1980-07-26,Vaughn Mason And Crew - Bounce Rock Skate Roll,27,36,25,25.0,27,Bounce Rock Skate Roll,9.0,4,2,0,9,1,up,1980-06-28
14928,Vaughn Mason And Crew,1980-08-02,Vaughn Mason And Crew - Bounce Rock Skate Roll,27,27,25,25.0,25,Bounce Rock Skate Roll,9.0,5,0,2,0,0,stay,1980-06-28
14929,Vaughn Mason And Crew,1980-08-09,Vaughn Mason And Crew - Bounce Rock Skate Roll,25,27,35,25.0,25,Bounce Rock Skate Roll,9.0,6,-10,0,2,1,down,1980-06-28
14930,Vaughn Mason And Crew,1980-08-16,Vaughn Mason And Crew - Bounce Rock Skate Roll,25,25,36,25.0,35,Bounce Rock Skate Roll,9.0,7,-1,-10,0,1,down,1980-06-28
14931,Vaughn Mason And Crew,1980-08-23,Vaughn Mason And Crew - Bounce Rock Skate Roll,35,25,44,25.0,36,Bounce Rock Skate Roll,9.0,8,-8,-1,-10,1,down,1980-06-28
14932,Vaughn Mason And Crew,1980-08-30,Vaughn Mason And Crew - Bounce Rock Skate Roll,36,35,51,25.0,44,Bounce Rock Skate Roll,9.0,9,-7,-8,-1,1,down,1980-06-28
14933,Millie Jackson,1980-07-05,Millie Jackson - For Men Only,51,51,29,23.0,33,For Men Only,6.0,0,4,18,0,1,up,1980-07-05
14934,Millie Jackson,1980-07-12,Millie Jackson - For Men Only,33,51,24,23.0,29,For Men Only,6.0,1,5,4,18,1,up,1980-07-05
14935,Millie Jackson,1980-07-19,Millie Jackson - For Men Only,29,33,23,23.0,24,For Men Only,6.0,2,1,5,4,1,up,1980-07-05
14936,Millie Jackson,1980-07-26,Millie Jackson - For Men Only,24,29,30,23.0,23,For Men Only,6.0,3,-7,1,5,1,down,1980-07-05
14937,Millie Jackson,1980-08-02,Millie Jackson - For Men Only,23,24,40,23.0,30,For Men Only,6.0,4,-10,-7,1,1,down,1980-07-05
14938,Millie Jackson,1980-08-09,Millie Jackson - For Men Only,30,23,44,23.0,40,For Men Only,6.0,5,-4,-10,-7,1,down,1980-07-05
14939,Millie Jackson,1980-08-16,Millie Jackson - For Men Only,40,30,51,23.0,44,For Men Only,6.0,6,-7,-4,-10,1,down,1980-07-05
14940,The Crusaders,1980-07-12,The Crusaders - Rhapsody And Blues,51,51,30,14.0,45,Rhapsody And Blues,14.0,0,15,6,0,1,up,1980-07-12
14941,The Crusaders,1980-07-19,The Crusaders - Rhapsody And Blues,45,51,20,14.0,30,Rhapsody And Blues,14.0,1,10,15,6,1,up,1980-07-12
14942,The Crusaders,1980-07-26,The Crusaders - Rhapsody And Blues,30,45,17,14.0,20,Rhapsody And Blues,14.0,2,3,10,15,1,up,1980-07-12
14943,The Crusaders,1980-08-02,The Crusaders - Rhapsody And Blues,20,30,15,14.0,17,Rhapsody And Blues,14.0,3,2,3,10,1,up,1980-07-12
14944,The Crusaders,1980-08-09,The Crusaders - Rhapsody And Blues,17,20,14,14.0,15,Rhapsody And Blues,14.0,4,1,2,3,1,up,1980-07-12
14945,The Crusaders,1980-08-16,The Crusaders - Rhapsody And Blues,15,17,14,14.0,14,Rhapsody And Blues,14.0,5,0,1,2,0,stay,1980-07-12
14946,The Crusaders,1980-08-23,The Crusaders - Rhapsody And Blues,14,15,16,14.0,14,Rhapsody And Blues,14.0,6,-2,0,1,1,down,1980-07-12
14947,The Crusaders,1980-08-30,The Crusaders - Rhapsody And Blues,14,14,19,14.0,16,Rhapsody And Blues,14.0,7,-3,-2,0,1,down,1980-07-12
14948,The Crusaders,1980-09-06,The Crusaders - Rhapsody And Blues,16,14,25,14.0,19,Rhapsody And Blues,14.0,8,-6,-3,-2,1,down,1980-07-12
14949,The Crusaders,1980-09-13,The Crusaders - Rhapsody And Blues,19,16,28,14.0,25,Rhapsody And Blues,14.0,9,-3,-6,-3,1,down,1980-07-12
14950,The Crusaders,1980-09-20,The Crusaders - Rhapsody And Blues,25,19,39,14.0,28,Rhapsody And Blues,14.0,10,-11,-3,-6,1,down,1980-07-12
14951,The Crusaders,1980-09-27,The Crusaders - Rhapsody And Blues,28,25,39,14.0,39,Rhapsody And Blues,14.0,11,0,-11,-3,0,stay,1980-07-12
14952,The Crusaders,1980-10-04,The Crusaders - Rhapsody And Blues,39,28,37,14.0,39,Rhapsody And Blues,14.0,12,2,0,-11,1,up,1980-07-12
14953,The Crusaders,1980-10-11,The Crusaders - Rhapsody And Blues,39,39,46,14.0,37,Rhapsody And Blues,14.0,13,-9,2,0,1,down,1980-07-12
14954,The Crusaders,1980-10-18,The Crusaders - Rhapsody And Blues,37,39,51,14.0,46,Rhapsody And Blues,14.0,14,-5,-9,2,1,down,1980-07-12
14955,Boz Scaggs,1980-07-19,Boz Scaggs - Middle Man,51,51,41,36.0,45,Middle Man,8.0,0,4,6,0,1,up,1980-07-19
14956,Boz Scaggs,1980-07-26,Boz Scaggs - Middle Man,45,51,39,36.0,41,Middle Man,8.0,1,2,4,6,1,up,1980-07-19
14957,Boz Scaggs,1980-08-02,Boz Scaggs - Middle Man,41,45,37,36.0,39,Middle Man,8.0,2,2,2,4,1,up,1980-07-19
14958,Boz Scaggs,1980-08-09,Boz Scaggs - Middle Man,39,41,36,36.0,37,Middle Man,8.0,3,1,2,2,1,up,1980-07-19
14959,Boz Scaggs,1980-08-16,Boz Scaggs - Middle Man,37,39,45,36.0,36,Middle Man,8.0,4,-9,1,2,1,down,1980-07-19
14960,Boz Scaggs,1980-08-23,Boz Scaggs - Middle Man,36,37,45,36.0,45,Middle Man,8.0,5,0,-9,1,0,stay,1980-07-19
14961,Boz Scaggs,1980-08-30,Boz Scaggs - Middle Man,45,36,46,36.0,45,Middle Man,8.0,6,-1,0,-9,1,down,1980-07-19
14962,Boz Scaggs,1980-09-06,Boz Scaggs - Middle Man,45,45,50,36.0,46,Middle Man,8.0,7,-4,-1,0,1,down,1980-07-19
14963,Boz Scaggs,1980-09-13,Boz Scaggs - Middle Man,46,45,51,36.0,50,Middle Man,8.0,8,-1,-4,-1,1,down,1980-07-19
14964,Barry White,1980-07-19,Barry White - Barry White's Sheet Music,51,51,38,19.0,46,Barry White's Sheet Music,13.0,0,8,5,0,1,up,1980-07-19
14965,Barry White,1980-07-26,Barry White - Barry White's Sheet Music,46,51,24,19.0,38,Barry White's Sheet Music,13.0,1,14,8,5,1,up,1980-07-19
14966,Barry White,1980-08-02,Barry White - Barry White's Sheet Music,38,46,21,19.0,24,Barry White's Sheet Music,13.0,2,3,14,8,1,up,1980-07-19
14967,Barry White,1980-08-09,Barry White - Barry White's Sheet Music,24,38,19,19.0,21,Barry White's Sheet Music,13.0,3,2,3,14,1,up,1980-07-19
14968,Barry White,1980-08-16,Barry White - Barry White's Sheet Music,21,24,19,19.0,19,Barry White's Sheet Music,13.0,4,0,2,3,0,stay,1980-07-19
14969,Barry White,1980-08-23,Barry White - Barry White's Sheet Music,19,21,25,19.0,19,Barry White's Sheet Music,13.0,5,-6,0,2,1,down,1980-07-19
14970,Barry White,1980-08-30,Barry White - Barry White's Sheet Music,19,19,26,19.0,25,Barry White's Sheet Music,13.0,6,-1,-6,0,1,down,1980-07-19
14971,Barry White,1980-09-06,Barry White - Barry White's Sheet Music,25,19,30,19.0,26,Barry White's Sheet Music,13.0,7,-4,-1,-6,1,down,1980-07-19
14972,Barry White,1980-09-13,Barry White - Barry White's Sheet Music,26,25,30,19.0,30,Barry White's Sheet Music,13.0,8,0,-4,-1,0,stay,1980-07-19
14973,Barry White,1980-09-20,Barry White - Barry White's Sheet Music,30,26,40,19.0,30,Barry White's Sheet Music,13.0,9,-10,0,-4,1,down,1980-07-19
14974,Barry White,1980-09-27,Barry White - Barry White's Sheet Music,30,30,42,19.0,40,Barry White's Sheet Music,13.0,10,-2,-10,0,1,down,1980-07-19
14975,Barry White,1980-10-04,Barry White - Barry White's Sheet Music,40,30,38,19.0,42,Barry White's Sheet Music,13.0,11,4,-2,-10,1,up,1980-07-19
14976,Barry White,1980-10-11,Barry White - Barry White's Sheet Music,42,40,45,19.0,38,Barry White's Sheet Music,13.0,12,-7,4,-2,1,down,1980-07-19
14977,Barry White,1980-10-18,Barry White - Barry White's Sheet Music,38,42,51,19.0,45,Barry White's Sheet Music,13.0,13,-6,-7,4,1,down,1980-07-19
14978,Brick,1980-07-19,Brick - Waiting On You,51,51,42,31.0,49,Waiting On You,11.0,0,7,2,0,1,up,1980-07-19
14979,Brick,1980-07-26,Brick - Waiting On You,49,51,40,31.0,42,Waiting On You,11.0,1,2,7,2,1,up,1980-07-19
14980,Brick,1980-08-02,Brick - Waiting On You,42,49,46,31.0,40,Waiting On You,11.0,2,-6,2,7,1,down,1980-07-19
14981,Brick,1980-08-09,Brick - Waiting On You,40,42,49,31.0,46,Waiting On You,11.0,3,-3,-6,2,1,down,1980-07-19
14982,Brick,1980-10-04,Brick - Waiting On You,46,40,39,31.0,49,Waiting On You,11.0,4,10,-3,-6,1,up,1980-07-19
14983,Brick,1980-10-11,Brick - Waiting On You,49,46,39,31.0,39,Waiting On You,11.0,5,0,10,-3,0,stay,1980-07-19
14984,Brick,1980-10-18,Brick - Waiting On You,39,49,31,31.0,39,Waiting On You,11.0,6,8,0,10,1,up,1980-07-19
14985,Brick,1980-10-25,Brick - Waiting On You,39,39,31,31.0,31,Waiting On You,11.0,7,0,8,0,0,stay,1980-07-19
14986,Brick,1980-11-01,Brick - Waiting On You,31,39,33,31.0,31,Waiting On You,11.0,8,-2,0,8,1,down,1980-07-19
14987,Brick,1980-11-08,Brick - Waiting On You,31,31,47,31.0,33,Waiting On You,11.0,9,-14,-2,0,1,down,1980-07-19
14988,Brick,1980-11-15,Brick - Waiting On You,33,31,49,31.0,47,Waiting On You,11.0,10,-2,-14,-2,1,down,1980-07-19
14989,Brick,1980-11-22,Brick - Waiting On You,47,33,51,31.0,49,Waiting On You,11.0,11,-2,-2,-14,1,down,1980-07-19
14990,Blow Fly,1980-07-26,Blow Fly - Blowfly's Party [X-Rated],51,51,28,26.0,34,Blowfly's Party [X-Rated],11.0,0,6,17,0,1,up,1980-07-26
14991,Blow Fly,1980-08-02,Blow Fly - Blowfly's Party [X-Rated],34,51,26,26.0,28,Blowfly's Party [X-Rated],11.0,1,2,6,17,1,up,1980-07-26
14992,Blow Fly,1980-08-09,Blow Fly - Blowfly's Party [X-Rated],28,34,26,26.0,26,Blowfly's Party [X-Rated],11.0,2,0,2,6,0,stay,1980-07-26
14993,Blow Fly,1980-08-16,Blow Fly - Blowfly's Party [X-Rated],26,28,37,26.0,26,Blowfly's Party [X-Rated],11.0,3,-11,0,2,1,down,1980-07-26
14994,Blow Fly,1980-08-23,Blow Fly - Blowfly's Party [X-Rated],26,26,36,26.0,37,Blowfly's Party [X-Rated],11.0,4,1,-11,0,1,up,1980-07-26
14995,Blow Fly,1980-08-30,Blow Fly - Blowfly's Party [X-Rated],37,26,38,26.0,36,Blowfly's Party [X-Rated],11.0,5,-2,1,-11,1,down,1980-07-26
14996,Blow Fly,1980-09-06,Blow Fly - Blowfly's Party [X-Rated],36,37,46,26.0,38,Blowfly's Party [X-Rated],11.0,6,-8,-2,1,1,down,1980-07-26
14997,Blow Fly,1980-09-13,Blow Fly - Blowfly's Party [X-Rated],38,36,48,26.0,46,Blowfly's Party [X-Rated],11.0,7,-2,-8,-2,1,down,1980-07-26
14998,Blow Fly,1980-09-20,Blow Fly - Blowfly's Party [X-Rated],46,38,48,26.0,48,Blowfly's Party [X-Rated],11.0,8,0,-2,-8,0,stay,1980-07-26
14999,Blow Fly,1980-09-27,Blow Fly - Blowfly's Party [X-Rated],48,46,48,26.0,48,Blowfly's Party [X-Rated],11.0,9,0,0,-2,0,stay,1980-07-26
15000,Blow Fly,1980-10-04,Blow Fly - Blowfly's Party [X-Rated],48,48,48,26.0,48,Blowfly's Party [X-Rated],11.0,10,0,0,0,0,stay,1980-07-26
15001,Blow Fly,1980-10-11,Blow Fly - Blowfly's Party [X-Rated],48,48,51,26.0,48,Blowfly's Party [X-Rated],11.0,11,-3,0,0,1,down,1980-07-26
15002,Pleasure,1980-07-26,Pleasure - Special Things,51,51,35,27.0,43,Special Things,11.0,0,8,8,0,1,up,1980-07-26
15003,Pleasure,1980-08-02,Pleasure - Special Things,43,51,30,27.0,35,Special Things,11.0,1,5,8,8,1,up,1980-07-26
15004,Pleasure,1980-08-09,Pleasure - Special Things,35,43,28,27.0,30,Special Things,11.0,2,2,5,8,1,up,1980-07-26
15005,Pleasure,1980-08-16,Pleasure - Special Things,30,35,28,27.0,28,Special Things,11.0,3,0,2,5,0,stay,1980-07-26
15006,Pleasure,1980-08-23,Pleasure - Special Things,28,30,27,27.0,28,Special Things,11.0,4,1,0,2,1,up,1980-07-26
15007,Pleasure,1980-08-30,Pleasure - Special Things,28,28,33,27.0,27,Special Things,11.0,5,-6,1,0,1,down,1980-07-26
15008,Pleasure,1980-09-06,Pleasure - Special Things,27,28,37,27.0,33,Special Things,11.0,6,-4,-6,1,1,down,1980-07-26
15009,Pleasure,1980-09-13,Pleasure - Special Things,33,27,45,27.0,37,Special Things,11.0,7,-8,-4,-6,1,down,1980-07-26
15010,Pleasure,1980-09-20,Pleasure - Special Things,37,33,45,27.0,45,Special Things,11.0,8,0,-8,-4,0,stay,1980-07-26
15011,Pleasure,1980-09-27,Pleasure - Special Things,45,37,44,27.0,45,Special Things,11.0,9,1,0,-8,1,up,1980-07-26
15012,Pleasure,1980-10-04,Pleasure - Special Things,45,45,45,27.0,44,Special Things,11.0,10,-1,1,0,1,down,1980-07-26
15013,Pleasure,1980-10-11,Pleasure - Special Things,44,45,51,27.0,45,Special Things,11.0,11,-6,-1,1,1,down,1980-07-26
15014,Chic,1980-08-02,Chic - Real People,51,51,12,8.0,21,Real People,11.0,0,9,30,0,1,up,1980-08-02
15015,Chic,1980-08-09,Chic - Real People,21,51,9,8.0,12,Real People,11.0,1,3,9,30,1,up,1980-08-02
15016,Chic,1980-08-16,Chic - Real People,12,21,8,8.0,9,Real People,11.0,2,1,3,9,1,up,1980-08-02
15017,Chic,1980-08-23,Chic - Real People,9,12,8,8.0,8,Real People,11.0,3,0,1,3,0,stay,1980-08-02
15018,Chic,1980-08-30,Chic - Real People,8,9,14,8.0,8,Real People,11.0,4,-6,0,1,1,down,1980-08-02
15019,Chic,1980-09-06,Chic - Real People,8,8,15,8.0,14,Real People,11.0,5,-1,-6,0,1,down,1980-08-02
15020,Chic,1980-09-13,Chic - Real People,14,8,19,8.0,15,Real People,11.0,6,-4,-1,-6,1,down,1980-08-02
15021,Chic,1980-09-20,Chic - Real People,15,14,21,8.0,19,Real People,11.0,7,-2,-4,-1,1,down,1980-08-02
15022,Chic,1980-09-27,Chic - Real People,19,15,27,8.0,21,Real People,11.0,8,-6,-2,-4,1,down,1980-08-02
15023,Chic,1980-10-04,Chic - Real People,21,19,31,8.0,27,Real People,11.0,9,-4,-6,-2,1,down,1980-08-02
15024,Chic,1980-10-11,Chic - Real People,27,21,34,8.0,31,Real People,11.0,10,-3,-4,-6,1,down,1980-08-02
15025,Chic,1980-10-18,Chic - Real People,31,27,51,8.0,34,Real People,11.0,11,-17,-3,-4,1,down,1980-08-02
15026,Dynasty,1980-08-02,Dynasty - Adventures In The Land Of Music,51,51,22,11.0,44,Adventures In The Land Of Music,20.0,0,22,7,0,1,up,1980-08-02
15027,Dynasty,1980-08-09,Dynasty - Adventures In The Land Of Music,44,51,16,11.0,22,Adventures In The Land Of Music,20.0,1,6,22,7,1,up,1980-08-02
15028,Dynasty,1980-08-16,Dynasty - Adventures In The Land Of Music,22,44,13,11.0,16,Adventures In The Land Of Music,20.0,2,3,6,22,1,up,1980-08-02
15029,Dynasty,1980-08-23,Dynasty - Adventures In The Land Of Music,16,22,12,11.0,13,Adventures In The Land Of Music,20.0,3,1,3,6,1,up,1980-08-02
15030,Dynasty,1980-08-30,Dynasty - Adventures In The Land Of Music,13,16,11,11.0,12,Adventures In The Land Of Music,20.0,4,1,1,3,1,up,1980-08-02
15031,Dynasty,1980-09-06,Dynasty - Adventures In The Land Of Music,12,13,11,11.0,11,Adventures In The Land Of Music,20.0,5,0,1,1,0,stay,1980-08-02
15032,Dynasty,1980-09-13,Dynasty - Adventures In The Land Of Music,11,12,11,11.0,11,Adventures In The Land Of Music,20.0,6,0,0,1,0,stay,1980-08-02
15033,Dynasty,1980-09-20,Dynasty - Adventures In The Land Of Music,11,11,14,11.0,11,Adventures In The Land Of Music,20.0,7,-3,0,0,1,down,1980-08-02
15034,Dynasty,1980-09-27,Dynasty - Adventures In The Land Of Music,11,11,15,11.0,14,Adventures In The Land Of Music,20.0,8,-1,-3,0,1,down,1980-08-02
15035,Dynasty,1980-10-04,Dynasty - Adventures In The Land Of Music,14,11,15,11.0,15,Adventures In The Land Of Music,20.0,9,0,-1,-3,0,stay,1980-08-02
15036,Dynasty,1980-10-11,Dynasty - Adventures In The Land Of Music,15,14,16,11.0,15,Adventures In The Land Of Music,20.0,10,-1,0,-1,1,down,1980-08-02
15037,Dynasty,1980-10-18,Dynasty - Adventures In The Land Of Music,15,15,17,11.0,16,Adventures In The Land Of Music,20.0,11,-1,-1,0,1,down,1980-08-02
15038,Dynasty,1980-10-25,Dynasty - Adventures In The Land Of Music,16,15,18,11.0,17,Adventures In The Land Of Music,20.0,12,-1,-1,-1,1,down,1980-08-02
15039,Dynasty,1980-11-01,Dynasty - Adventures In The Land Of Music,17,16,21,11.0,18,Adventures In The Land Of Music,20.0,13,-3,-1,-1,1,down,1980-08-02
15040,Dynasty,1980-11-08,Dynasty - Adventures In The Land Of Music,18,17,36,11.0,21,Adventures In The Land Of Music,20.0,14,-15,-3,-1,1,down,1980-08-02
15041,Dynasty,1980-11-15,Dynasty - Adventures In The Land Of Music,21,18,38,11.0,36,Adventures In The Land Of Music,20.0,15,-2,-15,-3,1,down,1980-08-02
15042,Dynasty,1980-11-22,Dynasty - Adventures In The Land Of Music,36,21,39,11.0,38,Adventures In The Land Of Music,20.0,16,-1,-2,-15,1,down,1980-08-02
15043,Dynasty,1980-11-29,Dynasty - Adventures In The Land Of Music,38,36,45,11.0,39,Adventures In The Land Of Music,20.0,17,-6,-1,-2,1,down,1980-08-02
15044,Dynasty,1980-12-06,Dynasty - Adventures In The Land Of Music,39,38,48,11.0,45,Adventures In The Land Of Music,20.0,18,-3,-6,-1,1,down,1980-08-02
15045,Dynasty,1980-12-13,Dynasty - Adventures In The Land Of Music,45,39,62,11.0,48,Adventures In The Land Of Music,20.0,19,-14,-3,-6,1,down,1980-08-02
15046,Dynasty,1981-01-31,Dynasty - Adventures In The Land Of Music,48,45,51,11.0,62,Adventures In The Land Of Music,20.0,20,11,-14,-3,1,up,1980-08-02
15047,Herb Alpert,1980-08-02,Herb Alpert - Beyond,51,51,35,26.0,46,Beyond,6.0,0,11,5,0,1,up,1980-08-02
15048,Herb Alpert,1980-08-09,Herb Alpert - Beyond,46,51,27,26.0,35,Beyond,6.0,1,8,11,5,1,up,1980-08-02
15049,Herb Alpert,1980-08-16,Herb Alpert - Beyond,35,46,26,26.0,27,Beyond,6.0,2,1,8,11,1,up,1980-08-02
15050,Herb Alpert,1980-08-23,Herb Alpert - Beyond,27,35,38,26.0,26,Beyond,6.0,3,-12,1,8,1,down,1980-08-02
15051,Herb Alpert,1980-08-30,Herb Alpert - Beyond,26,27,41,26.0,38,Beyond,6.0,4,-3,-12,1,1,down,1980-08-02
15052,Herb Alpert,1980-09-06,Herb Alpert - Beyond,38,26,49,26.0,41,Beyond,6.0,5,-8,-3,-12,1,down,1980-08-02
15053,Herb Alpert,1980-09-13,Herb Alpert - Beyond,41,38,51,26.0,49,Beyond,6.0,6,-2,-8,-3,1,down,1980-08-02
15054,Cameron,1980-08-02,Cameron - Cameron,51,51,36,18.0,47,Cameron,16.0,0,11,4,0,1,up,1980-08-02
15055,Cameron,1980-08-09,Cameron - Cameron,47,51,29,18.0,36,Cameron,16.0,1,7,11,4,1,up,1980-08-02
15056,Cameron,1980-08-16,Cameron - Cameron,36,47,25,18.0,29,Cameron,16.0,2,4,7,11,1,up,1980-08-02
15057,Cameron,1980-08-23,Cameron - Cameron,29,36,19,18.0,25,Cameron,16.0,3,6,4,7,1,up,1980-08-02
15058,Cameron,1980-08-30,Cameron - Cameron,25,29,18,18.0,19,Cameron,16.0,4,1,6,4,1,up,1980-08-02
15059,Cameron,1980-09-06,Cameron - Cameron,19,25,18,18.0,18,Cameron,16.0,5,0,1,6,0,stay,1980-08-02
15060,Cameron,1980-09-13,Cameron - Cameron,18,19,18,18.0,18,Cameron,16.0,6,0,0,1,0,stay,1980-08-02
15061,Cameron,1980-09-20,Cameron - Cameron,18,18,19,18.0,18,Cameron,16.0,7,-1,0,0,1,down,1980-08-02
15062,Cameron,1980-09-27,Cameron - Cameron,18,18,19,18.0,19,Cameron,16.0,8,0,-1,0,0,stay,1980-08-02
15063,Cameron,1980-10-04,Cameron - Cameron,19,18,20,18.0,19,Cameron,16.0,9,-1,0,-1,1,down,1980-08-02
15064,Cameron,1980-10-11,Cameron - Cameron,19,19,26,18.0,20,Cameron,16.0,10,-6,-1,0,1,down,1980-08-02
15065,Cameron,1980-10-18,Cameron - Cameron,20,19,26,18.0,26,Cameron,16.0,11,0,-6,-1,0,stay,1980-08-02
15066,Cameron,1980-10-25,Cameron - Cameron,26,20,42,18.0,26,Cameron,16.0,12,-16,0,-6,1,down,1980-08-02
15067,Cameron,1980-11-01,Cameron - Cameron,26,26,50,18.0,42,Cameron,16.0,13,-8,-16,0,1,down,1980-08-02
15068,Cameron,1980-11-08,Cameron - Cameron,42,26,50,18.0,50,Cameron,16.0,14,0,-8,-16,0,stay,1980-08-02
15069,Cameron,1980-11-15,Cameron - Cameron,50,42,51,18.0,50,Cameron,16.0,15,-1,0,-8,1,down,1980-08-02
15070,Cameron,1981-01-31,Cameron - Cameron,50,50,51,18.0,51,Cameron,16.0,16,0,-1,0,0,stay,1980-08-02
15071,Curtis Mayfield,1980-08-02,Curtis Mayfield - Something To Believe In,51,51,47,33.0,48,Something To Believe In,8.0,0,1,3,0,1,up,1980-08-02
15072,Curtis Mayfield,1980-08-09,Curtis Mayfield - Something To Believe In,48,51,39,33.0,47,Something To Believe In,8.0,1,8,1,3,1,up,1980-08-02
15073,Curtis Mayfield,1980-08-16,Curtis Mayfield - Something To Believe In,47,48,33,33.0,39,Something To Believe In,8.0,2,6,8,1,1,up,1980-08-02
15074,Curtis Mayfield,1980-08-23,Curtis Mayfield - Something To Believe In,39,47,33,33.0,33,Something To Believe In,8.0,3,0,6,8,0,stay,1980-08-02
15075,Curtis Mayfield,1980-08-30,Curtis Mayfield - Something To Believe In,33,39,44,33.0,33,Something To Believe In,8.0,4,-11,0,6,1,down,1980-08-02
15076,Curtis Mayfield,1980-09-06,Curtis Mayfield - Something To Believe In,33,33,42,33.0,44,Something To Believe In,8.0,5,2,-11,0,1,up,1980-08-02
15077,Curtis Mayfield,1980-09-13,Curtis Mayfield - Something To Believe In,44,33,46,33.0,42,Something To Believe In,8.0,6,-4,2,-11,1,down,1980-08-02
15078,Curtis Mayfield,1980-09-20,Curtis Mayfield - Something To Believe In,42,44,50,33.0,46,Something To Believe In,8.0,7,-4,-4,2,1,down,1980-08-02
15079,Curtis Mayfield,1980-09-27,Curtis Mayfield - Something To Believe In,46,42,51,33.0,50,Something To Believe In,8.0,8,-1,-4,-4,1,down,1980-08-02
15080,George Benson,1980-08-09,George Benson - Give Me The Night,51,51,10,1.0,24,Give Me The Night,31.0,0,14,27,0,1,up,1980-08-09
15081,George Benson,1980-08-16,George Benson - Give Me The Night,24,51,3,1.0,10,Give Me The Night,31.0,1,7,14,27,1,up,1980-08-09
15082,George Benson,1980-08-23,George Benson - Give Me The Night,10,24,3,1.0,3,Give Me The Night,31.0,2,0,7,14,0,stay,1980-08-09
15083,George Benson,1980-08-30,George Benson - Give Me The Night,3,10,2,1.0,3,Give Me The Night,31.0,3,1,0,7,1,up,1980-08-09
15084,George Benson,1980-09-06,George Benson - Give Me The Night,3,3,2,1.0,2,Give Me The Night,31.0,4,0,1,0,0,stay,1980-08-09
15085,George Benson,1980-09-13,George Benson - Give Me The Night,2,3,1,1.0,2,Give Me The Night,31.0,5,1,0,1,1,up,1980-08-09
15086,George Benson,1980-09-20,George Benson - Give Me The Night,2,2,1,1.0,1,Give Me The Night,31.0,6,0,1,0,0,stay,1980-08-09
15087,George Benson,1980-09-27,George Benson - Give Me The Night,1,2,1,1.0,1,Give Me The Night,31.0,7,0,0,1,0,stay,1980-08-09
15088,George Benson,1980-10-04,George Benson - Give Me The Night,1,1,1,1.0,1,Give Me The Night,31.0,8,0,0,0,0,stay,1980-08-09
15089,George Benson,1980-10-11,George Benson - Give Me The Night,1,1,3,1.0,1,Give Me The Night,31.0,9,-2,0,0,1,down,1980-08-09
15090,George Benson,1980-10-18,George Benson - Give Me The Night,1,1,3,1.0,3,Give Me The Night,31.0,10,0,-2,0,0,stay,1980-08-09
15091,George Benson,1980-10-25,George Benson - Give Me The Night,3,1,4,1.0,3,Give Me The Night,31.0,11,-1,0,-2,1,down,1980-08-09
15092,George Benson,1980-11-01,George Benson - Give Me The Night,3,3,4,1.0,4,Give Me The Night,31.0,12,0,-1,0,0,stay,1980-08-09
15093,George Benson,1980-11-08,George Benson - Give Me The Night,4,3,5,1.0,4,Give Me The Night,31.0,13,-1,0,-1,1,down,1980-08-09
15094,George Benson,1980-11-15,George Benson - Give Me The Night,4,4,5,1.0,5,Give Me The Night,31.0,14,0,-1,0,0,stay,1980-08-09
15095,George Benson,1980-11-22,George Benson - Give Me The Night,5,4,7,1.0,5,Give Me The Night,31.0,15,-2,0,-1,1,down,1980-08-09
15096,George Benson,1980-11-29,George Benson - Give Me The Night,5,5,9,1.0,7,Give Me The Night,31.0,16,-2,-2,0,1,down,1980-08-09
15097,George Benson,1980-12-06,George Benson - Give Me The Night,7,5,10,1.0,9,Give Me The Night,31.0,17,-1,-2,-2,1,down,1980-08-09
15098,George Benson,1980-12-13,George Benson - Give Me The Night,9,7,13,1.0,10,Give Me The Night,31.0,18,-3,-1,-2,1,down,1980-08-09
15099,George Benson,1980-12-20,George Benson - Give Me The Night,10,9,16,1.0,13,Give Me The Night,31.0,19,-3,-3,-1,1,down,1980-08-09
15100,George Benson,1980-12-27,George Benson - Give Me The Night,13,10,16,1.0,16,Give Me The Night,31.0,20,0,-3,-3,0,stay,1980-08-09
15101,George Benson,1981-01-03,George Benson - Give Me The Night,16,13,16,1.0,16,Give Me The Night,31.0,21,0,0,-3,0,stay,1980-08-09
15102,George Benson,1981-01-10,George Benson - Give Me The Night,16,16,28,1.0,16,Give Me The Night,31.0,22,-12,0,0,1,down,1980-08-09
15103,George Benson,1981-01-17,George Benson - Give Me The Night,16,16,29,1.0,28,Give Me The Night,31.0,23,-1,-12,0,1,down,1980-08-09
15104,George Benson,1981-01-24,George Benson - Give Me The Night,28,16,31,1.0,29,Give Me The Night,31.0,24,-2,-1,-12,1,down,1980-08-09
15105,George Benson,1981-02-07,George Benson - Give Me The Night,29,28,38,1.0,31,Give Me The Night,31.0,25,-7,-2,-1,1,down,1980-08-09
15106,George Benson,1981-02-14,George Benson - Give Me The Night,31,29,38,1.0,38,Give Me The Night,31.0,26,0,-7,-2,0,stay,1980-08-09
15107,George Benson,1981-02-21,George Benson - Give Me The Night,38,31,39,1.0,38,Give Me The Night,31.0,27,-1,0,-7,1,down,1980-08-09
15108,George Benson,1981-02-28,George Benson - Give Me The Night,38,38,40,1.0,39,Give Me The Night,31.0,28,-1,-1,0,1,down,1980-08-09
15109,George Benson,1981-03-07,George Benson - Give Me The Night,39,38,45,1.0,40,Give Me The Night,31.0,29,-5,-1,-1,1,down,1980-08-09
15110,George Benson,1981-03-14,George Benson - Give Me The Night,40,39,47,1.0,45,Give Me The Night,31.0,30,-2,-5,-1,1,down,1980-08-09
15111,George Benson,1981-03-21,George Benson - Give Me The Night,45,40,51,1.0,47,Give Me The Night,31.0,31,-4,-2,-5,1,down,1980-08-09
15112,Maze,1980-08-09,Maze - Joy And Pain,51,51,21,5.0,32,Joy And Pain,29.0,0,11,19,0,1,up,1980-08-09
15113,Maze,1980-08-16,Maze - Joy And Pain,32,51,9,5.0,21,Joy And Pain,29.0,1,12,11,19,1,up,1980-08-09
15114,Maze,1980-08-23,Maze - Joy And Pain,21,32,7,5.0,9,Joy And Pain,29.0,2,2,12,11,1,up,1980-08-09
15115,Maze,1980-08-30,Maze - Joy And Pain,9,21,6,5.0,7,Joy And Pain,29.0,3,1,2,12,1,up,1980-08-09
15116,Maze,1980-09-06,Maze - Joy And Pain,7,9,5,5.0,6,Joy And Pain,29.0,4,1,1,2,1,up,1980-08-09
15117,Maze,1980-09-13,Maze - Joy And Pain,6,7,5,5.0,5,Joy And Pain,29.0,5,0,1,1,0,stay,1980-08-09
15118,Maze,1980-09-20,Maze - Joy And Pain,5,6,5,5.0,5,Joy And Pain,29.0,6,0,0,1,0,stay,1980-08-09
15119,Maze,1980-09-27,Maze - Joy And Pain,5,5,5,5.0,5,Joy And Pain,29.0,7,0,0,0,0,stay,1980-08-09
15120,Maze,1980-10-04,Maze - Joy And Pain,5,5,5,5.0,5,Joy And Pain,29.0,8,0,0,0,0,stay,1980-08-09
15121,Maze,1980-10-11,Maze - Joy And Pain,5,5,10,5.0,5,Joy And Pain,29.0,9,-5,0,0,1,down,1980-08-09
15122,Maze,1980-10-18,Maze - Joy And Pain,5,5,11,5.0,10,Joy And Pain,29.0,10,-1,-5,0,1,down,1980-08-09
15123,Maze,1980-10-25,Maze - Joy And Pain,10,5,13,5.0,11,Joy And Pain,29.0,11,-2,-1,-5,1,down,1980-08-09
15124,Maze,1980-11-01,Maze - Joy And Pain,11,10,16,5.0,13,Joy And Pain,29.0,12,-3,-2,-1,1,down,1980-08-09
15125,Maze,1980-11-08,Maze - Joy And Pain,13,11,23,5.0,16,Joy And Pain,29.0,13,-7,-3,-2,1,down,1980-08-09
15126,Maze,1980-11-15,Maze - Joy And Pain,16,13,28,5.0,23,Joy And Pain,29.0,14,-5,-7,-3,1,down,1980-08-09
15127,Maze,1980-11-22,Maze - Joy And Pain,23,16,31,5.0,28,Joy And Pain,29.0,15,-3,-5,-7,1,down,1980-08-09
15128,Maze,1980-11-29,Maze - Joy And Pain,28,23,31,5.0,31,Joy And Pain,29.0,16,0,-3,-5,0,stay,1980-08-09
15129,Maze,1980-12-06,Maze - Joy And Pain,31,28,34,5.0,31,Joy And Pain,29.0,17,-3,0,-3,1,down,1980-08-09
15130,Maze,1980-12-13,Maze - Joy And Pain,31,31,36,5.0,34,Joy And Pain,29.0,18,-2,-3,0,1,down,1980-08-09
15131,Maze,1980-12-20,Maze - Joy And Pain,34,31,41,5.0,36,Joy And Pain,29.0,19,-5,-2,-3,1,down,1980-08-09
15132,Maze,1980-12-27,Maze - Joy And Pain,36,34,41,5.0,41,Joy And Pain,29.0,20,0,-5,-2,0,stay,1980-08-09
15133,Maze,1981-01-03,Maze - Joy And Pain,41,36,41,5.0,41,Joy And Pain,29.0,21,0,0,-5,0,stay,1980-08-09
15134,Maze,1981-01-10,Maze - Joy And Pain,41,41,43,5.0,41,Joy And Pain,29.0,22,-2,0,0,1,down,1980-08-09
15135,Maze,1981-01-17,Maze - Joy And Pain,41,41,44,5.0,43,Joy And Pain,29.0,23,-1,-2,0,1,down,1980-08-09
15136,Maze,1981-01-24,Maze - Joy And Pain,43,41,44,5.0,44,Joy And Pain,29.0,24,0,-1,-2,0,stay,1980-08-09
15137,Maze,1981-01-31,Maze - Joy And Pain,44,43,46,5.0,44,Joy And Pain,29.0,25,-2,0,-1,1,down,1980-08-09
15138,Maze,1981-02-07,Maze - Joy And Pain,44,44,47,5.0,46,Joy And Pain,29.0,26,-1,-2,0,1,down,1980-08-09
15139,Maze,1981-02-14,Maze - Joy And Pain,46,44,48,5.0,47,Joy And Pain,29.0,27,-1,-1,-2,1,down,1980-08-09
15140,Maze,1981-02-21,Maze - Joy And Pain,47,46,48,5.0,48,Joy And Pain,29.0,28,0,-1,-1,0,stay,1980-08-09
15141,Maze,1981-02-28,Maze - Joy And Pain,48,47,51,5.0,48,Joy And Pain,29.0,29,-3,0,-1,1,down,1980-08-09
15142,Tom Browne,1980-08-09,Tom Browne - Love Approach,51,51,41,1.0,49,Love Approach,26.0,0,8,2,0,1,up,1980-08-09
15143,Tom Browne,1980-08-16,Tom Browne - Love Approach,49,51,30,1.0,41,Love Approach,26.0,1,11,8,2,1,up,1980-08-09
15144,Tom Browne,1980-08-23,Tom Browne - Love Approach,41,49,18,1.0,30,Love Approach,26.0,2,12,11,8,1,up,1980-08-09
15145,Tom Browne,1980-08-30,Tom Browne - Love Approach,30,41,12,1.0,18,Love Approach,26.0,3,6,12,11,1,up,1980-08-09
15146,Tom Browne,1980-09-06,Tom Browne - Love Approach,18,30,7,1.0,12,Love Approach,26.0,4,5,6,12,1,up,1980-08-09
15147,Tom Browne,1980-09-13,Tom Browne - Love Approach,12,18,4,1.0,7,Love Approach,26.0,5,3,5,6,1,up,1980-08-09
15148,Tom Browne,1980-09-20,Tom Browne - Love Approach,7,12,4,1.0,4,Love Approach,26.0,6,0,3,5,0,stay,1980-08-09
15149,Tom Browne,1980-09-27,Tom Browne - Love Approach,4,7,4,1.0,4,Love Approach,26.0,7,0,0,3,0,stay,1980-08-09
15150,Tom Browne,1980-10-04,Tom Browne - Love Approach,4,4,3,1.0,4,Love Approach,26.0,8,1,0,0,1,up,1980-08-09
15151,Tom Browne,1980-10-11,Tom Browne - Love Approach,4,4,1,1.0,3,Love Approach,26.0,9,2,1,0,1,up,1980-08-09
15152,Tom Browne,1980-10-18,Tom Browne - Love Approach,3,4,2,1.0,1,Love Approach,26.0,10,-1,2,1,1,down,1980-08-09
15153,Tom Browne,1980-10-25,Tom Browne - Love Approach,1,3,3,1.0,2,Love Approach,26.0,11,-1,-1,2,1,down,1980-08-09
15154,Tom Browne,1980-11-01,Tom Browne - Love Approach,2,1,3,1.0,3,Love Approach,26.0,12,0,-1,-1,0,stay,1980-08-09
15155,Tom Browne,1980-11-08,Tom Browne - Love Approach,3,2,7,1.0,3,Love Approach,26.0,13,-4,0,-1,1,down,1980-08-09
15156,Tom Browne,1980-11-15,Tom Browne - Love Approach,3,3,7,1.0,7,Love Approach,26.0,14,0,-4,0,0,stay,1980-08-09
15157,Tom Browne,1980-11-22,Tom Browne - Love Approach,7,3,20,1.0,7,Love Approach,26.0,15,-13,0,-4,1,down,1980-08-09
15158,Tom Browne,1980-11-29,Tom Browne - Love Approach,7,7,21,1.0,20,Love Approach,26.0,16,-1,-13,0,1,down,1980-08-09
15159,Tom Browne,1980-12-06,Tom Browne - Love Approach,20,7,26,1.0,21,Love Approach,26.0,17,-5,-1,-13,1,down,1980-08-09
15160,Tom Browne,1980-12-13,Tom Browne - Love Approach,21,20,28,1.0,26,Love Approach,26.0,18,-2,-5,-1,1,down,1980-08-09
15161,Tom Browne,1980-12-20,Tom Browne - Love Approach,26,21,39,1.0,28,Love Approach,26.0,19,-11,-2,-5,1,down,1980-08-09
15162,Tom Browne,1980-12-27,Tom Browne - Love Approach,28,26,39,1.0,39,Love Approach,26.0,20,0,-11,-2,0,stay,1980-08-09
15163,Tom Browne,1981-01-03,Tom Browne - Love Approach,39,28,39,1.0,39,Love Approach,26.0,21,0,0,-11,0,stay,1980-08-09
15164,Tom Browne,1981-01-10,Tom Browne - Love Approach,39,39,44,1.0,39,Love Approach,26.0,22,-5,0,0,1,down,1980-08-09
15165,Tom Browne,1981-01-17,Tom Browne - Love Approach,39,39,46,1.0,44,Love Approach,26.0,23,-2,-5,0,1,down,1980-08-09
15166,Tom Browne,1981-01-24,Tom Browne - Love Approach,44,39,49,1.0,46,Love Approach,26.0,24,-3,-2,-5,1,down,1980-08-09
15167,Tom Browne,1981-01-31,Tom Browne - Love Approach,46,44,50,1.0,49,Love Approach,26.0,25,-1,-3,-2,1,down,1980-08-09
15168,Tom Browne,1981-02-07,Tom Browne - Love Approach,49,46,51,1.0,50,Love Approach,26.0,26,-1,-1,-3,1,down,1980-08-09
15169,Teddy Pendergrass,1980-08-16,Teddy Pendergrass - T.p.,51,51,7,3.0,23,T.p.,31.0,0,16,28,0,1,up,1980-08-16
15170,Teddy Pendergrass,1980-08-23,Teddy Pendergrass - T.p.,23,51,4,3.0,7,T.p.,31.0,1,3,16,28,1,up,1980-08-16
15171,Teddy Pendergrass,1980-08-30,Teddy Pendergrass - T.p.,7,23,3,3.0,4,T.p.,31.0,2,1,3,16,1,up,1980-08-16
15172,Teddy Pendergrass,1980-09-06,Teddy Pendergrass - T.p.,4,7,3,3.0,3,T.p.,31.0,3,0,1,3,0,stay,1980-08-16
15173,Teddy Pendergrass,1980-09-13,Teddy Pendergrass - T.p.,3,4,3,3.0,3,T.p.,31.0,4,0,0,1,0,stay,1980-08-16
15174,Teddy Pendergrass,1980-09-20,Teddy Pendergrass - T.p.,3,3,3,3.0,3,T.p.,31.0,5,0,0,0,0,stay,1980-08-16
15175,Teddy Pendergrass,1980-09-27,Teddy Pendergrass - T.p.,3,3,3,3.0,3,T.p.,31.0,6,0,0,0,0,stay,1980-08-16
15176,Teddy Pendergrass,1980-10-04,Teddy Pendergrass - T.p.,3,3,4,3.0,3,T.p.,31.0,7,-1,0,0,1,down,1980-08-16
15177,Teddy Pendergrass,1980-10-11,Teddy Pendergrass - T.p.,3,3,5,3.0,4,T.p.,31.0,8,-1,-1,0,1,down,1980-08-16
15178,Teddy Pendergrass,1980-10-18,Teddy Pendergrass - T.p.,4,3,7,3.0,5,T.p.,31.0,9,-2,-1,-1,1,down,1980-08-16
15179,Teddy Pendergrass,1980-10-25,Teddy Pendergrass - T.p.,5,4,7,3.0,7,T.p.,31.0,10,0,-2,-1,0,stay,1980-08-16
15180,Teddy Pendergrass,1980-11-01,Teddy Pendergrass - T.p.,7,5,7,3.0,7,T.p.,31.0,11,0,0,-2,0,stay,1980-08-16
15181,Teddy Pendergrass,1980-11-08,Teddy Pendergrass - T.p.,7,7,6,3.0,7,T.p.,31.0,12,1,0,0,1,up,1980-08-16
15182,Teddy Pendergrass,1980-11-15,Teddy Pendergrass - T.p.,7,7,6,3.0,6,T.p.,31.0,13,0,1,0,0,stay,1980-08-16
15183,Teddy Pendergrass,1980-11-22,Teddy Pendergrass - T.p.,6,7,5,3.0,6,T.p.,31.0,14,1,0,1,1,up,1980-08-16
15184,Teddy Pendergrass,1980-11-29,Teddy Pendergrass - T.p.,6,6,5,3.0,5,T.p.,31.0,15,0,1,0,0,stay,1980-08-16
15185,Teddy Pendergrass,1980-12-06,Teddy Pendergrass - T.p.,5,6,4,3.0,5,T.p.,31.0,16,1,0,1,1,up,1980-08-16
15186,Teddy Pendergrass,1980-12-13,Teddy Pendergrass - T.p.,5,5,4,3.0,4,T.p.,31.0,17,0,1,0,0,stay,1980-08-16
15187,Teddy Pendergrass,1980-12-20,Teddy Pendergrass - T.p.,4,5,4,3.0,4,T.p.,31.0,18,0,0,1,0,stay,1980-08-16
15188,Teddy Pendergrass,1980-12-27,Teddy Pendergrass - T.p.,4,4,4,3.0,4,T.p.,31.0,19,0,0,0,0,stay,1980-08-16
15189,Teddy Pendergrass,1981-01-03,Teddy Pendergrass - T.p.,4,4,4,3.0,4,T.p.,31.0,20,0,0,0,0,stay,1980-08-16
15190,Teddy Pendergrass,1981-01-10,Teddy Pendergrass - T.p.,4,4,12,3.0,4,T.p.,31.0,21,-8,0,0,1,down,1980-08-16
15191,Teddy Pendergrass,1981-01-17,Teddy Pendergrass - T.p.,4,4,13,3.0,12,T.p.,31.0,22,-1,-8,0,1,down,1980-08-16
15192,Teddy Pendergrass,1981-01-24,Teddy Pendergrass - T.p.,12,4,17,3.0,13,T.p.,31.0,23,-4,-1,-8,1,down,1980-08-16
15193,Teddy Pendergrass,1981-02-07,Teddy Pendergrass - T.p.,13,12,18,3.0,17,T.p.,31.0,24,-1,-4,-1,1,down,1980-08-16
15194,Teddy Pendergrass,1981-02-14,Teddy Pendergrass - T.p.,17,13,21,3.0,18,T.p.,31.0,25,-3,-1,-4,1,down,1980-08-16
15195,Teddy Pendergrass,1981-02-21,Teddy Pendergrass - T.p.,18,17,21,3.0,21,T.p.,31.0,26,0,-3,-1,0,stay,1980-08-16
15196,Teddy Pendergrass,1981-02-28,Teddy Pendergrass - T.p.,21,18,24,3.0,21,T.p.,31.0,27,-3,0,-3,1,down,1980-08-16
15197,Teddy Pendergrass,1981-03-07,Teddy Pendergrass - T.p.,21,21,25,3.0,24,T.p.,31.0,28,-1,-3,0,1,down,1980-08-16
15198,Teddy Pendergrass,1981-03-14,Teddy Pendergrass - T.p.,24,21,41,3.0,25,T.p.,31.0,29,-16,-1,-3,1,down,1980-08-16
15199,Teddy Pendergrass,1981-03-21,Teddy Pendergrass - T.p.,25,24,42,3.0,41,T.p.,31.0,30,-1,-16,-1,1,down,1980-08-16
15200,Teddy Pendergrass,1981-03-28,Teddy Pendergrass - T.p.,41,25,51,3.0,42,T.p.,31.0,31,-9,-1,-16,1,down,1980-08-16
15201,A Taste Of Honey,1980-08-16,A Taste Of Honey - Twice As Sweet,51,51,32,12.0,38,Twice As Sweet,26.0,0,6,13,0,1,up,1980-08-16
15202,A Taste Of Honey,1980-08-23,A Taste Of Honey - Twice As Sweet,38,51,28,12.0,32,Twice As Sweet,26.0,1,4,6,13,1,up,1980-08-16
15203,A Taste Of Honey,1980-08-30,A Taste Of Honey - Twice As Sweet,32,38,28,12.0,28,Twice As Sweet,26.0,2,0,4,6,0,stay,1980-08-16
15204,A Taste Of Honey,1980-09-06,A Taste Of Honey - Twice As Sweet,28,32,28,12.0,28,Twice As Sweet,26.0,3,0,0,4,0,stay,1980-08-16
15205,A Taste Of Honey,1980-09-13,A Taste Of Honey - Twice As Sweet,28,28,29,12.0,28,Twice As Sweet,26.0,4,-1,0,0,1,down,1980-08-16
15206,A Taste Of Honey,1980-09-20,A Taste Of Honey - Twice As Sweet,28,28,33,12.0,29,Twice As Sweet,26.0,5,-4,-1,0,1,down,1980-08-16
15207,A Taste Of Honey,1980-09-27,A Taste Of Honey - Twice As Sweet,29,28,33,12.0,33,Twice As Sweet,26.0,6,0,-4,-1,0,stay,1980-08-16
15208,A Taste Of Honey,1980-10-04,A Taste Of Honey - Twice As Sweet,33,29,36,12.0,33,Twice As Sweet,26.0,7,-3,0,-4,1,down,1980-08-16
15209,A Taste Of Honey,1980-10-11,A Taste Of Honey - Twice As Sweet,33,33,50,12.0,36,Twice As Sweet,26.0,8,-14,-3,0,1,down,1980-08-16
15210,A Taste Of Honey,1981-03-28,A Taste Of Honey - Twice As Sweet,36,33,40,12.0,50,Twice As Sweet,26.0,9,10,-14,-3,1,up,1980-08-16
15211,A Taste Of Honey,1981-04-04,A Taste Of Honey - Twice As Sweet,50,36,28,12.0,40,Twice As Sweet,26.0,10,12,10,-14,1,up,1980-08-16
15212,A Taste Of Honey,1981-04-11,A Taste Of Honey - Twice As Sweet,40,50,21,12.0,28,Twice As Sweet,26.0,11,7,12,10,1,up,1980-08-16
15213,A Taste Of Honey,1981-04-18,A Taste Of Honey - Twice As Sweet,28,40,19,12.0,21,Twice As Sweet,26.0,12,2,7,12,1,up,1980-08-16
15214,A Taste Of Honey,1981-04-25,A Taste Of Honey - Twice As Sweet,21,28,15,12.0,19,Twice As Sweet,26.0,13,4,2,7,1,up,1980-08-16
15215,A Taste Of Honey,1981-05-02,A Taste Of Honey - Twice As Sweet,19,21,15,12.0,15,Twice As Sweet,26.0,14,0,4,2,0,stay,1980-08-16
15216,A Taste Of Honey,1981-05-09,A Taste Of Honey - Twice As Sweet,15,19,12,12.0,15,Twice As Sweet,26.0,15,3,0,4,1,up,1980-08-16
15217,A Taste Of Honey,1981-05-16,A Taste Of Honey - Twice As Sweet,15,15,12,12.0,12,Twice As Sweet,26.0,16,0,3,0,0,stay,1980-08-16
15218,A Taste Of Honey,1981-05-23,A Taste Of Honey - Twice As Sweet,12,15,14,12.0,12,Twice As Sweet,26.0,17,-2,0,3,1,down,1980-08-16
15219,A Taste Of Honey,1981-05-30,A Taste Of Honey - Twice As Sweet,12,12,14,12.0,14,Twice As Sweet,26.0,18,0,-2,0,0,stay,1980-08-16
15220,A Taste Of Honey,1981-06-06,A Taste Of Honey - Twice As Sweet,14,12,16,12.0,14,Twice As Sweet,26.0,19,-2,0,-2,1,down,1980-08-16
15221,A Taste Of Honey,1981-06-13,A Taste Of Honey - Twice As Sweet,14,14,19,12.0,16,Twice As Sweet,26.0,20,-3,-2,0,1,down,1980-08-16
15222,A Taste Of Honey,1981-06-20,A Taste Of Honey - Twice As Sweet,16,14,23,12.0,19,Twice As Sweet,26.0,21,-4,-3,-2,1,down,1980-08-16
15223,A Taste Of Honey,1981-06-27,A Taste Of Honey - Twice As Sweet,19,16,25,12.0,23,Twice As Sweet,26.0,22,-2,-4,-3,1,down,1980-08-16
15224,A Taste Of Honey,1981-07-04,A Taste Of Honey - Twice As Sweet,23,19,25,12.0,25,Twice As Sweet,26.0,23,0,-2,-4,0,stay,1980-08-16
15225,A Taste Of Honey,1981-07-11,A Taste Of Honey - Twice As Sweet,25,23,32,12.0,25,Twice As Sweet,26.0,24,-7,0,-2,1,down,1980-08-16
15226,A Taste Of Honey,1981-07-18,A Taste Of Honey - Twice As Sweet,25,25,47,12.0,32,Twice As Sweet,26.0,25,-15,-7,0,1,down,1980-08-16
15227,A Taste Of Honey,1981-07-25,A Taste Of Honey - Twice As Sweet,32,25,51,12.0,47,Twice As Sweet,26.0,26,-4,-15,-7,1,down,1980-08-16
15228,Rick James,1980-08-16,Rick James - Garden Of Love,51,51,23,17.0,40,Garden Of Love,9.0,0,17,11,0,1,up,1980-08-16
15229,Rick James,1980-08-23,Rick James - Garden Of Love,40,51,20,17.0,23,Garden Of Love,9.0,1,3,17,11,1,up,1980-08-16
15230,Rick James,1980-08-30,Rick James - Garden Of Love,23,40,20,17.0,20,Garden Of Love,9.0,2,0,3,17,0,stay,1980-08-16
15231,Rick James,1980-09-06,Rick James - Garden Of Love,20,23,17,17.0,20,Garden Of Love,9.0,3,3,0,3,1,up,1980-08-16
15232,Rick James,1980-09-13,Rick James - Garden Of Love,20,20,17,17.0,17,Garden Of Love,9.0,4,0,3,0,0,stay,1980-08-16
15233,Rick James,1980-09-20,Rick James - Garden Of Love,17,20,24,17.0,17,Garden Of Love,9.0,5,-7,0,3,1,down,1980-08-16
15234,Rick James,1980-09-27,Rick James - Garden Of Love,17,17,26,17.0,24,Garden Of Love,9.0,6,-2,-7,0,1,down,1980-08-16
15235,Rick James,1980-10-04,Rick James - Garden Of Love,24,17,27,17.0,26,Garden Of Love,9.0,7,-1,-2,-7,1,down,1980-08-16
15236,Rick James,1980-10-11,Rick James - Garden Of Love,26,24,29,17.0,27,Garden Of Love,9.0,8,-2,-1,-2,1,down,1980-08-16
15237,Rick James,1980-10-18,Rick James - Garden Of Love,27,26,51,17.0,29,Garden Of Love,9.0,9,-22,-2,-1,1,down,1980-08-16
15238,Dionne Warwick,1980-08-16,Dionne Warwick - No Night So Long,51,51,35,22.0,45,No Night So Long,16.0,0,10,6,0,1,up,1980-08-16
15239,Dionne Warwick,1980-08-23,Dionne Warwick - No Night So Long,45,51,30,22.0,35,No Night So Long,16.0,1,5,10,6,1,up,1980-08-16
15240,Dionne Warwick,1980-08-30,Dionne Warwick - No Night So Long,35,45,24,22.0,30,No Night So Long,16.0,2,6,5,10,1,up,1980-08-16
15241,Dionne Warwick,1980-09-06,Dionne Warwick - No Night So Long,30,35,23,22.0,24,No Night So Long,16.0,3,1,6,5,1,up,1980-08-16
15242,Dionne Warwick,1980-09-13,Dionne Warwick - No Night So Long,24,30,22,22.0,23,No Night So Long,16.0,4,1,1,6,1,up,1980-08-16
15243,Dionne Warwick,1980-09-20,Dionne Warwick - No Night So Long,23,24,22,22.0,22,No Night So Long,16.0,5,0,1,1,0,stay,1980-08-16
15244,Dionne Warwick,1980-09-27,Dionne Warwick - No Night So Long,22,23,24,22.0,22,No Night So Long,16.0,6,-2,0,1,1,down,1980-08-16
15245,Dionne Warwick,1980-10-04,Dionne Warwick - No Night So Long,22,22,26,22.0,24,No Night So Long,16.0,7,-2,-2,0,1,down,1980-08-16
15246,Dionne Warwick,1980-10-11,Dionne Warwick - No Night So Long,24,22,28,22.0,26,No Night So Long,16.0,8,-2,-2,-2,1,down,1980-08-16
15247,Dionne Warwick,1980-10-18,Dionne Warwick - No Night So Long,26,24,32,22.0,28,No Night So Long,16.0,9,-4,-2,-2,1,down,1980-08-16
15248,Dionne Warwick,1980-10-25,Dionne Warwick - No Night So Long,28,26,34,22.0,32,No Night So Long,16.0,10,-2,-4,-2,1,down,1980-08-16
15249,Dionne Warwick,1980-11-01,Dionne Warwick - No Night So Long,32,28,41,22.0,34,No Night So Long,16.0,11,-7,-2,-4,1,down,1980-08-16
15250,Dionne Warwick,1980-11-08,Dionne Warwick - No Night So Long,34,32,41,22.0,41,No Night So Long,16.0,12,0,-7,-2,0,stay,1980-08-16
15251,Dionne Warwick,1980-11-15,Dionne Warwick - No Night So Long,41,34,42,22.0,41,No Night So Long,16.0,13,-1,0,-7,1,down,1980-08-16
15252,Dionne Warwick,1980-11-22,Dionne Warwick - No Night So Long,41,41,44,22.0,42,No Night So Long,16.0,14,-2,-1,0,1,down,1980-08-16
15253,Dionne Warwick,1980-11-29,Dionne Warwick - No Night So Long,42,41,68,22.0,44,No Night So Long,16.0,15,-24,-2,-1,1,down,1980-08-16
15254,Dionne Warwick,1981-01-31,Dionne Warwick - No Night So Long,44,42,51,22.0,68,No Night So Long,16.0,16,17,-24,-2,1,up,1980-08-16
15255,Bob Marley And The Wailers,1980-08-16,Bob Marley And The Wailers - Uprising,51,51,41,41.0,49,Uprising,11.0,0,8,2,0,1,up,1980-08-16
15256,Bob Marley And The Wailers,1980-08-23,Bob Marley And The Wailers - Uprising,49,51,41,41.0,41,Uprising,11.0,1,0,8,2,0,stay,1980-08-16
15257,Bob Marley And The Wailers,1980-08-30,Bob Marley And The Wailers - Uprising,41,49,45,41.0,41,Uprising,11.0,2,-4,0,8,1,down,1980-08-16
15258,Bob Marley And The Wailers,1980-09-06,Bob Marley And The Wailers - Uprising,41,41,45,41.0,45,Uprising,11.0,3,0,-4,0,0,stay,1980-08-16
15259,Bob Marley And The Wailers,1980-09-13,Bob Marley And The Wailers - Uprising,45,41,43,41.0,45,Uprising,11.0,4,2,0,-4,1,up,1980-08-16
15260,Bob Marley And The Wailers,1980-09-20,Bob Marley And The Wailers - Uprising,45,45,42,41.0,43,Uprising,11.0,5,1,2,0,1,up,1980-08-16
15261,Bob Marley And The Wailers,1980-09-27,Bob Marley And The Wailers - Uprising,43,45,43,41.0,42,Uprising,11.0,6,-1,1,2,1,down,1980-08-16
15262,Bob Marley And The Wailers,1980-10-04,Bob Marley And The Wailers - Uprising,42,43,43,41.0,43,Uprising,11.0,7,0,-1,1,0,stay,1980-08-16
15263,Bob Marley And The Wailers,1980-10-11,Bob Marley And The Wailers - Uprising,43,42,47,41.0,43,Uprising,11.0,8,-4,0,-1,1,down,1980-08-16
15264,Bob Marley And The Wailers,1980-10-18,Bob Marley And The Wailers - Uprising,43,43,47,41.0,47,Uprising,11.0,9,0,-4,0,0,stay,1980-08-16
15265,Bob Marley And The Wailers,1980-10-25,Bob Marley And The Wailers - Uprising,47,43,48,41.0,47,Uprising,11.0,10,-1,0,-4,1,down,1980-08-16
15266,Bob Marley And The Wailers,1980-11-01,Bob Marley And The Wailers - Uprising,47,47,51,41.0,48,Uprising,11.0,11,-3,-1,0,1,down,1980-08-16
15267,Ashford & Simpson,1980-08-23,Ashford & Simpson - A Musical Affair,51,51,13,8.0,24,A Musical Affair,12.0,0,11,27,0,1,up,1980-08-23
15268,Ashford & Simpson,1980-08-30,Ashford & Simpson - A Musical Affair,24,51,9,8.0,13,A Musical Affair,12.0,1,4,11,27,1,up,1980-08-23
15269,Ashford & Simpson,1980-09-06,Ashford & Simpson - A Musical Affair,13,24,8,8.0,9,A Musical Affair,12.0,2,1,4,11,1,up,1980-08-23
15270,Ashford & Simpson,1980-09-13,Ashford & Simpson - A Musical Affair,9,13,8,8.0,8,A Musical Affair,12.0,3,0,1,4,0,stay,1980-08-23
15271,Ashford & Simpson,1980-09-20,Ashford & Simpson - A Musical Affair,8,9,12,8.0,8,A Musical Affair,12.0,4,-4,0,1,1,down,1980-08-23
15272,Ashford & Simpson,1980-09-27,Ashford & Simpson - A Musical Affair,8,8,18,8.0,12,A Musical Affair,12.0,5,-6,-4,0,1,down,1980-08-23
15273,Ashford & Simpson,1980-10-04,Ashford & Simpson - A Musical Affair,12,8,19,8.0,18,A Musical Affair,12.0,6,-1,-6,-4,1,down,1980-08-23
15274,Ashford & Simpson,1980-10-11,Ashford & Simpson - A Musical Affair,18,12,20,8.0,19,A Musical Affair,12.0,7,-1,-1,-6,1,down,1980-08-23
15275,Ashford & Simpson,1980-10-18,Ashford & Simpson - A Musical Affair,19,18,21,8.0,20,A Musical Affair,12.0,8,-1,-1,-1,1,down,1980-08-23
15276,Ashford & Simpson,1980-10-25,Ashford & Simpson - A Musical Affair,20,19,28,8.0,21,A Musical Affair,12.0,9,-7,-1,-1,1,down,1980-08-23
15277,Ashford & Simpson,1980-11-01,Ashford & Simpson - A Musical Affair,21,20,37,8.0,28,A Musical Affair,12.0,10,-9,-7,-1,1,down,1980-08-23
15278,Ashford & Simpson,1980-11-08,Ashford & Simpson - A Musical Affair,28,21,49,8.0,37,A Musical Affair,12.0,11,-12,-9,-7,1,down,1980-08-23
15279,Ashford & Simpson,1980-11-15,Ashford & Simpson - A Musical Affair,37,28,51,8.0,49,A Musical Affair,12.0,12,-2,-12,-9,1,down,1980-08-23
15280,Soundtrack,1980-08-23,Soundtrack - Fame,51,51,34,21.0,42,Fame,10.0,0,8,9,0,1,up,1980-08-23
15281,Soundtrack,1980-08-30,Soundtrack - Fame,42,51,32,21.0,34,Fame,10.0,1,2,8,9,1,up,1980-08-23
15282,Soundtrack,1980-09-06,Soundtrack - Fame,34,42,26,21.0,32,Fame,10.0,2,6,2,8,1,up,1980-08-23
15283,Soundtrack,1980-09-13,Soundtrack - Fame,32,34,24,21.0,26,Fame,10.0,3,2,6,2,1,up,1980-08-23
15284,Soundtrack,1980-09-20,Soundtrack - Fame,26,32,23,21.0,24,Fame,10.0,4,1,2,6,1,up,1980-08-23
15285,Soundtrack,1980-09-27,Soundtrack - Fame,24,26,22,21.0,23,Fame,10.0,5,1,1,2,1,up,1980-08-23
15286,Soundtrack,1980-10-04,Soundtrack - Fame,23,24,21,21.0,22,Fame,10.0,6,1,1,1,1,up,1980-08-23
15287,Soundtrack,1980-10-11,Soundtrack - Fame,22,23,27,21.0,21,Fame,10.0,7,-6,1,1,1,down,1980-08-23
15288,Soundtrack,1980-10-18,Soundtrack - Fame,21,22,27,21.0,27,Fame,10.0,8,0,-6,1,0,stay,1980-08-23
15289,Soundtrack,1980-10-25,Soundtrack - Fame,27,21,49,21.0,27,Fame,10.0,9,-22,0,-6,1,down,1980-08-23
15290,Soundtrack,1980-11-01,Soundtrack - Fame,27,27,51,21.0,49,Fame,10.0,10,-2,-22,0,1,down,1980-08-23
15291,Michael Henderson,1980-08-23,Michael Henderson - Wide Receiver,51,51,31,6.0,47,Wide Receiver,21.0,0,16,4,0,1,up,1980-08-23
15292,Michael Henderson,1980-08-30,Michael Henderson - Wide Receiver,47,51,17,6.0,31,Wide Receiver,21.0,1,14,16,4,1,up,1980-08-23
15293,Michael Henderson,1980-09-06,Michael Henderson - Wide Receiver,31,47,13,6.0,17,Wide Receiver,21.0,2,4,14,16,1,up,1980-08-23
15294,Michael Henderson,1980-09-13,Michael Henderson - Wide Receiver,17,31,12,6.0,13,Wide Receiver,21.0,3,1,4,14,1,up,1980-08-23
15295,Michael Henderson,1980-09-20,Michael Henderson - Wide Receiver,13,17,7,6.0,12,Wide Receiver,21.0,4,5,1,4,1,up,1980-08-23
15296,Michael Henderson,1980-09-27,Michael Henderson - Wide Receiver,12,13,6,6.0,7,Wide Receiver,21.0,5,1,5,1,1,up,1980-08-23
15297,Michael Henderson,1980-10-04,Michael Henderson - Wide Receiver,7,12,6,6.0,6,Wide Receiver,21.0,6,0,1,5,0,stay,1980-08-23
15298,Michael Henderson,1980-10-11,Michael Henderson - Wide Receiver,6,7,7,6.0,6,Wide Receiver,21.0,7,-1,0,1,1,down,1980-08-23
15299,Michael Henderson,1980-10-18,Michael Henderson - Wide Receiver,6,6,10,6.0,7,Wide Receiver,21.0,8,-3,-1,0,1,down,1980-08-23
15300,Michael Henderson,1980-10-25,Michael Henderson - Wide Receiver,7,6,12,6.0,10,Wide Receiver,21.0,9,-2,-3,-1,1,down,1980-08-23
15301,Michael Henderson,1980-11-01,Michael Henderson - Wide Receiver,10,7,14,6.0,12,Wide Receiver,21.0,10,-2,-2,-3,1,down,1980-08-23
15302,Michael Henderson,1980-11-08,Michael Henderson - Wide Receiver,12,10,18,6.0,14,Wide Receiver,21.0,11,-4,-2,-2,1,down,1980-08-23
15303,Michael Henderson,1980-11-15,Michael Henderson - Wide Receiver,14,12,23,6.0,18,Wide Receiver,21.0,12,-5,-4,-2,1,down,1980-08-23
15304,Michael Henderson,1980-11-22,Michael Henderson - Wide Receiver,18,14,24,6.0,23,Wide Receiver,21.0,13,-1,-5,-4,1,down,1980-08-23
15305,Michael Henderson,1980-11-29,Michael Henderson - Wide Receiver,23,18,28,6.0,24,Wide Receiver,21.0,14,-4,-1,-5,1,down,1980-08-23
15306,Michael Henderson,1980-12-06,Michael Henderson - Wide Receiver,24,23,28,6.0,28,Wide Receiver,21.0,15,0,-4,-1,0,stay,1980-08-23
15307,Michael Henderson,1980-12-13,Michael Henderson - Wide Receiver,28,24,32,6.0,28,Wide Receiver,21.0,16,-4,0,-4,1,down,1980-08-23
15308,Michael Henderson,1980-12-20,Michael Henderson - Wide Receiver,28,28,43,6.0,32,Wide Receiver,21.0,17,-11,-4,0,1,down,1980-08-23
15309,Michael Henderson,1980-12-27,Michael Henderson - Wide Receiver,32,28,43,6.0,43,Wide Receiver,21.0,18,0,-11,-4,0,stay,1980-08-23
15310,Michael Henderson,1981-01-03,Michael Henderson - Wide Receiver,43,32,48,6.0,43,Wide Receiver,21.0,19,-5,0,-11,1,down,1980-08-23
15311,Michael Henderson,1981-01-10,Michael Henderson - Wide Receiver,43,43,59,6.0,48,Wide Receiver,21.0,20,-11,-5,0,1,down,1980-08-23
15312,Michael Henderson,1981-01-31,Michael Henderson - Wide Receiver,48,43,51,6.0,59,Wide Receiver,21.0,21,8,-11,-5,1,up,1980-08-23
15313,The Dells,1980-08-23,The Dells - I Touched A Dream,51,51,43,23.0,50,I Touched A Dream,14.0,0,7,1,0,1,up,1980-08-23
15314,The Dells,1980-08-30,The Dells - I Touched A Dream,50,51,34,23.0,43,I Touched A Dream,14.0,1,9,7,1,1,up,1980-08-23
15315,The Dells,1980-09-06,The Dells - I Touched A Dream,43,50,34,23.0,34,I Touched A Dream,14.0,2,0,9,7,0,stay,1980-08-23
15316,The Dells,1980-09-13,The Dells - I Touched A Dream,34,43,32,23.0,34,I Touched A Dream,14.0,3,2,0,9,1,up,1980-08-23
15317,The Dells,1980-09-20,The Dells - I Touched A Dream,34,34,32,23.0,32,I Touched A Dream,14.0,4,0,2,0,0,stay,1980-08-23
15318,The Dells,1980-09-27,The Dells - I Touched A Dream,32,34,30,23.0,32,I Touched A Dream,14.0,5,2,0,2,1,up,1980-08-23
15319,The Dells,1980-10-04,The Dells - I Touched A Dream,32,32,28,23.0,30,I Touched A Dream,14.0,6,2,2,0,1,up,1980-08-23
15320,The Dells,1980-10-11,The Dells - I Touched A Dream,30,32,23,23.0,28,I Touched A Dream,14.0,7,5,2,2,1,up,1980-08-23
15321,The Dells,1980-10-18,The Dells - I Touched A Dream,28,30,23,23.0,23,I Touched A Dream,14.0,8,0,5,2,0,stay,1980-08-23
15322,The Dells,1980-10-25,The Dells - I Touched A Dream,23,28,23,23.0,23,I Touched A Dream,14.0,9,0,0,5,0,stay,1980-08-23
15323,The Dells,1980-11-01,The Dells - I Touched A Dream,23,23,34,23.0,23,I Touched A Dream,14.0,10,-11,0,0,1,down,1980-08-23
15324,The Dells,1980-11-08,The Dells - I Touched A Dream,23,23,48,23.0,34,I Touched A Dream,14.0,11,-14,-11,0,1,down,1980-08-23
15325,The Dells,1980-11-15,The Dells - I Touched A Dream,34,23,48,23.0,48,I Touched A Dream,14.0,12,0,-14,-11,0,stay,1980-08-23
15326,The Dells,1980-11-22,The Dells - I Touched A Dream,48,34,48,23.0,48,I Touched A Dream,14.0,13,0,0,-14,0,stay,1980-08-23
15327,The Dells,1980-11-29,The Dells - I Touched A Dream,48,48,51,23.0,48,I Touched A Dream,14.0,14,-3,0,0,1,down,1980-08-23
15328,The O'Jays,1980-08-30,The O'Jays - The Year 2000,51,51,7,6.0,15,The Year 2000,14.0,0,8,36,0,1,up,1980-08-30
15329,The O'Jays,1980-09-06,The O'Jays - The Year 2000,15,51,6,6.0,7,The Year 2000,14.0,1,1,8,36,1,up,1980-08-30
15330,The O'Jays,1980-09-13,The O'Jays - The Year 2000,7,15,6,6.0,6,The Year 2000,14.0,2,0,1,8,0,stay,1980-08-30
15331,The O'Jays,1980-09-20,The O'Jays - The Year 2000,6,7,6,6.0,6,The Year 2000,14.0,3,0,0,1,0,stay,1980-08-30
15332,The O'Jays,1980-09-27,The O'Jays - The Year 2000,6,6,7,6.0,6,The Year 2000,14.0,4,-1,0,0,1,down,1980-08-30
15333,The O'Jays,1980-10-04,The O'Jays - The Year 2000,6,6,12,6.0,7,The Year 2000,14.0,5,-5,-1,0,1,down,1980-08-30
15334,The O'Jays,1980-10-11,The O'Jays - The Year 2000,7,6,12,6.0,12,The Year 2000,14.0,6,0,-5,-1,0,stay,1980-08-30
15335,The O'Jays,1980-10-18,The O'Jays - The Year 2000,12,7,16,6.0,12,The Year 2000,14.0,7,-4,0,-5,1,down,1980-08-30
15336,The O'Jays,1980-10-25,The O'Jays - The Year 2000,12,12,20,6.0,16,The Year 2000,14.0,8,-4,-4,0,1,down,1980-08-30
15337,The O'Jays,1980-11-01,The O'Jays - The Year 2000,16,12,25,6.0,20,The Year 2000,14.0,9,-5,-4,-4,1,down,1980-08-30
15338,The O'Jays,1980-11-08,The O'Jays - The Year 2000,20,16,37,6.0,25,The Year 2000,14.0,10,-12,-5,-4,1,down,1980-08-30
15339,The O'Jays,1980-11-15,The O'Jays - The Year 2000,25,20,39,6.0,37,The Year 2000,14.0,11,-2,-12,-5,1,down,1980-08-30
15340,The O'Jays,1980-11-22,The O'Jays - The Year 2000,37,25,43,6.0,39,The Year 2000,14.0,12,-4,-2,-12,1,down,1980-08-30
15341,The O'Jays,1980-11-29,The O'Jays - The Year 2000,39,37,49,6.0,43,The Year 2000,14.0,13,-6,-4,-2,1,down,1980-08-30
15342,The O'Jays,1980-12-06,The O'Jays - The Year 2000,43,39,51,6.0,49,The Year 2000,14.0,14,-2,-6,-4,1,down,1980-08-30
15343,Minnie Riperton,1980-09-06,Minnie Riperton - Love Lives Forever,51,51,19,11.0,23,Love Lives Forever,17.0,0,4,28,0,1,up,1980-09-06
15344,Minnie Riperton,1980-09-13,Minnie Riperton - Love Lives Forever,23,51,16,11.0,19,Love Lives Forever,17.0,1,3,4,28,1,up,1980-09-06
15345,Minnie Riperton,1980-09-20,Minnie Riperton - Love Lives Forever,19,23,13,11.0,16,Love Lives Forever,17.0,2,3,3,4,1,up,1980-09-06
15346,Minnie Riperton,1980-09-27,Minnie Riperton - Love Lives Forever,16,19,11,11.0,13,Love Lives Forever,17.0,3,2,3,3,1,up,1980-09-06
15347,Minnie Riperton,1980-10-04,Minnie Riperton - Love Lives Forever,13,16,11,11.0,11,Love Lives Forever,17.0,4,0,2,3,0,stay,1980-09-06
15348,Minnie Riperton,1980-10-11,Minnie Riperton - Love Lives Forever,11,13,11,11.0,11,Love Lives Forever,17.0,5,0,0,2,0,stay,1980-09-06
15349,Minnie Riperton,1980-10-18,Minnie Riperton - Love Lives Forever,11,11,15,11.0,11,Love Lives Forever,17.0,6,-4,0,0,1,down,1980-09-06
15350,Minnie Riperton,1980-10-25,Minnie Riperton - Love Lives Forever,11,11,17,11.0,15,Love Lives Forever,17.0,7,-2,-4,0,1,down,1980-09-06
15351,Minnie Riperton,1980-11-01,Minnie Riperton - Love Lives Forever,15,11,17,11.0,17,Love Lives Forever,17.0,8,0,-2,-4,0,stay,1980-09-06
15352,Minnie Riperton,1980-11-08,Minnie Riperton - Love Lives Forever,17,15,27,11.0,17,Love Lives Forever,17.0,9,-10,0,-2,1,down,1980-09-06
15353,Minnie Riperton,1980-11-15,Minnie Riperton - Love Lives Forever,17,17,34,11.0,27,Love Lives Forever,17.0,10,-7,-10,0,1,down,1980-09-06
15354,Minnie Riperton,1980-11-22,Minnie Riperton - Love Lives Forever,27,17,36,11.0,34,Love Lives Forever,17.0,11,-2,-7,-10,1,down,1980-09-06
15355,Minnie Riperton,1980-11-29,Minnie Riperton - Love Lives Forever,34,27,38,11.0,36,Love Lives Forever,17.0,12,-2,-2,-7,1,down,1980-09-06
15356,Minnie Riperton,1980-12-06,Minnie Riperton - Love Lives Forever,36,34,42,11.0,38,Love Lives Forever,17.0,13,-4,-2,-2,1,down,1980-09-06
15357,Minnie Riperton,1980-12-13,Minnie Riperton - Love Lives Forever,38,36,43,11.0,42,Love Lives Forever,17.0,14,-1,-4,-2,1,down,1980-09-06
15358,Minnie Riperton,1980-12-20,Minnie Riperton - Love Lives Forever,42,38,48,11.0,43,Love Lives Forever,17.0,15,-5,-1,-4,1,down,1980-09-06
15359,Minnie Riperton,1980-12-27,Minnie Riperton - Love Lives Forever,43,42,48,11.0,48,Love Lives Forever,17.0,16,0,-5,-1,0,stay,1980-09-06
15360,Minnie Riperton,1981-01-03,Minnie Riperton - Love Lives Forever,48,43,51,11.0,48,Love Lives Forever,17.0,17,-3,0,-5,1,down,1980-09-06
15361,The Pointer Sisters,1980-09-06,The Pointer Sisters - Special Things,51,51,36,19.0,42,Special Things,16.0,0,6,9,0,1,up,1980-09-06
15362,The Pointer Sisters,1980-09-13,The Pointer Sisters - Special Things,42,51,31,19.0,36,Special Things,16.0,1,5,6,9,1,up,1980-09-06
15363,The Pointer Sisters,1980-09-20,The Pointer Sisters - Special Things,36,42,29,19.0,31,Special Things,16.0,2,2,5,6,1,up,1980-09-06
15364,The Pointer Sisters,1980-09-27,The Pointer Sisters - Special Things,31,36,25,19.0,29,Special Things,16.0,3,4,2,5,1,up,1980-09-06
15365,The Pointer Sisters,1980-10-04,The Pointer Sisters - Special Things,29,31,24,19.0,25,Special Things,16.0,4,1,4,2,1,up,1980-09-06
15366,The Pointer Sisters,1980-10-11,The Pointer Sisters - Special Things,25,29,24,19.0,24,Special Things,16.0,5,0,1,4,0,stay,1980-09-06
15367,The Pointer Sisters,1980-10-18,The Pointer Sisters - Special Things,24,25,24,19.0,24,Special Things,16.0,6,0,0,1,0,stay,1980-09-06
15368,The Pointer Sisters,1980-10-25,The Pointer Sisters - Special Things,24,24,21,19.0,24,Special Things,16.0,7,3,0,0,1,up,1980-09-06
15369,The Pointer Sisters,1980-11-01,The Pointer Sisters - Special Things,24,24,19,19.0,21,Special Things,16.0,8,2,3,0,1,up,1980-09-06
15370,The Pointer Sisters,1980-11-08,The Pointer Sisters - Special Things,21,24,22,19.0,19,Special Things,16.0,9,-3,2,3,1,down,1980-09-06
15371,The Pointer Sisters,1980-11-15,The Pointer Sisters - Special Things,19,21,27,19.0,22,Special Things,16.0,10,-5,-3,2,1,down,1980-09-06
15372,The Pointer Sisters,1980-11-22,The Pointer Sisters - Special Things,22,19,32,19.0,27,Special Things,16.0,11,-5,-5,-3,1,down,1980-09-06
15373,The Pointer Sisters,1980-11-29,The Pointer Sisters - Special Things,27,22,33,19.0,32,Special Things,16.0,12,-1,-5,-5,1,down,1980-09-06
15374,The Pointer Sisters,1980-12-06,The Pointer Sisters - Special Things,32,27,38,19.0,33,Special Things,16.0,13,-5,-1,-5,1,down,1980-09-06
15375,The Pointer Sisters,1980-12-13,The Pointer Sisters - Special Things,33,32,48,19.0,38,Special Things,16.0,14,-10,-5,-1,1,down,1980-09-06
15376,The Pointer Sisters,1980-12-20,The Pointer Sisters - Special Things,38,33,64,19.0,48,Special Things,16.0,15,-16,-10,-5,1,down,1980-09-06
15377,The Pointer Sisters,1981-01-31,The Pointer Sisters - Special Things,48,38,51,19.0,64,Special Things,16.0,16,13,-16,-10,1,up,1980-09-06
15378,LTD,1980-09-06,LTD - Shine On,51,51,22,6.0,49,Shine On,26.0,0,27,2,0,1,up,1980-09-06
15379,LTD,1980-09-13,LTD - Shine On,49,51,15,6.0,22,Shine On,26.0,1,7,27,2,1,up,1980-09-06
15380,LTD,1980-09-20,LTD - Shine On,22,49,11,6.0,15,Shine On,26.0,2,4,7,27,1,up,1980-09-06
15381,LTD,1980-09-27,LTD - Shine On,15,22,9,6.0,11,Shine On,26.0,3,2,4,7,1,up,1980-09-06
15382,LTD,1980-10-04,LTD - Shine On,11,15,8,6.0,9,Shine On,26.0,4,1,2,4,1,up,1980-09-06
15383,LTD,1980-10-11,LTD - Shine On,9,11,6,6.0,8,Shine On,26.0,5,2,1,2,1,up,1980-09-06
15384,LTD,1980-10-18,LTD - Shine On,8,9,6,6.0,6,Shine On,26.0,6,0,2,1,0,stay,1980-09-06
15385,LTD,1980-10-25,LTD - Shine On,6,8,6,6.0,6,Shine On,26.0,7,0,0,2,0,stay,1980-09-06
15386,LTD,1980-11-01,LTD - Shine On,6,6,6,6.0,6,Shine On,26.0,8,0,0,0,0,stay,1980-09-06
15387,LTD,1980-11-08,LTD - Shine On,6,6,10,6.0,6,Shine On,26.0,9,-4,0,0,1,down,1980-09-06
15388,LTD,1980-11-15,LTD - Shine On,6,6,13,6.0,10,Shine On,26.0,10,-3,-4,0,1,down,1980-09-06
15389,LTD,1980-11-22,LTD - Shine On,10,6,14,6.0,13,Shine On,26.0,11,-1,-3,-4,1,down,1980-09-06
15390,LTD,1980-11-29,LTD - Shine On,13,10,14,6.0,14,Shine On,26.0,12,0,-1,-3,0,stay,1980-09-06
15391,LTD,1980-12-06,LTD - Shine On,14,13,14,6.0,14,Shine On,26.0,13,0,0,-1,0,stay,1980-09-06
15392,LTD,1980-12-13,LTD - Shine On,14,14,17,6.0,14,Shine On,26.0,14,-3,0,0,1,down,1980-09-06
15393,LTD,1980-12-20,LTD - Shine On,14,14,17,6.0,17,Shine On,26.0,15,0,-3,0,0,stay,1980-09-06
15394,LTD,1980-12-27,LTD - Shine On,17,14,17,6.0,17,Shine On,26.0,16,0,0,-3,0,stay,1980-09-06
15395,LTD,1981-01-03,LTD - Shine On,17,17,18,6.0,17,Shine On,26.0,17,-1,0,0,1,down,1980-09-06
15396,LTD,1981-01-10,LTD - Shine On,17,17,23,6.0,18,Shine On,26.0,18,-5,-1,0,1,down,1980-09-06
15397,LTD,1981-01-17,LTD - Shine On,18,17,23,6.0,23,Shine On,26.0,19,0,-5,-1,0,stay,1980-09-06
15398,LTD,1981-01-24,LTD - Shine On,23,18,21,6.0,23,Shine On,26.0,20,2,0,-5,1,up,1980-09-06
15399,LTD,1981-02-07,LTD - Shine On,23,23,27,6.0,21,Shine On,26.0,21,-6,2,0,1,down,1980-09-06
15400,LTD,1981-02-14,LTD - Shine On,21,23,31,6.0,27,Shine On,26.0,22,-4,-6,2,1,down,1980-09-06
15401,LTD,1981-02-21,LTD - Shine On,27,21,31,6.0,31,Shine On,26.0,23,0,-4,-6,0,stay,1980-09-06
15402,LTD,1981-02-28,LTD - Shine On,31,27,36,6.0,31,Shine On,26.0,24,-5,0,-4,1,down,1980-09-06
15403,LTD,1981-03-07,LTD - Shine On,31,31,41,6.0,36,Shine On,26.0,25,-5,-5,0,1,down,1980-09-06
15404,LTD,1981-03-14,LTD - Shine On,36,31,51,6.0,41,Shine On,26.0,26,-10,-5,-5,1,down,1980-09-06
15405,The Rolling Stones,1980-09-06,The Rolling Stones - Emotional Rescue,51,51,40,35.0,50,Emotional Rescue,7.0,0,10,1,0,1,up,1980-09-06
15406,The Rolling Stones,1980-09-13,The Rolling Stones - Emotional Rescue,50,51,38,35.0,40,Emotional Rescue,7.0,1,2,10,1,1,up,1980-09-06
15407,The Rolling Stones,1980-09-20,The Rolling Stones - Emotional Rescue,40,50,36,35.0,38,Emotional Rescue,7.0,2,2,2,10,1,up,1980-09-06
15408,The Rolling Stones,1980-09-27,The Rolling Stones - Emotional Rescue,38,40,36,35.0,36,Emotional Rescue,7.0,3,0,2,2,0,stay,1980-09-06
15409,The Rolling Stones,1980-10-04,The Rolling Stones - Emotional Rescue,36,38,35,35.0,36,Emotional Rescue,7.0,4,1,0,2,1,up,1980-09-06
15410,The Rolling Stones,1980-10-11,The Rolling Stones - Emotional Rescue,36,36,35,35.0,35,Emotional Rescue,7.0,5,0,1,0,0,stay,1980-09-06
15411,The Rolling Stones,1980-10-18,The Rolling Stones - Emotional Rescue,35,36,42,35.0,35,Emotional Rescue,7.0,6,-7,0,1,1,down,1980-09-06
15412,The Rolling Stones,1980-10-25,The Rolling Stones - Emotional Rescue,35,35,51,35.0,42,Emotional Rescue,7.0,7,-9,-7,0,1,down,1980-09-06
15413,Teena Marie,1980-09-13,Teena Marie - Irons In The Fire,51,51,35,9.0,47,Irons In The Fire,26.0,0,12,4,0,1,up,1980-09-13
15414,Teena Marie,1980-09-20,Teena Marie - Irons In The Fire,47,51,25,9.0,35,Irons In The Fire,26.0,1,10,12,4,1,up,1980-09-13
15415,Teena Marie,1980-09-27,Teena Marie - Irons In The Fire,35,47,17,9.0,25,Irons In The Fire,26.0,2,8,10,12,1,up,1980-09-13
15416,Teena Marie,1980-10-04,Teena Marie - Irons In The Fire,25,35,17,9.0,17,Irons In The Fire,26.0,3,0,8,10,0,stay,1980-09-13
15417,Teena Marie,1980-10-11,Teena Marie - Irons In The Fire,17,25,14,9.0,17,Irons In The Fire,26.0,4,3,0,8,1,up,1980-09-13
15418,Teena Marie,1980-10-18,Teena Marie - Irons In The Fire,17,17,12,9.0,14,Irons In The Fire,26.0,5,2,3,0,1,up,1980-09-13
15419,Teena Marie,1980-10-25,Teena Marie - Irons In The Fire,14,17,11,9.0,12,Irons In The Fire,26.0,6,1,2,3,1,up,1980-09-13
15420,Teena Marie,1980-11-01,Teena Marie - Irons In The Fire,12,14,9,9.0,11,Irons In The Fire,26.0,7,2,1,2,1,up,1980-09-13
15421,Teena Marie,1980-11-08,Teena Marie - Irons In The Fire,11,12,9,9.0,9,Irons In The Fire,26.0,8,0,2,1,0,stay,1980-09-13
15422,Teena Marie,1980-11-15,Teena Marie - Irons In The Fire,9,11,14,9.0,9,Irons In The Fire,26.0,9,-5,0,2,1,down,1980-09-13
15423,Teena Marie,1980-11-22,Teena Marie - Irons In The Fire,9,9,22,9.0,14,Irons In The Fire,26.0,10,-8,-5,0,1,down,1980-09-13
15424,Teena Marie,1980-11-29,Teena Marie - Irons In The Fire,14,9,27,9.0,22,Irons In The Fire,26.0,11,-5,-8,-5,1,down,1980-09-13
15425,Teena Marie,1980-12-06,Teena Marie - Irons In The Fire,22,14,27,9.0,27,Irons In The Fire,26.0,12,0,-5,-8,0,stay,1980-09-13
15426,Teena Marie,1980-12-13,Teena Marie - Irons In The Fire,27,22,27,9.0,27,Irons In The Fire,26.0,13,0,0,-5,0,stay,1980-09-13
15427,Teena Marie,1980-12-20,Teena Marie - Irons In The Fire,27,27,26,9.0,27,Irons In The Fire,26.0,14,1,0,0,1,up,1980-09-13
15428,Teena Marie,1980-12-27,Teena Marie - Irons In The Fire,27,27,26,9.0,26,Irons In The Fire,26.0,15,0,1,0,0,stay,1980-09-13
15429,Teena Marie,1981-01-03,Teena Marie - Irons In The Fire,26,27,32,9.0,26,Irons In The Fire,26.0,16,-6,0,1,1,down,1980-09-13
15430,Teena Marie,1981-01-10,Teena Marie - Irons In The Fire,26,26,32,9.0,32,Irons In The Fire,26.0,17,0,-6,0,0,stay,1980-09-13
15431,Teena Marie,1981-01-17,Teena Marie - Irons In The Fire,32,26,34,9.0,32,Irons In The Fire,26.0,18,-2,0,-6,1,down,1980-09-13
15432,Teena Marie,1981-01-24,Teena Marie - Irons In The Fire,32,32,35,9.0,34,Irons In The Fire,26.0,19,-1,-2,0,1,down,1980-09-13
15433,Teena Marie,1981-02-07,Teena Marie - Irons In The Fire,34,32,37,9.0,35,Irons In The Fire,26.0,20,-2,-1,-2,1,down,1980-09-13
15434,Teena Marie,1981-02-14,Teena Marie - Irons In The Fire,35,34,39,9.0,37,Irons In The Fire,26.0,21,-2,-2,-1,1,down,1980-09-13
15435,Teena Marie,1981-02-21,Teena Marie - Irons In The Fire,37,35,38,9.0,39,Irons In The Fire,26.0,22,1,-2,-2,1,up,1980-09-13
15436,Teena Marie,1981-02-28,Teena Marie - Irons In The Fire,39,37,38,9.0,38,Irons In The Fire,26.0,23,0,1,-2,0,stay,1980-09-13
15437,Teena Marie,1981-03-07,Teena Marie - Irons In The Fire,38,39,39,9.0,38,Irons In The Fire,26.0,24,-1,0,1,1,down,1980-09-13
15438,Teena Marie,1981-03-14,Teena Marie - Irons In The Fire,38,38,44,9.0,39,Irons In The Fire,26.0,25,-5,-1,0,1,down,1980-09-13
15439,Teena Marie,1981-03-21,Teena Marie - Irons In The Fire,39,38,51,9.0,44,Irons In The Fire,26.0,26,-7,-5,-1,1,down,1980-09-13
15440,Zapp,1980-09-20,Zapp - Zapp,51,51,17,1.0,41,Zapp,25.0,0,24,10,0,1,up,1980-09-20
15441,Zapp,1980-09-27,Zapp - Zapp,41,51,8,1.0,17,Zapp,25.0,1,9,24,10,1,up,1980-09-20
15442,Zapp,1980-10-04,Zapp - Zapp,17,41,7,1.0,8,Zapp,25.0,2,1,9,24,1,up,1980-09-20
15443,Zapp,1980-10-11,Zapp - Zapp,8,17,4,1.0,7,Zapp,25.0,3,3,1,9,1,up,1980-09-20
15444,Zapp,1980-10-18,Zapp - Zapp,7,8,1,1.0,4,Zapp,25.0,4,3,3,1,1,up,1980-09-20
15445,Zapp,1980-10-25,Zapp - Zapp,4,7,1,1.0,1,Zapp,25.0,5,0,3,3,0,stay,1980-09-20
15446,Zapp,1980-11-01,Zapp - Zapp,1,4,2,1.0,1,Zapp,25.0,6,-1,0,3,1,down,1980-09-20
15447,Zapp,1980-11-08,Zapp - Zapp,1,1,2,1.0,2,Zapp,25.0,7,0,-1,0,0,stay,1980-09-20
15448,Zapp,1980-11-15,Zapp - Zapp,2,1,4,1.0,2,Zapp,25.0,8,-2,0,-1,1,down,1980-09-20
15449,Zapp,1980-11-22,Zapp - Zapp,2,2,6,1.0,4,Zapp,25.0,9,-2,-2,0,1,down,1980-09-20
15450,Zapp,1980-11-29,Zapp - Zapp,4,2,6,1.0,6,Zapp,25.0,10,0,-2,-2,0,stay,1980-09-20
15451,Zapp,1980-12-06,Zapp - Zapp,6,4,8,1.0,6,Zapp,25.0,11,-2,0,-2,1,down,1980-09-20
15452,Zapp,1980-12-13,Zapp - Zapp,6,6,9,1.0,8,Zapp,25.0,12,-1,-2,0,1,down,1980-09-20
15453,Zapp,1980-12-20,Zapp - Zapp,8,6,11,1.0,9,Zapp,25.0,13,-2,-1,-2,1,down,1980-09-20
15454,Zapp,1980-12-27,Zapp - Zapp,9,8,11,1.0,11,Zapp,25.0,14,0,-2,-1,0,stay,1980-09-20
15455,Zapp,1981-01-03,Zapp - Zapp,11,9,17,1.0,11,Zapp,25.0,15,-6,0,-2,1,down,1980-09-20
15456,Zapp,1981-01-10,Zapp - Zapp,11,11,17,1.0,17,Zapp,25.0,16,0,-6,0,0,stay,1980-09-20
15457,Zapp,1981-01-17,Zapp - Zapp,17,11,22,1.0,17,Zapp,25.0,17,-5,0,-6,1,down,1980-09-20
15458,Zapp,1981-01-24,Zapp - Zapp,17,17,25,1.0,22,Zapp,25.0,18,-3,-5,0,1,down,1980-09-20
15459,Zapp,1981-02-07,Zapp - Zapp,22,17,25,1.0,25,Zapp,25.0,19,0,-3,-5,0,stay,1980-09-20
15460,Zapp,1981-02-14,Zapp - Zapp,25,22,24,1.0,25,Zapp,25.0,20,1,0,-3,1,up,1980-09-20
15461,Zapp,1981-02-21,Zapp - Zapp,25,25,24,1.0,24,Zapp,25.0,21,0,1,0,0,stay,1980-09-20
15462,Zapp,1981-02-28,Zapp - Zapp,24,25,29,1.0,24,Zapp,25.0,22,-5,0,1,1,down,1980-09-20
15463,Zapp,1981-03-07,Zapp - Zapp,24,24,29,1.0,29,Zapp,25.0,23,0,-5,0,0,stay,1980-09-20
15464,Zapp,1981-03-14,Zapp - Zapp,29,24,45,1.0,29,Zapp,25.0,24,-16,0,-5,1,down,1980-09-20
15465,Zapp,1981-03-21,Zapp - Zapp,29,29,51,1.0,45,Zapp,25.0,25,-6,-16,0,1,down,1980-09-20
15466,Queen,1980-09-20,Queen - The Game,51,51,16,8.0,47,The Game,12.0,0,31,4,0,1,up,1980-09-20
15467,Queen,1980-09-27,Queen - The Game,47,51,12,8.0,16,The Game,12.0,1,4,31,4,1,up,1980-09-20
15468,Queen,1980-10-04,Queen - The Game,16,47,9,8.0,12,The Game,12.0,2,3,4,31,1,up,1980-09-20
15469,Queen,1980-10-11,Queen - The Game,12,16,8,8.0,9,The Game,12.0,3,1,3,4,1,up,1980-09-20
15470,Queen,1980-10-18,Queen - The Game,9,12,8,8.0,8,The Game,12.0,4,0,1,3,0,stay,1980-09-20
15471,Queen,1980-10-25,Queen - The Game,8,9,8,8.0,8,The Game,12.0,5,0,0,1,0,stay,1980-09-20
15472,Queen,1980-11-01,Queen - The Game,8,8,10,8.0,8,The Game,12.0,6,-2,0,0,1,down,1980-09-20
15473,Queen,1980-11-08,Queen - The Game,8,8,16,8.0,10,The Game,12.0,7,-6,-2,0,1,down,1980-09-20
15474,Queen,1980-11-15,Queen - The Game,10,8,31,8.0,16,The Game,12.0,8,-15,-6,-2,1,down,1980-09-20
15475,Queen,1980-11-22,Queen - The Game,16,10,37,8.0,31,The Game,12.0,9,-6,-15,-6,1,down,1980-09-20
15476,Queen,1980-11-29,Queen - The Game,31,16,41,8.0,37,The Game,12.0,10,-4,-6,-15,1,down,1980-09-20
15477,Queen,1980-12-06,Queen - The Game,37,31,41,8.0,41,The Game,12.0,11,0,-4,-6,0,stay,1980-09-20
15478,Queen,1980-12-13,Queen - The Game,41,37,51,8.0,41,The Game,12.0,12,-10,0,-4,1,down,1980-09-20
15479,Brass Construction,1980-09-27,Brass Construction - Brass Construction Vi,51,51,37,32.0,43,Brass Construction Vi,5.0,0,6,8,0,1,up,1980-09-27
15480,Brass Construction,1980-10-04,Brass Construction - Brass Construction Vi,43,51,32,32.0,37,Brass Construction Vi,5.0,1,5,6,8,1,up,1980-09-27
15481,Brass Construction,1980-10-11,Brass Construction - Brass Construction Vi,37,43,32,32.0,32,Brass Construction Vi,5.0,2,0,5,6,0,stay,1980-09-27
15482,Brass Construction,1980-10-18,Brass Construction - Brass Construction Vi,32,37,36,32.0,32,Brass Construction Vi,5.0,3,-4,0,5,1,down,1980-09-27
15483,Brass Construction,1980-10-25,Brass Construction - Brass Construction Vi,32,32,43,32.0,36,Brass Construction Vi,5.0,4,-7,-4,0,1,down,1980-09-27
15484,Brass Construction,1980-11-01,Brass Construction - Brass Construction Vi,36,32,51,32.0,43,Brass Construction Vi,5.0,5,-8,-7,-4,1,down,1980-09-27
15485,"Grover Washington, Jr.",1980-09-27,"Grover Washington, Jr. - Baddest",51,51,40,40.0,47,Baddest,3.0,0,7,4,0,1,up,1980-09-27
15486,"Grover Washington, Jr.",1980-10-04,"Grover Washington, Jr. - Baddest",47,51,40,40.0,40,Baddest,3.0,1,0,7,4,0,stay,1980-09-27
15487,"Grover Washington, Jr.",1980-10-11,"Grover Washington, Jr. - Baddest",40,47,42,40.0,40,Baddest,3.0,2,-2,0,7,1,down,1980-09-27
15488,"Grover Washington, Jr.",1980-10-18,"Grover Washington, Jr. - Baddest",40,40,51,40.0,42,Baddest,3.0,3,-9,-2,0,1,down,1980-09-27
15489,Sylvester,1980-10-04,Sylvester - Sell My Soul,51,51,44,44.0,50,Sell My Soul,2.0,0,6,1,0,1,up,1980-10-04
15490,Sylvester,1980-10-11,Sylvester - Sell My Soul,50,51,44,44.0,44,Sell My Soul,2.0,1,0,6,1,0,stay,1980-10-04
15491,Sylvester,1980-10-18,Sylvester - Sell My Soul,44,50,51,44.0,44,Sell My Soul,2.0,2,-7,0,6,1,down,1980-10-04
15492,McFadden And Whitehead,1980-10-11,McFadden And Whitehead - I Heard It In A Love Song,51,51,31,29.0,42,I Heard It In A Love Song,4.0,0,11,9,0,1,up,1980-10-11
15493,McFadden And Whitehead,1980-10-18,McFadden And Whitehead - I Heard It In A Love Song,42,51,29,29.0,31,I Heard It In A Love Song,4.0,1,2,11,9,1,up,1980-10-11
15494,McFadden And Whitehead,1980-10-25,McFadden And Whitehead - I Heard It In A Love Song,31,42,29,29.0,29,I Heard It In A Love Song,4.0,2,0,2,11,0,stay,1980-10-11
15495,McFadden And Whitehead,1980-11-01,McFadden And Whitehead - I Heard It In A Love Song,29,31,35,29.0,29,I Heard It In A Love Song,4.0,3,-6,0,2,1,down,1980-10-11
15496,McFadden And Whitehead,1980-11-08,McFadden And Whitehead - I Heard It In A Love Song,29,29,51,29.0,35,I Heard It In A Love Song,4.0,4,-16,-6,0,1,down,1980-10-11
15497,Mtume,1980-10-11,Mtume - In Search Of The Rainbow Seekers,51,51,37,30.0,46,In Search Of The Rainbow Seekers,4.0,0,9,5,0,1,up,1980-10-11
15498,Mtume,1980-10-18,Mtume - In Search Of The Rainbow Seekers,46,51,30,30.0,37,In Search Of The Rainbow Seekers,4.0,1,7,9,5,1,up,1980-10-11
15499,Mtume,1980-10-25,Mtume - In Search Of The Rainbow Seekers,37,46,30,30.0,30,In Search Of The Rainbow Seekers,4.0,2,0,7,9,0,stay,1980-10-11
15500,Mtume,1980-11-01,Mtume - In Search Of The Rainbow Seekers,30,37,42,30.0,30,In Search Of The Rainbow Seekers,4.0,3,-12,0,7,1,down,1980-10-11
15501,Mtume,1980-11-08,Mtume - In Search Of The Rainbow Seekers,30,30,51,30.0,42,In Search Of The Rainbow Seekers,4.0,4,-9,-12,0,1,down,1980-10-11
15502,Tyrone Davis,1980-10-11,Tyrone Davis - I Just Can't Keep On Going,51,51,40,39.0,47,I Just Can't Keep On Going,4.0,0,7,4,0,1,up,1980-10-11
15503,Tyrone Davis,1980-10-18,Tyrone Davis - I Just Can't Keep On Going,47,51,39,39.0,40,I Just Can't Keep On Going,4.0,1,1,7,4,1,up,1980-10-11
15504,Tyrone Davis,1980-10-25,Tyrone Davis - I Just Can't Keep On Going,40,47,39,39.0,39,I Just Can't Keep On Going,4.0,2,0,1,7,0,stay,1980-10-11
15505,Tyrone Davis,1980-11-01,Tyrone Davis - I Just Can't Keep On Going,39,40,45,39.0,39,I Just Can't Keep On Going,4.0,3,-6,0,1,1,down,1980-10-11
15506,Tyrone Davis,1980-11-08,Tyrone Davis - I Just Can't Keep On Going,39,39,51,39.0,45,I Just Can't Keep On Going,4.0,4,-6,-6,0,1,down,1980-10-11
15507,Lipps Inc.,1980-10-11,Lipps Inc. - Pucker Up,51,51,38,37.0,50,Pucker Up,6.0,0,12,1,0,1,up,1980-10-11
15508,Lipps Inc.,1980-10-18,Lipps Inc. - Pucker Up,50,51,37,37.0,38,Pucker Up,6.0,1,1,12,1,1,up,1980-10-11
15509,Lipps Inc.,1980-10-25,Lipps Inc. - Pucker Up,38,50,37,37.0,37,Pucker Up,6.0,2,0,1,12,0,stay,1980-10-11
15510,Lipps Inc.,1980-11-01,Lipps Inc. - Pucker Up,37,38,43,37.0,37,Pucker Up,6.0,3,-6,0,1,1,down,1980-10-11
15511,Lipps Inc.,1980-11-08,Lipps Inc. - Pucker Up,37,37,43,37.0,43,Pucker Up,6.0,4,0,-6,0,0,stay,1980-10-11
15512,Lipps Inc.,1980-11-15,Lipps Inc. - Pucker Up,43,37,46,37.0,43,Pucker Up,6.0,5,-3,0,-6,1,down,1980-10-11
15513,Lipps Inc.,1980-11-22,Lipps Inc. - Pucker Up,43,43,51,37.0,46,Pucker Up,6.0,6,-5,-3,0,1,down,1980-10-11
15514,The Jacksons,1980-10-18,The Jacksons - Triumph,51,51,5,1.0,18,Triumph,28.0,0,13,33,0,1,up,1980-10-18
15515,The Jacksons,1980-10-25,The Jacksons - Triumph,18,51,2,1.0,5,Triumph,28.0,1,3,13,33,1,up,1980-10-18
15516,The Jacksons,1980-11-01,The Jacksons - Triumph,5,18,1,1.0,2,Triumph,28.0,2,1,3,13,1,up,1980-10-18
15517,The Jacksons,1980-11-08,The Jacksons - Triumph,2,5,1,1.0,1,Triumph,28.0,3,0,1,3,0,stay,1980-10-18
15518,The Jacksons,1980-11-15,The Jacksons - Triumph,1,2,2,1.0,1,Triumph,28.0,4,-1,0,1,1,down,1980-10-18
15519,The Jacksons,1980-11-22,The Jacksons - Triumph,1,1,4,1.0,2,Triumph,28.0,5,-2,-1,0,1,down,1980-10-18
15520,The Jacksons,1980-11-29,The Jacksons - Triumph,2,1,4,1.0,4,Triumph,28.0,6,0,-2,-1,0,stay,1980-10-18
15521,The Jacksons,1980-12-06,The Jacksons - Triumph,4,2,5,1.0,4,Triumph,28.0,7,-1,0,-2,1,down,1980-10-18
15522,The Jacksons,1980-12-13,The Jacksons - Triumph,4,4,5,1.0,5,Triumph,28.0,8,0,-1,0,0,stay,1980-10-18
15523,The Jacksons,1980-12-20,The Jacksons - Triumph,5,4,5,1.0,5,Triumph,28.0,9,0,0,-1,0,stay,1980-10-18
15524,The Jacksons,1980-12-27,The Jacksons - Triumph,5,5,5,1.0,5,Triumph,28.0,10,0,0,0,0,stay,1980-10-18
15525,The Jacksons,1981-01-03,The Jacksons - Triumph,5,5,5,1.0,5,Triumph,28.0,11,0,0,0,0,stay,1980-10-18
15526,The Jacksons,1981-01-10,The Jacksons - Triumph,5,5,4,1.0,5,Triumph,28.0,12,1,0,0,1,up,1980-10-18
15527,The Jacksons,1981-01-17,The Jacksons - Triumph,5,5,4,1.0,4,Triumph,28.0,13,0,1,0,0,stay,1980-10-18
15528,The Jacksons,1981-01-24,The Jacksons - Triumph,4,5,5,1.0,4,Triumph,28.0,14,-1,0,1,1,down,1980-10-18
15529,The Jacksons,1981-01-31,The Jacksons - Triumph,4,4,5,1.0,5,Triumph,28.0,15,0,-1,0,0,stay,1980-10-18
15530,The Jacksons,1981-02-07,The Jacksons - Triumph,5,4,10,1.0,5,Triumph,28.0,16,-5,0,-1,1,down,1980-10-18
15531,The Jacksons,1981-02-14,The Jacksons - Triumph,5,5,12,1.0,10,Triumph,28.0,17,-2,-5,0,1,down,1980-10-18
15532,The Jacksons,1981-02-21,The Jacksons - Triumph,10,5,14,1.0,12,Triumph,28.0,18,-2,-2,-5,1,down,1980-10-18
15533,The Jacksons,1981-02-28,The Jacksons - Triumph,12,10,17,1.0,14,Triumph,28.0,19,-3,-2,-2,1,down,1980-10-18
15534,The Jacksons,1981-03-07,The Jacksons - Triumph,14,12,17,1.0,17,Triumph,28.0,20,0,-3,-2,0,stay,1980-10-18
15535,The Jacksons,1981-03-14,The Jacksons - Triumph,17,14,18,1.0,17,Triumph,28.0,21,-1,0,-3,1,down,1980-10-18
15536,The Jacksons,1981-03-21,The Jacksons - Triumph,17,17,24,1.0,18,Triumph,28.0,22,-6,-1,0,1,down,1980-10-18
15537,The Jacksons,1981-03-28,The Jacksons - Triumph,18,17,32,1.0,24,Triumph,28.0,23,-8,-6,-1,1,down,1980-10-18
15538,The Jacksons,1981-04-04,The Jacksons - Triumph,24,18,42,1.0,32,Triumph,28.0,24,-10,-8,-6,1,down,1980-10-18
15539,The Jacksons,1981-04-11,The Jacksons - Triumph,32,24,42,1.0,42,Triumph,28.0,25,0,-10,-8,0,stay,1980-10-18
15540,The Jacksons,1981-04-18,The Jacksons - Triumph,42,32,48,1.0,42,Triumph,28.0,26,-6,0,-10,1,down,1980-10-18
15541,The Jacksons,1981-04-25,The Jacksons - Triumph,42,42,48,1.0,48,Triumph,28.0,27,0,-6,0,0,stay,1980-10-18
15542,The Jacksons,1981-05-02,The Jacksons - Triumph,48,42,51,1.0,48,Triumph,28.0,28,-3,0,-6,1,down,1980-10-18
15543,"Ray, Goodman & Brown",1980-10-18,"Ray, Goodman & Brown - Ray, Goodman And Brown II",51,51,33,16.0,41,"Ray, Goodman And Brown II",17.0,0,8,10,0,1,up,1980-10-18
15544,"Ray, Goodman & Brown",1980-10-25,"Ray, Goodman & Brown - Ray, Goodman And Brown II",41,51,27,16.0,33,"Ray, Goodman And Brown II",17.0,1,6,8,10,1,up,1980-10-18
15545,"Ray, Goodman & Brown",1980-11-01,"Ray, Goodman & Brown - Ray, Goodman And Brown II",33,41,22,16.0,27,"Ray, Goodman And Brown II",17.0,2,5,6,8,1,up,1980-10-18
15546,"Ray, Goodman & Brown",1980-11-08,"Ray, Goodman & Brown - Ray, Goodman And Brown II",27,33,19,16.0,22,"Ray, Goodman And Brown II",17.0,3,3,5,6,1,up,1980-10-18
15547,"Ray, Goodman & Brown",1980-11-15,"Ray, Goodman & Brown - Ray, Goodman And Brown II",22,27,16,16.0,19,"Ray, Goodman And Brown II",17.0,4,3,3,5,1,up,1980-10-18
15548,"Ray, Goodman & Brown",1980-11-22,"Ray, Goodman & Brown - Ray, Goodman And Brown II",19,22,16,16.0,16,"Ray, Goodman And Brown II",17.0,5,0,3,3,0,stay,1980-10-18
15549,"Ray, Goodman & Brown",1980-11-29,"Ray, Goodman & Brown - Ray, Goodman And Brown II",16,19,20,16.0,16,"Ray, Goodman And Brown II",17.0,6,-4,0,3,1,down,1980-10-18
15550,"Ray, Goodman & Brown",1980-12-06,"Ray, Goodman & Brown - Ray, Goodman And Brown II",16,16,29,16.0,20,"Ray, Goodman And Brown II",17.0,7,-9,-4,0,1,down,1980-10-18
15551,"Ray, Goodman & Brown",1980-12-13,"Ray, Goodman & Brown - Ray, Goodman And Brown II",20,16,34,16.0,29,"Ray, Goodman And Brown II",17.0,8,-5,-9,-4,1,down,1980-10-18
15552,"Ray, Goodman & Brown",1980-12-20,"Ray, Goodman & Brown - Ray, Goodman And Brown II",29,20,34,16.0,34,"Ray, Goodman And Brown II",17.0,9,0,-5,-9,0,stay,1980-10-18
15553,"Ray, Goodman & Brown",1980-12-27,"Ray, Goodman & Brown - Ray, Goodman And Brown II",34,29,34,16.0,34,"Ray, Goodman And Brown II",17.0,10,0,0,-5,0,stay,1980-10-18
15554,"Ray, Goodman & Brown",1981-01-03,"Ray, Goodman & Brown - Ray, Goodman And Brown II",34,34,38,16.0,34,"Ray, Goodman And Brown II",17.0,11,-4,0,0,1,down,1980-10-18
15555,"Ray, Goodman & Brown",1981-01-10,"Ray, Goodman & Brown - Ray, Goodman And Brown II",34,34,39,16.0,38,"Ray, Goodman And Brown II",17.0,12,-1,-4,0,1,down,1980-10-18
15556,"Ray, Goodman & Brown",1981-01-17,"Ray, Goodman & Brown - Ray, Goodman And Brown II",38,34,42,16.0,39,"Ray, Goodman And Brown II",17.0,13,-3,-1,-4,1,down,1980-10-18
15557,"Ray, Goodman & Brown",1981-01-24,"Ray, Goodman & Brown - Ray, Goodman And Brown II",39,38,43,16.0,42,"Ray, Goodman And Brown II",17.0,14,-1,-3,-1,1,down,1980-10-18
15558,"Ray, Goodman & Brown",1981-01-31,"Ray, Goodman & Brown - Ray, Goodman And Brown II",42,39,44,16.0,43,"Ray, Goodman And Brown II",17.0,15,-1,-1,-3,1,down,1980-10-18
15559,"Ray, Goodman & Brown",1981-02-07,"Ray, Goodman & Brown - Ray, Goodman And Brown II",43,42,46,16.0,44,"Ray, Goodman And Brown II",17.0,16,-2,-1,-1,1,down,1980-10-18
15560,"Ray, Goodman & Brown",1981-02-14,"Ray, Goodman & Brown - Ray, Goodman And Brown II",44,43,51,16.0,46,"Ray, Goodman And Brown II",17.0,17,-5,-2,-1,1,down,1980-10-18
15561,LaToya Jackson,1980-10-18,LaToya Jackson - Latoya Jackson,51,51,38,26.0,48,Latoya Jackson,10.0,0,10,3,0,1,up,1980-10-18
15562,LaToya Jackson,1980-10-25,LaToya Jackson - Latoya Jackson,48,51,32,26.0,38,Latoya Jackson,10.0,1,6,10,3,1,up,1980-10-18
15563,LaToya Jackson,1980-11-01,LaToya Jackson - Latoya Jackson,38,48,26,26.0,32,Latoya Jackson,10.0,2,6,6,10,1,up,1980-10-18
15564,LaToya Jackson,1980-11-08,LaToya Jackson - Latoya Jackson,32,38,26,26.0,26,Latoya Jackson,10.0,3,0,6,6,0,stay,1980-10-18
15565,LaToya Jackson,1980-11-15,LaToya Jackson - Latoya Jackson,26,32,26,26.0,26,Latoya Jackson,10.0,4,0,0,6,0,stay,1980-10-18
15566,LaToya Jackson,1980-11-22,LaToya Jackson - Latoya Jackson,26,26,33,26.0,26,Latoya Jackson,10.0,5,-7,0,0,1,down,1980-10-18
15567,LaToya Jackson,1980-11-29,LaToya Jackson - Latoya Jackson,26,26,34,26.0,33,Latoya Jackson,10.0,6,-1,-7,0,1,down,1980-10-18
15568,LaToya Jackson,1980-12-06,LaToya Jackson - Latoya Jackson,33,26,36,26.0,34,Latoya Jackson,10.0,7,-2,-1,-7,1,down,1980-10-18
15569,LaToya Jackson,1980-12-13,LaToya Jackson - Latoya Jackson,34,33,47,26.0,36,Latoya Jackson,10.0,8,-11,-2,-1,1,down,1980-10-18
15570,LaToya Jackson,1980-12-20,LaToya Jackson - Latoya Jackson,36,34,69,26.0,47,Latoya Jackson,10.0,9,-22,-11,-2,1,down,1980-10-18
15571,LaToya Jackson,1981-01-31,LaToya Jackson - Latoya Jackson,47,36,51,26.0,69,Latoya Jackson,10.0,10,18,-22,-11,1,up,1980-10-18
15572,Linda Clifford,1980-10-18,Linda Clifford - I'm Yours,51,51,49,47.0,49,I'm Yours,3.0,0,0,2,0,0,stay,1980-10-18
15573,Linda Clifford,1980-10-25,Linda Clifford - I'm Yours,49,51,47,47.0,49,I'm Yours,3.0,1,2,0,2,1,up,1980-10-18
15574,Linda Clifford,1980-11-01,Linda Clifford - I'm Yours,49,49,47,47.0,47,I'm Yours,3.0,2,0,2,0,0,stay,1980-10-18
15575,Linda Clifford,1980-11-08,Linda Clifford - I'm Yours,47,49,51,47.0,47,I'm Yours,3.0,3,-4,0,2,1,down,1980-10-18
15576,The Stylistics,1980-10-18,The Stylistics - Hurry Up This Way Again,51,51,40,11.0,50,Hurry Up This Way Again,20.0,0,10,1,0,1,up,1980-10-18
15577,The Stylistics,1980-10-25,The Stylistics - Hurry Up This Way Again,50,51,33,11.0,40,Hurry Up This Way Again,20.0,1,7,10,1,1,up,1980-10-18
15578,The Stylistics,1980-11-01,The Stylistics - Hurry Up This Way Again,40,50,23,11.0,33,Hurry Up This Way Again,20.0,2,10,7,10,1,up,1980-10-18
15579,The Stylistics,1980-11-08,The Stylistics - Hurry Up This Way Again,33,40,20,11.0,23,Hurry Up This Way Again,20.0,3,3,10,7,1,up,1980-10-18
15580,The Stylistics,1980-11-15,The Stylistics - Hurry Up This Way Again,23,33,17,11.0,20,Hurry Up This Way Again,20.0,4,3,3,10,1,up,1980-10-18
15581,The Stylistics,1980-11-22,The Stylistics - Hurry Up This Way Again,20,23,15,11.0,17,Hurry Up This Way Again,20.0,5,2,3,3,1,up,1980-10-18
15582,The Stylistics,1980-11-29,The Stylistics - Hurry Up This Way Again,17,20,13,11.0,15,Hurry Up This Way Again,20.0,6,2,2,3,1,up,1980-10-18
15583,The Stylistics,1980-12-06,The Stylistics - Hurry Up This Way Again,15,17,11,11.0,13,Hurry Up This Way Again,20.0,7,2,2,2,1,up,1980-10-18
15584,The Stylistics,1980-12-13,The Stylistics - Hurry Up This Way Again,13,15,11,11.0,11,Hurry Up This Way Again,20.0,8,0,2,2,0,stay,1980-10-18
15585,The Stylistics,1980-12-20,The Stylistics - Hurry Up This Way Again,11,13,15,11.0,11,Hurry Up This Way Again,20.0,9,-4,0,2,1,down,1980-10-18
15586,The Stylistics,1980-12-27,The Stylistics - Hurry Up This Way Again,11,11,15,11.0,15,Hurry Up This Way Again,20.0,10,0,-4,0,0,stay,1980-10-18
15587,The Stylistics,1981-01-03,The Stylistics - Hurry Up This Way Again,15,11,14,11.0,15,Hurry Up This Way Again,20.0,11,1,0,-4,1,up,1980-10-18
15588,The Stylistics,1981-01-10,The Stylistics - Hurry Up This Way Again,15,15,16,11.0,14,Hurry Up This Way Again,20.0,12,-2,1,0,1,down,1980-10-18
15589,The Stylistics,1981-01-17,The Stylistics - Hurry Up This Way Again,14,15,24,11.0,16,Hurry Up This Way Again,20.0,13,-8,-2,1,1,down,1980-10-18
15590,The Stylistics,1981-01-24,The Stylistics - Hurry Up This Way Again,16,14,26,11.0,24,Hurry Up This Way Again,20.0,14,-2,-8,-2,1,down,1980-10-18
15591,The Stylistics,1981-02-07,The Stylistics - Hurry Up This Way Again,24,16,29,11.0,26,Hurry Up This Way Again,20.0,15,-3,-2,-8,1,down,1980-10-18
15592,The Stylistics,1981-02-14,The Stylistics - Hurry Up This Way Again,26,24,33,11.0,29,Hurry Up This Way Again,20.0,16,-4,-3,-2,1,down,1980-10-18
15593,The Stylistics,1981-02-21,The Stylistics - Hurry Up This Way Again,29,26,34,11.0,33,Hurry Up This Way Again,20.0,17,-1,-4,-3,1,down,1980-10-18
15594,The Stylistics,1981-02-28,The Stylistics - Hurry Up This Way Again,33,29,42,11.0,34,Hurry Up This Way Again,20.0,18,-8,-1,-4,1,down,1980-10-18
15595,The Stylistics,1981-03-07,The Stylistics - Hurry Up This Way Again,34,33,48,11.0,42,Hurry Up This Way Again,20.0,19,-6,-8,-1,1,down,1980-10-18
15596,The Stylistics,1981-03-14,The Stylistics - Hurry Up This Way Again,42,34,51,11.0,48,Hurry Up This Way Again,20.0,20,-3,-6,-8,1,down,1980-10-18
15597,Kool & The Gang,1980-10-25,Kool & The Gang - Celebrate,51,51,10,2.0,20,Celebrate,30.0,0,10,31,0,1,up,1980-10-25
15598,Kool & The Gang,1980-11-01,Kool & The Gang - Celebrate,20,51,5,2.0,10,Celebrate,30.0,1,5,10,31,1,up,1980-10-25
15599,Kool & The Gang,1980-11-08,Kool & The Gang - Celebrate,10,20,4,2.0,5,Celebrate,30.0,2,1,5,10,1,up,1980-10-25
15600,Kool & The Gang,1980-11-15,Kool & The Gang - Celebrate,5,10,3,2.0,4,Celebrate,30.0,3,1,1,5,1,up,1980-10-25
15601,Kool & The Gang,1980-11-22,Kool & The Gang - Celebrate,4,5,3,2.0,3,Celebrate,30.0,4,0,1,1,0,stay,1980-10-25
15602,Kool & The Gang,1980-11-29,Kool & The Gang - Celebrate,3,4,3,2.0,3,Celebrate,30.0,5,0,0,1,0,stay,1980-10-25
15603,Kool & The Gang,1980-12-06,Kool & The Gang - Celebrate,3,3,3,2.0,3,Celebrate,30.0,6,0,0,0,0,stay,1980-10-25
15604,Kool & The Gang,1980-12-13,Kool & The Gang - Celebrate,3,3,3,2.0,3,Celebrate,30.0,7,0,0,0,0,stay,1980-10-25
15605,Kool & The Gang,1980-12-20,Kool & The Gang - Celebrate,3,3,3,2.0,3,Celebrate,30.0,8,0,0,0,0,stay,1980-10-25
15606,Kool & The Gang,1980-12-27,Kool & The Gang - Celebrate,3,3,3,2.0,3,Celebrate,30.0,9,0,0,0,0,stay,1980-10-25
15607,Kool & The Gang,1981-01-03,Kool & The Gang - Celebrate,3,3,2,2.0,3,Celebrate,30.0,10,1,0,0,1,up,1980-10-25
15608,Kool & The Gang,1981-01-10,Kool & The Gang - Celebrate,3,3,2,2.0,2,Celebrate,30.0,11,0,1,0,0,stay,1980-10-25
15609,Kool & The Gang,1981-01-17,Kool & The Gang - Celebrate,2,3,2,2.0,2,Celebrate,30.0,12,0,0,1,0,stay,1980-10-25
15610,Kool & The Gang,1981-01-24,Kool & The Gang - Celebrate,2,2,2,2.0,2,Celebrate,30.0,13,0,0,0,0,stay,1980-10-25
15611,Kool & The Gang,1981-01-31,Kool & The Gang - Celebrate,2,2,4,2.0,2,Celebrate,30.0,14,-2,0,0,1,down,1980-10-25
15612,Kool & The Gang,1981-02-07,Kool & The Gang - Celebrate,2,2,4,2.0,4,Celebrate,30.0,15,0,-2,0,0,stay,1980-10-25
15613,Kool & The Gang,1981-02-14,Kool & The Gang - Celebrate,4,2,5,2.0,4,Celebrate,30.0,16,-1,0,-2,1,down,1980-10-25
15614,Kool & The Gang,1981-02-21,Kool & The Gang - Celebrate,4,4,6,2.0,5,Celebrate,30.0,17,-1,-1,0,1,down,1980-10-25
15615,Kool & The Gang,1981-02-28,Kool & The Gang - Celebrate,5,4,7,2.0,6,Celebrate,30.0,18,-1,-1,-1,1,down,1980-10-25
15616,Kool & The Gang,1981-03-07,Kool & The Gang - Celebrate,6,5,9,2.0,7,Celebrate,30.0,19,-2,-1,-1,1,down,1980-10-25
15617,Kool & The Gang,1981-03-14,Kool & The Gang - Celebrate,7,6,9,2.0,9,Celebrate,30.0,20,0,-2,-1,0,stay,1980-10-25
15618,Kool & The Gang,1981-03-21,Kool & The Gang - Celebrate,9,7,12,2.0,9,Celebrate,30.0,21,-3,0,-2,1,down,1980-10-25
15619,Kool & The Gang,1981-03-28,Kool & The Gang - Celebrate,9,9,15,2.0,12,Celebrate,30.0,22,-3,-3,0,1,down,1980-10-25
15620,Kool & The Gang,1981-04-04,Kool & The Gang - Celebrate,12,9,19,2.0,15,Celebrate,30.0,23,-4,-3,-3,1,down,1980-10-25
15621,Kool & The Gang,1981-04-11,Kool & The Gang - Celebrate,15,12,19,2.0,19,Celebrate,30.0,24,0,-4,-3,0,stay,1980-10-25
15622,Kool & The Gang,1981-04-18,Kool & The Gang - Celebrate,19,15,31,2.0,19,Celebrate,30.0,25,-12,0,-4,1,down,1980-10-25
15623,Kool & The Gang,1981-04-25,Kool & The Gang - Celebrate,19,19,34,2.0,31,Celebrate,30.0,26,-3,-12,0,1,down,1980-10-25
15624,Kool & The Gang,1981-05-02,Kool & The Gang - Celebrate,31,19,35,2.0,34,Celebrate,30.0,27,-1,-3,-12,1,down,1980-10-25
15625,Kool & The Gang,1981-05-09,Kool & The Gang - Celebrate,34,31,38,2.0,35,Celebrate,30.0,28,-3,-1,-3,1,down,1980-10-25
15626,Kool & The Gang,1981-05-16,Kool & The Gang - Celebrate,35,34,39,2.0,38,Celebrate,30.0,29,-1,-3,-1,1,down,1980-10-25
15627,Kool & The Gang,1981-05-23,Kool & The Gang - Celebrate,38,35,51,2.0,39,Celebrate,30.0,30,-12,-1,-3,1,down,1980-10-25
15628,Kurtis Blow,1980-10-25,Kurtis Blow - Kurtis Blow,51,51,15,10.0,28,Kurtis Blow,8.0,0,13,23,0,1,up,1980-10-25
15629,Kurtis Blow,1980-11-01,Kurtis Blow - Kurtis Blow,28,51,12,10.0,15,Kurtis Blow,8.0,1,3,13,23,1,up,1980-10-25
15630,Kurtis Blow,1980-11-08,Kurtis Blow - Kurtis Blow,15,28,11,10.0,12,Kurtis Blow,8.0,2,1,3,13,1,up,1980-10-25
15631,Kurtis Blow,1980-11-15,Kurtis Blow - Kurtis Blow,12,15,10,10.0,11,Kurtis Blow,8.0,3,1,1,3,1,up,1980-10-25
15632,Kurtis Blow,1980-11-22,Kurtis Blow - Kurtis Blow,11,12,10,10.0,10,Kurtis Blow,8.0,4,0,1,1,0,stay,1980-10-25
15633,Kurtis Blow,1980-11-29,Kurtis Blow - Kurtis Blow,10,11,15,10.0,10,Kurtis Blow,8.0,5,-5,0,1,1,down,1980-10-25
15634,Kurtis Blow,1980-12-06,Kurtis Blow - Kurtis Blow,10,10,19,10.0,15,Kurtis Blow,8.0,6,-4,-5,0,1,down,1980-10-25
15635,Kurtis Blow,1980-12-13,Kurtis Blow - Kurtis Blow,15,10,41,10.0,19,Kurtis Blow,8.0,7,-22,-4,-5,1,down,1980-10-25
15636,Kurtis Blow,1980-12-20,Kurtis Blow - Kurtis Blow,19,15,51,10.0,41,Kurtis Blow,8.0,8,-10,-22,-4,1,down,1980-10-25
15637,The Jones Girls,1980-10-25,The Jones Girls - At Peace With Woman,51,51,25,7.0,35,At Peace With Woman,24.0,0,10,16,0,1,up,1980-10-25
15638,The Jones Girls,1980-11-01,The Jones Girls - At Peace With Woman,35,51,15,7.0,25,At Peace With Woman,24.0,1,10,10,16,1,up,1980-10-25
15639,The Jones Girls,1980-11-08,The Jones Girls - At Peace With Woman,25,35,12,7.0,15,At Peace With Woman,24.0,2,3,10,10,1,up,1980-10-25
15640,The Jones Girls,1980-11-15,The Jones Girls - At Peace With Woman,15,25,11,7.0,12,At Peace With Woman,24.0,3,1,3,10,1,up,1980-10-25
15641,The Jones Girls,1980-11-22,The Jones Girls - At Peace With Woman,12,15,11,7.0,11,At Peace With Woman,24.0,4,0,1,3,0,stay,1980-10-25
15642,The Jones Girls,1980-11-29,The Jones Girls - At Peace With Woman,11,12,11,7.0,11,At Peace With Woman,24.0,5,0,0,1,0,stay,1980-10-25
15643,The Jones Girls,1980-12-06,The Jones Girls - At Peace With Woman,11,11,13,7.0,11,At Peace With Woman,24.0,6,-2,0,0,1,down,1980-10-25
15644,The Jones Girls,1980-12-13,The Jones Girls - At Peace With Woman,11,11,10,7.0,13,At Peace With Woman,24.0,7,3,-2,0,1,up,1980-10-25
15645,The Jones Girls,1980-12-20,The Jones Girls - At Peace With Woman,13,11,9,7.0,10,At Peace With Woman,24.0,8,1,3,-2,1,up,1980-10-25
15646,The Jones Girls,1980-12-27,The Jones Girls - At Peace With Woman,10,13,9,7.0,9,At Peace With Woman,24.0,9,0,1,3,0,stay,1980-10-25
15647,The Jones Girls,1981-01-03,The Jones Girls - At Peace With Woman,9,10,8,7.0,9,At Peace With Woman,24.0,10,1,0,1,1,up,1980-10-25
15648,The Jones Girls,1981-01-10,The Jones Girls - At Peace With Woman,9,9,7,7.0,8,At Peace With Woman,24.0,11,1,1,0,1,up,1980-10-25
15649,The Jones Girls,1981-01-17,The Jones Girls - At Peace With Woman,8,9,7,7.0,7,At Peace With Woman,24.0,12,0,1,1,0,stay,1980-10-25
15650,The Jones Girls,1981-01-24,The Jones Girls - At Peace With Woman,7,8,10,7.0,7,At Peace With Woman,24.0,13,-3,0,1,1,down,1980-10-25
15651,The Jones Girls,1981-01-31,The Jones Girls - At Peace With Woman,7,7,15,7.0,10,At Peace With Woman,24.0,14,-5,-3,0,1,down,1980-10-25
15652,The Jones Girls,1981-02-07,The Jones Girls - At Peace With Woman,10,7,16,7.0,15,At Peace With Woman,24.0,15,-1,-5,-3,1,down,1980-10-25
15653,The Jones Girls,1981-02-14,The Jones Girls - At Peace With Woman,15,10,17,7.0,16,At Peace With Woman,24.0,16,-1,-1,-5,1,down,1980-10-25
15654,The Jones Girls,1981-02-21,The Jones Girls - At Peace With Woman,16,15,16,7.0,17,At Peace With Woman,24.0,17,1,-1,-1,1,up,1980-10-25
15655,The Jones Girls,1981-02-28,The Jones Girls - At Peace With Woman,17,16,21,7.0,16,At Peace With Woman,24.0,18,-5,1,-1,1,down,1980-10-25
15656,The Jones Girls,1981-03-07,The Jones Girls - At Peace With Woman,16,17,22,7.0,21,At Peace With Woman,24.0,19,-1,-5,1,1,down,1980-10-25
15657,The Jones Girls,1981-03-14,The Jones Girls - At Peace With Woman,21,16,22,7.0,22,At Peace With Woman,24.0,20,0,-1,-5,0,stay,1980-10-25
15658,The Jones Girls,1981-03-21,The Jones Girls - At Peace With Woman,22,21,36,7.0,22,At Peace With Woman,24.0,21,-14,0,-1,1,down,1980-10-25
15659,The Jones Girls,1981-03-28,The Jones Girls - At Peace With Woman,22,22,38,7.0,36,At Peace With Woman,24.0,22,-2,-14,0,1,down,1980-10-25
15660,The Jones Girls,1981-04-04,The Jones Girls - At Peace With Woman,36,22,43,7.0,38,At Peace With Woman,24.0,23,-5,-2,-14,1,down,1980-10-25
15661,The Jones Girls,1981-04-11,The Jones Girls - At Peace With Woman,38,36,51,7.0,43,At Peace With Woman,24.0,24,-8,-5,-2,1,down,1980-10-25
15662,Narada,1980-10-25,Narada - Victory,51,51,36,21.0,44,Victory,9.0,0,8,7,0,1,up,1980-10-25
15663,Narada,1980-11-01,Narada - Victory,44,51,28,21.0,36,Victory,9.0,1,8,8,7,1,up,1980-10-25
15664,Narada,1980-11-08,Narada - Victory,36,44,24,21.0,28,Victory,9.0,2,4,8,8,1,up,1980-10-25
15665,Narada,1980-11-15,Narada - Victory,28,36,21,21.0,24,Victory,9.0,3,3,4,8,1,up,1980-10-25
15666,Narada,1980-11-22,Narada - Victory,24,28,21,21.0,21,Victory,9.0,4,0,3,4,0,stay,1980-10-25
15667,Narada,1980-11-29,Narada - Victory,21,24,26,21.0,21,Victory,9.0,5,-5,0,3,1,down,1980-10-25
15668,Narada,1980-12-06,Narada - Victory,21,21,40,21.0,26,Victory,9.0,6,-14,-5,0,1,down,1980-10-25
15669,Narada,1980-12-13,Narada - Victory,26,21,49,21.0,40,Victory,9.0,7,-9,-14,-5,1,down,1980-10-25
15670,Narada,1980-12-20,Narada - Victory,40,26,71,21.0,49,Victory,9.0,8,-22,-9,-14,1,down,1980-10-25
15671,Narada,1981-01-31,Narada - Victory,49,40,51,21.0,71,Victory,9.0,9,20,-22,-9,1,up,1980-10-25
15672,Norman Connors,1980-10-25,Norman Connors - Take It To The Limit,51,51,35,30.0,45,Take It To The Limit,5.0,0,10,6,0,1,up,1980-10-25
15673,Norman Connors,1980-11-01,Norman Connors - Take It To The Limit,45,51,30,30.0,35,Take It To The Limit,5.0,1,5,10,6,1,up,1980-10-25
15674,Norman Connors,1980-11-08,Norman Connors - Take It To The Limit,35,45,30,30.0,30,Take It To The Limit,5.0,2,0,5,10,0,stay,1980-10-25
15675,Norman Connors,1980-11-15,Norman Connors - Take It To The Limit,30,35,41,30.0,30,Take It To The Limit,5.0,3,-11,0,5,1,down,1980-10-25
15676,Norman Connors,1980-11-22,Norman Connors - Take It To The Limit,30,30,67,30.0,41,Take It To The Limit,5.0,4,-26,-11,0,1,down,1980-10-25
15677,Norman Connors,1981-01-31,Norman Connors - Take It To The Limit,41,30,51,30.0,67,Take It To The Limit,5.0,5,16,-26,-11,1,up,1980-10-25
15678,The Doobie Brothers,1980-10-25,The Doobie Brothers - One Step Closer,51,51,41,31.0,50,One Step Closer,11.0,0,9,1,0,1,up,1980-10-25
15679,The Doobie Brothers,1980-11-01,The Doobie Brothers - One Step Closer,50,51,31,31.0,41,One Step Closer,11.0,1,10,9,1,1,up,1980-10-25
15680,The Doobie Brothers,1980-11-08,The Doobie Brothers - One Step Closer,41,50,31,31.0,31,One Step Closer,11.0,2,0,10,9,0,stay,1980-10-25
15681,The Doobie Brothers,1980-11-15,The Doobie Brothers - One Step Closer,31,41,35,31.0,31,One Step Closer,11.0,3,-4,0,10,1,down,1980-10-25
15682,The Doobie Brothers,1980-11-22,The Doobie Brothers - One Step Closer,31,31,38,31.0,35,One Step Closer,11.0,4,-3,-4,0,1,down,1980-10-25
15683,The Doobie Brothers,1980-11-29,The Doobie Brothers - One Step Closer,35,31,43,31.0,38,One Step Closer,11.0,5,-5,-3,-4,1,down,1980-10-25
15684,The Doobie Brothers,1980-12-06,The Doobie Brothers - One Step Closer,38,35,44,31.0,43,One Step Closer,11.0,6,-1,-5,-3,1,down,1980-10-25
15685,The Doobie Brothers,1980-12-13,The Doobie Brothers - One Step Closer,43,38,44,31.0,44,One Step Closer,11.0,7,0,-1,-5,0,stay,1980-10-25
15686,The Doobie Brothers,1980-12-20,The Doobie Brothers - One Step Closer,44,43,45,31.0,44,One Step Closer,11.0,8,-1,0,-1,1,down,1980-10-25
15687,The Doobie Brothers,1980-12-27,The Doobie Brothers - One Step Closer,44,44,45,31.0,45,One Step Closer,11.0,9,0,-1,0,0,stay,1980-10-25
15688,The Doobie Brothers,1981-01-03,The Doobie Brothers - One Step Closer,45,44,66,31.0,45,One Step Closer,11.0,10,-21,0,-1,1,down,1980-10-25
15689,The Doobie Brothers,1981-01-31,The Doobie Brothers - One Step Closer,45,45,51,31.0,66,One Step Closer,11.0,11,15,-21,0,1,up,1980-10-25
15690,Richard Pryor,1980-11-01,Richard Pryor - Holy Smoke,51,51,38,37.0,44,Holy Smoke,6.0,0,6,7,0,1,up,1980-11-01
15691,Richard Pryor,1980-11-08,Richard Pryor - Holy Smoke,44,51,38,37.0,38,Holy Smoke,6.0,1,0,6,7,0,stay,1980-11-01
15692,Richard Pryor,1980-11-15,Richard Pryor - Holy Smoke,38,44,37,37.0,38,Holy Smoke,6.0,2,1,0,6,1,up,1980-11-01
15693,Richard Pryor,1980-11-22,Richard Pryor - Holy Smoke,38,38,42,37.0,37,Holy Smoke,6.0,3,-5,1,0,1,down,1980-11-01
15694,Richard Pryor,1980-11-29,Richard Pryor - Holy Smoke,37,38,42,37.0,42,Holy Smoke,6.0,4,0,-5,1,0,stay,1980-11-01
15695,Richard Pryor,1980-12-06,Richard Pryor - Holy Smoke,42,37,73,37.0,42,Holy Smoke,6.0,5,-31,0,-5,1,down,1980-11-01
15696,Richard Pryor,1981-01-31,Richard Pryor - Holy Smoke,42,42,51,37.0,73,Holy Smoke,6.0,6,22,-31,0,1,up,1980-11-01
15697,Aretha Franklin,1980-11-01,Aretha Franklin - Aretha,51,51,32,6.0,45,Aretha,32.0,0,13,6,0,1,up,1980-11-01
15698,Aretha Franklin,1980-11-08,Aretha Franklin - Aretha,45,51,21,6.0,32,Aretha,32.0,1,11,13,6,1,up,1980-11-01
15699,Aretha Franklin,1980-11-15,Aretha Franklin - Aretha,32,45,15,6.0,21,Aretha,32.0,2,6,11,13,1,up,1980-11-01
15700,Aretha Franklin,1980-11-22,Aretha Franklin - Aretha,21,32,13,6.0,15,Aretha,32.0,3,2,6,11,1,up,1980-11-01
15701,Aretha Franklin,1980-11-29,Aretha Franklin - Aretha,15,21,10,6.0,13,Aretha,32.0,4,3,2,6,1,up,1980-11-01
15702,Aretha Franklin,1980-12-06,Aretha Franklin - Aretha,13,15,9,6.0,10,Aretha,32.0,5,1,3,2,1,up,1980-11-01
15703,Aretha Franklin,1980-12-13,Aretha Franklin - Aretha,10,13,8,6.0,9,Aretha,32.0,6,1,1,3,1,up,1980-11-01
15704,Aretha Franklin,1980-12-20,Aretha Franklin - Aretha,9,10,7,6.0,8,Aretha,32.0,7,1,1,1,1,up,1980-11-01
15705,Aretha Franklin,1980-12-27,Aretha Franklin - Aretha,8,9,7,6.0,7,Aretha,32.0,8,0,1,1,0,stay,1980-11-01
15706,Aretha Franklin,1981-01-03,Aretha Franklin - Aretha,7,8,7,6.0,7,Aretha,32.0,9,0,0,1,0,stay,1980-11-01
15707,Aretha Franklin,1981-01-10,Aretha Franklin - Aretha,7,7,6,6.0,7,Aretha,32.0,10,1,0,0,1,up,1980-11-01
15708,Aretha Franklin,1981-01-17,Aretha Franklin - Aretha,7,7,6,6.0,6,Aretha,32.0,11,0,1,0,0,stay,1980-11-01
15709,Aretha Franklin,1981-01-24,Aretha Franklin - Aretha,6,7,6,6.0,6,Aretha,32.0,12,0,0,1,0,stay,1980-11-01
15710,Aretha Franklin,1981-01-31,Aretha Franklin - Aretha,6,6,8,6.0,6,Aretha,32.0,13,-2,0,0,1,down,1980-11-01
15711,Aretha Franklin,1981-02-07,Aretha Franklin - Aretha,6,6,13,6.0,8,Aretha,32.0,14,-5,-2,0,1,down,1980-11-01
15712,Aretha Franklin,1981-02-14,Aretha Franklin - Aretha,8,6,14,6.0,13,Aretha,32.0,15,-1,-5,-2,1,down,1980-11-01
15713,Aretha Franklin,1981-02-21,Aretha Franklin - Aretha,13,8,18,6.0,14,Aretha,32.0,16,-4,-1,-5,1,down,1980-11-01
15714,Aretha Franklin,1981-02-28,Aretha Franklin - Aretha,14,13,14,6.0,18,Aretha,32.0,17,4,-4,-1,1,up,1980-11-01
15715,Aretha Franklin,1981-03-07,Aretha Franklin - Aretha,18,14,14,6.0,14,Aretha,32.0,18,0,4,-4,0,stay,1980-11-01
15716,Aretha Franklin,1981-03-14,Aretha Franklin - Aretha,14,18,13,6.0,14,Aretha,32.0,19,1,0,4,1,up,1980-11-01
15717,Aretha Franklin,1981-03-21,Aretha Franklin - Aretha,14,14,13,6.0,13,Aretha,32.0,20,0,1,0,0,stay,1980-11-01
15718,Aretha Franklin,1981-03-28,Aretha Franklin - Aretha,13,14,14,6.0,13,Aretha,32.0,21,-1,0,1,1,down,1980-11-01
15719,Aretha Franklin,1981-04-04,Aretha Franklin - Aretha,13,13,18,6.0,14,Aretha,32.0,22,-4,-1,0,1,down,1980-11-01
15720,Aretha Franklin,1981-04-11,Aretha Franklin - Aretha,14,13,25,6.0,18,Aretha,32.0,23,-7,-4,-1,1,down,1980-11-01
15721,Aretha Franklin,1981-04-18,Aretha Franklin - Aretha,18,14,32,6.0,25,Aretha,32.0,24,-7,-7,-4,1,down,1980-11-01
15722,Aretha Franklin,1981-04-25,Aretha Franklin - Aretha,25,18,36,6.0,32,Aretha,32.0,25,-4,-7,-7,1,down,1980-11-01
15723,Aretha Franklin,1981-05-02,Aretha Franklin - Aretha,32,25,38,6.0,36,Aretha,32.0,26,-2,-4,-7,1,down,1980-11-01
15724,Aretha Franklin,1981-05-09,Aretha Franklin - Aretha,36,32,40,6.0,38,Aretha,32.0,27,-2,-2,-4,1,down,1980-11-01
15725,Aretha Franklin,1981-05-16,Aretha Franklin - Aretha,38,36,40,6.0,40,Aretha,32.0,28,0,-2,-2,0,stay,1980-11-01
15726,Aretha Franklin,1981-05-23,Aretha Franklin - Aretha,40,38,40,6.0,40,Aretha,32.0,29,0,0,-2,0,stay,1980-11-01
15727,Aretha Franklin,1981-05-30,Aretha Franklin - Aretha,40,40,45,6.0,40,Aretha,32.0,30,-5,0,0,1,down,1980-11-01
15728,Aretha Franklin,1981-06-06,Aretha Franklin - Aretha,40,40,46,6.0,45,Aretha,32.0,31,-1,-5,0,1,down,1980-11-01
15729,Aretha Franklin,1981-06-13,Aretha Franklin - Aretha,45,40,51,6.0,46,Aretha,32.0,32,-5,-1,-5,1,down,1980-11-01
15730,Slave,1980-11-01,Slave - Stone Jam,51,51,36,5.0,46,Stone Jam,37.0,0,10,5,0,1,up,1980-11-01
15731,Slave,1980-11-08,Slave - Stone Jam,46,51,29,5.0,36,Stone Jam,37.0,1,7,10,5,1,up,1980-11-01
15732,Slave,1980-11-15,Slave - Stone Jam,36,46,25,5.0,29,Stone Jam,37.0,2,4,7,10,1,up,1980-11-01
15733,Slave,1980-11-22,Slave - Stone Jam,29,36,23,5.0,25,Stone Jam,37.0,3,2,4,7,1,up,1980-11-01
15734,Slave,1980-11-29,Slave - Stone Jam,25,29,23,5.0,23,Stone Jam,37.0,4,0,2,4,0,stay,1980-11-01
15735,Slave,1980-12-06,Slave - Stone Jam,23,25,21,5.0,23,Stone Jam,37.0,5,2,0,2,1,up,1980-11-01
15736,Slave,1980-12-13,Slave - Stone Jam,23,23,22,5.0,21,Stone Jam,37.0,6,-1,2,0,1,down,1980-11-01
15737,Slave,1980-12-20,Slave - Stone Jam,21,23,19,5.0,22,Stone Jam,37.0,7,3,-1,2,1,up,1980-11-01
15738,Slave,1980-12-27,Slave - Stone Jam,22,21,19,5.0,19,Stone Jam,37.0,8,0,3,-1,0,stay,1980-11-01
15739,Slave,1981-01-03,Slave - Stone Jam,19,22,15,5.0,19,Stone Jam,37.0,9,4,0,3,1,up,1980-11-01
15740,Slave,1981-01-10,Slave - Stone Jam,19,19,13,5.0,15,Stone Jam,37.0,10,2,4,0,1,up,1980-11-01
15741,Slave,1981-01-17,Slave - Stone Jam,15,19,12,5.0,13,Stone Jam,37.0,11,1,2,4,1,up,1980-11-01
15742,Slave,1981-01-24,Slave - Stone Jam,13,15,11,5.0,12,Stone Jam,37.0,12,1,1,2,1,up,1980-11-01
15743,Slave,1981-01-31,Slave - Stone Jam,12,13,10,5.0,11,Stone Jam,37.0,13,1,1,1,1,up,1980-11-01
15744,Slave,1981-02-07,Slave - Stone Jam,11,12,9,5.0,10,Stone Jam,37.0,14,1,1,1,1,up,1980-11-01
15745,Slave,1981-02-14,Slave - Stone Jam,10,11,8,5.0,9,Stone Jam,37.0,15,1,1,1,1,up,1980-11-01
15746,Slave,1981-02-21,Slave - Stone Jam,9,10,7,5.0,8,Stone Jam,37.0,16,1,1,1,1,up,1980-11-01
15747,Slave,1981-02-28,Slave - Stone Jam,8,9,6,5.0,7,Stone Jam,37.0,17,1,1,1,1,up,1980-11-01
15748,Slave,1981-03-07,Slave - Stone Jam,7,8,6,5.0,6,Stone Jam,37.0,18,0,1,1,0,stay,1980-11-01
15749,Slave,1981-03-14,Slave - Stone Jam,6,7,5,5.0,6,Stone Jam,37.0,19,1,0,1,1,up,1980-11-01
15750,Slave,1981-03-21,Slave - Stone Jam,6,6,5,5.0,5,Stone Jam,37.0,20,0,1,0,0,stay,1980-11-01
15751,Slave,1981-03-28,Slave - Stone Jam,5,6,9,5.0,5,Stone Jam,37.0,21,-4,0,1,1,down,1980-11-01
15752,Slave,1981-04-04,Slave - Stone Jam,5,5,9,5.0,9,Stone Jam,37.0,22,0,-4,0,0,stay,1980-11-01
15753,Slave,1981-04-11,Slave - Stone Jam,9,5,12,5.0,9,Stone Jam,37.0,23,-3,0,-4,1,down,1980-11-01
15754,Slave,1981-04-18,Slave - Stone Jam,9,9,12,5.0,12,Stone Jam,37.0,24,0,-3,0,0,stay,1980-11-01
15755,Slave,1981-04-25,Slave - Stone Jam,12,9,17,5.0,12,Stone Jam,37.0,25,-5,0,-3,1,down,1980-11-01
15756,Slave,1981-05-02,Slave - Stone Jam,12,12,22,5.0,17,Stone Jam,37.0,26,-5,-5,0,1,down,1980-11-01
15757,Slave,1981-05-09,Slave - Stone Jam,17,12,29,5.0,22,Stone Jam,37.0,27,-7,-5,-5,1,down,1980-11-01
15758,Slave,1981-05-16,Slave - Stone Jam,22,17,31,5.0,29,Stone Jam,37.0,28,-2,-7,-5,1,down,1980-11-01
15759,Slave,1981-05-23,Slave - Stone Jam,29,22,31,5.0,31,Stone Jam,37.0,29,0,-2,-7,0,stay,1980-11-01
15760,Slave,1981-05-30,Slave - Stone Jam,31,29,33,5.0,31,Stone Jam,37.0,30,-2,0,-2,1,down,1980-11-01
15761,Slave,1981-06-06,Slave - Stone Jam,31,31,33,5.0,33,Stone Jam,37.0,31,0,-2,0,0,stay,1980-11-01
15762,Slave,1981-06-13,Slave - Stone Jam,33,31,36,5.0,33,Stone Jam,37.0,32,-3,0,-2,1,down,1980-11-01
15763,Slave,1981-06-20,Slave - Stone Jam,33,33,38,5.0,36,Stone Jam,37.0,33,-2,-3,0,1,down,1980-11-01
15764,Slave,1981-06-27,Slave - Stone Jam,36,33,42,5.0,38,Stone Jam,37.0,34,-4,-2,-3,1,down,1980-11-01
15765,Slave,1981-07-04,Slave - Stone Jam,38,36,42,5.0,42,Stone Jam,37.0,35,0,-4,-2,0,stay,1980-11-01
15766,Slave,1981-07-11,Slave - Stone Jam,42,38,49,5.0,42,Stone Jam,37.0,36,-7,0,-4,1,down,1980-11-01
15767,Slave,1981-07-18,Slave - Stone Jam,42,42,51,5.0,49,Stone Jam,37.0,37,-2,-7,0,1,down,1980-11-01
15768,Seawind,1980-11-01,Seawind - Seawind,51,51,40,20.0,50,Seawind,13.0,0,10,1,0,1,up,1980-11-01
15769,Seawind,1980-11-08,Seawind - Seawind,50,51,34,20.0,40,Seawind,13.0,1,6,10,1,1,up,1980-11-01
15770,Seawind,1980-11-15,Seawind - Seawind,40,50,30,20.0,34,Seawind,13.0,2,4,6,10,1,up,1980-11-01
15771,Seawind,1980-11-22,Seawind - Seawind,34,40,28,20.0,30,Seawind,13.0,3,2,4,6,1,up,1980-11-01
15772,Seawind,1980-11-29,Seawind - Seawind,30,34,25,20.0,28,Seawind,13.0,4,3,2,4,1,up,1980-11-01
15773,Seawind,1980-12-06,Seawind - Seawind,28,30,23,20.0,25,Seawind,13.0,5,2,3,2,1,up,1980-11-01
15774,Seawind,1980-12-13,Seawind - Seawind,25,28,20,20.0,23,Seawind,13.0,6,3,2,3,1,up,1980-11-01
15775,Seawind,1980-12-20,Seawind - Seawind,23,25,20,20.0,20,Seawind,13.0,7,0,3,2,0,stay,1980-11-01
15776,Seawind,1980-12-27,Seawind - Seawind,20,23,20,20.0,20,Seawind,13.0,8,0,0,3,0,stay,1980-11-01
15777,Seawind,1981-01-03,Seawind - Seawind,20,20,40,20.0,20,Seawind,13.0,9,-20,0,0,1,down,1980-11-01
15778,Seawind,1981-01-10,Seawind - Seawind,20,20,41,20.0,40,Seawind,13.0,10,-1,-20,0,1,down,1980-11-01
15779,Seawind,1981-01-17,Seawind - Seawind,40,20,45,20.0,41,Seawind,13.0,11,-4,-1,-20,1,down,1980-11-01
15780,Seawind,1981-01-24,Seawind - Seawind,41,40,46,20.0,45,Seawind,13.0,12,-1,-4,-1,1,down,1980-11-01
15781,Seawind,1981-01-31,Seawind - Seawind,45,41,51,20.0,46,Seawind,13.0,13,-5,-1,-4,1,down,1980-11-01
15782,Wilton Felder,1980-11-08,Wilton Felder - Inherit The Wind,51,51,25,14.0,44,Inherit The Wind,21.0,0,19,7,0,1,up,1980-11-08
15783,Wilton Felder,1980-11-15,Wilton Felder - Inherit The Wind,44,51,18,14.0,25,Inherit The Wind,21.0,1,7,19,7,1,up,1980-11-08
15784,Wilton Felder,1980-11-22,Wilton Felder - Inherit The Wind,25,44,17,14.0,18,Inherit The Wind,21.0,2,1,7,19,1,up,1980-11-08
15785,Wilton Felder,1980-11-29,Wilton Felder - Inherit The Wind,18,25,16,14.0,17,Inherit The Wind,21.0,3,1,1,7,1,up,1980-11-08
15786,Wilton Felder,1980-12-06,Wilton Felder - Inherit The Wind,17,18,15,14.0,16,Inherit The Wind,21.0,4,1,1,1,1,up,1980-11-08
15787,Wilton Felder,1980-12-13,Wilton Felder - Inherit The Wind,16,17,15,14.0,15,Inherit The Wind,21.0,5,0,1,1,0,stay,1980-11-08
15788,Wilton Felder,1980-12-20,Wilton Felder - Inherit The Wind,15,16,14,14.0,15,Inherit The Wind,21.0,6,1,0,1,1,up,1980-11-08
15789,Wilton Felder,1980-12-27,Wilton Felder - Inherit The Wind,15,15,14,14.0,14,Inherit The Wind,21.0,7,0,1,0,0,stay,1980-11-08
15790,Wilton Felder,1981-01-03,Wilton Felder - Inherit The Wind,14,15,37,14.0,14,Inherit The Wind,21.0,8,-23,0,1,1,down,1980-11-08
15791,Wilton Felder,1981-01-10,Wilton Felder - Inherit The Wind,14,14,37,14.0,37,Inherit The Wind,21.0,9,0,-23,0,0,stay,1980-11-08
15792,Wilton Felder,1981-01-17,Wilton Felder - Inherit The Wind,37,14,38,14.0,37,Inherit The Wind,21.0,10,-1,0,-23,1,down,1980-11-08
15793,Wilton Felder,1981-01-24,Wilton Felder - Inherit The Wind,37,37,38,14.0,38,Inherit The Wind,21.0,11,0,-1,0,0,stay,1980-11-08
15794,Wilton Felder,1981-01-31,Wilton Felder - Inherit The Wind,38,37,36,14.0,38,Inherit The Wind,21.0,12,2,0,-1,1,up,1980-11-08
15795,Wilton Felder,1981-02-07,Wilton Felder - Inherit The Wind,38,38,35,14.0,36,Inherit The Wind,21.0,13,1,2,0,1,up,1980-11-08
15796,Wilton Felder,1981-02-14,Wilton Felder - Inherit The Wind,36,38,35,14.0,35,Inherit The Wind,21.0,14,0,1,2,0,stay,1980-11-08
15797,Wilton Felder,1981-02-21,Wilton Felder - Inherit The Wind,35,36,33,14.0,35,Inherit The Wind,21.0,15,2,0,1,1,up,1980-11-08
15798,Wilton Felder,1981-02-28,Wilton Felder - Inherit The Wind,35,35,33,14.0,33,Inherit The Wind,21.0,16,0,2,0,0,stay,1980-11-08
15799,Wilton Felder,1981-03-07,Wilton Felder - Inherit The Wind,33,35,34,14.0,33,Inherit The Wind,21.0,17,-1,0,2,1,down,1980-11-08
15800,Wilton Felder,1981-03-14,Wilton Felder - Inherit The Wind,33,33,38,14.0,34,Inherit The Wind,21.0,18,-4,-1,0,1,down,1980-11-08
15801,Wilton Felder,1981-03-21,Wilton Felder - Inherit The Wind,34,33,40,14.0,38,Inherit The Wind,21.0,19,-2,-4,-1,1,down,1980-11-08
15802,Wilton Felder,1981-03-28,Wilton Felder - Inherit The Wind,38,34,46,14.0,40,Inherit The Wind,21.0,20,-6,-2,-4,1,down,1980-11-08
15803,Wilton Felder,1981-04-04,Wilton Felder - Inherit The Wind,40,38,51,14.0,46,Inherit The Wind,21.0,21,-5,-6,-2,1,down,1980-11-08
15804,Prince,1980-11-08,Prince - Dirty Mind,51,51,14,7.0,46,Dirty Mind,20.0,0,32,5,0,1,up,1980-11-08
15805,Prince,1980-11-15,Prince - Dirty Mind,46,51,9,7.0,14,Dirty Mind,20.0,1,5,32,5,1,up,1980-11-08
15806,Prince,1980-11-22,Prince - Dirty Mind,14,46,8,7.0,9,Dirty Mind,20.0,2,1,5,32,1,up,1980-11-08
15807,Prince,1980-11-29,Prince - Dirty Mind,9,14,7,7.0,8,Dirty Mind,20.0,3,1,1,5,1,up,1980-11-08
15808,Prince,1980-12-06,Prince - Dirty Mind,8,9,7,7.0,7,Dirty Mind,20.0,4,0,1,1,0,stay,1980-11-08
15809,Prince,1980-12-13,Prince - Dirty Mind,7,8,7,7.0,7,Dirty Mind,20.0,5,0,0,1,0,stay,1980-11-08
15810,Prince,1980-12-20,Prince - Dirty Mind,7,7,8,7.0,7,Dirty Mind,20.0,6,-1,0,0,1,down,1980-11-08
15811,Prince,1980-12-27,Prince - Dirty Mind,7,7,8,7.0,8,Dirty Mind,20.0,7,0,-1,0,0,stay,1980-11-08
15812,Prince,1981-01-03,Prince - Dirty Mind,8,7,13,7.0,8,Dirty Mind,20.0,8,-5,0,-1,1,down,1980-11-08
15813,Prince,1981-01-10,Prince - Dirty Mind,8,8,15,7.0,13,Dirty Mind,20.0,9,-2,-5,0,1,down,1980-11-08
15814,Prince,1981-01-17,Prince - Dirty Mind,13,8,15,7.0,15,Dirty Mind,20.0,10,0,-2,-5,0,stay,1980-11-08
15815,Prince,1981-01-24,Prince - Dirty Mind,15,13,22,7.0,15,Dirty Mind,20.0,11,-7,0,-2,1,down,1980-11-08
15816,Prince,1981-02-07,Prince - Dirty Mind,15,15,22,7.0,22,Dirty Mind,20.0,12,0,-7,0,0,stay,1980-11-08
15817,Prince,1981-02-14,Prince - Dirty Mind,22,15,30,7.0,22,Dirty Mind,20.0,13,-8,0,-7,1,down,1980-11-08
15818,Prince,1981-02-21,Prince - Dirty Mind,22,22,41,7.0,30,Dirty Mind,20.0,14,-11,-8,0,1,down,1980-11-08
15819,Prince,1981-02-28,Prince - Dirty Mind,30,22,41,7.0,41,Dirty Mind,20.0,15,0,-11,-8,0,stay,1980-11-08
15820,Prince,1981-03-07,Prince - Dirty Mind,41,30,43,7.0,41,Dirty Mind,20.0,16,-2,0,-11,1,down,1980-11-08
15821,Prince,1981-03-14,Prince - Dirty Mind,41,41,46,7.0,43,Dirty Mind,20.0,17,-3,-2,0,1,down,1980-11-08
15822,Prince,1981-03-21,Prince - Dirty Mind,43,41,46,7.0,46,Dirty Mind,20.0,18,0,-3,-2,0,stay,1980-11-08
15823,Prince,1981-03-28,Prince - Dirty Mind,46,43,47,7.0,46,Dirty Mind,20.0,19,-1,0,-3,1,down,1980-11-08
15824,Prince,1981-04-04,Prince - Dirty Mind,46,46,51,7.0,47,Dirty Mind,20.0,20,-4,-1,0,1,down,1980-11-08
15825,Donna Summer,1980-11-08,Donna Summer - The Wanderer,51,51,15,12.0,48,The Wanderer,10.0,0,33,3,0,1,up,1980-11-08
15826,Donna Summer,1980-11-15,Donna Summer - The Wanderer,48,51,12,12.0,15,The Wanderer,10.0,1,3,33,3,1,up,1980-11-08
15827,Donna Summer,1980-11-22,Donna Summer - The Wanderer,15,48,12,12.0,12,The Wanderer,10.0,2,0,3,33,0,stay,1980-11-08
15828,Donna Summer,1980-11-29,Donna Summer - The Wanderer,12,15,12,12.0,12,The Wanderer,10.0,3,0,0,3,0,stay,1980-11-08
15829,Donna Summer,1980-12-06,Donna Summer - The Wanderer,12,12,12,12.0,12,The Wanderer,10.0,4,0,0,0,0,stay,1980-11-08
15830,Donna Summer,1980-12-13,Donna Summer - The Wanderer,12,12,18,12.0,12,The Wanderer,10.0,5,-6,0,0,1,down,1980-11-08
15831,Donna Summer,1980-12-20,Donna Summer - The Wanderer,12,12,24,12.0,18,The Wanderer,10.0,6,-6,-6,0,1,down,1980-11-08
15832,Donna Summer,1980-12-27,Donna Summer - The Wanderer,18,12,24,12.0,24,The Wanderer,10.0,7,0,-6,-6,0,stay,1980-11-08
15833,Donna Summer,1981-01-03,Donna Summer - The Wanderer,24,18,33,12.0,24,The Wanderer,10.0,8,-9,0,-6,1,down,1980-11-08
15834,Donna Summer,1981-01-10,Donna Summer - The Wanderer,24,24,61,12.0,33,The Wanderer,10.0,9,-28,-9,0,1,down,1980-11-08
15835,Donna Summer,1981-01-31,Donna Summer - The Wanderer,33,24,51,12.0,61,The Wanderer,10.0,10,10,-28,-9,1,up,1980-11-08
15836,Stevie Wonder,1980-11-15,Stevie Wonder - Hotter Than July,51,51,1,1.0,3,Hotter Than July,36.0,0,2,48,0,1,up,1980-11-15
15837,Stevie Wonder,1980-11-22,Stevie Wonder - Hotter Than July,3,51,1,1.0,1,Hotter Than July,36.0,1,0,2,48,0,stay,1980-11-15
15838,Stevie Wonder,1980-11-29,Stevie Wonder - Hotter Than July,1,3,1,1.0,1,Hotter Than July,36.0,2,0,0,2,0,stay,1980-11-15
15839,Stevie Wonder,1980-12-06,Stevie Wonder - Hotter Than July,1,1,1,1.0,1,Hotter Than July,36.0,3,0,0,0,0,stay,1980-11-15
15840,Stevie Wonder,1980-12-13,Stevie Wonder - Hotter Than July,1,1,1,1.0,1,Hotter Than July,36.0,4,0,0,0,0,stay,1980-11-15
15841,Stevie Wonder,1980-12-20,Stevie Wonder - Hotter Than July,1,1,1,1.0,1,Hotter Than July,36.0,5,0,0,0,0,stay,1980-11-15
15842,Stevie Wonder,1980-12-27,Stevie Wonder - Hotter Than July,1,1,1,1.0,1,Hotter Than July,36.0,6,0,0,0,0,stay,1980-11-15
15843,Stevie Wonder,1981-01-03,Stevie Wonder - Hotter Than July,1,1,1,1.0,1,Hotter Than July,36.0,7,0,0,0,0,stay,1980-11-15
15844,Stevie Wonder,1981-01-10,Stevie Wonder - Hotter Than July,1,1,1,1.0,1,Hotter Than July,36.0,8,0,0,0,0,stay,1980-11-15
15845,Stevie Wonder,1981-01-17,Stevie Wonder - Hotter Than July,1,1,1,1.0,1,Hotter Than July,36.0,9,0,0,0,0,stay,1980-11-15
15846,Stevie Wonder,1981-01-24,Stevie Wonder - Hotter Than July,1,1,1,1.0,1,Hotter Than July,36.0,10,0,0,0,0,stay,1980-11-15
15847,Stevie Wonder,1981-01-31,Stevie Wonder - Hotter Than July,1,1,1,1.0,1,Hotter Than July,36.0,11,0,0,0,0,stay,1980-11-15
15848,Stevie Wonder,1981-02-07,Stevie Wonder - Hotter Than July,1,1,1,1.0,1,Hotter Than July,36.0,12,0,0,0,0,stay,1980-11-15
15849,Stevie Wonder,1981-02-14,Stevie Wonder - Hotter Than July,1,1,3,1.0,1,Hotter Than July,36.0,13,-2,0,0,1,down,1980-11-15
15850,Stevie Wonder,1981-02-21,Stevie Wonder - Hotter Than July,1,1,3,1.0,3,Hotter Than July,36.0,14,0,-2,0,0,stay,1980-11-15
15851,Stevie Wonder,1981-02-28,Stevie Wonder - Hotter Than July,3,1,3,1.0,3,Hotter Than July,36.0,15,0,0,-2,0,stay,1980-11-15
15852,Stevie Wonder,1981-03-07,Stevie Wonder - Hotter Than July,3,3,3,1.0,3,Hotter Than July,36.0,16,0,0,0,0,stay,1980-11-15
15853,Stevie Wonder,1981-03-14,Stevie Wonder - Hotter Than July,3,3,4,1.0,3,Hotter Than July,36.0,17,-1,0,0,1,down,1980-11-15
15854,Stevie Wonder,1981-03-21,Stevie Wonder - Hotter Than July,3,3,4,1.0,4,Hotter Than July,36.0,18,0,-1,0,0,stay,1980-11-15
15855,Stevie Wonder,1981-03-28,Stevie Wonder - Hotter Than July,4,3,4,1.0,4,Hotter Than July,36.0,19,0,0,-1,0,stay,1980-11-15
15856,Stevie Wonder,1981-04-04,Stevie Wonder - Hotter Than July,4,4,8,1.0,4,Hotter Than July,36.0,20,-4,0,0,1,down,1980-11-15
15857,Stevie Wonder,1981-04-11,Stevie Wonder - Hotter Than July,4,4,8,1.0,8,Hotter Than July,36.0,21,0,-4,0,0,stay,1980-11-15
15858,Stevie Wonder,1981-04-18,Stevie Wonder - Hotter Than July,8,4,9,1.0,8,Hotter Than July,36.0,22,-1,0,-4,1,down,1980-11-15
15859,Stevie Wonder,1981-04-25,Stevie Wonder - Hotter Than July,8,8,9,1.0,9,Hotter Than July,36.0,23,0,-1,0,0,stay,1980-11-15
15860,Stevie Wonder,1981-05-02,Stevie Wonder - Hotter Than July,9,8,10,1.0,9,Hotter Than July,36.0,24,-1,0,-1,1,down,1980-11-15
15861,Stevie Wonder,1981-05-09,Stevie Wonder - Hotter Than July,9,9,20,1.0,10,Hotter Than July,36.0,25,-10,-1,0,1,down,1980-11-15
15862,Stevie Wonder,1981-05-16,Stevie Wonder - Hotter Than July,10,9,20,1.0,20,Hotter Than July,36.0,26,0,-10,-1,0,stay,1980-11-15
15863,Stevie Wonder,1981-05-23,Stevie Wonder - Hotter Than July,20,10,23,1.0,20,Hotter Than July,36.0,27,-3,0,-10,1,down,1980-11-15
15864,Stevie Wonder,1981-05-30,Stevie Wonder - Hotter Than July,20,20,23,1.0,23,Hotter Than July,36.0,28,0,-3,0,0,stay,1980-11-15
15865,Stevie Wonder,1981-06-06,Stevie Wonder - Hotter Than July,23,20,27,1.0,23,Hotter Than July,36.0,29,-4,0,-3,1,down,1980-11-15
15866,Stevie Wonder,1981-06-13,Stevie Wonder - Hotter Than July,23,23,29,1.0,27,Hotter Than July,36.0,30,-2,-4,0,1,down,1980-11-15
15867,Stevie Wonder,1981-06-20,Stevie Wonder - Hotter Than July,27,23,29,1.0,29,Hotter Than July,36.0,31,0,-2,-4,0,stay,1980-11-15
15868,Stevie Wonder,1981-06-27,Stevie Wonder - Hotter Than July,29,27,30,1.0,29,Hotter Than July,36.0,32,-1,0,-2,1,down,1980-11-15
15869,Stevie Wonder,1981-07-04,Stevie Wonder - Hotter Than July,29,29,31,1.0,30,Hotter Than July,36.0,33,-1,-1,0,1,down,1980-11-15
15870,Stevie Wonder,1981-07-11,Stevie Wonder - Hotter Than July,30,29,33,1.0,31,Hotter Than July,36.0,34,-2,-1,-1,1,down,1980-11-15
15871,Stevie Wonder,1981-07-18,Stevie Wonder - Hotter Than July,31,30,41,1.0,33,Hotter Than July,36.0,35,-8,-2,-1,1,down,1980-11-15
15872,Stevie Wonder,1981-07-25,Stevie Wonder - Hotter Than July,33,31,51,1.0,41,Hotter Than July,36.0,36,-10,-8,-2,1,down,1980-11-15
15873,The Fatback Band,1980-11-15,The Fatback Band - 14 Karat,51,51,22,16.0,32,14 Karat,9.0,0,10,19,0,1,up,1980-11-15
15874,The Fatback Band,1980-11-22,The Fatback Band - 14 Karat,32,51,19,16.0,22,14 Karat,9.0,1,3,10,19,1,up,1980-11-15
15875,The Fatback Band,1980-11-29,The Fatback Band - 14 Karat,22,32,17,16.0,19,14 Karat,9.0,2,2,3,10,1,up,1980-11-15
15876,The Fatback Band,1980-12-06,The Fatback Band - 14 Karat,19,22,16,16.0,17,14 Karat,9.0,3,1,2,3,1,up,1980-11-15
15877,The Fatback Band,1980-12-13,The Fatback Band - 14 Karat,17,19,16,16.0,16,14 Karat,9.0,4,0,1,2,0,stay,1980-11-15
15878,The Fatback Band,1980-12-20,The Fatback Band - 14 Karat,16,17,32,16.0,16,14 Karat,9.0,5,-16,0,1,1,down,1980-11-15
15879,The Fatback Band,1980-12-27,The Fatback Band - 14 Karat,16,16,32,16.0,32,14 Karat,9.0,6,0,-16,0,0,stay,1980-11-15
15880,The Fatback Band,1981-01-03,The Fatback Band - 14 Karat,32,16,44,16.0,32,14 Karat,9.0,7,-12,0,-16,1,down,1980-11-15
15881,The Fatback Band,1981-01-10,The Fatback Band - 14 Karat,32,32,65,16.0,44,14 Karat,9.0,8,-21,-12,0,1,down,1980-11-15
15882,The Fatback Band,1981-01-31,The Fatback Band - 14 Karat,44,32,51,16.0,65,14 Karat,9.0,9,14,-21,-12,1,up,1980-11-15
15883,Cameo,1980-11-15,Cameo - Feel Me,51,51,19,6.0,35,Feel Me,27.0,0,16,16,0,1,up,1980-11-15
15884,Cameo,1980-11-22,Cameo - Feel Me,35,51,9,6.0,19,Feel Me,27.0,1,10,16,16,1,up,1980-11-15
15885,Cameo,1980-11-29,Cameo - Feel Me,19,35,8,6.0,9,Feel Me,27.0,2,1,10,16,1,up,1980-11-15
15886,Cameo,1980-12-06,Cameo - Feel Me,9,19,6,6.0,8,Feel Me,27.0,3,2,1,10,1,up,1980-11-15
15887,Cameo,1980-12-13,Cameo - Feel Me,8,9,6,6.0,6,Feel Me,27.0,4,0,2,1,0,stay,1980-11-15
15888,Cameo,1980-12-20,Cameo - Feel Me,6,8,6,6.0,6,Feel Me,27.0,5,0,0,2,0,stay,1980-11-15
15889,Cameo,1980-12-27,Cameo - Feel Me,6,6,6,6.0,6,Feel Me,27.0,6,0,0,0,0,stay,1980-11-15
15890,Cameo,1981-01-03,Cameo - Feel Me,6,6,9,6.0,6,Feel Me,27.0,7,-3,0,0,1,down,1980-11-15
15891,Cameo,1981-01-10,Cameo - Feel Me,6,6,8,6.0,9,Feel Me,27.0,8,1,-3,0,1,up,1980-11-15
15892,Cameo,1981-01-17,Cameo - Feel Me,9,6,8,6.0,8,Feel Me,27.0,9,0,1,-3,0,stay,1980-11-15
15893,Cameo,1981-01-24,Cameo - Feel Me,8,9,9,6.0,8,Feel Me,27.0,10,-1,0,1,1,down,1980-11-15
15894,Cameo,1981-01-31,Cameo - Feel Me,8,8,14,6.0,9,Feel Me,27.0,11,-5,-1,0,1,down,1980-11-15
15895,Cameo,1981-02-07,Cameo - Feel Me,9,8,15,6.0,14,Feel Me,27.0,12,-1,-5,-1,1,down,1980-11-15
15896,Cameo,1981-02-14,Cameo - Feel Me,14,9,15,6.0,15,Feel Me,27.0,13,0,-1,-5,0,stay,1980-11-15
15897,Cameo,1981-02-21,Cameo - Feel Me,15,14,20,6.0,15,Feel Me,27.0,14,-5,0,-1,1,down,1980-11-15
15898,Cameo,1981-02-28,Cameo - Feel Me,15,15,20,6.0,20,Feel Me,27.0,15,0,-5,0,0,stay,1980-11-15
15899,Cameo,1981-03-07,Cameo - Feel Me,20,15,21,6.0,20,Feel Me,27.0,16,-1,0,-5,1,down,1980-11-15
15900,Cameo,1981-03-14,Cameo - Feel Me,20,20,19,6.0,21,Feel Me,27.0,17,2,-1,0,1,up,1980-11-15
15901,Cameo,1981-03-21,Cameo - Feel Me,21,20,19,6.0,19,Feel Me,27.0,18,0,2,-1,0,stay,1980-11-15
15902,Cameo,1981-03-28,Cameo - Feel Me,19,21,22,6.0,19,Feel Me,27.0,19,-3,0,2,1,down,1980-11-15
15903,Cameo,1981-04-04,Cameo - Feel Me,19,19,24,6.0,22,Feel Me,27.0,20,-2,-3,0,1,down,1980-11-15
15904,Cameo,1981-04-11,Cameo - Feel Me,22,19,26,6.0,24,Feel Me,27.0,21,-2,-2,-3,1,down,1980-11-15
15905,Cameo,1981-04-18,Cameo - Feel Me,24,22,33,6.0,26,Feel Me,27.0,22,-7,-2,-2,1,down,1980-11-15
15906,Cameo,1981-04-25,Cameo - Feel Me,26,24,49,6.0,33,Feel Me,27.0,23,-16,-7,-2,1,down,1980-11-15
15907,Cameo,1981-06-20,Cameo - Feel Me,33,26,48,6.0,49,Feel Me,27.0,24,1,-16,-7,1,up,1980-11-15
15908,Cameo,1981-06-27,Cameo - Feel Me,49,33,48,6.0,48,Feel Me,27.0,25,0,1,-16,0,stay,1980-11-15
15909,Cameo,1981-07-04,Cameo - Feel Me,48,49,44,6.0,48,Feel Me,27.0,26,4,0,1,1,up,1980-11-15
15910,Cameo,1981-07-11,Cameo - Feel Me,48,48,51,6.0,44,Feel Me,27.0,27,-7,4,0,1,down,1980-11-15
15911,Twennynine Featuring Lenny White,1980-11-15,Twennynine Featuring Lenny White - Twennynine With Lenny White,51,51,29,22.0,39,Twennynine With Lenny White,6.0,0,10,12,0,1,up,1980-11-15
15912,Twennynine Featuring Lenny White,1980-11-22,Twennynine Featuring Lenny White - Twennynine With Lenny White,39,51,25,22.0,29,Twennynine With Lenny White,6.0,1,4,10,12,1,up,1980-11-15
15913,Twennynine Featuring Lenny White,1980-11-29,Twennynine Featuring Lenny White - Twennynine With Lenny White,29,39,22,22.0,25,Twennynine With Lenny White,6.0,2,3,4,10,1,up,1980-11-15
15914,Twennynine Featuring Lenny White,1980-12-06,Twennynine Featuring Lenny White - Twennynine With Lenny White,25,29,22,22.0,22,Twennynine With Lenny White,6.0,3,0,3,4,0,stay,1980-11-15
15915,Twennynine Featuring Lenny White,1980-12-13,Twennynine Featuring Lenny White - Twennynine With Lenny White,22,25,42,22.0,22,Twennynine With Lenny White,6.0,4,-20,0,3,1,down,1980-11-15
15916,Twennynine Featuring Lenny White,1980-12-20,Twennynine Featuring Lenny White - Twennynine With Lenny White,22,22,74,22.0,42,Twennynine With Lenny White,6.0,5,-32,-20,0,1,down,1980-11-15
15917,Twennynine Featuring Lenny White,1981-01-31,Twennynine Featuring Lenny White - Twennynine With Lenny White,42,22,51,22.0,74,Twennynine With Lenny White,6.0,6,23,-32,-20,1,up,1980-11-15
15918,Spyro Gyra,1980-11-15,Spyro Gyra - Carnaval,51,51,32,24.0,42,Carnaval,14.0,0,10,9,0,1,up,1980-11-15
15919,Spyro Gyra,1980-11-22,Spyro Gyra - Carnaval,42,51,27,24.0,32,Carnaval,14.0,1,5,10,9,1,up,1980-11-15
15920,Spyro Gyra,1980-11-29,Spyro Gyra - Carnaval,32,42,24,24.0,27,Carnaval,14.0,2,3,5,10,1,up,1980-11-15
15921,Spyro Gyra,1980-12-06,Spyro Gyra - Carnaval,27,32,24,24.0,24,Carnaval,14.0,3,0,3,5,0,stay,1980-11-15
15922,Spyro Gyra,1980-12-13,Spyro Gyra - Carnaval,24,27,29,24.0,24,Carnaval,14.0,4,-5,0,3,1,down,1980-11-15
15923,Spyro Gyra,1980-12-20,Spyro Gyra - Carnaval,24,24,28,24.0,29,Carnaval,14.0,5,1,-5,0,1,up,1980-11-15
15924,Spyro Gyra,1980-12-27,Spyro Gyra - Carnaval,29,24,28,24.0,28,Carnaval,14.0,6,0,1,-5,0,stay,1980-11-15
15925,Spyro Gyra,1981-01-03,Spyro Gyra - Carnaval,28,29,47,24.0,28,Carnaval,14.0,7,-19,0,1,1,down,1980-11-15
15926,Spyro Gyra,1981-01-10,Spyro Gyra - Carnaval,28,28,47,24.0,47,Carnaval,14.0,8,0,-19,0,0,stay,1980-11-15
15927,Spyro Gyra,1981-01-17,Spyro Gyra - Carnaval,47,28,48,24.0,47,Carnaval,14.0,9,-1,0,-19,1,down,1980-11-15
15928,Spyro Gyra,1981-01-24,Spyro Gyra - Carnaval,47,47,52,24.0,48,Carnaval,14.0,10,-4,-1,0,1,down,1980-11-15
15929,Spyro Gyra,1981-01-31,Spyro Gyra - Carnaval,48,47,49,24.0,52,Carnaval,14.0,11,3,-4,-1,1,up,1980-11-15
15930,Spyro Gyra,1981-02-07,Spyro Gyra - Carnaval,52,48,50,24.0,49,Carnaval,14.0,12,-1,3,-4,1,down,1980-11-15
15931,Spyro Gyra,1981-02-28,Spyro Gyra - Carnaval,49,52,49,24.0,50,Carnaval,14.0,13,1,-1,3,1,up,1980-11-15
15932,Spyro Gyra,1981-03-07,Spyro Gyra - Carnaval,50,49,51,24.0,49,Carnaval,14.0,14,-2,1,-1,1,down,1980-11-15
15933,"Grover Washington, Jr.",1980-11-22,"Grover Washington, Jr. - Winelight",51,51,26,2.0,40,Winelight,38.0,0,14,11,0,1,up,1980-11-22
15934,"Grover Washington, Jr.",1980-11-29,"Grover Washington, Jr. - Winelight",40,51,19,2.0,26,Winelight,38.0,1,7,14,11,1,up,1980-11-22
15935,"Grover Washington, Jr.",1980-12-06,"Grover Washington, Jr. - Winelight",26,40,17,2.0,19,Winelight,38.0,2,2,7,14,1,up,1980-11-22
15936,"Grover Washington, Jr.",1980-12-13,"Grover Washington, Jr. - Winelight",19,26,14,2.0,17,Winelight,38.0,3,3,2,7,1,up,1980-11-22
15937,"Grover Washington, Jr.",1980-12-20,"Grover Washington, Jr. - Winelight",17,19,12,2.0,14,Winelight,38.0,4,2,3,2,1,up,1980-11-22
15938,"Grover Washington, Jr.",1980-12-27,"Grover Washington, Jr. - Winelight",14,17,12,2.0,12,Winelight,38.0,5,0,2,3,0,stay,1980-11-22
15939,"Grover Washington, Jr.",1981-01-03,"Grover Washington, Jr. - Winelight",12,14,12,2.0,12,Winelight,38.0,6,0,0,2,0,stay,1980-11-22
15940,"Grover Washington, Jr.",1981-01-10,"Grover Washington, Jr. - Winelight",12,12,14,2.0,12,Winelight,38.0,7,-2,0,0,1,down,1980-11-22
15941,"Grover Washington, Jr.",1981-01-17,"Grover Washington, Jr. - Winelight",12,12,14,2.0,14,Winelight,38.0,8,0,-2,0,0,stay,1980-11-22
15942,"Grover Washington, Jr.",1981-01-24,"Grover Washington, Jr. - Winelight",14,12,13,2.0,14,Winelight,38.0,9,1,0,-2,1,up,1980-11-22
15943,"Grover Washington, Jr.",1981-02-07,"Grover Washington, Jr. - Winelight",14,14,12,2.0,13,Winelight,38.0,10,1,1,0,1,up,1980-11-22
15944,"Grover Washington, Jr.",1981-02-14,"Grover Washington, Jr. - Winelight",13,14,13,2.0,12,Winelight,38.0,11,-1,1,1,1,down,1980-11-22
15945,"Grover Washington, Jr.",1981-02-21,"Grover Washington, Jr. - Winelight",12,13,12,2.0,13,Winelight,38.0,12,1,-1,1,1,up,1980-11-22
15946,"Grover Washington, Jr.",1981-02-28,"Grover Washington, Jr. - Winelight",13,12,11,2.0,12,Winelight,38.0,13,1,1,-1,1,up,1980-11-22
15947,"Grover Washington, Jr.",1981-03-07,"Grover Washington, Jr. - Winelight",12,13,10,2.0,11,Winelight,38.0,14,1,1,1,1,up,1980-11-22
15948,"Grover Washington, Jr.",1981-03-14,"Grover Washington, Jr. - Winelight",11,12,8,2.0,10,Winelight,38.0,15,2,1,1,1,up,1980-11-22
15949,"Grover Washington, Jr.",1981-03-21,"Grover Washington, Jr. - Winelight",10,11,8,2.0,8,Winelight,38.0,16,0,2,1,0,stay,1980-11-22
15950,"Grover Washington, Jr.",1981-03-28,"Grover Washington, Jr. - Winelight",8,10,5,2.0,8,Winelight,38.0,17,3,0,2,1,up,1980-11-22
15951,"Grover Washington, Jr.",1981-04-04,"Grover Washington, Jr. - Winelight",8,8,3,2.0,5,Winelight,38.0,18,2,3,0,1,up,1980-11-22
15952,"Grover Washington, Jr.",1981-04-11,"Grover Washington, Jr. - Winelight",5,8,2,2.0,3,Winelight,38.0,19,1,2,3,1,up,1980-11-22
15953,"Grover Washington, Jr.",1981-04-18,"Grover Washington, Jr. - Winelight",3,5,2,2.0,2,Winelight,38.0,20,0,1,2,0,stay,1980-11-22
15954,"Grover Washington, Jr.",1981-04-25,"Grover Washington, Jr. - Winelight",2,3,2,2.0,2,Winelight,38.0,21,0,0,1,0,stay,1980-11-22
15955,"Grover Washington, Jr.",1981-05-02,"Grover Washington, Jr. - Winelight",2,2,2,2.0,2,Winelight,38.0,22,0,0,0,0,stay,1980-11-22
15956,"Grover Washington, Jr.",1981-05-09,"Grover Washington, Jr. - Winelight",2,2,5,2.0,2,Winelight,38.0,23,-3,0,0,1,down,1980-11-22
15957,"Grover Washington, Jr.",1981-05-16,"Grover Washington, Jr. - Winelight",2,2,7,2.0,5,Winelight,38.0,24,-2,-3,0,1,down,1980-11-22
15958,"Grover Washington, Jr.",1981-05-23,"Grover Washington, Jr. - Winelight",5,2,8,2.0,7,Winelight,38.0,25,-1,-2,-3,1,down,1980-11-22
15959,"Grover Washington, Jr.",1981-05-30,"Grover Washington, Jr. - Winelight",7,5,12,2.0,8,Winelight,38.0,26,-4,-1,-2,1,down,1980-11-22
15960,"Grover Washington, Jr.",1981-06-06,"Grover Washington, Jr. - Winelight",8,7,13,2.0,12,Winelight,38.0,27,-1,-4,-1,1,down,1980-11-22
15961,"Grover Washington, Jr.",1981-06-13,"Grover Washington, Jr. - Winelight",12,8,16,2.0,13,Winelight,38.0,28,-3,-1,-4,1,down,1980-11-22
15962,"Grover Washington, Jr.",1981-06-20,"Grover Washington, Jr. - Winelight",13,12,16,2.0,16,Winelight,38.0,29,0,-3,-1,0,stay,1980-11-22
15963,"Grover Washington, Jr.",1981-06-27,"Grover Washington, Jr. - Winelight",16,13,16,2.0,16,Winelight,38.0,30,0,0,-3,0,stay,1980-11-22
15964,"Grover Washington, Jr.",1981-07-04,"Grover Washington, Jr. - Winelight",16,16,16,2.0,16,Winelight,38.0,31,0,0,0,0,stay,1980-11-22
15965,"Grover Washington, Jr.",1981-07-11,"Grover Washington, Jr. - Winelight",16,16,19,2.0,16,Winelight,38.0,32,-3,0,0,1,down,1980-11-22
15966,"Grover Washington, Jr.",1981-07-18,"Grover Washington, Jr. - Winelight",16,16,19,2.0,19,Winelight,38.0,33,0,-3,0,0,stay,1980-11-22
15967,"Grover Washington, Jr.",1981-07-25,"Grover Washington, Jr. - Winelight",19,16,32,2.0,19,Winelight,38.0,34,-13,0,-3,1,down,1980-11-22
15968,"Grover Washington, Jr.",1981-08-01,"Grover Washington, Jr. - Winelight",19,19,33,2.0,32,Winelight,38.0,35,-1,-13,0,1,down,1980-11-22
15969,"Grover Washington, Jr.",1981-08-08,"Grover Washington, Jr. - Winelight",32,19,36,2.0,33,Winelight,38.0,36,-3,-1,-13,1,down,1980-11-22
15970,"Grover Washington, Jr.",1981-08-15,"Grover Washington, Jr. - Winelight",33,32,44,2.0,36,Winelight,38.0,37,-8,-3,-1,1,down,1980-11-22
15971,"Grover Washington, Jr.",1981-08-22,"Grover Washington, Jr. - Winelight",36,33,51,2.0,44,Winelight,38.0,38,-7,-8,-3,1,down,1980-11-22
15972,Switch,1980-11-22,Switch - This Is My Dream,51,51,35,21.0,45,This Is My Dream,18.0,0,10,6,0,1,up,1980-11-22
15973,Switch,1980-11-29,Switch - This Is My Dream,45,51,30,21.0,35,This Is My Dream,18.0,1,5,10,6,1,up,1980-11-22
15974,Switch,1980-12-06,Switch - This Is My Dream,35,45,25,21.0,30,This Is My Dream,18.0,2,5,5,10,1,up,1980-11-22
15975,Switch,1980-12-13,Switch - This Is My Dream,30,35,21,21.0,25,This Is My Dream,18.0,3,4,5,5,1,up,1980-11-22
15976,Switch,1980-12-20,Switch - This Is My Dream,25,30,21,21.0,21,This Is My Dream,18.0,4,0,4,5,0,stay,1980-11-22
15977,Switch,1980-12-27,Switch - This Is My Dream,21,25,21,21.0,21,This Is My Dream,18.0,5,0,0,4,0,stay,1980-11-22
15978,Switch,1981-01-03,Switch - This Is My Dream,21,21,27,21.0,21,This Is My Dream,18.0,6,-6,0,0,1,down,1980-11-22
15979,Switch,1981-01-10,Switch - This Is My Dream,21,21,31,21.0,27,This Is My Dream,18.0,7,-4,-6,0,1,down,1980-11-22
15980,Switch,1981-01-17,Switch - This Is My Dream,27,21,31,21.0,31,This Is My Dream,18.0,8,0,-4,-6,0,stay,1980-11-22
15981,Switch,1981-01-24,Switch - This Is My Dream,31,27,24,21.0,31,This Is My Dream,18.0,9,7,0,-4,1,up,1980-11-22
15982,Switch,1981-02-07,Switch - This Is My Dream,31,31,23,21.0,24,This Is My Dream,18.0,10,1,7,0,1,up,1980-11-22
15983,Switch,1981-02-14,Switch - This Is My Dream,24,31,23,21.0,23,This Is My Dream,18.0,11,0,1,7,0,stay,1980-11-22
15984,Switch,1981-02-21,Switch - This Is My Dream,23,24,22,21.0,23,This Is My Dream,18.0,12,1,0,1,1,up,1980-11-22
15985,Switch,1981-02-28,Switch - This Is My Dream,23,23,23,21.0,22,This Is My Dream,18.0,13,-1,1,0,1,down,1980-11-22
15986,Switch,1981-03-07,Switch - This Is My Dream,22,23,24,21.0,23,This Is My Dream,18.0,14,-1,-1,1,1,down,1980-11-22
15987,Switch,1981-03-14,Switch - This Is My Dream,23,22,34,21.0,24,This Is My Dream,18.0,15,-10,-1,-1,1,down,1980-11-22
15988,Switch,1981-03-21,Switch - This Is My Dream,24,23,34,21.0,34,This Is My Dream,18.0,16,0,-10,-1,0,stay,1980-11-22
15989,Switch,1981-03-28,Switch - This Is My Dream,34,24,43,21.0,34,This Is My Dream,18.0,17,-9,0,-10,1,down,1980-11-22
15990,Switch,1981-04-04,Switch - This Is My Dream,34,34,51,21.0,43,This Is My Dream,18.0,18,-8,-9,0,1,down,1980-11-22
15991,Roy Ayers,1980-11-22,Roy Ayers - Love Fantasy,51,51,47,47.0,47,Love Fantasy,1.0,0,0,4,0,0,stay,1980-11-22
15992,Roy Ayers,1980-11-29,Roy Ayers - Love Fantasy,47,51,51,47.0,47,Love Fantasy,1.0,1,-4,0,4,1,down,1980-11-22
15993,The Reddings,1980-11-22,The Reddings - The Awakening,51,51,40,21.0,50,The Awakening,13.0,0,10,1,0,1,up,1980-11-22
15994,The Reddings,1980-11-29,The Reddings - The Awakening,50,51,35,21.0,40,The Awakening,13.0,1,5,10,1,1,up,1980-11-22
15995,The Reddings,1980-12-06,The Reddings - The Awakening,40,50,30,21.0,35,The Awakening,13.0,2,5,5,10,1,up,1980-11-22
15996,The Reddings,1980-12-13,The Reddings - The Awakening,35,40,25,21.0,30,The Awakening,13.0,3,5,5,5,1,up,1980-11-22
15997,The Reddings,1980-12-20,The Reddings - The Awakening,30,35,22,21.0,25,The Awakening,13.0,4,3,5,5,1,up,1980-11-22
15998,The Reddings,1980-12-27,The Reddings - The Awakening,25,30,22,21.0,22,The Awakening,13.0,5,0,3,5,0,stay,1980-11-22
15999,The Reddings,1981-01-03,The Reddings - The Awakening,22,25,21,21.0,22,The Awakening,13.0,6,1,0,3,1,up,1980-11-22
16000,The Reddings,1981-01-10,The Reddings - The Awakening,22,22,26,21.0,21,The Awakening,13.0,7,-5,1,0,1,down,1980-11-22
16001,The Reddings,1981-01-17,The Reddings - The Awakening,21,22,32,21.0,26,The Awakening,13.0,8,-6,-5,1,1,down,1980-11-22
16002,The Reddings,1981-01-24,The Reddings - The Awakening,26,21,33,21.0,32,The Awakening,13.0,9,-1,-6,-5,1,down,1980-11-22
16003,The Reddings,1981-02-07,The Reddings - The Awakening,32,26,34,21.0,33,The Awakening,13.0,10,-1,-1,-6,1,down,1980-11-22
16004,The Reddings,1981-02-14,The Reddings - The Awakening,33,32,34,21.0,34,The Awakening,13.0,11,0,-1,-1,0,stay,1980-11-22
16005,The Reddings,1981-02-21,The Reddings - The Awakening,34,33,49,21.0,34,The Awakening,13.0,12,-15,0,-1,1,down,1980-11-22
16006,The Reddings,1981-02-28,The Reddings - The Awakening,34,34,51,21.0,49,The Awakening,13.0,13,-2,-15,0,1,down,1980-11-22
16007,"Earth, Wind & Fire",1980-11-29,"Earth, Wind & Fire - Faces",51,51,2,2.0,2,Faces,17.0,0,0,49,0,0,stay,1980-11-29
16008,"Earth, Wind & Fire",1980-12-06,"Earth, Wind & Fire - Faces",2,51,2,2.0,2,Faces,17.0,1,0,0,49,0,stay,1980-11-29
16009,"Earth, Wind & Fire",1980-12-13,"Earth, Wind & Fire - Faces",2,2,2,2.0,2,Faces,17.0,2,0,0,0,0,stay,1980-11-29
16010,"Earth, Wind & Fire",1980-12-20,"Earth, Wind & Fire - Faces",2,2,2,2.0,2,Faces,17.0,3,0,0,0,0,stay,1980-11-29
16011,"Earth, Wind & Fire",1980-12-27,"Earth, Wind & Fire - Faces",2,2,2,2.0,2,Faces,17.0,4,0,0,0,0,stay,1980-11-29
16012,"Earth, Wind & Fire",1981-01-03,"Earth, Wind & Fire - Faces",2,2,3,2.0,2,Faces,17.0,5,-1,0,0,1,down,1980-11-29
16013,"Earth, Wind & Fire",1981-01-10,"Earth, Wind & Fire - Faces",2,2,3,2.0,3,Faces,17.0,6,0,-1,0,0,stay,1980-11-29
16014,"Earth, Wind & Fire",1981-01-17,"Earth, Wind & Fire - Faces",3,2,11,2.0,3,Faces,17.0,7,-8,0,-1,1,down,1980-11-29
16015,"Earth, Wind & Fire",1981-01-24,"Earth, Wind & Fire - Faces",3,3,19,2.0,11,Faces,17.0,8,-8,-8,0,1,down,1980-11-29
16016,"Earth, Wind & Fire",1981-02-07,"Earth, Wind & Fire - Faces",11,3,21,2.0,19,Faces,17.0,9,-2,-8,-8,1,down,1980-11-29
16017,"Earth, Wind & Fire",1981-02-14,"Earth, Wind & Fire - Faces",19,11,27,2.0,21,Faces,17.0,10,-6,-2,-8,1,down,1980-11-29
16018,"Earth, Wind & Fire",1981-02-21,"Earth, Wind & Fire - Faces",21,19,27,2.0,27,Faces,17.0,11,0,-6,-2,0,stay,1980-11-29
16019,"Earth, Wind & Fire",1981-02-28,"Earth, Wind & Fire - Faces",27,21,28,2.0,27,Faces,17.0,12,-1,0,-6,1,down,1980-11-29
16020,"Earth, Wind & Fire",1981-03-07,"Earth, Wind & Fire - Faces",27,27,30,2.0,28,Faces,17.0,13,-2,-1,0,1,down,1980-11-29
16021,"Earth, Wind & Fire",1981-03-14,"Earth, Wind & Fire - Faces",28,27,43,2.0,30,Faces,17.0,14,-13,-2,-1,1,down,1980-11-29
16022,"Earth, Wind & Fire",1981-03-21,"Earth, Wind & Fire - Faces",30,28,43,2.0,43,Faces,17.0,15,0,-13,-2,0,stay,1980-11-29
16023,"Earth, Wind & Fire",1981-03-28,"Earth, Wind & Fire - Faces",43,30,48,2.0,43,Faces,17.0,16,-5,0,-13,1,down,1980-11-29
16024,"Earth, Wind & Fire",1981-04-04,"Earth, Wind & Fire - Faces",43,43,51,2.0,48,Faces,17.0,17,-3,-5,0,1,down,1980-11-29
16025,Hiroshima,1980-11-29,Hiroshima - Odori,51,51,36,31.0,45,Odori,6.0,0,9,6,0,1,up,1980-11-29
16026,Hiroshima,1980-12-06,Hiroshima - Odori,45,51,32,31.0,36,Odori,6.0,1,4,9,6,1,up,1980-11-29
16027,Hiroshima,1980-12-13,Hiroshima - Odori,36,45,31,31.0,32,Odori,6.0,2,1,4,9,1,up,1980-11-29
16028,Hiroshima,1980-12-20,Hiroshima - Odori,32,36,44,31.0,31,Odori,6.0,3,-13,1,4,1,down,1980-11-29
16029,Hiroshima,1980-12-27,Hiroshima - Odori,31,32,44,31.0,44,Odori,6.0,4,0,-13,1,0,stay,1980-11-29
16030,Hiroshima,1981-01-03,Hiroshima - Odori,44,31,58,31.0,44,Odori,6.0,5,-14,0,-13,1,down,1980-11-29
16031,Hiroshima,1981-01-31,Hiroshima - Odori,44,44,51,31.0,58,Odori,6.0,6,7,-14,0,1,up,1980-11-29
16032,Lakeside,1980-11-29,Lakeside - Fantastic Voyage,51,51,39,2.0,49,Fantastic Voyage,33.0,0,10,2,0,1,up,1980-11-29
16033,Lakeside,1980-12-06,Lakeside - Fantastic Voyage,49,51,20,2.0,39,Fantastic Voyage,33.0,1,19,10,2,1,up,1980-11-29
16034,Lakeside,1980-12-13,Lakeside - Fantastic Voyage,39,49,12,2.0,20,Fantastic Voyage,33.0,2,8,19,10,1,up,1980-11-29
16035,Lakeside,1980-12-20,Lakeside - Fantastic Voyage,20,39,10,2.0,12,Fantastic Voyage,33.0,3,2,8,19,1,up,1980-11-29
16036,Lakeside,1980-12-27,Lakeside - Fantastic Voyage,12,20,10,2.0,10,Fantastic Voyage,33.0,4,0,2,8,0,stay,1980-11-29
16037,Lakeside,1981-01-03,Lakeside - Fantastic Voyage,10,12,6,2.0,10,Fantastic Voyage,33.0,5,4,0,2,1,up,1980-11-29
16038,Lakeside,1981-01-10,Lakeside - Fantastic Voyage,10,10,5,2.0,6,Fantastic Voyage,33.0,6,1,4,0,1,up,1980-11-29
16039,Lakeside,1981-01-17,Lakeside - Fantastic Voyage,6,10,3,2.0,5,Fantastic Voyage,33.0,7,2,1,4,1,up,1980-11-29
16040,Lakeside,1981-01-24,Lakeside - Fantastic Voyage,5,6,3,2.0,3,Fantastic Voyage,33.0,8,0,2,1,0,stay,1980-11-29
16041,Lakeside,1981-01-31,Lakeside - Fantastic Voyage,3,5,2,2.0,3,Fantastic Voyage,33.0,9,1,0,2,1,up,1980-11-29
16042,Lakeside,1981-02-07,Lakeside - Fantastic Voyage,3,3,2,2.0,2,Fantastic Voyage,33.0,10,0,1,0,0,stay,1980-11-29
16043,Lakeside,1981-02-14,Lakeside - Fantastic Voyage,2,3,2,2.0,2,Fantastic Voyage,33.0,11,0,0,1,0,stay,1980-11-29
16044,Lakeside,1981-02-21,Lakeside - Fantastic Voyage,2,2,4,2.0,2,Fantastic Voyage,33.0,12,-2,0,0,1,down,1980-11-29
16045,Lakeside,1981-02-28,Lakeside - Fantastic Voyage,2,2,4,2.0,4,Fantastic Voyage,33.0,13,0,-2,0,0,stay,1980-11-29
16046,Lakeside,1981-03-07,Lakeside - Fantastic Voyage,4,2,5,2.0,4,Fantastic Voyage,33.0,14,-1,0,-2,1,down,1980-11-29
16047,Lakeside,1981-03-14,Lakeside - Fantastic Voyage,4,4,10,2.0,5,Fantastic Voyage,33.0,15,-5,-1,0,1,down,1980-11-29
16048,Lakeside,1981-03-21,Lakeside - Fantastic Voyage,5,4,10,2.0,10,Fantastic Voyage,33.0,16,0,-5,-1,0,stay,1980-11-29
16049,Lakeside,1981-03-28,Lakeside - Fantastic Voyage,10,5,11,2.0,10,Fantastic Voyage,33.0,17,-1,0,-5,1,down,1980-11-29
16050,Lakeside,1981-04-04,Lakeside - Fantastic Voyage,10,10,11,2.0,11,Fantastic Voyage,33.0,18,0,-1,0,0,stay,1980-11-29
16051,Lakeside,1981-04-11,Lakeside - Fantastic Voyage,11,10,11,2.0,11,Fantastic Voyage,33.0,19,0,0,-1,0,stay,1980-11-29
16052,Lakeside,1981-04-18,Lakeside - Fantastic Voyage,11,11,11,2.0,11,Fantastic Voyage,33.0,20,0,0,0,0,stay,1980-11-29
16053,Lakeside,1981-04-25,Lakeside - Fantastic Voyage,11,11,12,2.0,11,Fantastic Voyage,33.0,21,-1,0,0,1,down,1980-11-29
16054,Lakeside,1981-05-02,Lakeside - Fantastic Voyage,11,11,18,2.0,12,Fantastic Voyage,33.0,22,-6,-1,0,1,down,1980-11-29
16055,Lakeside,1981-05-09,Lakeside - Fantastic Voyage,12,11,19,2.0,18,Fantastic Voyage,33.0,23,-1,-6,-1,1,down,1980-11-29
16056,Lakeside,1981-05-16,Lakeside - Fantastic Voyage,18,12,19,2.0,19,Fantastic Voyage,33.0,24,0,-1,-6,0,stay,1980-11-29
16057,Lakeside,1981-05-23,Lakeside - Fantastic Voyage,19,18,18,2.0,19,Fantastic Voyage,33.0,25,1,0,-1,1,up,1980-11-29
16058,Lakeside,1981-05-30,Lakeside - Fantastic Voyage,19,19,27,2.0,18,Fantastic Voyage,33.0,26,-9,1,0,1,down,1980-11-29
16059,Lakeside,1981-06-06,Lakeside - Fantastic Voyage,18,19,29,2.0,27,Fantastic Voyage,33.0,27,-2,-9,1,1,down,1980-11-29
16060,Lakeside,1981-06-13,Lakeside - Fantastic Voyage,27,18,34,2.0,29,Fantastic Voyage,33.0,28,-5,-2,-9,1,down,1980-11-29
16061,Lakeside,1981-06-20,Lakeside - Fantastic Voyage,29,27,37,2.0,34,Fantastic Voyage,33.0,29,-3,-5,-2,1,down,1980-11-29
16062,Lakeside,1981-06-27,Lakeside - Fantastic Voyage,34,29,41,2.0,37,Fantastic Voyage,33.0,30,-4,-3,-5,1,down,1980-11-29
16063,Lakeside,1981-07-04,Lakeside - Fantastic Voyage,37,34,41,2.0,41,Fantastic Voyage,33.0,31,0,-4,-3,0,stay,1980-11-29
16064,Lakeside,1981-07-11,Lakeside - Fantastic Voyage,41,37,41,2.0,41,Fantastic Voyage,33.0,32,0,0,-4,0,stay,1980-11-29
16065,Lakeside,1981-07-18,Lakeside - Fantastic Voyage,41,41,51,2.0,41,Fantastic Voyage,33.0,33,-10,0,0,1,down,1980-11-29
16066,Patrice Rushen,1980-11-29,Patrice Rushen - Posh,51,51,40,23.0,50,Posh,17.0,0,10,1,0,1,up,1980-11-29
16067,Patrice Rushen,1980-12-06,Patrice Rushen - Posh,50,51,33,23.0,40,Posh,17.0,1,7,10,1,1,up,1980-11-29
16068,Patrice Rushen,1980-12-13,Patrice Rushen - Posh,40,50,23,23.0,33,Posh,17.0,2,10,7,10,1,up,1980-11-29
16069,Patrice Rushen,1980-12-20,Patrice Rushen - Posh,33,40,23,23.0,23,Posh,17.0,3,0,10,7,0,stay,1980-11-29
16070,Patrice Rushen,1980-12-27,Patrice Rushen - Posh,23,33,23,23.0,23,Posh,17.0,4,0,0,10,0,stay,1980-11-29
16071,Patrice Rushen,1981-01-03,Patrice Rushen - Posh,23,23,23,23.0,23,Posh,17.0,5,0,0,0,0,stay,1980-11-29
16072,Patrice Rushen,1981-01-10,Patrice Rushen - Posh,23,23,27,23.0,23,Posh,17.0,6,-4,0,0,1,down,1980-11-29
16073,Patrice Rushen,1981-01-17,Patrice Rushen - Posh,23,23,27,23.0,27,Posh,17.0,7,0,-4,0,0,stay,1980-11-29
16074,Patrice Rushen,1981-01-24,Patrice Rushen - Posh,27,23,29,23.0,27,Posh,17.0,8,-2,0,-4,1,down,1980-11-29
16075,Patrice Rushen,1981-02-07,Patrice Rushen - Posh,27,27,31,23.0,29,Posh,17.0,9,-2,-2,0,1,down,1980-11-29
16076,Patrice Rushen,1981-02-14,Patrice Rushen - Posh,29,27,32,23.0,31,Posh,17.0,10,-1,-2,-2,1,down,1980-11-29
16077,Patrice Rushen,1981-02-21,Patrice Rushen - Posh,31,29,32,23.0,32,Posh,17.0,11,0,-1,-2,0,stay,1980-11-29
16078,Patrice Rushen,1981-02-28,Patrice Rushen - Posh,32,31,34,23.0,32,Posh,17.0,12,-2,0,-1,1,down,1980-11-29
16079,Patrice Rushen,1981-03-07,Patrice Rushen - Posh,32,32,42,23.0,34,Posh,17.0,13,-8,-2,0,1,down,1980-11-29
16080,Patrice Rushen,1981-03-14,Patrice Rushen - Posh,34,32,42,23.0,42,Posh,17.0,14,0,-8,-2,0,stay,1980-11-29
16081,Patrice Rushen,1981-03-21,Patrice Rushen - Posh,42,34,45,23.0,42,Posh,17.0,15,-3,0,-8,1,down,1980-11-29
16082,Patrice Rushen,1981-03-28,Patrice Rushen - Posh,42,42,50,23.0,45,Posh,17.0,16,-5,-3,0,1,down,1980-11-29
16083,Patrice Rushen,1981-04-04,Patrice Rushen - Posh,45,42,51,23.0,50,Posh,17.0,17,-1,-5,-3,1,down,1980-11-29
16084,Herbie Hancock,1980-12-06,Herbie Hancock - Mr. Hands,51,51,46,46.0,47,Mr. Hands,2.0,0,1,4,0,1,up,1980-12-06
16085,Herbie Hancock,1980-12-13,Herbie Hancock - Mr. Hands,47,51,70,46.0,46,Mr. Hands,2.0,1,-24,1,4,1,down,1980-12-06
16086,Herbie Hancock,1981-01-31,Herbie Hancock - Mr. Hands,46,47,51,46.0,70,Mr. Hands,2.0,2,19,-24,1,1,up,1980-12-06
16087,The Dramatics,1980-12-06,The Dramatics - The Dramatic Way,51,51,43,38.0,48,The Dramatic Way,8.0,0,5,3,0,1,up,1980-12-06
16088,The Dramatics,1980-12-13,The Dramatics - The Dramatic Way,48,51,38,38.0,43,The Dramatic Way,8.0,1,5,5,3,1,up,1980-12-06
16089,The Dramatics,1980-12-20,The Dramatics - The Dramatic Way,43,48,38,38.0,38,The Dramatic Way,8.0,2,0,5,5,0,stay,1980-12-06
16090,The Dramatics,1980-12-27,The Dramatics - The Dramatic Way,38,43,38,38.0,38,The Dramatic Way,8.0,3,0,0,5,0,stay,1980-12-06
16091,The Dramatics,1981-01-03,The Dramatics - The Dramatic Way,38,38,46,38.0,38,The Dramatic Way,8.0,4,-8,0,0,1,down,1980-12-06
16092,The Dramatics,1981-01-10,The Dramatics - The Dramatic Way,38,38,48,38.0,46,The Dramatic Way,8.0,5,-2,-8,0,1,down,1980-12-06
16093,The Dramatics,1981-01-17,The Dramatics - The Dramatic Way,46,38,49,38.0,48,The Dramatic Way,8.0,6,-1,-2,-8,1,down,1980-12-06
16094,The Dramatics,1981-01-24,The Dramatics - The Dramatic Way,48,46,55,38.0,49,The Dramatic Way,8.0,7,-6,-1,-2,1,down,1980-12-06
16095,The Dramatics,1981-01-31,The Dramatics - The Dramatic Way,49,48,51,38.0,55,The Dramatic Way,8.0,8,4,-6,-1,1,up,1980-12-06
16096,Sweat Band,1980-12-06,Sweat Band - Sweat Band,51,51,35,22.0,50,Sweat Band,10.0,0,15,1,0,1,up,1980-12-06
16097,Sweat Band,1980-12-13,Sweat Band - Sweat Band,50,51,30,22.0,35,Sweat Band,10.0,1,5,15,1,1,up,1980-12-06
16098,Sweat Band,1980-12-20,Sweat Band - Sweat Band,35,50,25,22.0,30,Sweat Band,10.0,2,5,5,15,1,up,1980-12-06
16099,Sweat Band,1980-12-27,Sweat Band - Sweat Band,30,35,25,22.0,25,Sweat Band,10.0,3,0,5,5,0,stay,1980-12-06
16100,Sweat Band,1981-01-03,Sweat Band - Sweat Band,25,30,22,22.0,25,Sweat Band,10.0,4,3,0,5,1,up,1980-12-06
16101,Sweat Band,1981-01-10,Sweat Band - Sweat Band,25,25,22,22.0,22,Sweat Band,10.0,5,0,3,0,0,stay,1980-12-06
16102,Sweat Band,1981-01-17,Sweat Band - Sweat Band,22,25,26,22.0,22,Sweat Band,10.0,6,-4,0,3,1,down,1980-12-06
16103,Sweat Band,1981-01-24,Sweat Band - Sweat Band,22,22,28,22.0,26,Sweat Band,10.0,7,-2,-4,0,1,down,1980-12-06
16104,Sweat Band,1981-02-07,Sweat Band - Sweat Band,26,22,44,22.0,28,Sweat Band,10.0,8,-16,-2,-4,1,down,1980-12-06
16105,Sweat Band,1981-02-14,Sweat Band - Sweat Band,28,26,50,22.0,44,Sweat Band,10.0,9,-6,-16,-2,1,down,1980-12-06
16106,Sweat Band,1981-02-21,Sweat Band - Sweat Band,44,28,51,22.0,50,Sweat Band,10.0,10,-1,-6,-16,1,down,1980-12-06
16107,Bootsy,1980-12-13,Bootsy - Ultra Wave,51,51,35,30.0,45,Ultra Wave,9.0,0,10,6,0,1,up,1980-12-13
16108,Bootsy,1980-12-20,Bootsy - Ultra Wave,45,51,31,30.0,35,Ultra Wave,9.0,1,4,10,6,1,up,1980-12-13
16109,Bootsy,1980-12-27,Bootsy - Ultra Wave,35,45,31,30.0,31,Ultra Wave,9.0,2,0,4,10,0,stay,1980-12-13
16110,Bootsy,1981-01-03,Bootsy - Ultra Wave,31,35,30,30.0,31,Ultra Wave,9.0,3,1,0,4,1,up,1980-12-13
16111,Bootsy,1981-01-10,Bootsy - Ultra Wave,31,31,33,30.0,30,Ultra Wave,9.0,4,-3,1,0,1,down,1980-12-13
16112,Bootsy,1981-01-17,Bootsy - Ultra Wave,30,31,36,30.0,33,Ultra Wave,9.0,5,-3,-3,1,1,down,1980-12-13
16113,Bootsy,1981-01-24,Bootsy - Ultra Wave,33,30,41,30.0,36,Ultra Wave,9.0,6,-5,-3,-3,1,down,1980-12-13
16114,Bootsy,1981-01-31,Bootsy - Ultra Wave,36,33,48,30.0,41,Ultra Wave,9.0,7,-7,-5,-3,1,down,1980-12-13
16115,Bootsy,1981-02-07,Bootsy - Ultra Wave,41,36,48,30.0,48,Ultra Wave,9.0,8,0,-7,-5,0,stay,1980-12-13
16116,Bootsy,1981-02-14,Bootsy - Ultra Wave,48,41,51,30.0,48,Ultra Wave,9.0,9,-3,0,-7,1,down,1980-12-13
16117,Bobby Bland,1980-12-13,Bobby Bland - Sweet Vibrations,51,51,40,29.0,47,Sweet Vibrations,14.0,0,7,4,0,1,up,1980-12-13
16118,Bobby Bland,1980-12-20,Bobby Bland - Sweet Vibrations,47,51,30,29.0,40,Sweet Vibrations,14.0,1,10,7,4,1,up,1980-12-13
16119,Bobby Bland,1980-12-27,Bobby Bland - Sweet Vibrations,40,47,30,29.0,30,Sweet Vibrations,14.0,2,0,10,7,0,stay,1980-12-13
16120,Bobby Bland,1981-01-03,Bobby Bland - Sweet Vibrations,30,40,29,29.0,30,Sweet Vibrations,14.0,3,1,0,10,1,up,1980-12-13
16121,Bobby Bland,1981-01-10,Bobby Bland - Sweet Vibrations,30,30,29,29.0,29,Sweet Vibrations,14.0,4,0,1,0,0,stay,1980-12-13
16122,Bobby Bland,1981-01-17,Bobby Bland - Sweet Vibrations,29,30,30,29.0,29,Sweet Vibrations,14.0,5,-1,0,1,1,down,1980-12-13
16123,Bobby Bland,1981-01-24,Bobby Bland - Sweet Vibrations,29,29,41,29.0,30,Sweet Vibrations,14.0,6,-11,-1,0,1,down,1980-12-13
16124,Bobby Bland,1981-02-07,Bobby Bland - Sweet Vibrations,30,29,42,29.0,41,Sweet Vibrations,14.0,7,-1,-11,-1,1,down,1980-12-13
16125,Bobby Bland,1981-02-14,Bobby Bland - Sweet Vibrations,41,30,43,29.0,42,Sweet Vibrations,14.0,8,-1,-1,-11,1,down,1980-12-13
16126,Bobby Bland,1981-02-21,Bobby Bland - Sweet Vibrations,42,41,43,29.0,43,Sweet Vibrations,14.0,9,0,-1,-1,0,stay,1980-12-13
16127,Bobby Bland,1981-02-28,Bobby Bland - Sweet Vibrations,43,42,46,29.0,43,Sweet Vibrations,14.0,10,-3,0,-1,1,down,1980-12-13
16128,Bobby Bland,1981-03-07,Bobby Bland - Sweet Vibrations,43,43,49,29.0,46,Sweet Vibrations,14.0,11,-3,-3,0,1,down,1980-12-13
16129,Bobby Bland,1981-03-14,Bobby Bland - Sweet Vibrations,46,43,49,29.0,49,Sweet Vibrations,14.0,12,0,-3,-3,0,stay,1980-12-13
16130,Bobby Bland,1981-03-21,Bobby Bland - Sweet Vibrations,49,46,48,29.0,49,Sweet Vibrations,14.0,13,1,0,-3,1,up,1980-12-13
16131,Bobby Bland,1981-03-28,Bobby Bland - Sweet Vibrations,49,49,51,29.0,48,Sweet Vibrations,14.0,14,-3,1,0,1,down,1980-12-13
16132,Jermaine Jackson,1980-12-13,Jermaine Jackson - Jermaine,51,51,37,17.0,50,Jermaine,28.0,0,13,1,0,1,up,1980-12-13
16133,Jermaine Jackson,1980-12-20,Jermaine Jackson - Jermaine,50,51,33,17.0,37,Jermaine,28.0,1,4,13,1,1,up,1980-12-13
16134,Jermaine Jackson,1980-12-27,Jermaine Jackson - Jermaine,37,50,33,17.0,33,Jermaine,28.0,2,0,4,13,0,stay,1980-12-13
16135,Jermaine Jackson,1981-01-03,Jermaine Jackson - Jermaine,33,37,25,17.0,33,Jermaine,28.0,3,8,0,4,1,up,1980-12-13
16136,Jermaine Jackson,1981-01-10,Jermaine Jackson - Jermaine,33,33,21,17.0,25,Jermaine,28.0,4,4,8,0,1,up,1980-12-13
16137,Jermaine Jackson,1981-01-17,Jermaine Jackson - Jermaine,25,33,21,17.0,21,Jermaine,28.0,5,0,4,8,0,stay,1980-12-13
16138,Jermaine Jackson,1981-01-24,Jermaine Jackson - Jermaine,21,25,20,17.0,21,Jermaine,28.0,6,1,0,4,1,up,1980-12-13
16139,Jermaine Jackson,1981-02-07,Jermaine Jackson - Jermaine,21,21,19,17.0,20,Jermaine,28.0,7,1,1,0,1,up,1980-12-13
16140,Jermaine Jackson,1981-02-14,Jermaine Jackson - Jermaine,20,21,18,17.0,19,Jermaine,28.0,8,1,1,1,1,up,1980-12-13
16141,Jermaine Jackson,1981-02-21,Jermaine Jackson - Jermaine,19,20,17,17.0,18,Jermaine,28.0,9,1,1,1,1,up,1980-12-13
16142,Jermaine Jackson,1981-02-28,Jermaine Jackson - Jermaine,18,19,22,17.0,17,Jermaine,28.0,10,-5,1,1,1,down,1980-12-13
16143,Jermaine Jackson,1981-03-07,Jermaine Jackson - Jermaine,17,18,23,17.0,22,Jermaine,28.0,11,-1,-5,1,1,down,1980-12-13
16144,Jermaine Jackson,1981-03-14,Jermaine Jackson - Jermaine,22,17,23,17.0,23,Jermaine,28.0,12,0,-1,-5,0,stay,1980-12-13
16145,Jermaine Jackson,1981-03-21,Jermaine Jackson - Jermaine,23,22,27,17.0,23,Jermaine,28.0,13,-4,0,-1,1,down,1980-12-13
16146,Jermaine Jackson,1981-03-28,Jermaine Jackson - Jermaine,23,23,33,17.0,27,Jermaine,28.0,14,-6,-4,0,1,down,1980-12-13
16147,Jermaine Jackson,1981-04-04,Jermaine Jackson - Jermaine,27,23,33,17.0,33,Jermaine,28.0,15,0,-6,-4,0,stay,1980-12-13
16148,Jermaine Jackson,1981-04-11,Jermaine Jackson - Jermaine,33,27,27,17.0,33,Jermaine,28.0,16,6,0,-6,1,up,1980-12-13
16149,Jermaine Jackson,1981-04-18,Jermaine Jackson - Jermaine,33,33,25,17.0,27,Jermaine,28.0,17,2,6,0,1,up,1980-12-13
16150,Jermaine Jackson,1981-04-25,Jermaine Jackson - Jermaine,27,33,20,17.0,25,Jermaine,28.0,18,5,2,6,1,up,1980-12-13
16151,Jermaine Jackson,1981-05-02,Jermaine Jackson - Jermaine,25,27,20,17.0,20,Jermaine,28.0,19,0,5,2,0,stay,1980-12-13
16152,Jermaine Jackson,1981-05-09,Jermaine Jackson - Jermaine,20,25,21,17.0,20,Jermaine,28.0,20,-1,0,5,1,down,1980-12-13
16153,Jermaine Jackson,1981-05-16,Jermaine Jackson - Jermaine,20,20,25,17.0,21,Jermaine,28.0,21,-4,-1,0,1,down,1980-12-13
16154,Jermaine Jackson,1981-05-23,Jermaine Jackson - Jermaine,21,20,28,17.0,25,Jermaine,28.0,22,-3,-4,-1,1,down,1980-12-13
16155,Jermaine Jackson,1981-05-30,Jermaine Jackson - Jermaine,25,21,34,17.0,28,Jermaine,28.0,23,-6,-3,-4,1,down,1980-12-13
16156,Jermaine Jackson,1981-06-06,Jermaine Jackson - Jermaine,28,25,35,17.0,34,Jermaine,28.0,24,-1,-6,-3,1,down,1980-12-13
16157,Jermaine Jackson,1981-06-13,Jermaine Jackson - Jermaine,34,28,40,17.0,35,Jermaine,28.0,25,-5,-1,-6,1,down,1980-12-13
16158,Jermaine Jackson,1981-06-20,Jermaine Jackson - Jermaine,35,34,41,17.0,40,Jermaine,28.0,26,-1,-5,-1,1,down,1980-12-13
16159,Jermaine Jackson,1981-06-27,Jermaine Jackson - Jermaine,40,35,46,17.0,41,Jermaine,28.0,27,-5,-1,-5,1,down,1980-12-13
16160,Jermaine Jackson,1981-07-04,Jermaine Jackson - Jermaine,41,40,51,17.0,46,Jermaine,28.0,28,-5,-5,-1,1,down,1980-12-13
16161,Barkays,1980-12-20,Barkays - As One,51,51,13,6.0,19,As One,18.0,0,6,32,0,1,up,1980-12-20
16162,Barkays,1980-12-27,Barkays - As One,19,51,13,6.0,13,As One,18.0,1,0,6,32,0,stay,1980-12-20
16163,Barkays,1981-01-03,Barkays - As One,13,19,11,6.0,13,As One,18.0,2,2,0,6,1,up,1980-12-20
16164,Barkays,1981-01-10,Barkays - As One,13,13,10,6.0,11,As One,18.0,3,1,2,0,1,up,1980-12-20
16165,Barkays,1981-01-17,Barkays - As One,11,13,10,6.0,10,As One,18.0,4,0,1,2,0,stay,1980-12-20
16166,Barkays,1981-01-24,Barkays - As One,10,11,7,6.0,10,As One,18.0,5,3,0,1,1,up,1980-12-20
16167,Barkays,1981-01-31,Barkays - As One,10,10,6,6.0,7,As One,18.0,6,1,3,0,1,up,1980-12-20
16168,Barkays,1981-02-07,Barkays - As One,7,10,6,6.0,6,As One,18.0,7,0,1,3,0,stay,1980-12-20
16169,Barkays,1981-02-14,Barkays - As One,6,7,7,6.0,6,As One,18.0,8,-1,0,1,1,down,1980-12-20
16170,Barkays,1981-02-21,Barkays - As One,6,6,8,6.0,7,As One,18.0,9,-1,-1,0,1,down,1980-12-20
16171,Barkays,1981-02-28,Barkays - As One,7,6,12,6.0,8,As One,18.0,10,-4,-1,-1,1,down,1980-12-20
16172,Barkays,1981-03-07,Barkays - As One,8,7,13,6.0,12,As One,18.0,11,-1,-4,-1,1,down,1980-12-20
16173,Barkays,1981-03-14,Barkays - As One,12,8,17,6.0,13,As One,18.0,12,-4,-1,-4,1,down,1980-12-20
16174,Barkays,1981-03-21,Barkays - As One,13,12,20,6.0,17,As One,18.0,13,-3,-4,-1,1,down,1980-12-20
16175,Barkays,1981-03-28,Barkays - As One,17,13,24,6.0,20,As One,18.0,14,-4,-3,-4,1,down,1980-12-20
16176,Barkays,1981-04-04,Barkays - As One,20,17,34,6.0,24,As One,18.0,15,-10,-4,-3,1,down,1980-12-20
16177,Barkays,1981-04-11,Barkays - As One,24,20,36,6.0,34,As One,18.0,16,-2,-10,-4,1,down,1980-12-20
16178,Barkays,1981-04-18,Barkays - As One,34,24,46,6.0,36,As One,18.0,17,-10,-2,-10,1,down,1980-12-20
16179,Barkays,1981-04-25,Barkays - As One,36,34,51,6.0,46,As One,18.0,18,-5,-10,-2,1,down,1980-12-20
16180,ConFunkShun,1980-12-20,ConFunkShun - Touch,51,51,18,7.0,24,Touch,17.0,0,6,27,0,1,up,1980-12-20
16181,ConFunkShun,1980-12-27,ConFunkShun - Touch,24,51,18,7.0,18,Touch,17.0,1,0,6,27,0,stay,1980-12-20
16182,ConFunkShun,1981-01-03,ConFunkShun - Touch,18,24,10,7.0,18,Touch,17.0,2,8,0,6,1,up,1980-12-20
16183,ConFunkShun,1981-01-10,ConFunkShun - Touch,18,18,9,7.0,10,Touch,17.0,3,1,8,0,1,up,1980-12-20
16184,ConFunkShun,1981-01-17,ConFunkShun - Touch,10,18,9,7.0,9,Touch,17.0,4,0,1,8,0,stay,1980-12-20
16185,ConFunkShun,1981-01-24,ConFunkShun - Touch,9,10,8,7.0,9,Touch,17.0,5,1,0,1,1,up,1980-12-20
16186,ConFunkShun,1981-01-31,ConFunkShun - Touch,9,9,7,7.0,8,Touch,17.0,6,1,1,0,1,up,1980-12-20
16187,ConFunkShun,1981-02-07,ConFunkShun - Touch,8,9,7,7.0,7,Touch,17.0,7,0,1,1,0,stay,1980-12-20
16188,ConFunkShun,1981-02-14,ConFunkShun - Touch,7,8,9,7.0,7,Touch,17.0,8,-2,0,1,1,down,1980-12-20
16189,ConFunkShun,1981-02-21,ConFunkShun - Touch,7,7,13,7.0,9,Touch,17.0,9,-4,-2,0,1,down,1980-12-20
16190,ConFunkShun,1981-02-28,ConFunkShun - Touch,9,7,18,7.0,13,Touch,17.0,10,-5,-4,-2,1,down,1980-12-20
16191,ConFunkShun,1981-03-07,ConFunkShun - Touch,13,9,20,7.0,18,Touch,17.0,11,-2,-5,-4,1,down,1980-12-20
16192,ConFunkShun,1981-03-14,ConFunkShun - Touch,18,13,26,7.0,20,Touch,17.0,12,-6,-2,-5,1,down,1980-12-20
16193,ConFunkShun,1981-03-21,ConFunkShun - Touch,20,18,39,7.0,26,Touch,17.0,13,-13,-6,-2,1,down,1980-12-20
16194,ConFunkShun,1981-03-28,ConFunkShun - Touch,26,20,39,7.0,39,Touch,17.0,14,0,-13,-6,0,stay,1980-12-20
16195,ConFunkShun,1981-04-04,ConFunkShun - Touch,39,26,41,7.0,39,Touch,17.0,15,-2,0,-13,1,down,1980-12-20
16196,ConFunkShun,1981-04-11,ConFunkShun - Touch,39,39,46,7.0,41,Touch,17.0,16,-5,-2,0,1,down,1980-12-20
16197,ConFunkShun,1981-04-18,ConFunkShun - Touch,41,39,51,7.0,46,Touch,17.0,17,-5,-5,-2,1,down,1980-12-20
16198,Heatwave,1980-12-20,Heatwave - Candles,51,51,29,24.0,39,Candles,10.0,0,10,12,0,1,up,1980-12-20
16199,Heatwave,1980-12-27,Heatwave - Candles,39,51,29,24.0,29,Candles,10.0,1,0,10,12,0,stay,1980-12-20
16200,Heatwave,1981-01-03,Heatwave - Candles,29,39,24,24.0,29,Candles,10.0,2,5,0,10,1,up,1980-12-20
16201,Heatwave,1981-01-10,Heatwave - Candles,29,29,24,24.0,24,Candles,10.0,3,0,5,0,0,stay,1980-12-20
16202,Heatwave,1981-01-17,Heatwave - Candles,24,29,25,24.0,24,Candles,10.0,4,-1,0,5,1,down,1980-12-20
16203,Heatwave,1981-01-24,Heatwave - Candles,24,24,30,24.0,25,Candles,10.0,5,-5,-1,0,1,down,1980-12-20
16204,Heatwave,1981-02-07,Heatwave - Candles,25,24,36,24.0,30,Candles,10.0,6,-6,-5,-1,1,down,1980-12-20
16205,Heatwave,1981-02-14,Heatwave - Candles,30,25,36,24.0,36,Candles,10.0,7,0,-6,-5,0,stay,1980-12-20
16206,Heatwave,1981-02-21,Heatwave - Candles,36,30,47,24.0,36,Candles,10.0,8,-11,0,-6,1,down,1980-12-20
16207,Heatwave,1981-02-28,Heatwave - Candles,36,36,48,24.0,47,Candles,10.0,9,-1,-11,0,1,down,1980-12-20
16208,Heatwave,1981-03-07,Heatwave - Candles,47,36,51,24.0,48,Candles,10.0,10,-3,-1,-11,1,down,1980-12-20
16209,Skyy,1980-12-20,Skyy - Skyyport,51,51,42,16.0,50,Skyyport,21.0,0,8,1,0,1,up,1980-12-20
16210,Skyy,1980-12-27,Skyy - Skyyport,50,51,42,16.0,42,Skyyport,21.0,1,0,8,1,0,stay,1980-12-20
16211,Skyy,1981-01-03,Skyy - Skyyport,42,50,34,16.0,42,Skyyport,21.0,2,8,0,8,1,up,1980-12-20
16212,Skyy,1981-01-10,Skyy - Skyyport,42,42,34,16.0,34,Skyyport,21.0,3,0,8,0,0,stay,1980-12-20
16213,Skyy,1981-01-17,Skyy - Skyyport,34,42,33,16.0,34,Skyyport,21.0,4,1,0,8,1,up,1980-12-20
16214,Skyy,1981-01-24,Skyy - Skyyport,34,34,27,16.0,33,Skyyport,21.0,5,6,1,0,1,up,1980-12-20
16215,Skyy,1981-02-07,Skyy - Skyyport,33,34,24,16.0,27,Skyyport,21.0,6,3,6,1,1,up,1980-12-20
16216,Skyy,1981-02-14,Skyy - Skyyport,27,33,22,16.0,24,Skyyport,21.0,7,2,3,6,1,up,1980-12-20
16217,Skyy,1981-02-21,Skyy - Skyyport,24,27,19,16.0,22,Skyyport,21.0,8,3,2,3,1,up,1980-12-20
16218,Skyy,1981-02-28,Skyy - Skyyport,22,24,16,16.0,19,Skyyport,21.0,9,3,3,2,1,up,1980-12-20
16219,Skyy,1981-03-07,Skyy - Skyyport,19,22,16,16.0,16,Skyyport,21.0,10,0,3,3,0,stay,1980-12-20
16220,Skyy,1981-03-14,Skyy - Skyyport,16,19,16,16.0,16,Skyyport,21.0,11,0,0,3,0,stay,1980-12-20
16221,Skyy,1981-03-21,Skyy - Skyyport,16,16,17,16.0,16,Skyyport,21.0,12,-1,0,0,1,down,1980-12-20
16222,Skyy,1981-03-28,Skyy - Skyyport,16,16,17,16.0,17,Skyyport,21.0,13,0,-1,0,0,stay,1980-12-20
16223,Skyy,1981-04-04,Skyy - Skyyport,17,16,21,16.0,17,Skyyport,21.0,14,-4,0,-1,1,down,1980-12-20
16224,Skyy,1981-04-11,Skyy - Skyyport,17,17,24,16.0,21,Skyyport,21.0,15,-3,-4,0,1,down,1980-12-20
16225,Skyy,1981-04-18,Skyy - Skyyport,21,17,23,16.0,24,Skyyport,21.0,16,1,-3,-4,1,up,1980-12-20
16226,Skyy,1981-04-25,Skyy - Skyyport,24,21,27,16.0,23,Skyyport,21.0,17,-4,1,-3,1,down,1980-12-20
16227,Skyy,1981-05-02,Skyy - Skyyport,23,24,36,16.0,27,Skyyport,21.0,18,-9,-4,1,1,down,1980-12-20
16228,Skyy,1981-05-09,Skyy - Skyyport,27,23,39,16.0,36,Skyyport,21.0,19,-3,-9,-4,1,down,1980-12-20
16229,Skyy,1981-05-16,Skyy - Skyyport,36,27,44,16.0,39,Skyyport,21.0,20,-5,-3,-9,1,down,1980-12-20
16230,Skyy,1981-05-23,Skyy - Skyyport,39,36,51,16.0,44,Skyyport,21.0,21,-7,-5,-3,1,down,1980-12-20
16231,The Manhattans,1980-12-27,The Manhattans - Manhattans Greatest Hits,51,51,35,18.0,35,Manhattans Greatest Hits,9.0,0,0,16,0,0,stay,1980-12-27
16232,The Manhattans,1981-01-03,The Manhattans - Manhattans Greatest Hits,35,51,20,18.0,35,Manhattans Greatest Hits,9.0,1,15,0,16,1,up,1980-12-27
16233,The Manhattans,1981-01-10,The Manhattans - Manhattans Greatest Hits,35,35,18,18.0,20,Manhattans Greatest Hits,9.0,2,2,15,0,1,up,1980-12-27
16234,The Manhattans,1981-01-17,The Manhattans - Manhattans Greatest Hits,20,35,18,18.0,18,Manhattans Greatest Hits,9.0,3,0,2,15,0,stay,1980-12-27
16235,The Manhattans,1981-01-24,The Manhattans - Manhattans Greatest Hits,18,20,23,18.0,18,Manhattans Greatest Hits,9.0,4,-5,0,2,1,down,1980-12-27
16236,The Manhattans,1981-02-07,The Manhattans - Manhattans Greatest Hits,18,18,20,18.0,23,Manhattans Greatest Hits,9.0,5,3,-5,0,1,up,1980-12-27
16237,The Manhattans,1981-02-14,The Manhattans - Manhattans Greatest Hits,23,18,29,18.0,20,Manhattans Greatest Hits,9.0,6,-9,3,-5,1,down,1980-12-27
16238,The Manhattans,1981-02-21,The Manhattans - Manhattans Greatest Hits,20,23,29,18.0,29,Manhattans Greatest Hits,9.0,7,0,-9,3,0,stay,1980-12-27
16239,The Manhattans,1981-02-28,The Manhattans - Manhattans Greatest Hits,29,20,32,18.0,29,Manhattans Greatest Hits,9.0,8,-3,0,-9,1,down,1980-12-27
16240,The Manhattans,1981-03-07,The Manhattans - Manhattans Greatest Hits,29,29,51,18.0,32,Manhattans Greatest Hits,9.0,9,-19,-3,0,1,down,1980-12-27
16241,Parliament,1980-12-27,Parliament - Trombipulation,51,51,37,16.0,37,Trombipulation,9.0,0,0,14,0,0,stay,1980-12-27
16242,Parliament,1981-01-03,Parliament - Trombipulation,37,51,26,16.0,37,Trombipulation,9.0,1,11,0,14,1,up,1980-12-27
16243,Parliament,1981-01-10,Parliament - Trombipulation,37,37,20,16.0,26,Trombipulation,9.0,2,6,11,0,1,up,1980-12-27
16244,Parliament,1981-01-17,Parliament - Trombipulation,26,37,17,16.0,20,Trombipulation,9.0,3,3,6,11,1,up,1980-12-27
16245,Parliament,1981-01-24,Parliament - Trombipulation,20,26,16,16.0,17,Trombipulation,9.0,4,1,3,6,1,up,1980-12-27
16246,Parliament,1981-02-07,Parliament - Trombipulation,17,20,17,16.0,16,Trombipulation,9.0,5,-1,1,3,1,down,1980-12-27
16247,Parliament,1981-02-14,Parliament - Trombipulation,16,17,19,16.0,17,Trombipulation,9.0,6,-2,-1,1,1,down,1980-12-27
16248,Parliament,1981-02-21,Parliament - Trombipulation,17,16,30,16.0,19,Trombipulation,9.0,7,-11,-2,-1,1,down,1980-12-27
16249,Parliament,1981-02-28,Parliament - Trombipulation,19,17,44,16.0,30,Trombipulation,9.0,8,-14,-11,-2,1,down,1980-12-27
16250,Parliament,1981-03-07,Parliament - Trombipulation,30,19,51,16.0,44,Trombipulation,9.0,9,-7,-14,-11,1,down,1980-12-27
16251,Roberta Flack & Peabo Bryson,1980-12-27,Roberta Flack & Peabo Bryson - Live & More,51,51,40,10.0,40,Live & More,17.0,0,0,11,0,0,stay,1980-12-27
16252,Roberta Flack & Peabo Bryson,1981-01-03,Roberta Flack & Peabo Bryson - Live & More,40,51,31,10.0,40,Live & More,17.0,1,9,0,11,1,up,1980-12-27
16253,Roberta Flack & Peabo Bryson,1981-01-10,Roberta Flack & Peabo Bryson - Live & More,40,40,19,10.0,31,Live & More,17.0,2,12,9,0,1,up,1980-12-27
16254,Roberta Flack & Peabo Bryson,1981-01-17,Roberta Flack & Peabo Bryson - Live & More,31,40,16,10.0,19,Live & More,17.0,3,3,12,9,1,up,1980-12-27
16255,Roberta Flack & Peabo Bryson,1981-01-24,Roberta Flack & Peabo Bryson - Live & More,19,31,12,10.0,16,Live & More,17.0,4,4,3,12,1,up,1980-12-27
16256,Roberta Flack & Peabo Bryson,1981-02-07,Roberta Flack & Peabo Bryson - Live & More,16,19,11,10.0,12,Live & More,17.0,5,1,4,3,1,up,1980-12-27
16257,Roberta Flack & Peabo Bryson,1981-02-14,Roberta Flack & Peabo Bryson - Live & More,12,16,10,10.0,11,Live & More,17.0,6,1,1,4,1,up,1980-12-27
16258,Roberta Flack & Peabo Bryson,1981-02-21,Roberta Flack & Peabo Bryson - Live & More,11,12,10,10.0,10,Live & More,17.0,7,0,1,1,0,stay,1980-12-27
16259,Roberta Flack & Peabo Bryson,1981-02-28,Roberta Flack & Peabo Bryson - Live & More,10,11,10,10.0,10,Live & More,17.0,8,0,0,1,0,stay,1980-12-27
16260,Roberta Flack & Peabo Bryson,1981-03-07,Roberta Flack & Peabo Bryson - Live & More,10,10,12,10.0,10,Live & More,17.0,9,-2,0,0,1,down,1980-12-27
16261,Roberta Flack & Peabo Bryson,1981-03-14,Roberta Flack & Peabo Bryson - Live & More,10,10,12,10.0,12,Live & More,17.0,10,0,-2,0,0,stay,1980-12-27
16262,Roberta Flack & Peabo Bryson,1981-03-21,Roberta Flack & Peabo Bryson - Live & More,12,10,15,10.0,12,Live & More,17.0,11,-3,0,-2,1,down,1980-12-27
16263,Roberta Flack & Peabo Bryson,1981-03-28,Roberta Flack & Peabo Bryson - Live & More,12,12,21,10.0,15,Live & More,17.0,12,-6,-3,0,1,down,1980-12-27
16264,Roberta Flack & Peabo Bryson,1981-04-04,Roberta Flack & Peabo Bryson - Live & More,15,12,38,10.0,21,Live & More,17.0,13,-17,-6,-3,1,down,1980-12-27
16265,Roberta Flack & Peabo Bryson,1981-04-11,Roberta Flack & Peabo Bryson - Live & More,21,15,38,10.0,38,Live & More,17.0,14,0,-17,-6,0,stay,1980-12-27
16266,Roberta Flack & Peabo Bryson,1981-04-18,Roberta Flack & Peabo Bryson - Live & More,38,21,38,10.0,38,Live & More,17.0,15,0,0,-17,0,stay,1980-12-27
16267,Roberta Flack & Peabo Bryson,1981-04-25,Roberta Flack & Peabo Bryson - Live & More,38,38,47,10.0,38,Live & More,17.0,16,-9,0,0,1,down,1980-12-27
16268,Roberta Flack & Peabo Bryson,1981-05-02,Roberta Flack & Peabo Bryson - Live & More,38,38,51,10.0,47,Live & More,17.0,17,-4,-9,0,1,down,1980-12-27
16269,The Chi-lites,1980-12-27,The Chi-lites - Heavenly Body,51,51,49,42.0,49,Heavenly Body,5.0,0,0,2,0,0,stay,1980-12-27
16270,The Chi-lites,1981-01-03,The Chi-lites - Heavenly Body,49,51,42,42.0,49,Heavenly Body,5.0,1,7,0,2,1,up,1980-12-27
16271,The Chi-lites,1981-01-10,The Chi-lites - Heavenly Body,49,49,42,42.0,42,Heavenly Body,5.0,2,0,7,0,0,stay,1980-12-27
16272,The Chi-lites,1981-01-17,The Chi-lites - Heavenly Body,42,49,43,42.0,42,Heavenly Body,5.0,3,-1,0,7,1,down,1980-12-27
16273,The Chi-lites,1981-01-24,The Chi-lites - Heavenly Body,42,42,45,42.0,43,Heavenly Body,5.0,4,-2,-1,0,1,down,1980-12-27
16274,The Chi-lites,1981-01-31,The Chi-lites - Heavenly Body,43,42,51,42.0,45,Heavenly Body,5.0,5,-6,-2,-1,1,down,1980-12-27
16275,Yarbrough & Peoples,1980-12-27,Yarbrough & Peoples - The Two Of Us,51,51,50,1.0,50,The Two Of Us,26.0,0,0,1,0,0,stay,1980-12-27
16276,Yarbrough & Peoples,1981-01-03,Yarbrough & Peoples - The Two Of Us,50,51,35,1.0,50,The Two Of Us,26.0,1,15,0,1,1,up,1980-12-27
16277,Yarbrough & Peoples,1981-01-10,Yarbrough & Peoples - The Two Of Us,50,50,25,1.0,35,The Two Of Us,26.0,2,10,15,0,1,up,1980-12-27
16278,Yarbrough & Peoples,1981-01-17,Yarbrough & Peoples - The Two Of Us,35,50,19,1.0,25,The Two Of Us,26.0,3,6,10,15,1,up,1980-12-27
16279,Yarbrough & Peoples,1981-01-24,Yarbrough & Peoples - The Two Of Us,25,35,9,1.0,19,The Two Of Us,26.0,4,10,6,10,1,up,1980-12-27
16280,Yarbrough & Peoples,1981-02-07,Yarbrough & Peoples - The Two Of Us,19,25,5,1.0,9,The Two Of Us,26.0,5,4,10,6,1,up,1980-12-27
16281,Yarbrough & Peoples,1981-02-14,Yarbrough & Peoples - The Two Of Us,9,19,4,1.0,5,The Two Of Us,26.0,6,1,4,10,1,up,1980-12-27
16282,Yarbrough & Peoples,1981-02-21,Yarbrough & Peoples - The Two Of Us,5,9,2,1.0,4,The Two Of Us,26.0,7,2,1,4,1,up,1980-12-27
16283,Yarbrough & Peoples,1981-02-28,Yarbrough & Peoples - The Two Of Us,4,5,1,1.0,2,The Two Of Us,26.0,8,1,2,1,1,up,1980-12-27
16284,Yarbrough & Peoples,1981-03-07,Yarbrough & Peoples - The Two Of Us,2,4,1,1.0,1,The Two Of Us,26.0,9,0,1,2,0,stay,1980-12-27
16285,Yarbrough & Peoples,1981-03-14,Yarbrough & Peoples - The Two Of Us,1,2,2,1.0,1,The Two Of Us,26.0,10,-1,0,1,1,down,1980-12-27
16286,Yarbrough & Peoples,1981-03-21,Yarbrough & Peoples - The Two Of Us,1,1,2,1.0,2,The Two Of Us,26.0,11,0,-1,0,0,stay,1980-12-27
16287,Yarbrough & Peoples,1981-03-28,Yarbrough & Peoples - The Two Of Us,2,1,2,1.0,2,The Two Of Us,26.0,12,0,0,-1,0,stay,1980-12-27
16288,Yarbrough & Peoples,1981-04-04,Yarbrough & Peoples - The Two Of Us,2,2,6,1.0,2,The Two Of Us,26.0,13,-4,0,0,1,down,1980-12-27
16289,Yarbrough & Peoples,1981-04-11,Yarbrough & Peoples - The Two Of Us,2,2,6,1.0,6,The Two Of Us,26.0,14,0,-4,0,0,stay,1980-12-27
16290,Yarbrough & Peoples,1981-04-18,Yarbrough & Peoples - The Two Of Us,6,2,6,1.0,6,The Two Of Us,26.0,15,0,0,-4,0,stay,1980-12-27
16291,Yarbrough & Peoples,1981-04-25,Yarbrough & Peoples - The Two Of Us,6,6,6,1.0,6,The Two Of Us,26.0,16,0,0,0,0,stay,1980-12-27
16292,Yarbrough & Peoples,1981-05-02,Yarbrough & Peoples - The Two Of Us,6,6,8,1.0,6,The Two Of Us,26.0,17,-2,0,0,1,down,1980-12-27
16293,Yarbrough & Peoples,1981-05-09,Yarbrough & Peoples - The Two Of Us,6,6,9,1.0,8,The Two Of Us,26.0,18,-1,-2,0,1,down,1980-12-27
16294,Yarbrough & Peoples,1981-05-16,Yarbrough & Peoples - The Two Of Us,8,6,18,1.0,9,The Two Of Us,26.0,19,-9,-1,-2,1,down,1980-12-27
16295,Yarbrough & Peoples,1981-05-23,Yarbrough & Peoples - The Two Of Us,9,8,29,1.0,18,The Two Of Us,26.0,20,-11,-9,-1,1,down,1980-12-27
16296,Yarbrough & Peoples,1981-05-30,Yarbrough & Peoples - The Two Of Us,18,9,30,1.0,29,The Two Of Us,26.0,21,-1,-11,-9,1,down,1980-12-27
16297,Yarbrough & Peoples,1981-06-06,Yarbrough & Peoples - The Two Of Us,29,18,36,1.0,30,The Two Of Us,26.0,22,-6,-1,-11,1,down,1980-12-27
16298,Yarbrough & Peoples,1981-06-13,Yarbrough & Peoples - The Two Of Us,30,29,43,1.0,36,The Two Of Us,26.0,23,-7,-6,-1,1,down,1980-12-27
16299,Yarbrough & Peoples,1981-06-20,Yarbrough & Peoples - The Two Of Us,36,30,43,1.0,43,The Two Of Us,26.0,24,0,-7,-6,0,stay,1980-12-27
16300,Yarbrough & Peoples,1981-06-27,Yarbrough & Peoples - The Two Of Us,43,36,44,1.0,43,The Two Of Us,26.0,25,-1,0,-7,1,down,1980-12-27
16301,Yarbrough & Peoples,1981-07-04,Yarbrough & Peoples - The Two Of Us,43,43,51,1.0,44,The Two Of Us,26.0,26,-7,-1,0,1,down,1980-12-27
16302,The Gap Band,1981-01-10,The Gap Band - The Gap Band III,51,51,11,1.0,19,The Gap Band III,33.0,0,8,32,0,1,up,1981-01-10
16303,The Gap Band,1981-01-17,The Gap Band - The Gap Band III,19,51,5,1.0,11,The Gap Band III,33.0,1,6,8,32,1,up,1981-01-10
16304,The Gap Band,1981-01-24,The Gap Band - The Gap Band III,11,19,4,1.0,5,The Gap Band III,33.0,2,1,6,8,1,up,1981-01-10
16305,The Gap Band,1981-01-31,The Gap Band - The Gap Band III,5,11,3,1.0,4,The Gap Band III,33.0,3,1,1,6,1,up,1981-01-10
16306,The Gap Band,1981-02-07,The Gap Band - The Gap Band III,4,5,3,1.0,3,The Gap Band III,33.0,4,0,1,1,0,stay,1981-01-10
16307,The Gap Band,1981-02-14,The Gap Band - The Gap Band III,3,4,1,1.0,3,The Gap Band III,33.0,5,2,0,1,1,up,1981-01-10
16308,The Gap Band,1981-02-21,The Gap Band - The Gap Band III,3,3,1,1.0,1,The Gap Band III,33.0,6,0,2,0,0,stay,1981-01-10
16309,The Gap Band,1981-02-28,The Gap Band - The Gap Band III,1,3,2,1.0,1,The Gap Band III,33.0,7,-1,0,2,1,down,1981-01-10
16310,The Gap Band,1981-03-07,The Gap Band - The Gap Band III,1,1,2,1.0,2,The Gap Band III,33.0,8,0,-1,0,0,stay,1981-01-10
16311,The Gap Band,1981-03-14,The Gap Band - The Gap Band III,2,1,1,1.0,2,The Gap Band III,33.0,9,1,0,-1,1,up,1981-01-10
16312,The Gap Band,1981-03-21,The Gap Band - The Gap Band III,2,2,1,1.0,1,The Gap Band III,33.0,10,0,1,0,0,stay,1981-01-10
16313,The Gap Band,1981-03-28,The Gap Band - The Gap Band III,1,2,1,1.0,1,The Gap Band III,33.0,11,0,0,1,0,stay,1981-01-10
16314,The Gap Band,1981-04-04,The Gap Band - The Gap Band III,1,1,1,1.0,1,The Gap Band III,33.0,12,0,0,0,0,stay,1981-01-10
16315,The Gap Band,1981-04-11,The Gap Band - The Gap Band III,1,1,4,1.0,1,The Gap Band III,33.0,13,-3,0,0,1,down,1981-01-10
16316,The Gap Band,1981-04-18,The Gap Band - The Gap Band III,1,1,4,1.0,4,The Gap Band III,33.0,14,0,-3,0,0,stay,1981-01-10
16317,The Gap Band,1981-04-25,The Gap Band - The Gap Band III,4,1,4,1.0,4,The Gap Band III,33.0,15,0,0,-3,0,stay,1981-01-10
16318,The Gap Band,1981-05-02,The Gap Band - The Gap Band III,4,4,3,1.0,4,The Gap Band III,33.0,16,1,0,0,1,up,1981-01-10
16319,The Gap Band,1981-05-09,The Gap Band - The Gap Band III,4,4,3,1.0,3,The Gap Band III,33.0,17,0,1,0,0,stay,1981-01-10
16320,The Gap Band,1981-05-16,The Gap Band - The Gap Band III,3,4,5,1.0,3,The Gap Band III,33.0,18,-2,0,1,1,down,1981-01-10
16321,The Gap Band,1981-05-23,The Gap Band - The Gap Band III,3,3,7,1.0,5,The Gap Band III,33.0,19,-2,-2,0,1,down,1981-01-10
16322,The Gap Band,1981-05-30,The Gap Band - The Gap Band III,5,3,13,1.0,7,The Gap Band III,33.0,20,-6,-2,-2,1,down,1981-01-10
16323,The Gap Band,1981-06-06,The Gap Band - The Gap Band III,7,5,14,1.0,13,The Gap Band III,33.0,21,-1,-6,-2,1,down,1981-01-10
16324,The Gap Band,1981-06-13,The Gap Band - The Gap Band III,13,7,17,1.0,14,The Gap Band III,33.0,22,-3,-1,-6,1,down,1981-01-10
16325,The Gap Band,1981-06-20,The Gap Band - The Gap Band III,14,13,22,1.0,17,The Gap Band III,33.0,23,-5,-3,-1,1,down,1981-01-10
16326,The Gap Band,1981-06-27,The Gap Band - The Gap Band III,17,14,23,1.0,22,The Gap Band III,33.0,24,-1,-5,-3,1,down,1981-01-10
16327,The Gap Band,1981-07-04,The Gap Band - The Gap Band III,22,17,23,1.0,23,The Gap Band III,33.0,25,0,-1,-5,0,stay,1981-01-10
16328,The Gap Band,1981-07-11,The Gap Band - The Gap Band III,23,22,24,1.0,23,The Gap Band III,33.0,26,-1,0,-1,1,down,1981-01-10
16329,The Gap Band,1981-07-18,The Gap Band - The Gap Band III,23,23,26,1.0,24,The Gap Band III,33.0,27,-2,-1,0,1,down,1981-01-10
16330,The Gap Band,1981-07-25,The Gap Band - The Gap Band III,24,23,27,1.0,26,The Gap Band III,33.0,28,-1,-2,-1,1,down,1981-01-10
16331,The Gap Band,1981-08-01,The Gap Band - The Gap Band III,26,24,29,1.0,27,The Gap Band III,33.0,29,-2,-1,-2,1,down,1981-01-10
16332,The Gap Band,1981-08-08,The Gap Band - The Gap Band III,27,26,33,1.0,29,The Gap Band III,33.0,30,-4,-2,-1,1,down,1981-01-10
16333,The Gap Band,1981-08-15,The Gap Band - The Gap Band III,29,27,41,1.0,33,The Gap Band III,33.0,31,-8,-4,-2,1,down,1981-01-10
16334,The Gap Band,1981-08-22,The Gap Band - The Gap Band III,33,29,45,1.0,41,The Gap Band III,33.0,32,-4,-8,-4,1,down,1981-01-10
16335,The Gap Band,1981-08-29,The Gap Band - The Gap Band III,41,33,51,1.0,45,The Gap Band III,33.0,33,-6,-4,-8,1,down,1981-01-10
16336,Earl Klugh,1981-01-10,Earl Klugh - Late Night Guitar,51,51,40,40.0,45,Late Night Guitar,6.0,0,5,6,0,1,up,1981-01-10
16337,Earl Klugh,1981-01-17,Earl Klugh - Late Night Guitar,45,51,40,40.0,40,Late Night Guitar,6.0,1,0,5,6,0,stay,1981-01-10
16338,Earl Klugh,1981-01-24,Earl Klugh - Late Night Guitar,40,45,40,40.0,40,Late Night Guitar,6.0,2,0,0,5,0,stay,1981-01-10
16339,Earl Klugh,1981-01-31,Earl Klugh - Late Night Guitar,40,40,43,40.0,40,Late Night Guitar,6.0,3,-3,0,0,1,down,1981-01-10
16340,Earl Klugh,1981-02-07,Earl Klugh - Late Night Guitar,40,40,43,40.0,43,Late Night Guitar,6.0,4,0,-3,0,0,stay,1981-01-10
16341,Earl Klugh,1981-02-14,Earl Klugh - Late Night Guitar,43,40,46,40.0,43,Late Night Guitar,6.0,5,-3,0,-3,1,down,1981-01-10
16342,Earl Klugh,1981-02-21,Earl Klugh - Late Night Guitar,43,43,51,40.0,46,Late Night Guitar,6.0,6,-5,-3,0,1,down,1981-01-10
16343,The Whispers,1981-01-17,The Whispers - Imagination,51,51,20,3.0,30,Imagination,26.0,0,10,21,0,1,up,1981-01-17
16344,The Whispers,1981-01-24,The Whispers - Imagination,30,51,11,3.0,20,Imagination,26.0,1,9,10,21,1,up,1981-01-17
16345,The Whispers,1981-02-07,The Whispers - Imagination,20,30,8,3.0,11,Imagination,26.0,2,3,9,10,1,up,1981-01-17
16346,The Whispers,1981-02-14,The Whispers - Imagination,11,20,6,3.0,8,Imagination,26.0,3,2,3,9,1,up,1981-01-17
16347,The Whispers,1981-02-21,The Whispers - Imagination,8,11,5,3.0,6,Imagination,26.0,4,1,2,3,1,up,1981-01-17
16348,The Whispers,1981-02-28,The Whispers - Imagination,6,8,5,3.0,5,Imagination,26.0,5,0,1,2,0,stay,1981-01-17
16349,The Whispers,1981-03-07,The Whispers - Imagination,5,6,4,3.0,5,Imagination,26.0,6,1,0,1,1,up,1981-01-17
16350,The Whispers,1981-03-14,The Whispers - Imagination,5,5,3,3.0,4,Imagination,26.0,7,1,1,0,1,up,1981-01-17
16351,The Whispers,1981-03-21,The Whispers - Imagination,4,5,3,3.0,3,Imagination,26.0,8,0,1,1,0,stay,1981-01-17
16352,The Whispers,1981-03-28,The Whispers - Imagination,3,4,3,3.0,3,Imagination,26.0,9,0,0,1,0,stay,1981-01-17
16353,The Whispers,1981-04-04,The Whispers - Imagination,3,3,7,3.0,3,Imagination,26.0,10,-4,0,0,1,down,1981-01-17
16354,The Whispers,1981-04-11,The Whispers - Imagination,3,3,7,3.0,7,Imagination,26.0,11,0,-4,0,0,stay,1981-01-17
16355,The Whispers,1981-04-18,The Whispers - Imagination,7,3,10,3.0,7,Imagination,26.0,12,-3,0,-4,1,down,1981-01-17
16356,The Whispers,1981-04-25,The Whispers - Imagination,7,7,11,3.0,10,Imagination,26.0,13,-1,-3,0,1,down,1981-01-17
16357,The Whispers,1981-05-02,The Whispers - Imagination,10,7,11,3.0,11,Imagination,26.0,14,0,-1,-3,0,stay,1981-01-17
16358,The Whispers,1981-05-09,The Whispers - Imagination,11,10,17,3.0,11,Imagination,26.0,15,-6,0,-1,1,down,1981-01-17
16359,The Whispers,1981-05-16,The Whispers - Imagination,11,11,24,3.0,17,Imagination,26.0,16,-7,-6,0,1,down,1981-01-17
16360,The Whispers,1981-05-23,The Whispers - Imagination,17,11,26,3.0,24,Imagination,26.0,17,-2,-7,-6,1,down,1981-01-17
16361,The Whispers,1981-05-30,The Whispers - Imagination,24,17,26,3.0,26,Imagination,26.0,18,0,-2,-7,0,stay,1981-01-17
16362,The Whispers,1981-06-06,The Whispers - Imagination,26,24,28,3.0,26,Imagination,26.0,19,-2,0,-2,1,down,1981-01-17
16363,The Whispers,1981-06-13,The Whispers - Imagination,26,26,31,3.0,28,Imagination,26.0,20,-3,-2,0,1,down,1981-01-17
16364,The Whispers,1981-06-20,The Whispers - Imagination,28,26,32,3.0,31,Imagination,26.0,21,-1,-3,-2,1,down,1981-01-17
16365,The Whispers,1981-06-27,The Whispers - Imagination,31,28,32,3.0,32,Imagination,26.0,22,0,-1,-3,0,stay,1981-01-17
16366,The Whispers,1981-07-04,The Whispers - Imagination,32,31,34,3.0,32,Imagination,26.0,23,-2,0,-1,1,down,1981-01-17
16367,The Whispers,1981-07-11,The Whispers - Imagination,32,32,37,3.0,34,Imagination,26.0,24,-3,-2,0,1,down,1981-01-17
16368,The Whispers,1981-07-18,The Whispers - Imagination,34,32,49,3.0,37,Imagination,26.0,25,-12,-3,-2,1,down,1981-01-17
16369,The Whispers,1981-07-25,The Whispers - Imagination,37,34,51,3.0,49,Imagination,26.0,26,-2,-12,-3,1,down,1981-01-17
16370,Shalamar,1981-01-17,Shalamar - Three For Love,51,51,28,8.0,38,Three For Love,38.0,0,10,13,0,1,up,1981-01-17
16371,Shalamar,1981-01-24,Shalamar - Three For Love,38,51,18,8.0,28,Three For Love,38.0,1,10,10,13,1,up,1981-01-17
16372,Shalamar,1981-02-07,Shalamar - Three For Love,28,38,14,8.0,18,Three For Love,38.0,2,4,10,10,1,up,1981-01-17
16373,Shalamar,1981-02-14,Shalamar - Three For Love,18,28,11,8.0,14,Three For Love,38.0,3,3,4,10,1,up,1981-01-17
16374,Shalamar,1981-02-21,Shalamar - Three For Love,14,18,9,8.0,11,Three For Love,38.0,4,2,3,4,1,up,1981-01-17
16375,Shalamar,1981-02-28,Shalamar - Three For Love,11,14,8,8.0,9,Three For Love,38.0,5,1,2,3,1,up,1981-01-17
16376,Shalamar,1981-03-07,Shalamar - Three For Love,9,11,8,8.0,8,Three For Love,38.0,6,0,1,2,0,stay,1981-01-17
16377,Shalamar,1981-03-14,Shalamar - Three For Love,8,9,11,8.0,8,Three For Love,38.0,7,-3,0,1,1,down,1981-01-17
16378,Shalamar,1981-03-21,Shalamar - Three For Love,8,8,11,8.0,11,Three For Love,38.0,8,0,-3,0,0,stay,1981-01-17
16379,Shalamar,1981-03-28,Shalamar - Three For Love,11,8,12,8.0,11,Three For Love,38.0,9,-1,0,-3,1,down,1981-01-17
16380,Shalamar,1981-04-04,Shalamar - Three For Love,11,11,15,8.0,12,Three For Love,38.0,10,-3,-1,0,1,down,1981-01-17
16381,Shalamar,1981-04-11,Shalamar - Three For Love,12,11,14,8.0,15,Three For Love,38.0,11,1,-3,-1,1,up,1981-01-17
16382,Shalamar,1981-04-18,Shalamar - Three For Love,15,12,13,8.0,14,Three For Love,38.0,12,1,1,-3,1,up,1981-01-17
16383,Shalamar,1981-04-25,Shalamar - Three For Love,14,15,13,8.0,13,Three For Love,38.0,13,0,1,1,0,stay,1981-01-17
16384,Shalamar,1981-05-02,Shalamar - Three For Love,13,14,12,8.0,13,Three For Love,38.0,14,1,0,1,1,up,1981-01-17
16385,Shalamar,1981-05-09,Shalamar - Three For Love,13,13,10,8.0,12,Three For Love,38.0,15,2,1,0,1,up,1981-01-17
16386,Shalamar,1981-05-16,Shalamar - Three For Love,12,13,9,8.0,10,Three For Love,38.0,16,1,2,1,1,up,1981-01-17
16387,Shalamar,1981-05-23,Shalamar - Three For Love,10,12,9,8.0,9,Three For Love,38.0,17,0,1,2,0,stay,1981-01-17
16388,Shalamar,1981-05-30,Shalamar - Three For Love,9,10,8,8.0,9,Three For Love,38.0,18,1,0,1,1,up,1981-01-17
16389,Shalamar,1981-06-06,Shalamar - Three For Love,9,9,8,8.0,8,Three For Love,38.0,19,0,1,0,0,stay,1981-01-17
16390,Shalamar,1981-06-13,Shalamar - Three For Love,8,9,8,8.0,8,Three For Love,38.0,20,0,0,1,0,stay,1981-01-17
16391,Shalamar,1981-06-20,Shalamar - Three For Love,8,8,10,8.0,8,Three For Love,38.0,21,-2,0,0,1,down,1981-01-17
16392,Shalamar,1981-06-27,Shalamar - Three For Love,8,8,10,8.0,10,Three For Love,38.0,22,0,-2,0,0,stay,1981-01-17
16393,Shalamar,1981-07-04,Shalamar - Three For Love,10,8,10,8.0,10,Three For Love,38.0,23,0,0,-2,0,stay,1981-01-17
16394,Shalamar,1981-07-11,Shalamar - Three For Love,10,10,10,8.0,10,Three For Love,38.0,24,0,0,0,0,stay,1981-01-17
16395,Shalamar,1981-07-18,Shalamar - Three For Love,10,10,11,8.0,10,Three For Love,38.0,25,-1,0,0,1,down,1981-01-17
16396,Shalamar,1981-07-25,Shalamar - Three For Love,10,10,17,8.0,11,Three For Love,38.0,26,-6,-1,0,1,down,1981-01-17
16397,Shalamar,1981-08-01,Shalamar - Three For Love,11,10,17,8.0,17,Three For Love,38.0,27,0,-6,-1,0,stay,1981-01-17
16398,Shalamar,1981-08-08,Shalamar - Three For Love,17,11,19,8.0,17,Three For Love,38.0,28,-2,0,-6,1,down,1981-01-17
16399,Shalamar,1981-08-15,Shalamar - Three For Love,17,17,22,8.0,19,Three For Love,38.0,29,-3,-2,0,1,down,1981-01-17
16400,Shalamar,1981-08-22,Shalamar - Three For Love,19,17,28,8.0,22,Three For Love,38.0,30,-6,-3,-2,1,down,1981-01-17
16401,Shalamar,1981-08-29,Shalamar - Three For Love,22,19,28,8.0,28,Three For Love,38.0,31,0,-6,-3,0,stay,1981-01-17
16402,Shalamar,1981-09-05,Shalamar - Three For Love,28,22,30,8.0,28,Three For Love,38.0,32,-2,0,-6,1,down,1981-01-17
16403,Shalamar,1981-09-12,Shalamar - Three For Love,28,28,35,8.0,30,Three For Love,38.0,33,-5,-2,0,1,down,1981-01-17
16404,Shalamar,1981-09-19,Shalamar - Three For Love,30,28,46,8.0,35,Three For Love,38.0,34,-11,-5,-2,1,down,1981-01-17
16405,Shalamar,1981-09-26,Shalamar - Three For Love,35,30,46,8.0,46,Three For Love,38.0,35,0,-11,-5,0,stay,1981-01-17
16406,Shalamar,1981-10-03,Shalamar - Three For Love,46,35,49,8.0,46,Three For Love,38.0,36,-3,0,-11,1,down,1981-01-17
16407,Shalamar,1981-10-24,Shalamar - Three For Love,46,46,47,8.0,49,Three For Love,38.0,37,2,-3,0,1,up,1981-01-17
16408,Shalamar,1981-10-31,Shalamar - Three For Love,49,46,51,8.0,47,Three For Love,38.0,38,-4,2,-3,1,down,1981-01-17
16409,Lou Rawls,1981-01-17,Lou Rawls - Shades Of Blue,51,51,39,34.0,46,Shades Of Blue,4.0,0,7,5,0,1,up,1981-01-17
16410,Lou Rawls,1981-01-24,Lou Rawls - Shades Of Blue,46,51,34,34.0,39,Shades Of Blue,4.0,1,5,7,5,1,up,1981-01-17
16411,Lou Rawls,1981-02-07,Lou Rawls - Shades Of Blue,39,46,39,34.0,34,Shades Of Blue,4.0,2,-5,5,7,1,down,1981-01-17
16412,Lou Rawls,1981-02-14,Lou Rawls - Shades Of Blue,34,39,47,34.0,39,Shades Of Blue,4.0,3,-8,-5,5,1,down,1981-01-17
16413,Lou Rawls,1981-02-21,Lou Rawls - Shades Of Blue,39,34,51,34.0,47,Shades Of Blue,4.0,4,-4,-8,-5,1,down,1981-01-17
16414,Millie Jackson,1981-01-17,Millie Jackson - I Had To Say It,51,51,41,25.0,49,I Had To Say It,13.0,0,8,2,0,1,up,1981-01-17
16415,Millie Jackson,1981-01-24,Millie Jackson - I Had To Say It,49,51,32,25.0,41,I Had To Say It,13.0,1,9,8,2,1,up,1981-01-17
16416,Millie Jackson,1981-02-07,Millie Jackson - I Had To Say It,41,49,28,25.0,32,I Had To Say It,13.0,2,4,9,8,1,up,1981-01-17
16417,Millie Jackson,1981-02-14,Millie Jackson - I Had To Say It,32,41,25,25.0,28,I Had To Say It,13.0,3,3,4,9,1,up,1981-01-17
16418,Millie Jackson,1981-02-21,Millie Jackson - I Had To Say It,28,32,25,25.0,25,I Had To Say It,13.0,4,0,3,4,0,stay,1981-01-17
16419,Millie Jackson,1981-02-28,Millie Jackson - I Had To Say It,25,28,26,25.0,25,I Had To Say It,13.0,5,-1,0,3,1,down,1981-01-17
16420,Millie Jackson,1981-03-07,Millie Jackson - I Had To Say It,25,25,28,25.0,26,I Had To Say It,13.0,6,-2,-1,0,1,down,1981-01-17
16421,Millie Jackson,1981-03-14,Millie Jackson - I Had To Say It,26,25,28,25.0,28,I Had To Say It,13.0,7,0,-2,-1,0,stay,1981-01-17
16422,Millie Jackson,1981-03-21,Millie Jackson - I Had To Say It,28,26,30,25.0,28,I Had To Say It,13.0,8,-2,0,-2,1,down,1981-01-17
16423,Millie Jackson,1981-03-28,Millie Jackson - I Had To Say It,28,28,34,25.0,30,I Had To Say It,13.0,9,-4,-2,0,1,down,1981-01-17
16424,Millie Jackson,1981-04-04,Millie Jackson - I Had To Say It,30,28,37,25.0,34,I Had To Say It,13.0,10,-3,-4,-2,1,down,1981-01-17
16425,Millie Jackson,1981-04-11,Millie Jackson - I Had To Say It,34,30,50,25.0,37,I Had To Say It,13.0,11,-13,-3,-4,1,down,1981-01-17
16426,Millie Jackson,1981-04-18,Millie Jackson - I Had To Say It,37,34,47,25.0,50,I Had To Say It,13.0,12,3,-13,-3,1,up,1981-01-17
16427,Millie Jackson,1981-04-25,Millie Jackson - I Had To Say It,50,37,51,25.0,47,I Had To Say It,13.0,13,-4,3,-13,1,down,1981-01-17
16428,Kano,1981-01-31,Kano - Kano,51,51,37,26.0,42,Kano,8.0,0,5,9,0,1,up,1981-01-31
16429,Kano,1981-02-07,Kano - Kano,42,51,33,26.0,37,Kano,8.0,1,4,5,9,1,up,1981-01-31
16430,Kano,1981-02-14,Kano - Kano,37,42,26,26.0,33,Kano,8.0,2,7,4,5,1,up,1981-01-31
16431,Kano,1981-02-21,Kano - Kano,33,37,26,26.0,26,Kano,8.0,3,0,7,4,0,stay,1981-01-31
16432,Kano,1981-02-28,Kano - Kano,26,33,27,26.0,26,Kano,8.0,4,-1,0,7,1,down,1981-01-31
16433,Kano,1981-03-07,Kano - Kano,26,26,27,26.0,27,Kano,8.0,5,0,-1,0,0,stay,1981-01-31
16434,Kano,1981-03-14,Kano - Kano,27,26,39,26.0,27,Kano,8.0,6,-12,0,-1,1,down,1981-01-31
16435,Kano,1981-03-21,Kano - Kano,27,27,41,26.0,39,Kano,8.0,7,-2,-12,0,1,down,1981-01-31
16436,Kano,1981-03-28,Kano - Kano,39,27,51,26.0,41,Kano,8.0,8,-10,-2,-12,1,down,1981-01-31
16437,The Blackbyrds,1981-01-31,The Blackbyrds - Better Days,51,51,42,40.0,47,Better Days,5.0,0,5,4,0,1,up,1981-01-31
16438,The Blackbyrds,1981-02-07,The Blackbyrds - Better Days,47,51,41,40.0,42,Better Days,5.0,1,1,5,4,1,up,1981-01-31
16439,The Blackbyrds,1981-02-14,The Blackbyrds - Better Days,42,47,40,40.0,41,Better Days,5.0,2,1,1,5,1,up,1981-01-31
16440,The Blackbyrds,1981-02-21,The Blackbyrds - Better Days,41,42,46,40.0,40,Better Days,5.0,3,-6,1,1,1,down,1981-01-31
16441,The Blackbyrds,1981-02-28,The Blackbyrds - Better Days,40,41,47,40.0,46,Better Days,5.0,4,-1,-6,1,1,down,1981-01-31
16442,The Blackbyrds,1981-03-07,The Blackbyrds - Better Days,46,40,51,40.0,47,Better Days,5.0,5,-4,-1,-6,1,down,1981-01-31
16443,Steely Dan,1981-01-31,Steely Dan - Gaucho,51,51,38,19.0,48,Gaucho,11.0,0,10,3,0,1,up,1981-01-31
16444,Steely Dan,1981-02-07,Steely Dan - Gaucho,48,51,32,19.0,38,Gaucho,11.0,1,6,10,3,1,up,1981-01-31
16445,Steely Dan,1981-02-14,Steely Dan - Gaucho,38,48,28,19.0,32,Gaucho,11.0,2,4,6,10,1,up,1981-01-31
16446,Steely Dan,1981-02-21,Steely Dan - Gaucho,32,38,23,19.0,28,Gaucho,11.0,3,5,4,6,1,up,1981-01-31
16447,Steely Dan,1981-02-28,Steely Dan - Gaucho,28,32,19,19.0,23,Gaucho,11.0,4,4,5,4,1,up,1981-01-31
16448,Steely Dan,1981-03-07,Steely Dan - Gaucho,23,28,19,19.0,19,Gaucho,11.0,5,0,4,5,0,stay,1981-01-31
16449,Steely Dan,1981-03-14,Steely Dan - Gaucho,19,23,20,19.0,19,Gaucho,11.0,6,-1,0,4,1,down,1981-01-31
16450,Steely Dan,1981-03-21,Steely Dan - Gaucho,19,19,22,19.0,20,Gaucho,11.0,7,-2,-1,0,1,down,1981-01-31
16451,Steely Dan,1981-03-28,Steely Dan - Gaucho,20,19,23,19.0,22,Gaucho,11.0,8,-1,-2,-1,1,down,1981-01-31
16452,Steely Dan,1981-04-04,Steely Dan - Gaucho,22,20,39,19.0,23,Gaucho,11.0,9,-16,-1,-2,1,down,1981-01-31
16453,Steely Dan,1981-04-11,Steely Dan - Gaucho,23,22,40,19.0,39,Gaucho,11.0,10,-1,-16,-1,1,down,1981-01-31
16454,Steely Dan,1981-04-18,Steely Dan - Gaucho,39,23,51,19.0,40,Gaucho,11.0,11,-11,-1,-16,1,down,1981-01-31
16455,Tierra,1981-01-31,Tierra - City Nights,51,51,39,15.0,50,City Nights,9.0,0,11,1,0,1,up,1981-01-31
16456,Tierra,1981-02-07,Tierra - City Nights,50,51,26,15.0,39,City Nights,9.0,1,13,11,1,1,up,1981-01-31
16457,Tierra,1981-02-14,Tierra - City Nights,39,50,20,15.0,26,City Nights,9.0,2,6,13,11,1,up,1981-01-31
16458,Tierra,1981-02-21,Tierra - City Nights,26,39,15,15.0,20,City Nights,9.0,3,5,6,13,1,up,1981-01-31
16459,Tierra,1981-02-28,Tierra - City Nights,20,26,15,15.0,15,City Nights,9.0,4,0,5,6,0,stay,1981-01-31
16460,Tierra,1981-03-07,Tierra - City Nights,15,20,15,15.0,15,City Nights,9.0,5,0,0,5,0,stay,1981-01-31
16461,Tierra,1981-03-14,Tierra - City Nights,15,15,24,15.0,15,City Nights,9.0,6,-9,0,0,1,down,1981-01-31
16462,Tierra,1981-03-21,Tierra - City Nights,15,15,37,15.0,24,City Nights,9.0,7,-13,-9,0,1,down,1981-01-31
16463,Tierra,1981-03-28,Tierra - City Nights,24,15,41,15.0,37,City Nights,9.0,8,-4,-13,-9,1,down,1981-01-31
16464,Tierra,1981-04-04,Tierra - City Nights,37,24,51,15.0,41,City Nights,9.0,9,-10,-4,-13,1,down,1981-01-31
16465,Clarence Carter,1981-01-31,Clarence Carter - Let's Burn,51,51,45,28.0,56,Let's Burn,15.0,0,11,-5,0,1,up,1981-01-31
16466,Clarence Carter,1981-02-14,Clarence Carter - Let's Burn,56,51,37,28.0,45,Let's Burn,15.0,1,8,11,-5,1,up,1981-01-31
16467,Clarence Carter,1981-02-21,Clarence Carter - Let's Burn,45,56,36,28.0,37,Let's Burn,15.0,2,1,8,11,1,up,1981-01-31
16468,Clarence Carter,1981-02-28,Clarence Carter - Let's Burn,37,45,37,28.0,36,Let's Burn,15.0,3,-1,1,8,1,down,1981-01-31
16469,Clarence Carter,1981-03-07,Clarence Carter - Let's Burn,36,37,35,28.0,37,Let's Burn,15.0,4,2,-1,1,1,up,1981-01-31
16470,Clarence Carter,1981-03-14,Clarence Carter - Let's Burn,37,36,32,28.0,35,Let's Burn,15.0,5,3,2,-1,1,up,1981-01-31
16471,Clarence Carter,1981-03-21,Clarence Carter - Let's Burn,35,37,29,28.0,32,Let's Burn,15.0,6,3,3,2,1,up,1981-01-31
16472,Clarence Carter,1981-03-28,Clarence Carter - Let's Burn,32,35,29,28.0,29,Let's Burn,15.0,7,0,3,3,0,stay,1981-01-31
16473,Clarence Carter,1981-04-04,Clarence Carter - Let's Burn,29,32,29,28.0,29,Let's Burn,15.0,8,0,0,3,0,stay,1981-01-31
16474,Clarence Carter,1981-04-11,Clarence Carter - Let's Burn,29,29,28,28.0,29,Let's Burn,15.0,9,1,0,0,1,up,1981-01-31
16475,Clarence Carter,1981-04-18,Clarence Carter - Let's Burn,29,29,28,28.0,28,Let's Burn,15.0,10,0,1,0,0,stay,1981-01-31
16476,Clarence Carter,1981-04-25,Clarence Carter - Let's Burn,28,29,30,28.0,28,Let's Burn,15.0,11,-2,0,1,1,down,1981-01-31
16477,Clarence Carter,1981-05-02,Clarence Carter - Let's Burn,28,28,41,28.0,30,Let's Burn,15.0,12,-11,-2,0,1,down,1981-01-31
16478,Clarence Carter,1981-05-09,Clarence Carter - Let's Burn,30,28,43,28.0,41,Let's Burn,15.0,13,-2,-11,-2,1,down,1981-01-31
16479,Clarence Carter,1981-05-16,Clarence Carter - Let's Burn,41,30,48,28.0,43,Let's Burn,15.0,14,-5,-2,-11,1,down,1981-01-31
16480,Clarence Carter,1981-05-23,Clarence Carter - Let's Burn,43,41,51,28.0,48,Let's Burn,15.0,15,-3,-5,-2,1,down,1981-01-31
16481,Carrie Lucas,1981-01-31,Carrie Lucas - Portrait Of Carrie,51,51,51,57.0,57,Portrait Of Carrie,0.0,0,6,-6,0,1,up,1981-01-31
16482,T.S. Monk,1981-01-31,T.S. Monk - House Of Music,51,51,45,13.0,63,House Of Music,19.0,0,18,-12,0,1,up,1981-01-31
16483,T.S. Monk,1981-02-21,T.S. Monk - House Of Music,63,51,35,13.0,45,House Of Music,19.0,1,10,18,-12,1,up,1981-01-31
16484,T.S. Monk,1981-02-28,T.S. Monk - House Of Music,45,63,30,13.0,35,House Of Music,19.0,2,5,10,18,1,up,1981-01-31
16485,T.S. Monk,1981-03-07,T.S. Monk - House Of Music,35,45,26,13.0,30,House Of Music,19.0,3,4,5,10,1,up,1981-01-31
16486,T.S. Monk,1981-03-14,T.S. Monk - House Of Music,30,35,21,13.0,26,House Of Music,19.0,4,5,4,5,1,up,1981-01-31
16487,T.S. Monk,1981-03-21,T.S. Monk - House Of Music,26,30,18,13.0,21,House Of Music,19.0,5,3,5,4,1,up,1981-01-31
16488,T.S. Monk,1981-03-28,T.S. Monk - House Of Music,21,26,16,13.0,18,House Of Music,19.0,6,2,3,5,1,up,1981-01-31
16489,T.S. Monk,1981-04-04,T.S. Monk - House Of Music,18,21,14,13.0,16,House Of Music,19.0,7,2,2,3,1,up,1981-01-31
16490,T.S. Monk,1981-04-11,T.S. Monk - House Of Music,16,18,13,13.0,14,House Of Music,19.0,8,1,2,2,1,up,1981-01-31
16491,T.S. Monk,1981-04-18,T.S. Monk - House Of Music,14,16,15,13.0,13,House Of Music,19.0,9,-2,1,2,1,down,1981-01-31
16492,T.S. Monk,1981-04-25,T.S. Monk - House Of Music,13,14,19,13.0,15,House Of Music,19.0,10,-4,-2,1,1,down,1981-01-31
16493,T.S. Monk,1981-05-02,T.S. Monk - House Of Music,15,13,21,13.0,19,House Of Music,19.0,11,-2,-4,-2,1,down,1981-01-31
16494,T.S. Monk,1981-05-09,T.S. Monk - House Of Music,19,15,27,13.0,21,House Of Music,19.0,12,-6,-2,-4,1,down,1981-01-31
16495,T.S. Monk,1981-05-16,T.S. Monk - House Of Music,21,19,29,13.0,27,House Of Music,19.0,13,-2,-6,-2,1,down,1981-01-31
16496,T.S. Monk,1981-05-23,T.S. Monk - House Of Music,27,21,32,13.0,29,House Of Music,19.0,14,-3,-2,-6,1,down,1981-01-31
16497,T.S. Monk,1981-05-30,T.S. Monk - House Of Music,29,27,38,13.0,32,House Of Music,19.0,15,-6,-3,-2,1,down,1981-01-31
16498,T.S. Monk,1981-06-06,T.S. Monk - House Of Music,32,29,40,13.0,38,House Of Music,19.0,16,-2,-6,-3,1,down,1981-01-31
16499,T.S. Monk,1981-06-13,T.S. Monk - House Of Music,38,32,44,13.0,40,House Of Music,19.0,17,-4,-2,-6,1,down,1981-01-31
16500,T.S. Monk,1981-06-20,T.S. Monk - House Of Music,40,38,46,13.0,44,House Of Music,19.0,18,-2,-4,-2,1,down,1981-01-31
16501,T.S. Monk,1981-06-27,T.S. Monk - House Of Music,44,40,51,13.0,46,House Of Music,19.0,19,-5,-2,-4,1,down,1981-01-31
16502,Lenny Williams,1981-01-31,Lenny Williams - Let's Do It Today,51,51,51,75.0,75,Let's Do It Today,0.0,0,24,-24,0,1,up,1981-01-31
16503,Marvin Gaye,1981-02-07,Marvin Gaye - In Our Lifetime,51,51,30,6.0,45,In Our Lifetime,20.0,0,15,6,0,1,up,1981-02-07
16504,Marvin Gaye,1981-02-14,Marvin Gaye - In Our Lifetime,45,51,16,6.0,30,In Our Lifetime,20.0,1,14,15,6,1,up,1981-02-07
16505,Marvin Gaye,1981-02-21,Marvin Gaye - In Our Lifetime,30,45,11,6.0,16,In Our Lifetime,20.0,2,5,14,15,1,up,1981-02-07
16506,Marvin Gaye,1981-02-28,Marvin Gaye - In Our Lifetime,16,30,9,6.0,11,In Our Lifetime,20.0,3,2,5,14,1,up,1981-02-07
16507,Marvin Gaye,1981-03-07,Marvin Gaye - In Our Lifetime,11,16,7,6.0,9,In Our Lifetime,20.0,4,2,2,5,1,up,1981-02-07
16508,Marvin Gaye,1981-03-14,Marvin Gaye - In Our Lifetime,9,11,6,6.0,7,In Our Lifetime,20.0,5,1,2,2,1,up,1981-02-07
16509,Marvin Gaye,1981-03-21,Marvin Gaye - In Our Lifetime,7,9,6,6.0,6,In Our Lifetime,20.0,6,0,1,2,0,stay,1981-02-07
16510,Marvin Gaye,1981-03-28,Marvin Gaye - In Our Lifetime,6,7,10,6.0,6,In Our Lifetime,20.0,7,-4,0,1,1,down,1981-02-07
16511,Marvin Gaye,1981-04-04,Marvin Gaye - In Our Lifetime,6,6,10,6.0,10,In Our Lifetime,20.0,8,0,-4,0,0,stay,1981-02-07
16512,Marvin Gaye,1981-04-11,Marvin Gaye - In Our Lifetime,10,6,18,6.0,10,In Our Lifetime,20.0,9,-8,0,-4,1,down,1981-02-07
16513,Marvin Gaye,1981-04-18,Marvin Gaye - In Our Lifetime,10,10,18,6.0,18,In Our Lifetime,20.0,10,0,-8,0,0,stay,1981-02-07
16514,Marvin Gaye,1981-04-25,Marvin Gaye - In Our Lifetime,18,10,22,6.0,18,In Our Lifetime,20.0,11,-4,0,-8,1,down,1981-02-07
16515,Marvin Gaye,1981-05-02,Marvin Gaye - In Our Lifetime,18,18,25,6.0,22,In Our Lifetime,20.0,12,-3,-4,0,1,down,1981-02-07
16516,Marvin Gaye,1981-05-09,Marvin Gaye - In Our Lifetime,22,18,32,6.0,25,In Our Lifetime,20.0,13,-7,-3,-4,1,down,1981-02-07
16517,Marvin Gaye,1981-05-16,Marvin Gaye - In Our Lifetime,25,22,32,6.0,32,In Our Lifetime,20.0,14,0,-7,-3,0,stay,1981-02-07
16518,Marvin Gaye,1981-05-23,Marvin Gaye - In Our Lifetime,32,25,36,6.0,32,In Our Lifetime,20.0,15,-4,0,-7,1,down,1981-02-07
16519,Marvin Gaye,1981-05-30,Marvin Gaye - In Our Lifetime,32,32,46,6.0,36,In Our Lifetime,20.0,16,-10,-4,0,1,down,1981-02-07
16520,Marvin Gaye,1981-06-06,Marvin Gaye - In Our Lifetime,36,32,44,6.0,46,In Our Lifetime,20.0,17,2,-10,-4,1,up,1981-02-07
16521,Marvin Gaye,1981-06-13,Marvin Gaye - In Our Lifetime,46,36,45,6.0,44,In Our Lifetime,20.0,18,-1,2,-10,1,down,1981-02-07
16522,Marvin Gaye,1981-06-20,Marvin Gaye - In Our Lifetime,44,46,50,6.0,45,In Our Lifetime,20.0,19,-5,-1,2,1,down,1981-02-07
16523,Marvin Gaye,1981-06-27,Marvin Gaye - In Our Lifetime,45,44,51,6.0,50,In Our Lifetime,20.0,20,-1,-5,-1,1,down,1981-02-07
16524,Joe Sample,1981-02-14,Joe Sample - Voices In The Rain,51,51,42,29.0,49,Voices In The Rain,8.0,0,7,2,0,1,up,1981-02-14
16525,Joe Sample,1981-02-21,Joe Sample - Voices In The Rain,49,51,37,29.0,42,Voices In The Rain,8.0,1,5,7,2,1,up,1981-02-14
16526,Joe Sample,1981-02-28,Joe Sample - Voices In The Rain,42,49,31,29.0,37,Voices In The Rain,8.0,2,6,5,7,1,up,1981-02-14
16527,Joe Sample,1981-03-07,Joe Sample - Voices In The Rain,37,42,31,29.0,31,Voices In The Rain,8.0,3,0,6,5,0,stay,1981-02-14
16528,Joe Sample,1981-03-14,Joe Sample - Voices In The Rain,31,37,29,29.0,31,Voices In The Rain,8.0,4,2,0,6,1,up,1981-02-14
16529,Joe Sample,1981-03-21,Joe Sample - Voices In The Rain,31,31,38,29.0,29,Voices In The Rain,8.0,5,-9,2,0,1,down,1981-02-14
16530,Joe Sample,1981-03-28,Joe Sample - Voices In The Rain,29,31,44,29.0,38,Voices In The Rain,8.0,6,-6,-9,2,1,down,1981-02-14
16531,Joe Sample,1981-04-04,Joe Sample - Voices In The Rain,38,29,46,29.0,44,Voices In The Rain,8.0,7,-2,-6,-9,1,down,1981-02-14
16532,Joe Sample,1981-04-11,Joe Sample - Voices In The Rain,44,38,51,29.0,46,Voices In The Rain,8.0,8,-5,-2,-6,1,down,1981-02-14
16533,Tom Browne,1981-02-21,Tom Browne - Magic,51,51,28,5.0,44,Magic,20.0,0,16,7,0,1,up,1981-02-21
16534,Tom Browne,1981-02-28,Tom Browne - Magic,44,51,13,5.0,28,Magic,20.0,1,15,16,7,1,up,1981-02-21
16535,Tom Browne,1981-03-07,Tom Browne - Magic,28,44,11,5.0,13,Magic,20.0,2,2,15,16,1,up,1981-02-21
16536,Tom Browne,1981-03-14,Tom Browne - Magic,13,28,7,5.0,11,Magic,20.0,3,4,2,15,1,up,1981-02-21
16537,Tom Browne,1981-03-21,Tom Browne - Magic,11,13,7,5.0,7,Magic,20.0,4,0,4,2,0,stay,1981-02-21
16538,Tom Browne,1981-03-28,Tom Browne - Magic,7,11,6,5.0,7,Magic,20.0,5,1,0,4,1,up,1981-02-21
16539,Tom Browne,1981-04-04,Tom Browne - Magic,7,7,5,5.0,6,Magic,20.0,6,1,1,0,1,up,1981-02-21
16540,Tom Browne,1981-04-11,Tom Browne - Magic,6,7,5,5.0,5,Magic,20.0,7,0,1,1,0,stay,1981-02-21
16541,Tom Browne,1981-04-18,Tom Browne - Magic,5,6,5,5.0,5,Magic,20.0,8,0,0,1,0,stay,1981-02-21
16542,Tom Browne,1981-04-25,Tom Browne - Magic,5,5,8,5.0,5,Magic,20.0,9,-3,0,0,1,down,1981-02-21
16543,Tom Browne,1981-05-02,Tom Browne - Magic,5,5,9,5.0,8,Magic,20.0,10,-1,-3,0,1,down,1981-02-21
16544,Tom Browne,1981-05-09,Tom Browne - Magic,8,5,11,5.0,9,Magic,20.0,11,-2,-1,-3,1,down,1981-02-21
16545,Tom Browne,1981-05-16,Tom Browne - Magic,9,8,14,5.0,11,Magic,20.0,12,-3,-2,-1,1,down,1981-02-21
16546,Tom Browne,1981-05-23,Tom Browne - Magic,11,9,16,5.0,14,Magic,20.0,13,-2,-3,-2,1,down,1981-02-21
16547,Tom Browne,1981-05-30,Tom Browne - Magic,14,11,16,5.0,16,Magic,20.0,14,0,-2,-3,0,stay,1981-02-21
16548,Tom Browne,1981-06-06,Tom Browne - Magic,16,14,20,5.0,16,Magic,20.0,15,-4,0,-2,1,down,1981-02-21
16549,Tom Browne,1981-06-13,Tom Browne - Magic,16,16,20,5.0,20,Magic,20.0,16,0,-4,0,0,stay,1981-02-21
16550,Tom Browne,1981-06-20,Tom Browne - Magic,20,16,30,5.0,20,Magic,20.0,17,-10,0,-4,1,down,1981-02-21
16551,Tom Browne,1981-06-27,Tom Browne - Magic,20,20,33,5.0,30,Magic,20.0,18,-3,-10,0,1,down,1981-02-21
16552,Tom Browne,1981-07-04,Tom Browne - Magic,30,20,40,5.0,33,Magic,20.0,19,-7,-3,-10,1,down,1981-02-21
16553,Tom Browne,1981-07-11,Tom Browne - Magic,33,30,51,5.0,40,Magic,20.0,20,-11,-7,-3,1,down,1981-02-21
16554,Rose Royce,1981-02-21,Rose Royce - Golden Touch,51,51,44,30.0,49,Golden Touch,8.0,0,5,2,0,1,up,1981-02-21
16555,Rose Royce,1981-02-28,Rose Royce - Golden Touch,49,51,39,30.0,44,Golden Touch,8.0,1,5,5,2,1,up,1981-02-21
16556,Rose Royce,1981-03-07,Rose Royce - Golden Touch,44,49,36,30.0,39,Golden Touch,8.0,2,3,5,5,1,up,1981-02-21
16557,Rose Royce,1981-03-14,Rose Royce - Golden Touch,39,44,31,30.0,36,Golden Touch,8.0,3,5,3,5,1,up,1981-02-21
16558,Rose Royce,1981-03-21,Rose Royce - Golden Touch,36,39,31,30.0,31,Golden Touch,8.0,4,0,5,3,0,stay,1981-02-21
16559,Rose Royce,1981-03-28,Rose Royce - Golden Touch,31,36,30,30.0,31,Golden Touch,8.0,5,1,0,5,1,up,1981-02-21
16560,Rose Royce,1981-04-04,Rose Royce - Golden Touch,31,31,30,30.0,30,Golden Touch,8.0,6,0,1,0,0,stay,1981-02-21
16561,Rose Royce,1981-04-11,Rose Royce - Golden Touch,30,31,35,30.0,30,Golden Touch,8.0,7,-5,0,1,1,down,1981-02-21
16562,Rose Royce,1981-04-18,Rose Royce - Golden Touch,30,30,51,30.0,35,Golden Touch,8.0,8,-16,-5,0,1,down,1981-02-21
16563,Sister Sledge,1981-02-28,Sister Sledge - All American Girls,51,51,25,13.0,40,All American Girls,16.0,0,15,11,0,1,up,1981-02-28
16564,Sister Sledge,1981-03-07,Sister Sledge - All American Girls,40,51,18,13.0,25,All American Girls,16.0,1,7,15,11,1,up,1981-02-28
16565,Sister Sledge,1981-03-14,Sister Sledge - All American Girls,25,40,14,13.0,18,All American Girls,16.0,2,4,7,15,1,up,1981-02-28
16566,Sister Sledge,1981-03-21,Sister Sledge - All American Girls,18,25,14,13.0,14,All American Girls,16.0,3,0,4,7,0,stay,1981-02-28
16567,Sister Sledge,1981-03-28,Sister Sledge - All American Girls,14,18,13,13.0,14,All American Girls,16.0,4,1,0,4,1,up,1981-02-28
16568,Sister Sledge,1981-04-04,Sister Sledge - All American Girls,14,14,13,13.0,13,All American Girls,16.0,5,0,1,0,0,stay,1981-02-28
16569,Sister Sledge,1981-04-11,Sister Sledge - All American Girls,13,14,17,13.0,13,All American Girls,16.0,6,-4,0,1,1,down,1981-02-28
16570,Sister Sledge,1981-04-18,Sister Sledge - All American Girls,13,13,17,13.0,17,All American Girls,16.0,7,0,-4,0,0,stay,1981-02-28
16571,Sister Sledge,1981-04-25,Sister Sledge - All American Girls,17,13,25,13.0,17,All American Girls,16.0,8,-8,0,-4,1,down,1981-02-28
16572,Sister Sledge,1981-05-02,Sister Sledge - All American Girls,17,17,27,13.0,25,All American Girls,16.0,9,-2,-8,0,1,down,1981-02-28
16573,Sister Sledge,1981-05-09,Sister Sledge - All American Girls,25,17,33,13.0,27,All American Girls,16.0,10,-6,-2,-8,1,down,1981-02-28
16574,Sister Sledge,1981-05-16,Sister Sledge - All American Girls,27,25,34,13.0,33,All American Girls,16.0,11,-1,-6,-2,1,down,1981-02-28
16575,Sister Sledge,1981-05-23,Sister Sledge - All American Girls,33,27,39,13.0,34,All American Girls,16.0,12,-5,-1,-6,1,down,1981-02-28
16576,Sister Sledge,1981-05-30,Sister Sledge - All American Girls,34,33,39,13.0,39,All American Girls,16.0,13,0,-5,-1,0,stay,1981-02-28
16577,Sister Sledge,1981-06-06,Sister Sledge - All American Girls,39,34,42,13.0,39,All American Girls,16.0,14,-3,0,-5,1,down,1981-02-28
16578,Sister Sledge,1981-06-13,Sister Sledge - All American Girls,39,39,46,13.0,42,All American Girls,16.0,15,-4,-3,0,1,down,1981-02-28
16579,Sister Sledge,1981-06-20,Sister Sledge - All American Girls,42,39,51,13.0,46,All American Girls,16.0,16,-5,-4,-3,1,down,1981-02-28
16580,B.B. King,1981-02-28,B.B. King - There Must Be A Better World Somewhere,51,51,35,26.0,45,There Must Be A Better World Somewhere,12.0,0,10,6,0,1,up,1981-02-28
16581,B.B. King,1981-03-07,B.B. King - There Must Be A Better World Somewhere,45,51,32,26.0,35,There Must Be A Better World Somewhere,12.0,1,3,10,6,1,up,1981-02-28
16582,B.B. King,1981-03-14,B.B. King - There Must Be A Better World Somewhere,35,45,27,26.0,32,There Must Be A Better World Somewhere,12.0,2,5,3,10,1,up,1981-02-28
16583,B.B. King,1981-03-21,B.B. King - There Must Be A Better World Somewhere,32,35,26,26.0,27,There Must Be A Better World Somewhere,12.0,3,1,5,3,1,up,1981-02-28
16584,B.B. King,1981-03-28,B.B. King - There Must Be A Better World Somewhere,27,32,27,26.0,26,There Must Be A Better World Somewhere,12.0,4,-1,1,5,1,down,1981-02-28
16585,B.B. King,1981-04-04,B.B. King - There Must Be A Better World Somewhere,26,27,27,26.0,27,There Must Be A Better World Somewhere,12.0,5,0,-1,1,0,stay,1981-02-28
16586,B.B. King,1981-04-11,B.B. King - There Must Be A Better World Somewhere,27,26,33,26.0,27,There Must Be A Better World Somewhere,12.0,6,-6,0,-1,1,down,1981-02-28
16587,B.B. King,1981-04-18,B.B. King - There Must Be A Better World Somewhere,27,27,34,26.0,33,There Must Be A Better World Somewhere,12.0,7,-1,-6,0,1,down,1981-02-28
16588,B.B. King,1981-04-25,B.B. King - There Must Be A Better World Somewhere,33,27,41,26.0,34,There Must Be A Better World Somewhere,12.0,8,-7,-1,-6,1,down,1981-02-28
16589,B.B. King,1981-05-02,B.B. King - There Must Be A Better World Somewhere,34,33,44,26.0,41,There Must Be A Better World Somewhere,12.0,9,-3,-7,-1,1,down,1981-02-28
16590,B.B. King,1981-05-09,B.B. King - There Must Be A Better World Somewhere,41,34,44,26.0,44,There Must Be A Better World Somewhere,12.0,10,0,-3,-7,0,stay,1981-02-28
16591,B.B. King,1981-05-16,B.B. King - There Must Be A Better World Somewhere,44,41,43,26.0,44,There Must Be A Better World Somewhere,12.0,11,1,0,-3,1,up,1981-02-28
16592,B.B. King,1981-05-23,B.B. King - There Must Be A Better World Somewhere,44,44,51,26.0,43,There Must Be A Better World Somewhere,12.0,12,-8,1,0,1,down,1981-02-28
16593,Kleeer,1981-03-07,Kleeer - License To Dream,51,51,38,13.0,45,License To Dream,21.0,0,7,6,0,1,up,1981-03-07
16594,Kleeer,1981-03-14,Kleeer - License To Dream,45,51,30,13.0,38,License To Dream,21.0,1,8,7,6,1,up,1981-03-07
16595,Kleeer,1981-03-21,Kleeer - License To Dream,38,45,23,13.0,30,License To Dream,21.0,2,7,8,7,1,up,1981-03-07
16596,Kleeer,1981-03-28,Kleeer - License To Dream,30,38,20,13.0,23,License To Dream,21.0,3,3,7,8,1,up,1981-03-07
16597,Kleeer,1981-04-04,Kleeer - License To Dream,23,30,17,13.0,20,License To Dream,21.0,4,3,3,7,1,up,1981-03-07
16598,Kleeer,1981-04-11,Kleeer - License To Dream,20,23,15,13.0,17,License To Dream,21.0,5,2,3,3,1,up,1981-03-07
16599,Kleeer,1981-04-18,Kleeer - License To Dream,17,20,14,13.0,15,License To Dream,21.0,6,1,2,3,1,up,1981-03-07
16600,Kleeer,1981-04-25,Kleeer - License To Dream,15,17,14,13.0,14,License To Dream,21.0,7,0,1,2,0,stay,1981-03-07
16601,Kleeer,1981-05-02,Kleeer - License To Dream,14,15,13,13.0,14,License To Dream,21.0,8,1,0,1,1,up,1981-03-07
16602,Kleeer,1981-05-09,Kleeer - License To Dream,14,14,16,13.0,13,License To Dream,21.0,9,-3,1,0,1,down,1981-03-07
16603,Kleeer,1981-05-16,Kleeer - License To Dream,13,14,17,13.0,16,License To Dream,21.0,10,-1,-3,1,1,down,1981-03-07
16604,Kleeer,1981-05-23,Kleeer - License To Dream,16,13,17,13.0,17,License To Dream,21.0,11,0,-1,-3,0,stay,1981-03-07
16605,Kleeer,1981-05-30,Kleeer - License To Dream,17,16,17,13.0,17,License To Dream,21.0,12,0,0,-1,0,stay,1981-03-07
16606,Kleeer,1981-06-06,Kleeer - License To Dream,17,17,19,13.0,17,License To Dream,21.0,13,-2,0,0,1,down,1981-03-07
16607,Kleeer,1981-06-13,Kleeer - License To Dream,17,17,27,13.0,19,License To Dream,21.0,14,-8,-2,0,1,down,1981-03-07
16608,Kleeer,1981-06-20,Kleeer - License To Dream,19,17,27,13.0,27,License To Dream,21.0,15,0,-8,-2,0,stay,1981-03-07
16609,Kleeer,1981-06-27,Kleeer - License To Dream,27,19,28,13.0,27,License To Dream,21.0,16,-1,0,-8,1,down,1981-03-07
16610,Kleeer,1981-07-04,Kleeer - License To Dream,27,27,32,13.0,28,License To Dream,21.0,17,-4,-1,0,1,down,1981-03-07
16611,Kleeer,1981-07-11,Kleeer - License To Dream,28,27,34,13.0,32,License To Dream,21.0,18,-2,-4,-1,1,down,1981-03-07
16612,Kleeer,1981-07-18,Kleeer - License To Dream,32,28,48,13.0,34,License To Dream,21.0,19,-14,-2,-4,1,down,1981-03-07
16613,Kleeer,1981-07-25,Kleeer - License To Dream,34,32,48,13.0,48,License To Dream,21.0,20,0,-14,-2,0,stay,1981-03-07
16614,Kleeer,1981-08-01,Kleeer - License To Dream,48,34,51,13.0,48,License To Dream,21.0,21,-3,0,-14,1,down,1981-03-07
16615,One Way,1981-03-07,One Way - Love Is...One Way,51,51,44,18.0,50,Love Is...One Way,22.0,0,6,1,0,1,up,1981-03-07
16616,One Way,1981-03-14,One Way - Love Is...One Way,50,51,37,18.0,44,Love Is...One Way,22.0,1,7,6,1,1,up,1981-03-07
16617,One Way,1981-03-21,One Way - Love Is...One Way,44,50,32,18.0,37,Love Is...One Way,22.0,2,5,7,6,1,up,1981-03-07
16618,One Way,1981-03-28,One Way - Love Is...One Way,37,44,28,18.0,32,Love Is...One Way,22.0,3,4,5,7,1,up,1981-03-07
16619,One Way,1981-04-04,One Way - Love Is...One Way,32,37,22,18.0,28,Love Is...One Way,22.0,4,6,4,5,1,up,1981-03-07
16620,One Way,1981-04-11,One Way - Love Is...One Way,28,32,22,18.0,22,Love Is...One Way,22.0,5,0,6,4,0,stay,1981-03-07
16621,One Way,1981-04-18,One Way - Love Is...One Way,22,28,21,18.0,22,Love Is...One Way,22.0,6,1,0,6,1,up,1981-03-07
16622,One Way,1981-04-25,One Way - Love Is...One Way,22,22,21,18.0,21,Love Is...One Way,22.0,7,0,1,0,0,stay,1981-03-07
16623,One Way,1981-05-02,One Way - Love Is...One Way,21,22,26,18.0,21,Love Is...One Way,22.0,8,-5,0,1,1,down,1981-03-07
16624,One Way,1981-05-09,One Way - Love Is...One Way,21,21,22,18.0,26,Love Is...One Way,22.0,9,4,-5,0,1,up,1981-03-07
16625,One Way,1981-05-16,One Way - Love Is...One Way,26,21,22,18.0,22,Love Is...One Way,22.0,10,0,4,-5,0,stay,1981-03-07
16626,One Way,1981-05-23,One Way - Love Is...One Way,22,26,22,18.0,22,Love Is...One Way,22.0,11,0,0,4,0,stay,1981-03-07
16627,One Way,1981-05-30,One Way - Love Is...One Way,22,22,22,18.0,22,Love Is...One Way,22.0,12,0,0,0,0,stay,1981-03-07
16628,One Way,1981-06-06,One Way - Love Is...One Way,22,22,23,18.0,22,Love Is...One Way,22.0,13,-1,0,0,1,down,1981-03-07
16629,One Way,1981-06-13,One Way - Love Is...One Way,22,22,21,18.0,23,Love Is...One Way,22.0,14,2,-1,0,1,up,1981-03-07
16630,One Way,1981-06-20,One Way - Love Is...One Way,23,22,18,18.0,21,Love Is...One Way,22.0,15,3,2,-1,1,up,1981-03-07
16631,One Way,1981-06-27,One Way - Love Is...One Way,21,23,18,18.0,18,Love Is...One Way,22.0,16,0,3,2,0,stay,1981-03-07
16632,One Way,1981-07-04,One Way - Love Is...One Way,18,21,19,18.0,18,Love Is...One Way,22.0,17,-1,0,3,1,down,1981-03-07
16633,One Way,1981-07-11,One Way - Love Is...One Way,18,18,21,18.0,19,Love Is...One Way,22.0,18,-2,-1,0,1,down,1981-03-07
16634,One Way,1981-07-18,One Way - Love Is...One Way,19,18,21,18.0,21,Love Is...One Way,22.0,19,0,-2,-1,0,stay,1981-03-07
16635,One Way,1981-07-25,One Way - Love Is...One Way,21,19,31,18.0,21,Love Is...One Way,22.0,20,-10,0,-2,1,down,1981-03-07
16636,One Way,1981-08-01,One Way - Love Is...One Way,21,21,38,18.0,31,Love Is...One Way,22.0,21,-7,-10,0,1,down,1981-03-07
16637,One Way,1981-08-08,One Way - Love Is...One Way,31,21,51,18.0,38,Love Is...One Way,22.0,22,-13,-7,-10,1,down,1981-03-07
16638,Smokey Robinson,1981-03-14,Smokey Robinson - Being With You,51,51,15,1.0,33,Being With You,24.0,0,18,18,0,1,up,1981-03-14
16639,Smokey Robinson,1981-03-21,Smokey Robinson - Being With You,33,51,9,1.0,15,Being With You,24.0,1,6,18,18,1,up,1981-03-14
16640,Smokey Robinson,1981-03-28,Smokey Robinson - Being With You,15,33,7,1.0,9,Being With You,24.0,2,2,6,18,1,up,1981-03-14
16641,Smokey Robinson,1981-04-04,Smokey Robinson - Being With You,9,15,2,1.0,7,Being With You,24.0,3,5,2,6,1,up,1981-03-14
16642,Smokey Robinson,1981-04-11,Smokey Robinson - Being With You,7,9,1,1.0,2,Being With You,24.0,4,1,5,2,1,up,1981-03-14
16643,Smokey Robinson,1981-04-18,Smokey Robinson - Being With You,2,7,1,1.0,1,Being With You,24.0,5,0,1,5,0,stay,1981-03-14
16644,Smokey Robinson,1981-04-25,Smokey Robinson - Being With You,1,2,1,1.0,1,Being With You,24.0,6,0,0,1,0,stay,1981-03-14
16645,Smokey Robinson,1981-05-02,Smokey Robinson - Being With You,1,1,1,1.0,1,Being With You,24.0,7,0,0,0,0,stay,1981-03-14
16646,Smokey Robinson,1981-05-09,Smokey Robinson - Being With You,1,1,1,1.0,1,Being With You,24.0,8,0,0,0,0,stay,1981-03-14
16647,Smokey Robinson,1981-05-16,Smokey Robinson - Being With You,1,1,2,1.0,1,Being With You,24.0,9,-1,0,0,1,down,1981-03-14
16648,Smokey Robinson,1981-05-23,Smokey Robinson - Being With You,1,1,4,1.0,2,Being With You,24.0,10,-2,-1,0,1,down,1981-03-14
16649,Smokey Robinson,1981-05-30,Smokey Robinson - Being With You,2,1,6,1.0,4,Being With You,24.0,11,-2,-2,-1,1,down,1981-03-14
16650,Smokey Robinson,1981-06-06,Smokey Robinson - Being With You,4,2,7,1.0,6,Being With You,24.0,12,-1,-2,-2,1,down,1981-03-14
16651,Smokey Robinson,1981-06-13,Smokey Robinson - Being With You,6,4,7,1.0,7,Being With You,24.0,13,0,-1,-2,0,stay,1981-03-14
16652,Smokey Robinson,1981-06-20,Smokey Robinson - Being With You,7,6,11,1.0,7,Being With You,24.0,14,-4,0,-1,1,down,1981-03-14
16653,Smokey Robinson,1981-06-27,Smokey Robinson - Being With You,7,7,14,1.0,11,Being With You,24.0,15,-3,-4,0,1,down,1981-03-14
16654,Smokey Robinson,1981-07-04,Smokey Robinson - Being With You,11,7,14,1.0,14,Being With You,24.0,16,0,-3,-4,0,stay,1981-03-14
16655,Smokey Robinson,1981-07-11,Smokey Robinson - Being With You,14,11,14,1.0,14,Being With You,24.0,17,0,0,-3,0,stay,1981-03-14
16656,Smokey Robinson,1981-07-18,Smokey Robinson - Being With You,14,14,18,1.0,14,Being With You,24.0,18,-4,0,0,1,down,1981-03-14
16657,Smokey Robinson,1981-07-25,Smokey Robinson - Being With You,14,14,23,1.0,18,Being With You,24.0,19,-5,-4,0,1,down,1981-03-14
16658,Smokey Robinson,1981-08-01,Smokey Robinson - Being With You,18,14,23,1.0,23,Being With You,24.0,20,0,-5,-4,0,stay,1981-03-14
16659,Smokey Robinson,1981-08-08,Smokey Robinson - Being With You,23,18,31,1.0,23,Being With You,24.0,21,-8,0,-5,1,down,1981-03-14
16660,Smokey Robinson,1981-08-15,Smokey Robinson - Being With You,23,23,31,1.0,31,Being With You,24.0,22,0,-8,0,0,stay,1981-03-14
16661,Smokey Robinson,1981-08-22,Smokey Robinson - Being With You,31,23,38,1.0,31,Being With You,24.0,23,-7,0,-8,1,down,1981-03-14
16662,Smokey Robinson,1981-08-29,Smokey Robinson - Being With You,31,31,51,1.0,38,Being With You,24.0,24,-13,-7,0,1,down,1981-03-14
16663,Diana Ross,1981-03-14,Diana Ross - To Love Again,51,51,25,16.0,37,To Love Again,13.0,0,12,14,0,1,up,1981-03-14
16664,Diana Ross,1981-03-21,Diana Ross - To Love Again,37,51,21,16.0,25,To Love Again,13.0,1,4,12,14,1,up,1981-03-14
16665,Diana Ross,1981-03-28,Diana Ross - To Love Again,25,37,18,16.0,21,To Love Again,13.0,2,3,4,12,1,up,1981-03-14
16666,Diana Ross,1981-04-04,Diana Ross - To Love Again,21,25,16,16.0,18,To Love Again,13.0,3,2,3,4,1,up,1981-03-14
16667,Diana Ross,1981-04-11,Diana Ross - To Love Again,18,21,16,16.0,16,To Love Again,13.0,4,0,2,3,0,stay,1981-03-14
16668,Diana Ross,1981-04-18,Diana Ross - To Love Again,16,18,26,16.0,16,To Love Again,13.0,5,-10,0,2,1,down,1981-03-14
16669,Diana Ross,1981-04-25,Diana Ross - To Love Again,16,16,29,16.0,26,To Love Again,13.0,6,-3,-10,0,1,down,1981-03-14
16670,Diana Ross,1981-05-02,Diana Ross - To Love Again,26,16,34,16.0,29,To Love Again,13.0,7,-5,-3,-10,1,down,1981-03-14
16671,Diana Ross,1981-05-09,Diana Ross - To Love Again,29,26,35,16.0,34,To Love Again,13.0,8,-1,-5,-3,1,down,1981-03-14
16672,Diana Ross,1981-05-16,Diana Ross - To Love Again,34,29,46,16.0,35,To Love Again,13.0,9,-11,-1,-5,1,down,1981-03-14
16673,Diana Ross,1981-05-23,Diana Ross - To Love Again,35,34,43,16.0,46,To Love Again,13.0,10,3,-11,-1,1,up,1981-03-14
16674,Diana Ross,1981-05-30,Diana Ross - To Love Again,46,35,47,16.0,43,To Love Again,13.0,11,-4,3,-11,1,down,1981-03-14
16675,Diana Ross,1981-06-06,Diana Ross - To Love Again,43,46,49,16.0,47,To Love Again,13.0,12,-2,-4,3,1,down,1981-03-14
16676,Diana Ross,1981-06-13,Diana Ross - To Love Again,47,43,51,16.0,49,To Love Again,13.0,13,-2,-2,-4,1,down,1981-03-14
16677,Peabo Bryson,1981-03-14,Peabo Bryson - Turn The Hands Of Time,51,51,33,23.0,40,Turn The Hands Of Time,13.0,0,7,11,0,1,up,1981-03-14
16678,Peabo Bryson,1981-03-21,Peabo Bryson - Turn The Hands Of Time,40,51,28,23.0,33,Turn The Hands Of Time,13.0,1,5,7,11,1,up,1981-03-14
16679,Peabo Bryson,1981-03-28,Peabo Bryson - Turn The Hands Of Time,33,40,26,23.0,28,Turn The Hands Of Time,13.0,2,2,5,7,1,up,1981-03-14
16680,Peabo Bryson,1981-04-04,Peabo Bryson - Turn The Hands Of Time,28,33,23,23.0,26,Turn The Hands Of Time,13.0,3,3,2,5,1,up,1981-03-14
16681,Peabo Bryson,1981-04-11,Peabo Bryson - Turn The Hands Of Time,26,28,23,23.0,23,Turn The Hands Of Time,13.0,4,0,3,2,0,stay,1981-03-14
16682,Peabo Bryson,1981-04-18,Peabo Bryson - Turn The Hands Of Time,23,26,24,23.0,23,Turn The Hands Of Time,13.0,5,-1,0,3,1,down,1981-03-14
16683,Peabo Bryson,1981-04-25,Peabo Bryson - Turn The Hands Of Time,23,23,28,23.0,24,Turn The Hands Of Time,13.0,6,-4,-1,0,1,down,1981-03-14
16684,Peabo Bryson,1981-05-02,Peabo Bryson - Turn The Hands Of Time,24,23,31,23.0,28,Turn The Hands Of Time,13.0,7,-3,-4,-1,1,down,1981-03-14
16685,Peabo Bryson,1981-05-09,Peabo Bryson - Turn The Hands Of Time,28,24,34,23.0,31,Turn The Hands Of Time,13.0,8,-3,-3,-4,1,down,1981-03-14
16686,Peabo Bryson,1981-05-16,Peabo Bryson - Turn The Hands Of Time,31,28,35,23.0,34,Turn The Hands Of Time,13.0,9,-1,-3,-3,1,down,1981-03-14
16687,Peabo Bryson,1981-05-23,Peabo Bryson - Turn The Hands Of Time,34,31,37,23.0,35,Turn The Hands Of Time,13.0,10,-2,-1,-3,1,down,1981-03-14
16688,Peabo Bryson,1981-05-30,Peabo Bryson - Turn The Hands Of Time,35,34,37,23.0,37,Turn The Hands Of Time,13.0,11,0,-2,-1,0,stay,1981-03-14
16689,Peabo Bryson,1981-06-06,Peabo Bryson - Turn The Hands Of Time,37,35,39,23.0,37,Turn The Hands Of Time,13.0,12,-2,0,-2,1,down,1981-03-14
16690,Peabo Bryson,1981-06-13,Peabo Bryson - Turn The Hands Of Time,37,37,51,23.0,39,Turn The Hands Of Time,13.0,13,-12,-2,0,1,down,1981-03-14
16691,T-Connection,1981-03-14,T-Connection - Everything Is Cool,51,51,40,31.0,47,Everything Is Cool,7.0,0,7,4,0,1,up,1981-03-14
16692,T-Connection,1981-03-21,T-Connection - Everything Is Cool,47,51,35,31.0,40,Everything Is Cool,7.0,1,5,7,4,1,up,1981-03-14
16693,T-Connection,1981-03-28,T-Connection - Everything Is Cool,40,47,31,31.0,35,Everything Is Cool,7.0,2,4,5,7,1,up,1981-03-14
16694,T-Connection,1981-04-04,T-Connection - Everything Is Cool,35,40,31,31.0,31,Everything Is Cool,7.0,3,0,4,5,0,stay,1981-03-14
16695,T-Connection,1981-04-11,T-Connection - Everything Is Cool,31,35,34,31.0,31,Everything Is Cool,7.0,4,-3,0,4,1,down,1981-03-14
16696,T-Connection,1981-04-18,T-Connection - Everything Is Cool,31,31,35,31.0,34,Everything Is Cool,7.0,5,-1,-3,0,1,down,1981-03-14
16697,T-Connection,1981-04-25,T-Connection - Everything Is Cool,34,31,45,31.0,35,Everything Is Cool,7.0,6,-10,-1,-3,1,down,1981-03-14
16698,T-Connection,1981-05-02,T-Connection - Everything Is Cool,35,34,51,31.0,45,Everything Is Cool,7.0,7,-6,-10,-1,1,down,1981-03-14
16699,Atlantic Starr,1981-03-14,Atlantic Starr - Radiant,51,51,36,5.0,50,Radiant,29.0,0,14,1,0,1,up,1981-03-14
16700,Atlantic Starr,1981-03-21,Atlantic Starr - Radiant,50,51,25,5.0,36,Radiant,29.0,1,11,14,1,1,up,1981-03-14
16701,Atlantic Starr,1981-03-28,Atlantic Starr - Radiant,36,50,19,5.0,25,Radiant,29.0,2,6,11,14,1,up,1981-03-14
16702,Atlantic Starr,1981-04-04,Atlantic Starr - Radiant,25,36,12,5.0,19,Radiant,29.0,3,7,6,11,1,up,1981-03-14
16703,Atlantic Starr,1981-04-11,Atlantic Starr - Radiant,19,25,10,5.0,12,Radiant,29.0,4,2,7,6,1,up,1981-03-14
16704,Atlantic Starr,1981-04-18,Atlantic Starr - Radiant,12,19,8,5.0,10,Radiant,29.0,5,2,2,7,1,up,1981-03-14
16705,Atlantic Starr,1981-04-25,Atlantic Starr - Radiant,10,12,7,5.0,8,Radiant,29.0,6,1,2,2,1,up,1981-03-14
16706,Atlantic Starr,1981-05-02,Atlantic Starr - Radiant,8,10,7,5.0,7,Radiant,29.0,7,0,1,2,0,stay,1981-03-14
16707,Atlantic Starr,1981-05-09,Atlantic Starr - Radiant,7,8,7,5.0,7,Radiant,29.0,8,0,0,1,0,stay,1981-03-14
16708,Atlantic Starr,1981-05-16,Atlantic Starr - Radiant,7,7,6,5.0,7,Radiant,29.0,9,1,0,0,1,up,1981-03-14
16709,Atlantic Starr,1981-05-23,Atlantic Starr - Radiant,7,7,6,5.0,6,Radiant,29.0,10,0,1,0,0,stay,1981-03-14
16710,Atlantic Starr,1981-05-30,Atlantic Starr - Radiant,6,7,5,5.0,6,Radiant,29.0,11,1,0,1,1,up,1981-03-14
16711,Atlantic Starr,1981-06-06,Atlantic Starr - Radiant,6,6,5,5.0,5,Radiant,29.0,12,0,1,0,0,stay,1981-03-14
16712,Atlantic Starr,1981-06-13,Atlantic Starr - Radiant,5,6,5,5.0,5,Radiant,29.0,13,0,0,1,0,stay,1981-03-14
16713,Atlantic Starr,1981-06-20,Atlantic Starr - Radiant,5,5,5,5.0,5,Radiant,29.0,14,0,0,0,0,stay,1981-03-14
16714,Atlantic Starr,1981-06-27,Atlantic Starr - Radiant,5,5,8,5.0,5,Radiant,29.0,15,-3,0,0,1,down,1981-03-14
16715,Atlantic Starr,1981-07-04,Atlantic Starr - Radiant,5,5,8,5.0,8,Radiant,29.0,16,0,-3,0,0,stay,1981-03-14
16716,Atlantic Starr,1981-07-11,Atlantic Starr - Radiant,8,5,8,5.0,8,Radiant,29.0,17,0,0,-3,0,stay,1981-03-14
16717,Atlantic Starr,1981-07-18,Atlantic Starr - Radiant,8,8,10,5.0,8,Radiant,29.0,18,-2,0,0,1,down,1981-03-14
16718,Atlantic Starr,1981-07-25,Atlantic Starr - Radiant,8,8,11,5.0,10,Radiant,29.0,19,-1,-2,0,1,down,1981-03-14
16719,Atlantic Starr,1981-08-01,Atlantic Starr - Radiant,10,8,14,5.0,11,Radiant,29.0,20,-3,-1,-2,1,down,1981-03-14
16720,Atlantic Starr,1981-08-08,Atlantic Starr - Radiant,11,10,15,5.0,14,Radiant,29.0,21,-1,-3,-1,1,down,1981-03-14
16721,Atlantic Starr,1981-08-15,Atlantic Starr - Radiant,14,11,19,5.0,15,Radiant,29.0,22,-4,-1,-3,1,down,1981-03-14
16722,Atlantic Starr,1981-08-22,Atlantic Starr - Radiant,15,14,26,5.0,19,Radiant,29.0,23,-7,-4,-1,1,down,1981-03-14
16723,Atlantic Starr,1981-08-29,Atlantic Starr - Radiant,19,15,26,5.0,26,Radiant,29.0,24,0,-7,-4,0,stay,1981-03-14
16724,Atlantic Starr,1981-09-05,Atlantic Starr - Radiant,26,19,29,5.0,26,Radiant,29.0,25,-3,0,-7,1,down,1981-03-14
16725,Atlantic Starr,1981-09-12,Atlantic Starr - Radiant,26,26,33,5.0,29,Radiant,29.0,26,-4,-3,0,1,down,1981-03-14
16726,Atlantic Starr,1981-09-19,Atlantic Starr - Radiant,29,26,33,5.0,33,Radiant,29.0,27,0,-4,-3,0,stay,1981-03-14
16727,Atlantic Starr,1981-09-26,Atlantic Starr - Radiant,33,29,49,5.0,33,Radiant,29.0,28,-16,0,-4,1,down,1981-03-14
16728,Atlantic Starr,1981-10-03,Atlantic Starr - Radiant,33,33,51,5.0,49,Radiant,29.0,29,-2,-16,0,1,down,1981-03-14
16729,The Isley Brothers,1981-03-21,The Isley Brothers - Grand Slam,51,51,16,3.0,35,Grand Slam,19.0,0,19,16,0,1,up,1981-03-21
16730,The Isley Brothers,1981-03-28,The Isley Brothers - Grand Slam,35,51,8,3.0,16,Grand Slam,19.0,1,8,19,16,1,up,1981-03-21
16731,The Isley Brothers,1981-04-04,The Isley Brothers - Grand Slam,16,35,4,3.0,8,Grand Slam,19.0,2,4,8,19,1,up,1981-03-21
16732,The Isley Brothers,1981-04-11,The Isley Brothers - Grand Slam,8,16,3,3.0,4,Grand Slam,19.0,3,1,4,8,1,up,1981-03-21
16733,The Isley Brothers,1981-04-18,The Isley Brothers - Grand Slam,4,8,3,3.0,3,Grand Slam,19.0,4,0,1,4,0,stay,1981-03-21
16734,The Isley Brothers,1981-04-25,The Isley Brothers - Grand Slam,3,4,3,3.0,3,Grand Slam,19.0,5,0,0,1,0,stay,1981-03-21
16735,The Isley Brothers,1981-05-02,The Isley Brothers - Grand Slam,3,3,6,3.0,3,Grand Slam,19.0,6,-3,0,0,1,down,1981-03-21
16736,The Isley Brothers,1981-05-09,The Isley Brothers - Grand Slam,3,3,6,3.0,6,Grand Slam,19.0,7,0,-3,0,0,stay,1981-03-21
16737,The Isley Brothers,1981-05-16,The Isley Brothers - Grand Slam,6,3,10,3.0,6,Grand Slam,19.0,8,-4,0,-3,1,down,1981-03-21
16738,The Isley Brothers,1981-05-23,The Isley Brothers - Grand Slam,6,6,11,3.0,10,Grand Slam,19.0,9,-1,-4,0,1,down,1981-03-21
16739,The Isley Brothers,1981-05-30,The Isley Brothers - Grand Slam,10,6,10,3.0,11,Grand Slam,19.0,10,1,-1,-4,1,up,1981-03-21
16740,The Isley Brothers,1981-06-06,The Isley Brothers - Grand Slam,11,10,10,3.0,10,Grand Slam,19.0,11,0,1,-1,0,stay,1981-03-21
16741,The Isley Brothers,1981-06-13,The Isley Brothers - Grand Slam,10,11,11,3.0,10,Grand Slam,19.0,12,-1,0,1,1,down,1981-03-21
16742,The Isley Brothers,1981-06-20,The Isley Brothers - Grand Slam,10,10,12,3.0,11,Grand Slam,19.0,13,-1,-1,0,1,down,1981-03-21
16743,The Isley Brothers,1981-06-27,The Isley Brothers - Grand Slam,11,10,22,3.0,12,Grand Slam,19.0,14,-10,-1,-1,1,down,1981-03-21
16744,The Isley Brothers,1981-07-04,The Isley Brothers - Grand Slam,12,11,26,3.0,22,Grand Slam,19.0,15,-4,-10,-1,1,down,1981-03-21
16745,The Isley Brothers,1981-07-11,The Isley Brothers - Grand Slam,22,12,26,3.0,26,Grand Slam,19.0,16,0,-4,-10,0,stay,1981-03-21
16746,The Isley Brothers,1981-07-18,The Isley Brothers - Grand Slam,26,22,27,3.0,26,Grand Slam,19.0,17,-1,0,-4,1,down,1981-03-21
16747,The Isley Brothers,1981-07-25,The Isley Brothers - Grand Slam,26,26,34,3.0,27,Grand Slam,19.0,18,-7,-1,0,1,down,1981-03-21
16748,The Isley Brothers,1981-08-01,The Isley Brothers - Grand Slam,27,26,51,3.0,34,Grand Slam,19.0,19,-17,-7,-1,1,down,1981-03-21
16749,Blondie,1981-03-21,Blondie - Autoamerican,51,51,33,25.0,50,Autoamerican,4.0,0,17,1,0,1,up,1981-03-21
16750,Blondie,1981-03-28,Blondie - Autoamerican,50,51,25,25.0,33,Autoamerican,4.0,1,8,17,1,1,up,1981-03-21
16751,Blondie,1981-04-04,Blondie - Autoamerican,33,50,25,25.0,25,Autoamerican,4.0,2,0,8,17,0,stay,1981-03-21
16752,Blondie,1981-04-11,Blondie - Autoamerican,25,33,37,25.0,25,Autoamerican,4.0,3,-12,0,8,1,down,1981-03-21
16753,Blondie,1981-04-18,Blondie - Autoamerican,25,25,51,25.0,37,Autoamerican,4.0,4,-14,-12,0,1,down,1981-03-21
16754,Bernard Wright,1981-03-28,Bernard Wright - Nard,51,51,37,23.0,44,Nard,16.0,0,7,7,0,1,up,1981-03-28
16755,Bernard Wright,1981-04-04,Bernard Wright - Nard,44,51,32,23.0,37,Nard,16.0,1,5,7,7,1,up,1981-03-28
16756,Bernard Wright,1981-04-11,Bernard Wright - Nard,37,44,32,23.0,32,Nard,16.0,2,0,5,7,0,stay,1981-03-28
16757,Bernard Wright,1981-04-18,Bernard Wright - Nard,32,37,29,23.0,32,Nard,16.0,3,3,0,5,1,up,1981-03-28
16758,Bernard Wright,1981-04-25,Bernard Wright - Nard,32,32,23,23.0,29,Nard,16.0,4,6,3,0,1,up,1981-03-28
16759,Bernard Wright,1981-05-02,Bernard Wright - Nard,29,32,23,23.0,23,Nard,16.0,5,0,6,3,0,stay,1981-03-28
16760,Bernard Wright,1981-05-09,Bernard Wright - Nard,23,29,26,23.0,23,Nard,16.0,6,-3,0,6,1,down,1981-03-28
16761,Bernard Wright,1981-05-16,Bernard Wright - Nard,23,23,26,23.0,26,Nard,16.0,7,0,-3,0,0,stay,1981-03-28
16762,Bernard Wright,1981-05-23,Bernard Wright - Nard,26,23,25,23.0,26,Nard,16.0,8,1,0,-3,1,up,1981-03-28
16763,Bernard Wright,1981-05-30,Bernard Wright - Nard,26,26,25,23.0,25,Nard,16.0,9,0,1,0,0,stay,1981-03-28
16764,Bernard Wright,1981-06-06,Bernard Wright - Nard,25,26,32,23.0,25,Nard,16.0,10,-7,0,1,1,down,1981-03-28
16765,Bernard Wright,1981-06-13,Bernard Wright - Nard,25,25,32,23.0,32,Nard,16.0,11,0,-7,0,0,stay,1981-03-28
16766,Bernard Wright,1981-06-20,Bernard Wright - Nard,32,25,36,23.0,32,Nard,16.0,12,-4,0,-7,1,down,1981-03-28
16767,Bernard Wright,1981-06-27,Bernard Wright - Nard,32,32,36,23.0,36,Nard,16.0,13,0,-4,0,0,stay,1981-03-28
16768,Bernard Wright,1981-07-04,Bernard Wright - Nard,36,32,38,23.0,36,Nard,16.0,14,-2,0,-4,1,down,1981-03-28
16769,Bernard Wright,1981-07-11,Bernard Wright - Nard,36,36,46,23.0,38,Nard,16.0,15,-8,-2,0,1,down,1981-03-28
16770,Bernard Wright,1981-07-18,Bernard Wright - Nard,38,36,51,23.0,46,Nard,16.0,16,-5,-8,-2,1,down,1981-03-28
16771,Jerry Knight,1981-03-28,Jerry Knight - Perfect Fit,51,51,42,30.0,47,Perfect Fit,10.0,0,5,4,0,1,up,1981-03-28
16772,Jerry Knight,1981-04-04,Jerry Knight - Perfect Fit,47,51,36,30.0,42,Perfect Fit,10.0,1,6,5,4,1,up,1981-03-28
16773,Jerry Knight,1981-04-11,Jerry Knight - Perfect Fit,42,47,30,30.0,36,Perfect Fit,10.0,2,6,6,5,1,up,1981-03-28
16774,Jerry Knight,1981-04-18,Jerry Knight - Perfect Fit,36,42,30,30.0,30,Perfect Fit,10.0,3,0,6,6,0,stay,1981-03-28
16775,Jerry Knight,1981-04-25,Jerry Knight - Perfect Fit,30,36,31,30.0,30,Perfect Fit,10.0,4,-1,0,6,1,down,1981-03-28
16776,Jerry Knight,1981-05-02,Jerry Knight - Perfect Fit,30,30,39,30.0,31,Perfect Fit,10.0,5,-8,-1,0,1,down,1981-03-28
16777,Jerry Knight,1981-05-09,Jerry Knight - Perfect Fit,31,30,42,30.0,39,Perfect Fit,10.0,6,-3,-8,-1,1,down,1981-03-28
16778,Jerry Knight,1981-05-16,Jerry Knight - Perfect Fit,39,31,47,30.0,42,Perfect Fit,10.0,7,-5,-3,-8,1,down,1981-03-28
16779,Jerry Knight,1981-05-23,Jerry Knight - Perfect Fit,42,39,47,30.0,47,Perfect Fit,10.0,8,0,-5,-3,0,stay,1981-03-28
16780,Jerry Knight,1981-05-30,Jerry Knight - Perfect Fit,47,42,50,30.0,47,Perfect Fit,10.0,9,-3,0,-5,1,down,1981-03-28
16781,Jerry Knight,1981-06-06,Jerry Knight - Perfect Fit,47,47,51,30.0,50,Perfect Fit,10.0,10,-1,-3,0,1,down,1981-03-28
16782,Champaign,1981-03-28,Champaign - How 'bout Us,51,51,35,14.0,49,How 'bout Us,18.0,0,14,2,0,1,up,1981-03-28
16783,Champaign,1981-04-04,Champaign - How 'bout Us,49,51,26,14.0,35,How 'bout Us,18.0,1,9,14,2,1,up,1981-03-28
16784,Champaign,1981-04-11,Champaign - How 'bout Us,35,49,20,14.0,26,How 'bout Us,18.0,2,6,9,14,1,up,1981-03-28
16785,Champaign,1981-04-18,Champaign - How 'bout Us,26,35,16,14.0,20,How 'bout Us,18.0,3,4,6,9,1,up,1981-03-28
16786,Champaign,1981-04-25,Champaign - How 'bout Us,20,26,16,14.0,16,How 'bout Us,18.0,4,0,4,6,0,stay,1981-03-28
16787,Champaign,1981-05-02,Champaign - How 'bout Us,16,20,14,14.0,16,How 'bout Us,18.0,5,2,0,4,1,up,1981-03-28
16788,Champaign,1981-05-09,Champaign - How 'bout Us,16,16,14,14.0,14,How 'bout Us,18.0,6,0,2,0,0,stay,1981-03-28
16789,Champaign,1981-05-16,Champaign - How 'bout Us,14,16,15,14.0,14,How 'bout Us,18.0,7,-1,0,2,1,down,1981-03-28
16790,Champaign,1981-05-23,Champaign - How 'bout Us,14,14,15,14.0,15,How 'bout Us,18.0,8,0,-1,0,0,stay,1981-03-28
16791,Champaign,1981-05-30,Champaign - How 'bout Us,15,14,15,14.0,15,How 'bout Us,18.0,9,0,0,-1,0,stay,1981-03-28
16792,Champaign,1981-06-06,Champaign - How 'bout Us,15,15,15,14.0,15,How 'bout Us,18.0,10,0,0,0,0,stay,1981-03-28
16793,Champaign,1981-06-13,Champaign - How 'bout Us,15,15,14,14.0,15,How 'bout Us,18.0,11,1,0,0,1,up,1981-03-28
16794,Champaign,1981-06-20,Champaign - How 'bout Us,15,15,14,14.0,14,How 'bout Us,18.0,12,0,1,0,0,stay,1981-03-28
16795,Champaign,1981-06-27,Champaign - How 'bout Us,14,15,15,14.0,14,How 'bout Us,18.0,13,-1,0,1,1,down,1981-03-28
16796,Champaign,1981-07-04,Champaign - How 'bout Us,14,14,18,14.0,15,How 'bout Us,18.0,14,-3,-1,0,1,down,1981-03-28
16797,Champaign,1981-07-11,Champaign - How 'bout Us,15,14,18,14.0,18,How 'bout Us,18.0,15,0,-3,-1,0,stay,1981-03-28
16798,Champaign,1981-07-18,Champaign - How 'bout Us,18,15,25,14.0,18,How 'bout Us,18.0,16,-7,0,-3,1,down,1981-03-28
16799,Champaign,1981-07-25,Champaign - How 'bout Us,18,18,49,14.0,25,How 'bout Us,18.0,17,-24,-7,0,1,down,1981-03-28
16800,Champaign,1981-08-01,Champaign - How 'bout Us,25,18,51,14.0,49,How 'bout Us,18.0,18,-2,-24,-7,1,down,1981-03-28
16801,Quincy Jones,1981-04-04,Quincy Jones - The Dude,51,51,20,3.0,36,The Dude,67.0,0,16,15,0,1,up,1981-04-04
16802,Quincy Jones,1981-04-11,Quincy Jones - The Dude,36,51,9,3.0,20,The Dude,67.0,1,11,16,15,1,up,1981-04-04
16803,Quincy Jones,1981-04-18,Quincy Jones - The Dude,20,36,7,3.0,9,The Dude,67.0,2,2,11,16,1,up,1981-04-04
16804,Quincy Jones,1981-04-25,Quincy Jones - The Dude,9,20,5,3.0,7,The Dude,67.0,3,2,2,11,1,up,1981-04-04
16805,Quincy Jones,1981-05-02,Quincy Jones - The Dude,7,9,5,3.0,5,The Dude,67.0,4,0,2,2,0,stay,1981-04-04
16806,Quincy Jones,1981-05-09,Quincy Jones - The Dude,5,7,4,3.0,5,The Dude,67.0,5,1,0,2,1,up,1981-04-04
16807,Quincy Jones,1981-05-16,Quincy Jones - The Dude,5,5,3,3.0,4,The Dude,67.0,6,1,1,0,1,up,1981-04-04
16808,Quincy Jones,1981-05-23,Quincy Jones - The Dude,4,5,3,3.0,3,The Dude,67.0,7,0,1,1,0,stay,1981-04-04
16809,Quincy Jones,1981-05-30,Quincy Jones - The Dude,3,4,3,3.0,3,The Dude,67.0,8,0,0,1,0,stay,1981-04-04
16810,Quincy Jones,1981-06-06,Quincy Jones - The Dude,3,3,4,3.0,3,The Dude,67.0,9,-1,0,0,1,down,1981-04-04
16811,Quincy Jones,1981-06-13,Quincy Jones - The Dude,3,3,6,3.0,4,The Dude,67.0,10,-2,-1,0,1,down,1981-04-04
16812,Quincy Jones,1981-06-20,Quincy Jones - The Dude,4,3,6,3.0,6,The Dude,67.0,11,0,-2,-1,0,stay,1981-04-04
16813,Quincy Jones,1981-06-27,Quincy Jones - The Dude,6,4,6,3.0,6,The Dude,67.0,12,0,0,-2,0,stay,1981-04-04
16814,Quincy Jones,1981-07-04,Quincy Jones - The Dude,6,6,6,3.0,6,The Dude,67.0,13,0,0,0,0,stay,1981-04-04
16815,Quincy Jones,1981-07-11,Quincy Jones - The Dude,6,6,6,3.0,6,The Dude,67.0,14,0,0,0,0,stay,1981-04-04
16816,Quincy Jones,1981-07-18,Quincy Jones - The Dude,6,6,8,3.0,6,The Dude,67.0,15,-2,0,0,1,down,1981-04-04
16817,Quincy Jones,1981-07-25,Quincy Jones - The Dude,6,6,8,3.0,8,The Dude,67.0,16,0,-2,0,0,stay,1981-04-04
16818,Quincy Jones,1981-08-01,Quincy Jones - The Dude,8,6,13,3.0,8,The Dude,67.0,17,-5,0,-2,1,down,1981-04-04
16819,Quincy Jones,1981-08-08,Quincy Jones - The Dude,8,8,17,3.0,13,The Dude,67.0,18,-4,-5,0,1,down,1981-04-04
16820,Quincy Jones,1981-08-15,Quincy Jones - The Dude,13,8,20,3.0,17,The Dude,67.0,19,-3,-4,-5,1,down,1981-04-04
16821,Quincy Jones,1981-08-22,Quincy Jones - The Dude,17,13,20,3.0,20,The Dude,67.0,20,0,-3,-4,0,stay,1981-04-04
16822,Quincy Jones,1981-08-29,Quincy Jones - The Dude,20,17,22,3.0,20,The Dude,67.0,21,-2,0,-3,1,down,1981-04-04
16823,Quincy Jones,1981-09-05,Quincy Jones - The Dude,20,20,23,3.0,22,The Dude,67.0,22,-1,-2,0,1,down,1981-04-04
16824,Quincy Jones,1981-09-12,Quincy Jones - The Dude,22,20,27,3.0,23,The Dude,67.0,23,-4,-1,-2,1,down,1981-04-04
16825,Quincy Jones,1981-09-19,Quincy Jones - The Dude,23,22,30,3.0,27,The Dude,67.0,24,-3,-4,-1,1,down,1981-04-04
16826,Quincy Jones,1981-09-26,Quincy Jones - The Dude,27,23,30,3.0,30,The Dude,67.0,25,0,-3,-4,0,stay,1981-04-04
16827,Quincy Jones,1981-10-03,Quincy Jones - The Dude,30,27,29,3.0,30,The Dude,67.0,26,1,0,-3,1,up,1981-04-04
16828,Quincy Jones,1981-10-10,Quincy Jones - The Dude,30,30,26,3.0,29,The Dude,67.0,27,3,1,0,1,up,1981-04-04
16829,Quincy Jones,1981-10-17,Quincy Jones - The Dude,29,30,26,3.0,26,The Dude,67.0,28,0,3,1,0,stay,1981-04-04
16830,Quincy Jones,1981-10-24,Quincy Jones - The Dude,26,29,23,3.0,26,The Dude,67.0,29,3,0,3,1,up,1981-04-04
16831,Quincy Jones,1981-10-31,Quincy Jones - The Dude,26,26,20,3.0,23,The Dude,67.0,30,3,3,0,1,up,1981-04-04
16832,Quincy Jones,1981-11-07,Quincy Jones - The Dude,23,26,19,3.0,20,The Dude,67.0,31,1,3,3,1,up,1981-04-04
16833,Quincy Jones,1981-11-14,Quincy Jones - The Dude,20,23,19,3.0,19,The Dude,67.0,32,0,1,3,0,stay,1981-04-04
16834,Quincy Jones,1981-11-21,Quincy Jones - The Dude,19,20,24,3.0,19,The Dude,67.0,33,-5,0,1,1,down,1981-04-04
16835,Quincy Jones,1981-11-28,Quincy Jones - The Dude,19,19,27,3.0,24,The Dude,67.0,34,-3,-5,0,1,down,1981-04-04
16836,Quincy Jones,1981-12-05,Quincy Jones - The Dude,24,19,32,3.0,27,The Dude,67.0,35,-5,-3,-5,1,down,1981-04-04
16837,Quincy Jones,1981-12-12,Quincy Jones - The Dude,27,24,32,3.0,32,The Dude,67.0,36,0,-5,-3,0,stay,1981-04-04
16838,Quincy Jones,1981-12-19,Quincy Jones - The Dude,32,27,39,3.0,32,The Dude,67.0,37,-7,0,-5,1,down,1981-04-04
16839,Quincy Jones,1981-12-26,Quincy Jones - The Dude,32,32,39,3.0,39,The Dude,67.0,38,0,-7,0,0,stay,1981-04-04
16840,Quincy Jones,1982-01-02,Quincy Jones - The Dude,39,32,48,3.0,39,The Dude,67.0,39,-9,0,-7,1,down,1981-04-04
16841,Quincy Jones,1982-01-09,Quincy Jones - The Dude,39,39,47,3.0,48,The Dude,67.0,40,1,-9,0,1,up,1981-04-04
16842,Quincy Jones,1982-01-16,Quincy Jones - The Dude,48,39,40,3.0,47,The Dude,67.0,41,7,1,-9,1,up,1981-04-04
16843,Quincy Jones,1982-01-23,Quincy Jones - The Dude,47,48,35,3.0,40,The Dude,67.0,42,5,7,1,1,up,1981-04-04
16844,Quincy Jones,1982-01-30,Quincy Jones - The Dude,40,47,31,3.0,35,The Dude,67.0,43,4,5,7,1,up,1981-04-04
16845,Quincy Jones,1982-02-06,Quincy Jones - The Dude,35,40,28,3.0,31,The Dude,67.0,44,3,4,5,1,up,1981-04-04
16846,Quincy Jones,1982-02-13,Quincy Jones - The Dude,31,35,23,3.0,28,The Dude,67.0,45,5,3,4,1,up,1981-04-04
16847,Quincy Jones,1982-02-20,Quincy Jones - The Dude,28,31,20,3.0,23,The Dude,67.0,46,3,5,3,1,up,1981-04-04
16848,Quincy Jones,1982-02-27,Quincy Jones - The Dude,23,28,17,3.0,20,The Dude,67.0,47,3,3,5,1,up,1981-04-04
16849,Quincy Jones,1982-03-06,Quincy Jones - The Dude,20,23,15,3.0,17,The Dude,67.0,48,2,3,3,1,up,1981-04-04
16850,Quincy Jones,1982-03-13,Quincy Jones - The Dude,17,20,8,3.0,15,The Dude,67.0,49,7,2,3,1,up,1981-04-04
16851,Quincy Jones,1982-03-20,Quincy Jones - The Dude,15,17,8,3.0,8,The Dude,67.0,50,0,7,2,0,stay,1981-04-04
16852,Quincy Jones,1982-03-27,Quincy Jones - The Dude,8,15,5,3.0,8,The Dude,67.0,51,3,0,7,1,up,1981-04-04
16853,Quincy Jones,1982-04-03,Quincy Jones - The Dude,8,8,4,3.0,5,The Dude,67.0,52,1,3,0,1,up,1981-04-04
16854,Quincy Jones,1982-04-10,Quincy Jones - The Dude,5,8,4,3.0,4,The Dude,67.0,53,0,1,3,0,stay,1981-04-04
16855,Quincy Jones,1982-04-17,Quincy Jones - The Dude,4,5,4,3.0,4,The Dude,67.0,54,0,0,1,0,stay,1981-04-04
16856,Quincy Jones,1982-04-24,Quincy Jones - The Dude,4,4,5,3.0,4,The Dude,67.0,55,-1,0,0,1,down,1981-04-04
16857,Quincy Jones,1982-05-01,Quincy Jones - The Dude,4,4,7,3.0,5,The Dude,67.0,56,-2,-1,0,1,down,1981-04-04
16858,Quincy Jones,1982-05-08,Quincy Jones - The Dude,5,4,13,3.0,7,The Dude,67.0,57,-6,-2,-1,1,down,1981-04-04
16859,Quincy Jones,1982-05-15,Quincy Jones - The Dude,7,5,14,3.0,13,The Dude,67.0,58,-1,-6,-2,1,down,1981-04-04
16860,Quincy Jones,1982-05-22,Quincy Jones - The Dude,13,7,15,3.0,14,The Dude,67.0,59,-1,-1,-6,1,down,1981-04-04
16861,Quincy Jones,1982-05-29,Quincy Jones - The Dude,14,13,19,3.0,15,The Dude,67.0,60,-4,-1,-1,1,down,1981-04-04
16862,Quincy Jones,1982-06-05,Quincy Jones - The Dude,15,14,29,3.0,19,The Dude,67.0,61,-10,-4,-1,1,down,1981-04-04
16863,Quincy Jones,1982-06-12,Quincy Jones - The Dude,19,15,32,3.0,29,The Dude,67.0,62,-3,-10,-4,1,down,1981-04-04
16864,Quincy Jones,1982-06-19,Quincy Jones - The Dude,29,19,38,3.0,32,The Dude,67.0,63,-6,-3,-10,1,down,1981-04-04
16865,Quincy Jones,1982-06-26,Quincy Jones - The Dude,32,29,36,3.0,38,The Dude,67.0,64,2,-6,-3,1,up,1981-04-04
16866,Quincy Jones,1982-07-03,Quincy Jones - The Dude,38,32,45,3.0,36,The Dude,67.0,65,-9,2,-6,1,down,1981-04-04
16867,Quincy Jones,1982-07-10,Quincy Jones - The Dude,36,38,43,3.0,45,The Dude,67.0,66,2,-9,2,1,up,1981-04-04
16868,Quincy Jones,1982-07-17,Quincy Jones - The Dude,45,36,51,3.0,43,The Dude,67.0,67,-8,2,-9,1,down,1981-04-04
16869,Rufus,1981-04-04,Rufus - Party 'til You're Broke,51,51,35,24.0,45,Party 'til You're Broke,13.0,0,10,6,0,1,up,1981-04-04
16870,Rufus,1981-04-11,Rufus - Party 'til You're Broke,45,51,31,24.0,35,Party 'til You're Broke,13.0,1,4,10,6,1,up,1981-04-04
16871,Rufus,1981-04-18,Rufus - Party 'til You're Broke,35,45,27,24.0,31,Party 'til You're Broke,13.0,2,4,4,10,1,up,1981-04-04
16872,Rufus,1981-04-25,Rufus - Party 'til You're Broke,31,35,24,24.0,27,Party 'til You're Broke,13.0,3,3,4,4,1,up,1981-04-04
16873,Rufus,1981-05-02,Rufus - Party 'til You're Broke,27,31,24,24.0,24,Party 'til You're Broke,13.0,4,0,3,4,0,stay,1981-04-04
16874,Rufus,1981-05-09,Rufus - Party 'til You're Broke,24,27,30,24.0,24,Party 'til You're Broke,13.0,5,-6,0,3,1,down,1981-04-04
16875,Rufus,1981-05-16,Rufus - Party 'til You're Broke,24,24,30,24.0,30,Party 'til You're Broke,13.0,6,0,-6,0,0,stay,1981-04-04
16876,Rufus,1981-05-23,Rufus - Party 'til You're Broke,30,24,34,24.0,30,Party 'til You're Broke,13.0,7,-4,0,-6,1,down,1981-04-04
16877,Rufus,1981-05-30,Rufus - Party 'til You're Broke,30,30,36,24.0,34,Party 'til You're Broke,13.0,8,-2,-4,0,1,down,1981-04-04
16878,Rufus,1981-06-06,Rufus - Party 'til You're Broke,34,30,37,24.0,36,Party 'til You're Broke,13.0,9,-1,-2,-4,1,down,1981-04-04
16879,Rufus,1981-06-13,Rufus - Party 'til You're Broke,36,34,37,24.0,37,Party 'til You're Broke,13.0,10,0,-1,-2,0,stay,1981-04-04
16880,Rufus,1981-06-20,Rufus - Party 'til You're Broke,37,36,40,24.0,37,Party 'til You're Broke,13.0,11,-3,0,-1,1,down,1981-04-04
16881,Rufus,1981-06-27,Rufus - Party 'til You're Broke,37,37,47,24.0,40,Party 'til You're Broke,13.0,12,-7,-3,0,1,down,1981-04-04
16882,Rufus,1981-07-04,Rufus - Party 'til You're Broke,40,37,51,24.0,47,Party 'til You're Broke,13.0,13,-4,-7,-3,1,down,1981-04-04
16883,Gene Dunlap,1981-04-04,Gene Dunlap - It's Just The Way I Feel,51,51,44,39.0,49,It's Just The Way I Feel,4.0,0,5,2,0,1,up,1981-04-04
16884,Gene Dunlap,1981-04-11,Gene Dunlap - It's Just The Way I Feel,49,51,39,39.0,44,It's Just The Way I Feel,4.0,1,5,5,2,1,up,1981-04-04
16885,Gene Dunlap,1981-04-18,Gene Dunlap - It's Just The Way I Feel,44,49,39,39.0,39,It's Just The Way I Feel,4.0,2,0,5,5,0,stay,1981-04-04
16886,Gene Dunlap,1981-04-25,Gene Dunlap - It's Just The Way I Feel,39,44,39,39.0,39,It's Just The Way I Feel,4.0,3,0,0,5,0,stay,1981-04-04
16887,Gene Dunlap,1981-05-02,Gene Dunlap - It's Just The Way I Feel,39,39,51,39.0,39,It's Just The Way I Feel,4.0,4,-12,0,0,1,down,1981-04-04
16888,Deniece Williams,1981-04-11,Deniece Williams - My Melody,51,51,29,13.0,40,My Melody,31.0,0,11,11,0,1,up,1981-04-11
16889,Deniece Williams,1981-04-18,Deniece Williams - My Melody,40,51,22,13.0,29,My Melody,31.0,1,7,11,11,1,up,1981-04-11
16890,Deniece Williams,1981-04-25,Deniece Williams - My Melody,29,40,18,13.0,22,My Melody,31.0,2,4,7,11,1,up,1981-04-11
16891,Deniece Williams,1981-05-02,Deniece Williams - My Melody,22,29,16,13.0,18,My Melody,31.0,3,2,4,7,1,up,1981-04-11
16892,Deniece Williams,1981-05-09,Deniece Williams - My Melody,18,22,13,13.0,16,My Melody,31.0,4,3,2,4,1,up,1981-04-11
16893,Deniece Williams,1981-05-16,Deniece Williams - My Melody,16,18,13,13.0,13,My Melody,31.0,5,0,3,2,0,stay,1981-04-11
16894,Deniece Williams,1981-05-23,Deniece Williams - My Melody,13,16,21,13.0,13,My Melody,31.0,6,-8,0,3,1,down,1981-04-11
16895,Deniece Williams,1981-05-30,Deniece Williams - My Melody,13,13,21,13.0,21,My Melody,31.0,7,0,-8,0,0,stay,1981-04-11
16896,Deniece Williams,1981-06-06,Deniece Williams - My Melody,21,13,17,13.0,21,My Melody,31.0,8,4,0,-8,1,up,1981-04-11
16897,Deniece Williams,1981-06-13,Deniece Williams - My Melody,21,21,15,13.0,17,My Melody,31.0,9,2,4,0,1,up,1981-04-11
16898,Deniece Williams,1981-06-20,Deniece Williams - My Melody,17,21,13,13.0,15,My Melody,31.0,10,2,2,4,1,up,1981-04-11
16899,Deniece Williams,1981-06-27,Deniece Williams - My Melody,15,17,13,13.0,13,My Melody,31.0,11,0,2,2,0,stay,1981-04-11
16900,Deniece Williams,1981-07-04,Deniece Williams - My Melody,13,15,13,13.0,13,My Melody,31.0,12,0,0,2,0,stay,1981-04-11
16901,Deniece Williams,1981-07-11,Deniece Williams - My Melody,13,13,13,13.0,13,My Melody,31.0,13,0,0,0,0,stay,1981-04-11
16902,Deniece Williams,1981-07-18,Deniece Williams - My Melody,13,13,14,13.0,13,My Melody,31.0,14,-1,0,0,1,down,1981-04-11
16903,Deniece Williams,1981-07-25,Deniece Williams - My Melody,13,13,16,13.0,14,My Melody,31.0,15,-2,-1,0,1,down,1981-04-11
16904,Deniece Williams,1981-08-01,Deniece Williams - My Melody,14,13,21,13.0,16,My Melody,31.0,16,-5,-2,-1,1,down,1981-04-11
16905,Deniece Williams,1981-08-08,Deniece Williams - My Melody,16,14,21,13.0,21,My Melody,31.0,17,0,-5,-2,0,stay,1981-04-11
16906,Deniece Williams,1981-08-15,Deniece Williams - My Melody,21,16,23,13.0,21,My Melody,31.0,18,-2,0,-5,1,down,1981-04-11
16907,Deniece Williams,1981-08-22,Deniece Williams - My Melody,21,21,23,13.0,23,My Melody,31.0,19,0,-2,0,0,stay,1981-04-11
16908,Deniece Williams,1981-08-29,Deniece Williams - My Melody,23,21,25,13.0,23,My Melody,31.0,20,-2,0,-2,1,down,1981-04-11
16909,Deniece Williams,1981-09-05,Deniece Williams - My Melody,23,23,26,13.0,25,My Melody,31.0,21,-1,-2,0,1,down,1981-04-11
16910,Deniece Williams,1981-09-12,Deniece Williams - My Melody,25,23,26,13.0,26,My Melody,31.0,22,0,-1,-2,0,stay,1981-04-11
16911,Deniece Williams,1981-09-19,Deniece Williams - My Melody,26,25,24,13.0,26,My Melody,31.0,23,2,0,-1,1,up,1981-04-11
16912,Deniece Williams,1981-09-26,Deniece Williams - My Melody,26,26,24,13.0,24,My Melody,31.0,24,0,2,0,0,stay,1981-04-11
16913,Deniece Williams,1981-10-03,Deniece Williams - My Melody,24,26,23,13.0,24,My Melody,31.0,25,1,0,2,1,up,1981-04-11
16914,Deniece Williams,1981-10-10,Deniece Williams - My Melody,24,24,34,13.0,23,My Melody,31.0,26,-11,1,0,1,down,1981-04-11
16915,Deniece Williams,1981-10-17,Deniece Williams - My Melody,23,24,34,13.0,34,My Melody,31.0,27,0,-11,1,0,stay,1981-04-11
16916,Deniece Williams,1981-10-24,Deniece Williams - My Melody,34,23,36,13.0,34,My Melody,31.0,28,-2,0,-11,1,down,1981-04-11
16917,Deniece Williams,1981-10-31,Deniece Williams - My Melody,34,34,48,13.0,36,My Melody,31.0,29,-12,-2,0,1,down,1981-04-11
16918,Deniece Williams,1981-11-07,Deniece Williams - My Melody,36,34,50,13.0,48,My Melody,31.0,30,-2,-12,-2,1,down,1981-04-11
16919,Deniece Williams,1981-11-14,Deniece Williams - My Melody,48,36,51,13.0,50,My Melody,31.0,31,-1,-2,-12,1,down,1981-04-11
16920,Funkadelic,1981-04-11,Funkadelic - Connections And Disconnections,51,51,45,45.0,45,Connections And Disconnections,4.0,0,0,6,0,0,stay,1981-04-11
16921,Funkadelic,1981-04-18,Funkadelic - Connections And Disconnections,45,51,45,45.0,45,Connections And Disconnections,4.0,1,0,0,6,0,stay,1981-04-11
16922,Funkadelic,1981-04-25,Funkadelic - Connections And Disconnections,45,45,46,45.0,45,Connections And Disconnections,4.0,2,-1,0,0,1,down,1981-04-11
16923,Funkadelic,1981-05-02,Funkadelic - Connections And Disconnections,45,45,46,45.0,46,Connections And Disconnections,4.0,3,0,-1,0,0,stay,1981-04-11
16924,Funkadelic,1981-05-09,Funkadelic - Connections And Disconnections,46,45,51,45.0,46,Connections And Disconnections,4.0,4,-5,0,-1,1,down,1981-04-11
16925,Debra Laws,1981-04-11,Debra Laws - Very Special,51,51,47,13.0,47,Very Special,24.0,0,0,4,0,0,stay,1981-04-11
16926,Debra Laws,1981-04-18,Debra Laws - Very Special,47,51,44,13.0,47,Very Special,24.0,1,3,0,4,1,up,1981-04-11
16927,Debra Laws,1981-04-25,Debra Laws - Very Special,47,47,43,13.0,44,Very Special,24.0,2,1,3,0,1,up,1981-04-11
16928,Debra Laws,1981-05-02,Debra Laws - Very Special,44,47,43,13.0,43,Very Special,24.0,3,0,1,3,0,stay,1981-04-11
16929,Debra Laws,1981-05-09,Debra Laws - Very Special,43,44,41,13.0,43,Very Special,24.0,4,2,0,1,1,up,1981-04-11
16930,Debra Laws,1981-05-16,Debra Laws - Very Special,43,43,38,13.0,41,Very Special,24.0,5,3,2,0,1,up,1981-04-11
16931,Debra Laws,1981-05-23,Debra Laws - Very Special,41,43,33,13.0,38,Very Special,24.0,6,5,3,2,1,up,1981-04-11
16932,Debra Laws,1981-05-30,Debra Laws - Very Special,38,41,29,13.0,33,Very Special,24.0,7,4,5,3,1,up,1981-04-11
16933,Debra Laws,1981-06-06,Debra Laws - Very Special,33,38,26,13.0,29,Very Special,24.0,8,3,4,5,1,up,1981-04-11
16934,Debra Laws,1981-06-13,Debra Laws - Very Special,29,33,24,13.0,26,Very Special,24.0,9,2,3,4,1,up,1981-04-11
16935,Debra Laws,1981-06-20,Debra Laws - Very Special,26,29,19,13.0,24,Very Special,24.0,10,5,2,3,1,up,1981-04-11
16936,Debra Laws,1981-06-27,Debra Laws - Very Special,24,26,17,13.0,19,Very Special,24.0,11,2,5,2,1,up,1981-04-11
16937,Debra Laws,1981-07-04,Debra Laws - Very Special,19,24,15,13.0,17,Very Special,24.0,12,2,2,5,1,up,1981-04-11
16938,Debra Laws,1981-07-11,Debra Laws - Very Special,17,19,15,13.0,15,Very Special,24.0,13,0,2,2,0,stay,1981-04-11
16939,Debra Laws,1981-07-18,Debra Laws - Very Special,15,17,13,13.0,15,Very Special,24.0,14,2,0,2,1,up,1981-04-11
16940,Debra Laws,1981-07-25,Debra Laws - Very Special,15,15,13,13.0,13,Very Special,24.0,15,0,2,0,0,stay,1981-04-11
16941,Debra Laws,1981-08-01,Debra Laws - Very Special,13,15,20,13.0,13,Very Special,24.0,16,-7,0,2,1,down,1981-04-11
16942,Debra Laws,1981-08-08,Debra Laws - Very Special,13,13,22,13.0,20,Very Special,24.0,17,-2,-7,0,1,down,1981-04-11
16943,Debra Laws,1981-08-15,Debra Laws - Very Special,20,13,25,13.0,22,Very Special,24.0,18,-3,-2,-7,1,down,1981-04-11
16944,Debra Laws,1981-08-22,Debra Laws - Very Special,22,20,27,13.0,25,Very Special,24.0,19,-2,-3,-2,1,down,1981-04-11
16945,Debra Laws,1981-08-29,Debra Laws - Very Special,25,22,27,13.0,27,Very Special,24.0,20,0,-2,-3,0,stay,1981-04-11
16946,Debra Laws,1981-09-05,Debra Laws - Very Special,27,25,27,13.0,27,Very Special,24.0,21,0,0,-2,0,stay,1981-04-11
16947,Debra Laws,1981-09-12,Debra Laws - Very Special,27,27,32,13.0,27,Very Special,24.0,22,-5,0,0,1,down,1981-04-11
16948,Debra Laws,1981-09-19,Debra Laws - Very Special,27,27,43,13.0,32,Very Special,24.0,23,-11,-5,0,1,down,1981-04-11
16949,Debra Laws,1981-09-26,Debra Laws - Very Special,32,27,51,13.0,43,Very Special,24.0,24,-8,-11,-5,1,down,1981-04-11
16950,The Spinners,1981-04-11,The Spinners - Labor Of Love,51,51,41,40.0,48,Labor Of Love,5.0,0,7,3,0,1,up,1981-04-11
16951,The Spinners,1981-04-18,The Spinners - Labor Of Love,48,51,41,40.0,41,Labor Of Love,5.0,1,0,7,3,0,stay,1981-04-11
16952,The Spinners,1981-04-25,The Spinners - Labor Of Love,41,48,40,40.0,41,Labor Of Love,5.0,2,1,0,7,1,up,1981-04-11
16953,The Spinners,1981-05-02,The Spinners - Labor Of Love,41,41,45,40.0,40,Labor Of Love,5.0,3,-5,1,0,1,down,1981-04-11
16954,The Spinners,1981-05-09,The Spinners - Labor Of Love,40,41,50,40.0,45,Labor Of Love,5.0,4,-5,-5,1,1,down,1981-04-11
16955,The Spinners,1981-05-16,The Spinners - Labor Of Love,45,40,51,40.0,50,Labor Of Love,5.0,5,-1,-5,-5,1,down,1981-04-11
16956,Ohio Players,1981-04-11,Ohio Players - Tenderness,51,51,49,49.0,49,Tenderness,2.0,0,0,2,0,0,stay,1981-04-11
16957,Ohio Players,1981-04-18,Ohio Players - Tenderness,49,51,49,49.0,49,Tenderness,2.0,1,0,0,2,0,stay,1981-04-11
16958,Ohio Players,1981-04-25,Ohio Players - Tenderness,49,49,51,49.0,49,Tenderness,2.0,2,-2,0,0,1,down,1981-04-11
16959,Bill Summers & Summers Heat,1981-04-11,Bill Summers & Summers Heat - Call It What You Want,51,51,44,19.0,50,Call It What You Want,18.0,0,6,1,0,1,up,1981-04-11
16960,Bill Summers & Summers Heat,1981-04-18,Bill Summers & Summers Heat - Call It What You Want,50,51,37,19.0,44,Call It What You Want,18.0,1,7,6,1,1,up,1981-04-11
16961,Bill Summers & Summers Heat,1981-04-25,Bill Summers & Summers Heat - Call It What You Want,44,50,32,19.0,37,Call It What You Want,18.0,2,5,7,6,1,up,1981-04-11
16962,Bill Summers & Summers Heat,1981-05-02,Bill Summers & Summers Heat - Call It What You Want,37,44,28,19.0,32,Call It What You Want,18.0,3,4,5,7,1,up,1981-04-11
16963,Bill Summers & Summers Heat,1981-05-09,Bill Summers & Summers Heat - Call It What You Want,32,37,24,19.0,28,Call It What You Want,18.0,4,4,4,5,1,up,1981-04-11
16964,Bill Summers & Summers Heat,1981-05-16,Bill Summers & Summers Heat - Call It What You Want,28,32,21,19.0,24,Call It What You Want,18.0,5,3,4,4,1,up,1981-04-11
16965,Bill Summers & Summers Heat,1981-05-23,Bill Summers & Summers Heat - Call It What You Want,24,28,19,19.0,21,Call It What You Want,18.0,6,2,3,4,1,up,1981-04-11
16966,Bill Summers & Summers Heat,1981-05-30,Bill Summers & Summers Heat - Call It What You Want,21,24,19,19.0,19,Call It What You Want,18.0,7,0,2,3,0,stay,1981-04-11
16967,Bill Summers & Summers Heat,1981-06-06,Bill Summers & Summers Heat - Call It What You Want,19,21,21,19.0,19,Call It What You Want,18.0,8,-2,0,2,1,down,1981-04-11
16968,Bill Summers & Summers Heat,1981-06-13,Bill Summers & Summers Heat - Call It What You Want,19,19,23,19.0,21,Call It What You Want,18.0,9,-2,-2,0,1,down,1981-04-11
16969,Bill Summers & Summers Heat,1981-06-20,Bill Summers & Summers Heat - Call It What You Want,21,19,24,19.0,23,Call It What You Want,18.0,10,-1,-2,-2,1,down,1981-04-11
16970,Bill Summers & Summers Heat,1981-06-27,Bill Summers & Summers Heat - Call It What You Want,23,21,24,19.0,24,Call It What You Want,18.0,11,0,-1,-2,0,stay,1981-04-11
16971,Bill Summers & Summers Heat,1981-07-04,Bill Summers & Summers Heat - Call It What You Want,24,23,27,19.0,24,Call It What You Want,18.0,12,-3,0,-1,1,down,1981-04-11
16972,Bill Summers & Summers Heat,1981-07-11,Bill Summers & Summers Heat - Call It What You Want,24,24,28,19.0,27,Call It What You Want,18.0,13,-1,-3,0,1,down,1981-04-11
16973,Bill Summers & Summers Heat,1981-07-18,Bill Summers & Summers Heat - Call It What You Want,27,24,30,19.0,28,Call It What You Want,18.0,14,-2,-1,-3,1,down,1981-04-11
16974,Bill Summers & Summers Heat,1981-07-25,Bill Summers & Summers Heat - Call It What You Want,28,27,33,19.0,30,Call It What You Want,18.0,15,-3,-2,-1,1,down,1981-04-11
16975,Bill Summers & Summers Heat,1981-08-01,Bill Summers & Summers Heat - Call It What You Want,30,28,37,19.0,33,Call It What You Want,18.0,16,-4,-3,-2,1,down,1981-04-11
16976,Bill Summers & Summers Heat,1981-08-08,Bill Summers & Summers Heat - Call It What You Want,33,30,49,19.0,37,Call It What You Want,18.0,17,-12,-4,-3,1,down,1981-04-11
16977,Bill Summers & Summers Heat,1981-08-15,Bill Summers & Summers Heat - Call It What You Want,37,33,51,19.0,49,Call It What You Want,18.0,18,-2,-12,-4,1,down,1981-04-11
16978,Ray Parker Jr. & Raydio,1981-04-18,Ray Parker Jr. & Raydio - A Woman Needs Love,51,51,20,1.0,43,A Woman Needs Love,23.0,0,23,8,0,1,up,1981-04-18
16979,Ray Parker Jr. & Raydio,1981-04-25,Ray Parker Jr. & Raydio - A Woman Needs Love,43,51,10,1.0,20,A Woman Needs Love,23.0,1,10,23,8,1,up,1981-04-18
16980,Ray Parker Jr. & Raydio,1981-05-02,Ray Parker Jr. & Raydio - A Woman Needs Love,20,43,4,1.0,10,A Woman Needs Love,23.0,2,6,10,23,1,up,1981-04-18
16981,Ray Parker Jr. & Raydio,1981-05-09,Ray Parker Jr. & Raydio - A Woman Needs Love,10,20,2,1.0,4,A Woman Needs Love,23.0,3,2,6,10,1,up,1981-04-18
16982,Ray Parker Jr. & Raydio,1981-05-16,Ray Parker Jr. & Raydio - A Woman Needs Love,4,10,1,1.0,2,A Woman Needs Love,23.0,4,1,2,6,1,up,1981-04-18
16983,Ray Parker Jr. & Raydio,1981-05-23,Ray Parker Jr. & Raydio - A Woman Needs Love,2,4,1,1.0,1,A Woman Needs Love,23.0,5,0,1,2,0,stay,1981-04-18
16984,Ray Parker Jr. & Raydio,1981-05-30,Ray Parker Jr. & Raydio - A Woman Needs Love,1,2,2,1.0,1,A Woman Needs Love,23.0,6,-1,0,1,1,down,1981-04-18
16985,Ray Parker Jr. & Raydio,1981-06-06,Ray Parker Jr. & Raydio - A Woman Needs Love,1,1,2,1.0,2,A Woman Needs Love,23.0,7,0,-1,0,0,stay,1981-04-18
16986,Ray Parker Jr. & Raydio,1981-06-13,Ray Parker Jr. & Raydio - A Woman Needs Love,2,1,2,1.0,2,A Woman Needs Love,23.0,8,0,0,-1,0,stay,1981-04-18
16987,Ray Parker Jr. & Raydio,1981-06-20,Ray Parker Jr. & Raydio - A Woman Needs Love,2,2,2,1.0,2,A Woman Needs Love,23.0,9,0,0,0,0,stay,1981-04-18
16988,Ray Parker Jr. & Raydio,1981-06-27,Ray Parker Jr. & Raydio - A Woman Needs Love,2,2,2,1.0,2,A Woman Needs Love,23.0,10,0,0,0,0,stay,1981-04-18
16989,Ray Parker Jr. & Raydio,1981-07-04,Ray Parker Jr. & Raydio - A Woman Needs Love,2,2,4,1.0,2,A Woman Needs Love,23.0,11,-2,0,0,1,down,1981-04-18
16990,Ray Parker Jr. & Raydio,1981-07-11,Ray Parker Jr. & Raydio - A Woman Needs Love,2,2,5,1.0,4,A Woman Needs Love,23.0,12,-1,-2,0,1,down,1981-04-18
16991,Ray Parker Jr. & Raydio,1981-07-18,Ray Parker Jr. & Raydio - A Woman Needs Love,4,2,6,1.0,5,A Woman Needs Love,23.0,13,-1,-1,-2,1,down,1981-04-18
16992,Ray Parker Jr. & Raydio,1981-07-25,Ray Parker Jr. & Raydio - A Woman Needs Love,5,4,7,1.0,6,A Woman Needs Love,23.0,14,-1,-1,-1,1,down,1981-04-18
16993,Ray Parker Jr. & Raydio,1981-08-01,Ray Parker Jr. & Raydio - A Woman Needs Love,6,5,8,1.0,7,A Woman Needs Love,23.0,15,-1,-1,-1,1,down,1981-04-18
16994,Ray Parker Jr. & Raydio,1981-08-08,Ray Parker Jr. & Raydio - A Woman Needs Love,7,6,11,1.0,8,A Woman Needs Love,23.0,16,-3,-1,-1,1,down,1981-04-18
16995,Ray Parker Jr. & Raydio,1981-08-15,Ray Parker Jr. & Raydio - A Woman Needs Love,8,7,21,1.0,11,A Woman Needs Love,23.0,17,-10,-3,-1,1,down,1981-04-18
16996,Ray Parker Jr. & Raydio,1981-08-22,Ray Parker Jr. & Raydio - A Woman Needs Love,11,8,22,1.0,21,A Woman Needs Love,23.0,18,-1,-10,-3,1,down,1981-04-18
16997,Ray Parker Jr. & Raydio,1981-08-29,Ray Parker Jr. & Raydio - A Woman Needs Love,21,11,23,1.0,22,A Woman Needs Love,23.0,19,-1,-1,-10,1,down,1981-04-18
16998,Ray Parker Jr. & Raydio,1981-09-05,Ray Parker Jr. & Raydio - A Woman Needs Love,22,21,25,1.0,23,A Woman Needs Love,23.0,20,-2,-1,-1,1,down,1981-04-18
16999,Ray Parker Jr. & Raydio,1981-09-12,Ray Parker Jr. & Raydio - A Woman Needs Love,23,22,31,1.0,25,A Woman Needs Love,23.0,21,-6,-2,-1,1,down,1981-04-18
17000,Ray Parker Jr. & Raydio,1981-09-19,Ray Parker Jr. & Raydio - A Woman Needs Love,25,23,34,1.0,31,A Woman Needs Love,23.0,22,-3,-6,-2,1,down,1981-04-18
17001,Ray Parker Jr. & Raydio,1981-09-26,Ray Parker Jr. & Raydio - A Woman Needs Love,31,25,51,1.0,34,A Woman Needs Love,23.0,23,-17,-3,-6,1,down,1981-04-18
17002,Brenda Russell,1981-04-18,Brenda Russell - Love Life,51,51,42,42.0,48,Love Life,6.0,0,6,3,0,1,up,1981-04-18
17003,Brenda Russell,1981-04-25,Brenda Russell - Love Life,48,51,42,42.0,42,Love Life,6.0,1,0,6,3,0,stay,1981-04-18
17004,Brenda Russell,1981-05-02,Brenda Russell - Love Life,42,48,48,42.0,42,Love Life,6.0,2,-6,0,6,1,down,1981-04-18
17005,Brenda Russell,1981-05-09,Brenda Russell - Love Life,42,42,48,42.0,48,Love Life,6.0,3,0,-6,0,0,stay,1981-04-18
17006,Brenda Russell,1981-05-16,Brenda Russell - Love Life,48,42,49,42.0,48,Love Life,6.0,4,-1,0,-6,1,down,1981-04-18
17007,Brenda Russell,1981-05-23,Brenda Russell - Love Life,48,48,49,42.0,49,Love Life,6.0,5,0,-1,0,0,stay,1981-04-18
17008,Brenda Russell,1981-05-30,Brenda Russell - Love Life,49,48,51,42.0,49,Love Life,6.0,6,-2,0,-1,1,down,1981-04-18
17009,Change,1981-04-25,Change - Miracles,51,51,26,9.0,36,Miracles,18.0,0,10,15,0,1,up,1981-04-25
17010,Change,1981-05-02,Change - Miracles,36,51,19,9.0,26,Miracles,18.0,1,7,10,15,1,up,1981-04-25
17011,Change,1981-05-09,Change - Miracles,26,36,15,9.0,19,Miracles,18.0,2,4,7,10,1,up,1981-04-25
17012,Change,1981-05-16,Change - Miracles,19,26,11,9.0,15,Miracles,18.0,3,4,4,7,1,up,1981-04-25
17013,Change,1981-05-23,Change - Miracles,15,19,10,9.0,11,Miracles,18.0,4,1,4,4,1,up,1981-04-25
17014,Change,1981-05-30,Change - Miracles,11,15,9,9.0,10,Miracles,18.0,5,1,1,4,1,up,1981-04-25
17015,Change,1981-06-06,Change - Miracles,10,11,9,9.0,9,Miracles,18.0,6,0,1,1,0,stay,1981-04-25
17016,Change,1981-06-13,Change - Miracles,9,10,12,9.0,9,Miracles,18.0,7,-3,0,1,1,down,1981-04-25
17017,Change,1981-06-20,Change - Miracles,9,9,21,9.0,12,Miracles,18.0,8,-9,-3,0,1,down,1981-04-25
17018,Change,1981-06-27,Change - Miracles,12,9,21,9.0,21,Miracles,18.0,9,0,-9,-3,0,stay,1981-04-25
17019,Change,1981-07-04,Change - Miracles,21,12,22,9.0,21,Miracles,18.0,10,-1,0,-9,1,down,1981-04-25
17020,Change,1981-07-11,Change - Miracles,21,21,22,9.0,22,Miracles,18.0,11,0,-1,0,0,stay,1981-04-25
17021,Change,1981-07-18,Change - Miracles,22,21,23,9.0,22,Miracles,18.0,12,-1,0,-1,1,down,1981-04-25
17022,Change,1981-07-25,Change - Miracles,22,22,26,9.0,23,Miracles,18.0,13,-3,-1,0,1,down,1981-04-25
17023,Change,1981-08-01,Change - Miracles,23,22,27,9.0,26,Miracles,18.0,14,-1,-3,-1,1,down,1981-04-25
17024,Change,1981-08-08,Change - Miracles,26,23,32,9.0,27,Miracles,18.0,15,-5,-1,-3,1,down,1981-04-25
17025,Change,1981-08-15,Change - Miracles,27,26,34,9.0,32,Miracles,18.0,16,-2,-5,-1,1,down,1981-04-25
17026,Change,1981-08-22,Change - Miracles,32,27,39,9.0,34,Miracles,18.0,17,-5,-2,-5,1,down,1981-04-25
17027,Change,1981-08-29,Change - Miracles,34,32,51,9.0,39,Miracles,18.0,18,-12,-5,-2,1,down,1981-04-25
17028,Robert Winters And Fall,1981-04-25,Robert Winters And Fall - Magic Man,51,51,33,27.0,40,Magic Man,11.0,0,7,11,0,1,up,1981-04-25
17029,Robert Winters And Fall,1981-05-02,Robert Winters And Fall - Magic Man,40,51,33,27.0,33,Magic Man,11.0,1,0,7,11,0,stay,1981-04-25
17030,Robert Winters And Fall,1981-05-09,Robert Winters And Fall - Magic Man,33,40,28,27.0,33,Magic Man,11.0,2,5,0,7,1,up,1981-04-25
17031,Robert Winters And Fall,1981-05-16,Robert Winters And Fall - Magic Man,33,33,28,27.0,28,Magic Man,11.0,3,0,5,0,0,stay,1981-04-25
17032,Robert Winters And Fall,1981-05-23,Robert Winters And Fall - Magic Man,28,33,27,27.0,28,Magic Man,11.0,4,1,0,5,1,up,1981-04-25
17033,Robert Winters And Fall,1981-05-30,Robert Winters And Fall - Magic Man,28,28,28,27.0,27,Magic Man,11.0,5,-1,1,0,1,down,1981-04-25
17034,Robert Winters And Fall,1981-06-06,Robert Winters And Fall - Magic Man,27,28,34,27.0,28,Magic Man,11.0,6,-6,-1,1,1,down,1981-04-25
17035,Robert Winters And Fall,1981-06-13,Robert Winters And Fall - Magic Man,28,27,42,27.0,34,Magic Man,11.0,7,-8,-6,-1,1,down,1981-04-25
17036,Robert Winters And Fall,1981-06-20,Robert Winters And Fall - Magic Man,34,28,44,27.0,42,Magic Man,11.0,8,-2,-8,-6,1,down,1981-04-25
17037,Robert Winters And Fall,1981-06-27,Robert Winters And Fall - Magic Man,42,34,50,27.0,44,Magic Man,11.0,9,-6,-2,-8,1,down,1981-04-25
17038,Robert Winters And Fall,1981-07-04,Robert Winters And Fall - Magic Man,44,42,48,27.0,50,Magic Man,11.0,10,2,-6,-2,1,up,1981-04-25
17039,Robert Winters And Fall,1981-07-11,Robert Winters And Fall - Magic Man,50,44,51,27.0,48,Magic Man,11.0,11,-3,2,-6,1,down,1981-04-25
17040,Gino Vannelli,1981-04-25,Gino Vannelli - Nightwalker,51,51,37,22.0,43,Nightwalker,12.0,0,6,8,0,1,up,1981-04-25
17041,Gino Vannelli,1981-05-02,Gino Vannelli - Nightwalker,43,51,32,22.0,37,Nightwalker,12.0,1,5,6,8,1,up,1981-04-25
17042,Gino Vannelli,1981-05-09,Gino Vannelli - Nightwalker,37,43,31,22.0,32,Nightwalker,12.0,2,1,5,6,1,up,1981-04-25
17043,Gino Vannelli,1981-05-16,Gino Vannelli - Nightwalker,32,37,27,22.0,31,Nightwalker,12.0,3,4,1,5,1,up,1981-04-25
17044,Gino Vannelli,1981-05-23,Gino Vannelli - Nightwalker,31,32,24,22.0,27,Nightwalker,12.0,4,3,4,1,1,up,1981-04-25
17045,Gino Vannelli,1981-05-30,Gino Vannelli - Nightwalker,27,31,24,22.0,24,Nightwalker,12.0,5,0,3,4,0,stay,1981-04-25
17046,Gino Vannelli,1981-06-06,Gino Vannelli - Nightwalker,24,27,22,22.0,24,Nightwalker,12.0,6,2,0,3,1,up,1981-04-25
17047,Gino Vannelli,1981-06-13,Gino Vannelli - Nightwalker,24,24,30,22.0,22,Nightwalker,12.0,7,-8,2,0,1,down,1981-04-25
17048,Gino Vannelli,1981-06-20,Gino Vannelli - Nightwalker,22,24,31,22.0,30,Nightwalker,12.0,8,-1,-8,2,1,down,1981-04-25
17049,Gino Vannelli,1981-06-27,Gino Vannelli - Nightwalker,30,22,31,22.0,31,Nightwalker,12.0,9,0,-1,-8,0,stay,1981-04-25
17050,Gino Vannelli,1981-07-04,Gino Vannelli - Nightwalker,31,30,33,22.0,31,Nightwalker,12.0,10,-2,0,-1,1,down,1981-04-25
17051,Gino Vannelli,1981-07-11,Gino Vannelli - Nightwalker,31,31,48,22.0,33,Nightwalker,12.0,11,-15,-2,0,1,down,1981-04-25
17052,Gino Vannelli,1981-07-18,Gino Vannelli - Nightwalker,33,31,51,22.0,48,Nightwalker,12.0,12,-3,-15,-2,1,down,1981-04-25
17053,Marc Sadane,1981-04-25,Marc Sadane - One Way Love Affair,51,51,51,50.0,50,One Way Love Affair,0.0,0,-1,1,0,1,down,1981-04-25
17054,Rick James,1981-05-02,Rick James - Street Songs,51,51,17,1.0,35,Street Songs,56.0,0,18,16,0,1,up,1981-05-02
17055,Rick James,1981-05-09,Rick James - Street Songs,35,51,8,1.0,17,Street Songs,56.0,1,9,18,16,1,up,1981-05-02
17056,Rick James,1981-05-16,Rick James - Street Songs,17,35,4,1.0,8,Street Songs,56.0,2,4,9,18,1,up,1981-05-02
17057,Rick James,1981-05-23,Rick James - Street Songs,8,17,2,1.0,4,Street Songs,56.0,3,2,4,9,1,up,1981-05-02
17058,Rick James,1981-05-30,Rick James - Street Songs,4,8,1,1.0,2,Street Songs,56.0,4,1,2,4,1,up,1981-05-02
17059,Rick James,1981-06-06,Rick James - Street Songs,2,4,1,1.0,1,Street Songs,56.0,5,0,1,2,0,stay,1981-05-02
17060,Rick James,1981-06-13,Rick James - Street Songs,1,2,1,1.0,1,Street Songs,56.0,6,0,0,1,0,stay,1981-05-02
17061,Rick James,1981-06-20,Rick James - Street Songs,1,1,1,1.0,1,Street Songs,56.0,7,0,0,0,0,stay,1981-05-02
17062,Rick James,1981-06-27,Rick James - Street Songs,1,1,1,1.0,1,Street Songs,56.0,8,0,0,0,0,stay,1981-05-02
17063,Rick James,1981-07-04,Rick James - Street Songs,1,1,1,1.0,1,Street Songs,56.0,9,0,0,0,0,stay,1981-05-02
17064,Rick James,1981-07-11,Rick James - Street Songs,1,1,1,1.0,1,Street Songs,56.0,10,0,0,0,0,stay,1981-05-02
17065,Rick James,1981-07-18,Rick James - Street Songs,1,1,1,1.0,1,Street Songs,56.0,11,0,0,0,0,stay,1981-05-02
17066,Rick James,1981-07-25,Rick James - Street Songs,1,1,1,1.0,1,Street Songs,56.0,12,0,0,0,0,stay,1981-05-02
17067,Rick James,1981-08-01,Rick James - Street Songs,1,1,1,1.0,1,Street Songs,56.0,13,0,0,0,0,stay,1981-05-02
17068,Rick James,1981-08-08,Rick James - Street Songs,1,1,1,1.0,1,Street Songs,56.0,14,0,0,0,0,stay,1981-05-02
17069,Rick James,1981-08-15,Rick James - Street Songs,1,1,1,1.0,1,Street Songs,56.0,15,0,0,0,0,stay,1981-05-02
17070,Rick James,1981-08-22,Rick James - Street Songs,1,1,1,1.0,1,Street Songs,56.0,16,0,0,0,0,stay,1981-05-02
17071,Rick James,1981-08-29,Rick James - Street Songs,1,1,1,1.0,1,Street Songs,56.0,17,0,0,0,0,stay,1981-05-02
17072,Rick James,1981-09-05,Rick James - Street Songs,1,1,1,1.0,1,Street Songs,56.0,18,0,0,0,0,stay,1981-05-02
17073,Rick James,1981-09-12,Rick James - Street Songs,1,1,1,1.0,1,Street Songs,56.0,19,0,0,0,0,stay,1981-05-02
17074,Rick James,1981-09-19,Rick James - Street Songs,1,1,1,1.0,1,Street Songs,56.0,20,0,0,0,0,stay,1981-05-02
17075,Rick James,1981-09-26,Rick James - Street Songs,1,1,1,1.0,1,Street Songs,56.0,21,0,0,0,0,stay,1981-05-02
17076,Rick James,1981-10-03,Rick James - Street Songs,1,1,1,1.0,1,Street Songs,56.0,22,0,0,0,0,stay,1981-05-02
17077,Rick James,1981-10-10,Rick James - Street Songs,1,1,1,1.0,1,Street Songs,56.0,23,0,0,0,0,stay,1981-05-02
17078,Rick James,1981-10-17,Rick James - Street Songs,1,1,2,1.0,1,Street Songs,56.0,24,-1,0,0,1,down,1981-05-02
17079,Rick James,1981-10-24,Rick James - Street Songs,1,1,2,1.0,2,Street Songs,56.0,25,0,-1,0,0,stay,1981-05-02
17080,Rick James,1981-10-31,Rick James - Street Songs,2,1,4,1.0,2,Street Songs,56.0,26,-2,0,-1,1,down,1981-05-02
17081,Rick James,1981-11-07,Rick James - Street Songs,2,2,5,1.0,4,Street Songs,56.0,27,-1,-2,0,1,down,1981-05-02
17082,Rick James,1981-11-14,Rick James - Street Songs,4,2,15,1.0,5,Street Songs,56.0,28,-10,-1,-2,1,down,1981-05-02
17083,Rick James,1981-11-21,Rick James - Street Songs,5,4,15,1.0,15,Street Songs,56.0,29,0,-10,-1,0,stay,1981-05-02
17084,Rick James,1981-11-28,Rick James - Street Songs,15,5,15,1.0,15,Street Songs,56.0,30,0,0,-10,0,stay,1981-05-02
17085,Rick James,1981-12-05,Rick James - Street Songs,15,15,26,1.0,15,Street Songs,56.0,31,-11,0,0,1,down,1981-05-02
17086,Rick James,1981-12-12,Rick James - Street Songs,15,15,27,1.0,26,Street Songs,56.0,32,-1,-11,0,1,down,1981-05-02
17087,Rick James,1981-12-19,Rick James - Street Songs,26,15,27,1.0,27,Street Songs,56.0,33,0,-1,-11,0,stay,1981-05-02
17088,Rick James,1981-12-26,Rick James - Street Songs,27,26,27,1.0,27,Street Songs,56.0,34,0,0,-1,0,stay,1981-05-02
17089,Rick James,1982-01-02,Rick James - Street Songs,27,27,27,1.0,27,Street Songs,56.0,35,0,0,0,0,stay,1981-05-02
17090,Rick James,1982-01-09,Rick James - Street Songs,27,27,25,1.0,27,Street Songs,56.0,36,2,0,0,1,up,1981-05-02
17091,Rick James,1982-01-16,Rick James - Street Songs,27,27,24,1.0,25,Street Songs,56.0,37,1,2,0,1,up,1981-05-02
17092,Rick James,1982-01-23,Rick James - Street Songs,25,27,23,1.0,24,Street Songs,56.0,38,1,1,2,1,up,1981-05-02
17093,Rick James,1982-01-30,Rick James - Street Songs,24,25,35,1.0,23,Street Songs,56.0,39,-12,1,1,1,down,1981-05-02
17094,Rick James,1982-02-06,Rick James - Street Songs,23,24,36,1.0,35,Street Songs,56.0,40,-1,-12,1,1,down,1981-05-02
17095,Rick James,1982-02-13,Rick James - Street Songs,35,23,36,1.0,36,Street Songs,56.0,41,0,-1,-12,0,stay,1981-05-02
17096,Rick James,1982-02-20,Rick James - Street Songs,36,35,34,1.0,36,Street Songs,56.0,42,2,0,-1,1,up,1981-05-02
17097,Rick James,1982-02-27,Rick James - Street Songs,36,36,34,1.0,34,Street Songs,56.0,43,0,2,0,0,stay,1981-05-02
17098,Rick James,1982-03-06,Rick James - Street Songs,34,36,33,1.0,34,Street Songs,56.0,44,1,0,2,1,up,1981-05-02
17099,Rick James,1982-03-13,Rick James - Street Songs,34,34,32,1.0,33,Street Songs,56.0,45,1,1,0,1,up,1981-05-02
17100,Rick James,1982-03-20,Rick James - Street Songs,33,34,30,1.0,32,Street Songs,56.0,46,2,1,1,1,up,1981-05-02
17101,Rick James,1982-03-27,Rick James - Street Songs,32,33,40,1.0,30,Street Songs,56.0,47,-10,2,1,1,down,1981-05-02
17102,Rick James,1982-04-03,Rick James - Street Songs,30,32,41,1.0,40,Street Songs,56.0,48,-1,-10,2,1,down,1981-05-02
17103,Rick James,1982-04-10,Rick James - Street Songs,40,30,41,1.0,41,Street Songs,56.0,49,0,-1,-10,0,stay,1981-05-02
17104,Rick James,1982-04-17,Rick James - Street Songs,41,40,45,1.0,41,Street Songs,56.0,50,-4,0,-1,1,down,1981-05-02
17105,Rick James,1982-04-24,Rick James - Street Songs,41,41,49,1.0,45,Street Songs,56.0,51,-4,-4,0,1,down,1981-05-02
17106,Rick James,1982-05-01,Rick James - Street Songs,45,41,48,1.0,49,Street Songs,56.0,52,1,-4,-4,1,up,1981-05-02
17107,Rick James,1982-06-12,Rick James - Street Songs,49,45,47,1.0,48,Street Songs,56.0,53,1,1,-4,1,up,1981-05-02
17108,Rick James,1982-06-19,Rick James - Street Songs,48,49,47,1.0,47,Street Songs,56.0,54,0,1,1,0,stay,1981-05-02
17109,Rick James,1982-06-26,Rick James - Street Songs,47,48,47,1.0,47,Street Songs,56.0,55,0,0,1,0,stay,1981-05-02
17110,Rick James,1982-07-03,Rick James - Street Songs,47,47,51,1.0,47,Street Songs,56.0,56,-4,0,0,1,down,1981-05-02
17111,David Sanborn,1981-05-02,David Sanborn - Voyeur,51,51,29,18.0,38,Voyeur,12.0,0,9,13,0,1,up,1981-05-02
17112,David Sanborn,1981-05-09,David Sanborn - Voyeur,38,51,25,18.0,29,Voyeur,12.0,1,4,9,13,1,up,1981-05-02
17113,David Sanborn,1981-05-16,David Sanborn - Voyeur,29,38,23,18.0,25,Voyeur,12.0,2,2,4,9,1,up,1981-05-02
17114,David Sanborn,1981-05-23,David Sanborn - Voyeur,25,29,20,18.0,23,Voyeur,12.0,3,3,2,4,1,up,1981-05-02
17115,David Sanborn,1981-05-30,David Sanborn - Voyeur,23,25,18,18.0,20,Voyeur,12.0,4,2,3,2,1,up,1981-05-02
17116,David Sanborn,1981-06-06,David Sanborn - Voyeur,20,23,18,18.0,18,Voyeur,12.0,5,0,2,3,0,stay,1981-05-02
17117,David Sanborn,1981-06-13,David Sanborn - Voyeur,18,20,28,18.0,18,Voyeur,12.0,6,-10,0,2,1,down,1981-05-02
17118,David Sanborn,1981-06-20,David Sanborn - Voyeur,18,18,28,18.0,28,Voyeur,12.0,7,0,-10,0,0,stay,1981-05-02
17119,David Sanborn,1981-06-27,David Sanborn - Voyeur,28,18,27,18.0,28,Voyeur,12.0,8,1,0,-10,1,up,1981-05-02
17120,David Sanborn,1981-07-04,David Sanborn - Voyeur,28,28,28,18.0,27,Voyeur,12.0,9,-1,1,0,1,down,1981-05-02
17121,David Sanborn,1981-07-11,David Sanborn - Voyeur,27,28,31,18.0,28,Voyeur,12.0,10,-3,-1,1,1,down,1981-05-02
17122,David Sanborn,1981-07-18,David Sanborn - Voyeur,28,27,38,18.0,31,Voyeur,12.0,11,-7,-3,-1,1,down,1981-05-02
17123,David Sanborn,1981-07-25,David Sanborn - Voyeur,31,28,51,18.0,38,Voyeur,12.0,12,-13,-7,-3,1,down,1981-05-02
17124,Santana,1981-05-02,Santana - Zebop,51,51,37,36.0,44,Zebop,3.0,0,7,7,0,1,up,1981-05-02
17125,Santana,1981-05-09,Santana - Zebop,44,51,36,36.0,37,Zebop,3.0,1,1,7,7,1,up,1981-05-02
17126,Santana,1981-05-16,Santana - Zebop,37,44,36,36.0,36,Zebop,3.0,2,0,1,7,0,stay,1981-05-02
17127,Santana,1981-05-23,Santana - Zebop,36,37,51,36.0,36,Zebop,3.0,3,-15,0,1,1,down,1981-05-02
17128,Joe Simon,1981-05-02,Joe Simon - Glad You Came My Way,51,51,49,49.0,49,Glad You Came My Way,2.0,0,0,2,0,0,stay,1981-05-02
17129,Joe Simon,1981-05-09,Joe Simon - Glad You Came My Way,49,51,49,49.0,49,Glad You Came My Way,2.0,1,0,0,2,0,stay,1981-05-02
17130,Joe Simon,1981-05-16,Joe Simon - Glad You Came My Way,49,49,51,49.0,49,Glad You Came My Way,2.0,2,-2,0,0,1,down,1981-05-02
17131,Starpoint,1981-05-02,Starpoint - Keep On It,51,51,42,31.0,50,Keep On It,11.0,0,8,1,0,1,up,1981-05-02
17132,Starpoint,1981-05-09,Starpoint - Keep On It,50,51,37,31.0,42,Keep On It,11.0,1,5,8,1,1,up,1981-05-02
17133,Starpoint,1981-05-16,Starpoint - Keep On It,42,50,37,31.0,37,Keep On It,11.0,2,0,5,8,0,stay,1981-05-02
17134,Starpoint,1981-05-23,Starpoint - Keep On It,37,42,35,31.0,37,Keep On It,11.0,3,2,0,5,1,up,1981-05-02
17135,Starpoint,1981-05-30,Starpoint - Keep On It,37,37,31,31.0,35,Keep On It,11.0,4,4,2,0,1,up,1981-05-02
17136,Starpoint,1981-06-06,Starpoint - Keep On It,35,37,31,31.0,31,Keep On It,11.0,5,0,4,2,0,stay,1981-05-02
17137,Starpoint,1981-06-13,Starpoint - Keep On It,31,35,33,31.0,31,Keep On It,11.0,6,-2,0,4,1,down,1981-05-02
17138,Starpoint,1981-06-20,Starpoint - Keep On It,31,31,35,31.0,33,Keep On It,11.0,7,-2,-2,0,1,down,1981-05-02
17139,Starpoint,1981-06-27,Starpoint - Keep On It,33,31,37,31.0,35,Keep On It,11.0,8,-2,-2,-2,1,down,1981-05-02
17140,Starpoint,1981-07-04,Starpoint - Keep On It,35,33,37,31.0,37,Keep On It,11.0,9,0,-2,-2,0,stay,1981-05-02
17141,Starpoint,1981-07-11,Starpoint - Keep On It,37,35,47,31.0,37,Keep On It,11.0,10,-10,0,-2,1,down,1981-05-02
17142,Starpoint,1981-07-18,Starpoint - Keep On It,37,37,51,31.0,47,Keep On It,11.0,11,-4,-10,0,1,down,1981-05-02
17143,Chaka Khan,1981-05-09,Chaka Khan - What Cha' Gonna Do For Me,51,51,18,3.0,30,What Cha' Gonna Do For Me,17.0,0,12,21,0,1,up,1981-05-09
17144,Chaka Khan,1981-05-16,Chaka Khan - What Cha' Gonna Do For Me,30,51,8,3.0,18,What Cha' Gonna Do For Me,17.0,1,10,12,21,1,up,1981-05-09
17145,Chaka Khan,1981-05-23,Chaka Khan - What Cha' Gonna Do For Me,18,30,5,3.0,8,What Cha' Gonna Do For Me,17.0,2,3,10,12,1,up,1981-05-09
17146,Chaka Khan,1981-05-30,Chaka Khan - What Cha' Gonna Do For Me,8,18,4,3.0,5,What Cha' Gonna Do For Me,17.0,3,1,3,10,1,up,1981-05-09
17147,Chaka Khan,1981-06-06,Chaka Khan - What Cha' Gonna Do For Me,5,8,3,3.0,4,What Cha' Gonna Do For Me,17.0,4,1,1,3,1,up,1981-05-09
17148,Chaka Khan,1981-06-13,Chaka Khan - What Cha' Gonna Do For Me,4,5,3,3.0,3,What Cha' Gonna Do For Me,17.0,5,0,1,1,0,stay,1981-05-09
17149,Chaka Khan,1981-06-20,Chaka Khan - What Cha' Gonna Do For Me,3,4,3,3.0,3,What Cha' Gonna Do For Me,17.0,6,0,0,1,0,stay,1981-05-09
17150,Chaka Khan,1981-06-27,Chaka Khan - What Cha' Gonna Do For Me,3,3,3,3.0,3,What Cha' Gonna Do For Me,17.0,7,0,0,0,0,stay,1981-05-09
17151,Chaka Khan,1981-07-04,Chaka Khan - What Cha' Gonna Do For Me,3,3,11,3.0,3,What Cha' Gonna Do For Me,17.0,8,-8,0,0,1,down,1981-05-09
17152,Chaka Khan,1981-07-11,Chaka Khan - What Cha' Gonna Do For Me,3,3,11,3.0,11,What Cha' Gonna Do For Me,17.0,9,0,-8,0,0,stay,1981-05-09
17153,Chaka Khan,1981-07-18,Chaka Khan - What Cha' Gonna Do For Me,11,3,12,3.0,11,What Cha' Gonna Do For Me,17.0,10,-1,0,-8,1,down,1981-05-09
17154,Chaka Khan,1981-07-25,Chaka Khan - What Cha' Gonna Do For Me,11,11,19,3.0,12,What Cha' Gonna Do For Me,17.0,11,-7,-1,0,1,down,1981-05-09
17155,Chaka Khan,1981-08-01,Chaka Khan - What Cha' Gonna Do For Me,12,11,19,3.0,19,What Cha' Gonna Do For Me,17.0,12,0,-7,-1,0,stay,1981-05-09
17156,Chaka Khan,1981-08-08,Chaka Khan - What Cha' Gonna Do For Me,19,12,29,3.0,19,What Cha' Gonna Do For Me,17.0,13,-10,0,-7,1,down,1981-05-09
17157,Chaka Khan,1981-08-15,Chaka Khan - What Cha' Gonna Do For Me,19,19,33,3.0,29,What Cha' Gonna Do For Me,17.0,14,-4,-10,0,1,down,1981-05-09
17158,Chaka Khan,1981-08-22,Chaka Khan - What Cha' Gonna Do For Me,29,19,34,3.0,33,What Cha' Gonna Do For Me,17.0,15,-1,-4,-10,1,down,1981-05-09
17159,Chaka Khan,1981-08-29,Chaka Khan - What Cha' Gonna Do For Me,33,29,46,3.0,34,What Cha' Gonna Do For Me,17.0,16,-12,-1,-4,1,down,1981-05-09
17160,Chaka Khan,1981-09-05,Chaka Khan - What Cha' Gonna Do For Me,34,33,51,3.0,46,What Cha' Gonna Do For Me,17.0,17,-5,-12,-1,1,down,1981-05-09
17161,George Duke,1981-05-09,George Duke - The Clarke/Duke Project,51,51,23,7.0,40,The Clarke/Duke Project,20.0,0,17,11,0,1,up,1981-05-09
17162,George Duke,1981-05-16,George Duke - The Clarke/Duke Project,40,51,16,7.0,23,The Clarke/Duke Project,20.0,1,7,17,11,1,up,1981-05-09
17163,George Duke,1981-05-23,George Duke - The Clarke/Duke Project,23,40,12,7.0,16,The Clarke/Duke Project,20.0,2,4,7,17,1,up,1981-05-09
17164,George Duke,1981-05-30,George Duke - The Clarke/Duke Project,16,23,11,7.0,12,The Clarke/Duke Project,20.0,3,1,4,7,1,up,1981-05-09
17165,George Duke,1981-06-06,George Duke - The Clarke/Duke Project,12,16,11,7.0,11,The Clarke/Duke Project,20.0,4,0,1,4,0,stay,1981-05-09
17166,George Duke,1981-06-13,George Duke - The Clarke/Duke Project,11,12,9,7.0,11,The Clarke/Duke Project,20.0,5,2,0,1,1,up,1981-05-09
17167,George Duke,1981-06-20,George Duke - The Clarke/Duke Project,11,11,8,7.0,9,The Clarke/Duke Project,20.0,6,1,2,0,1,up,1981-05-09
17168,George Duke,1981-06-27,George Duke - The Clarke/Duke Project,9,11,7,7.0,8,The Clarke/Duke Project,20.0,7,1,1,2,1,up,1981-05-09
17169,George Duke,1981-07-04,George Duke - The Clarke/Duke Project,8,9,7,7.0,7,The Clarke/Duke Project,20.0,8,0,1,1,0,stay,1981-05-09
17170,George Duke,1981-07-11,George Duke - The Clarke/Duke Project,7,8,7,7.0,7,The Clarke/Duke Project,20.0,9,0,0,1,0,stay,1981-05-09
17171,George Duke,1981-07-18,George Duke - The Clarke/Duke Project,7,7,7,7.0,7,The Clarke/Duke Project,20.0,10,0,0,0,0,stay,1981-05-09
17172,George Duke,1981-07-25,George Duke - The Clarke/Duke Project,7,7,9,7.0,7,The Clarke/Duke Project,20.0,11,-2,0,0,1,down,1981-05-09
17173,George Duke,1981-08-01,George Duke - The Clarke/Duke Project,7,7,12,7.0,9,The Clarke/Duke Project,20.0,12,-3,-2,0,1,down,1981-05-09
17174,George Duke,1981-08-08,George Duke - The Clarke/Duke Project,9,7,12,7.0,12,The Clarke/Duke Project,20.0,13,0,-3,-2,0,stay,1981-05-09
17175,George Duke,1981-08-15,George Duke - The Clarke/Duke Project,12,9,18,7.0,12,The Clarke/Duke Project,20.0,14,-6,0,-3,1,down,1981-05-09
17176,George Duke,1981-08-22,George Duke - The Clarke/Duke Project,12,12,19,7.0,18,The Clarke/Duke Project,20.0,15,-1,-6,0,1,down,1981-05-09
17177,George Duke,1981-08-29,George Duke - The Clarke/Duke Project,18,12,20,7.0,19,The Clarke/Duke Project,20.0,16,-1,-1,-6,1,down,1981-05-09
17178,George Duke,1981-09-05,George Duke - The Clarke/Duke Project,19,18,24,7.0,20,The Clarke/Duke Project,20.0,17,-4,-1,-1,1,down,1981-05-09
17179,George Duke,1981-09-12,George Duke - The Clarke/Duke Project,20,19,28,7.0,24,The Clarke/Duke Project,20.0,18,-4,-4,-1,1,down,1981-05-09
17180,George Duke,1981-09-19,George Duke - The Clarke/Duke Project,24,20,32,7.0,28,The Clarke/Duke Project,20.0,19,-4,-4,-4,1,down,1981-05-09
17181,George Duke,1981-09-26,George Duke - The Clarke/Duke Project,28,24,51,7.0,32,The Clarke/Duke Project,20.0,20,-19,-4,-4,1,down,1981-05-09
17182,Jeff Lorber Fusion,1981-05-09,Jeff Lorber Fusion - Galaxian,51,51,47,45.0,47,Galaxian,2.0,0,0,4,0,0,stay,1981-05-09
17183,Jeff Lorber Fusion,1981-05-16,Jeff Lorber Fusion - Galaxian,47,51,45,45.0,47,Galaxian,2.0,1,2,0,4,1,up,1981-05-09
17184,Jeff Lorber Fusion,1981-05-23,Jeff Lorber Fusion - Galaxian,47,47,51,45.0,45,Galaxian,2.0,2,-6,2,0,1,down,1981-05-09
17185,Michael Jackson,1981-05-09,Michael Jackson - One Day In Your Life,51,51,45,41.0,50,One Day In Your Life,6.0,0,5,1,0,1,up,1981-05-09
17186,Michael Jackson,1981-05-16,Michael Jackson - One Day In Your Life,50,51,41,41.0,45,One Day In Your Life,6.0,1,4,5,1,1,up,1981-05-09
17187,Michael Jackson,1981-05-23,Michael Jackson - One Day In Your Life,45,50,41,41.0,41,One Day In Your Life,6.0,2,0,4,5,0,stay,1981-05-09
17188,Michael Jackson,1981-05-30,Michael Jackson - One Day In Your Life,41,45,48,41.0,41,One Day In Your Life,6.0,3,-7,0,4,1,down,1981-05-09
17189,Michael Jackson,1981-06-06,Michael Jackson - One Day In Your Life,41,41,48,41.0,48,One Day In Your Life,6.0,4,0,-7,0,0,stay,1981-05-09
17190,Michael Jackson,1981-06-13,Michael Jackson - One Day In Your Life,48,41,48,41.0,48,One Day In Your Life,6.0,5,0,0,-7,0,stay,1981-05-09
17191,Michael Jackson,1981-06-20,Michael Jackson - One Day In Your Life,48,48,51,41.0,48,One Day In Your Life,6.0,6,-3,0,0,1,down,1981-05-09
17192,Mass Production,1981-05-16,Mass Production - Turn Up The Music,51,51,42,42.0,46,Turn Up The Music,4.0,0,4,5,0,1,up,1981-05-16
17193,Mass Production,1981-05-23,Mass Production - Turn Up The Music,46,51,42,42.0,42,Turn Up The Music,4.0,1,0,4,5,0,stay,1981-05-16
17194,Mass Production,1981-05-30,Mass Production - Turn Up The Music,42,46,42,42.0,42,Turn Up The Music,4.0,2,0,0,4,0,stay,1981-05-16
17195,Mass Production,1981-06-06,Mass Production - Turn Up The Music,42,42,43,42.0,42,Turn Up The Music,4.0,3,-1,0,0,1,down,1981-05-16
17196,Mass Production,1981-06-13,Mass Production - Turn Up The Music,42,42,51,42.0,43,Turn Up The Music,4.0,4,-8,-1,0,1,down,1981-05-16
17197,Stephanie Mills,1981-05-23,Stephanie Mills - Stephanie,51,51,13,3.0,33,Stephanie,21.0,0,20,18,0,1,up,1981-05-23
17198,Stephanie Mills,1981-05-30,Stephanie Mills - Stephanie,33,51,7,3.0,13,Stephanie,21.0,1,6,20,18,1,up,1981-05-23
17199,Stephanie Mills,1981-06-06,Stephanie Mills - Stephanie,13,33,6,3.0,7,Stephanie,21.0,2,1,6,20,1,up,1981-05-23
17200,Stephanie Mills,1981-06-13,Stephanie Mills - Stephanie,7,13,4,3.0,6,Stephanie,21.0,3,2,1,6,1,up,1981-05-23
17201,Stephanie Mills,1981-06-20,Stephanie Mills - Stephanie,6,7,4,3.0,4,Stephanie,21.0,4,0,2,1,0,stay,1981-05-23
17202,Stephanie Mills,1981-06-27,Stephanie Mills - Stephanie,4,6,4,3.0,4,Stephanie,21.0,5,0,0,2,0,stay,1981-05-23
17203,Stephanie Mills,1981-07-04,Stephanie Mills - Stephanie,4,4,3,3.0,4,Stephanie,21.0,6,1,0,0,1,up,1981-05-23
17204,Stephanie Mills,1981-07-11,Stephanie Mills - Stephanie,4,4,3,3.0,3,Stephanie,21.0,7,0,1,0,0,stay,1981-05-23
17205,Stephanie Mills,1981-07-18,Stephanie Mills - Stephanie,3,4,4,3.0,3,Stephanie,21.0,8,-1,0,1,1,down,1981-05-23
17206,Stephanie Mills,1981-07-25,Stephanie Mills - Stephanie,3,3,6,3.0,4,Stephanie,21.0,9,-2,-1,0,1,down,1981-05-23
17207,Stephanie Mills,1981-08-01,Stephanie Mills - Stephanie,4,3,7,3.0,6,Stephanie,21.0,10,-1,-2,-1,1,down,1981-05-23
17208,Stephanie Mills,1981-08-08,Stephanie Mills - Stephanie,6,4,8,3.0,7,Stephanie,21.0,11,-1,-1,-2,1,down,1981-05-23
17209,Stephanie Mills,1981-08-15,Stephanie Mills - Stephanie,7,6,9,3.0,8,Stephanie,21.0,12,-1,-1,-1,1,down,1981-05-23
17210,Stephanie Mills,1981-08-22,Stephanie Mills - Stephanie,8,7,17,3.0,9,Stephanie,21.0,13,-8,-1,-1,1,down,1981-05-23
17211,Stephanie Mills,1981-08-29,Stephanie Mills - Stephanie,9,8,18,3.0,17,Stephanie,21.0,14,-1,-8,-1,1,down,1981-05-23
17212,Stephanie Mills,1981-09-05,Stephanie Mills - Stephanie,17,9,19,3.0,18,Stephanie,21.0,15,-1,-1,-8,1,down,1981-05-23
17213,Stephanie Mills,1981-09-12,Stephanie Mills - Stephanie,18,17,19,3.0,19,Stephanie,21.0,16,0,-1,-1,0,stay,1981-05-23
17214,Stephanie Mills,1981-09-19,Stephanie Mills - Stephanie,19,18,27,3.0,19,Stephanie,21.0,17,-8,0,-1,1,down,1981-05-23
17215,Stephanie Mills,1981-09-26,Stephanie Mills - Stephanie,19,19,28,3.0,27,Stephanie,21.0,18,-1,-8,0,1,down,1981-05-23
17216,Stephanie Mills,1981-10-03,Stephanie Mills - Stephanie,27,19,34,3.0,28,Stephanie,21.0,19,-6,-1,-8,1,down,1981-05-23
17217,Stephanie Mills,1981-10-10,Stephanie Mills - Stephanie,28,27,45,3.0,34,Stephanie,21.0,20,-11,-6,-1,1,down,1981-05-23
17218,Stephanie Mills,1981-10-17,Stephanie Mills - Stephanie,34,28,51,3.0,45,Stephanie,21.0,21,-6,-11,-6,1,down,1981-05-23
17219,Barry And Glodean White,1981-05-23,Barry And Glodean White - Barry And Glodean,51,51,44,44.0,50,Barry And Glodean,3.0,0,6,1,0,1,up,1981-05-23
17220,Barry And Glodean White,1981-05-30,Barry And Glodean White - Barry And Glodean,50,51,44,44.0,44,Barry And Glodean,3.0,1,0,6,1,0,stay,1981-05-23
17221,Barry And Glodean White,1981-06-06,Barry And Glodean White - Barry And Glodean,44,50,47,44.0,44,Barry And Glodean,3.0,2,-3,0,6,1,down,1981-05-23
17222,Barry And Glodean White,1981-06-13,Barry And Glodean White - Barry And Glodean,44,44,51,44.0,47,Barry And Glodean,3.0,3,-4,-3,0,1,down,1981-05-23
17223,Grace Jones,1981-05-30,Grace Jones - Nightclubbing,51,51,20,9.0,30,Nightclubbing,16.0,0,10,21,0,1,up,1981-05-30
17224,Grace Jones,1981-06-06,Grace Jones - Nightclubbing,30,51,12,9.0,20,Nightclubbing,16.0,1,8,10,21,1,up,1981-05-30
17225,Grace Jones,1981-06-13,Grace Jones - Nightclubbing,20,30,10,9.0,12,Nightclubbing,16.0,2,2,8,10,1,up,1981-05-30
17226,Grace Jones,1981-06-20,Grace Jones - Nightclubbing,12,20,9,9.0,10,Nightclubbing,16.0,3,1,2,8,1,up,1981-05-30
17227,Grace Jones,1981-06-27,Grace Jones - Nightclubbing,10,12,9,9.0,9,Nightclubbing,16.0,4,0,1,2,0,stay,1981-05-30
17228,Grace Jones,1981-07-04,Grace Jones - Nightclubbing,9,10,9,9.0,9,Nightclubbing,16.0,5,0,0,1,0,stay,1981-05-30
17229,Grace Jones,1981-07-11,Grace Jones - Nightclubbing,9,9,9,9.0,9,Nightclubbing,16.0,6,0,0,0,0,stay,1981-05-30
17230,Grace Jones,1981-07-18,Grace Jones - Nightclubbing,9,9,9,9.0,9,Nightclubbing,16.0,7,0,0,0,0,stay,1981-05-30
17231,Grace Jones,1981-07-25,Grace Jones - Nightclubbing,9,9,10,9.0,9,Nightclubbing,16.0,8,-1,0,0,1,down,1981-05-30
17232,Grace Jones,1981-08-01,Grace Jones - Nightclubbing,9,9,15,9.0,10,Nightclubbing,16.0,9,-5,-1,0,1,down,1981-05-30
17233,Grace Jones,1981-08-08,Grace Jones - Nightclubbing,10,9,18,9.0,15,Nightclubbing,16.0,10,-3,-5,-1,1,down,1981-05-30
17234,Grace Jones,1981-08-15,Grace Jones - Nightclubbing,15,10,26,9.0,18,Nightclubbing,16.0,11,-8,-3,-5,1,down,1981-05-30
17235,Grace Jones,1981-08-22,Grace Jones - Nightclubbing,18,15,30,9.0,26,Nightclubbing,16.0,12,-4,-8,-3,1,down,1981-05-30
17236,Grace Jones,1981-08-29,Grace Jones - Nightclubbing,26,18,30,9.0,30,Nightclubbing,16.0,13,0,-4,-8,0,stay,1981-05-30
17237,Grace Jones,1981-09-05,Grace Jones - Nightclubbing,30,26,33,9.0,30,Nightclubbing,16.0,14,-3,0,-4,1,down,1981-05-30
17238,Grace Jones,1981-09-12,Grace Jones - Nightclubbing,30,30,45,9.0,33,Nightclubbing,16.0,15,-12,-3,0,1,down,1981-05-30
17239,Grace Jones,1981-09-19,Grace Jones - Nightclubbing,33,30,51,9.0,45,Nightclubbing,16.0,16,-6,-12,-3,1,down,1981-05-30
17240,Lee Ritenour,1981-05-30,Lee Ritenour - Rit,51,51,32,20.0,38,Rit,13.0,0,6,13,0,1,up,1981-05-30
17241,Lee Ritenour,1981-06-06,Lee Ritenour - Rit,38,51,25,20.0,32,Rit,13.0,1,7,6,13,1,up,1981-05-30
17242,Lee Ritenour,1981-06-13,Lee Ritenour - Rit,32,38,22,20.0,25,Rit,13.0,2,3,7,6,1,up,1981-05-30
17243,Lee Ritenour,1981-06-20,Lee Ritenour - Rit,25,32,20,20.0,22,Rit,13.0,3,2,3,7,1,up,1981-05-30
17244,Lee Ritenour,1981-06-27,Lee Ritenour - Rit,22,25,20,20.0,20,Rit,13.0,4,0,2,3,0,stay,1981-05-30
17245,Lee Ritenour,1981-07-04,Lee Ritenour - Rit,20,22,21,20.0,20,Rit,13.0,5,-1,0,2,1,down,1981-05-30
17246,Lee Ritenour,1981-07-11,Lee Ritenour - Rit,20,20,27,20.0,21,Rit,13.0,6,-6,-1,0,1,down,1981-05-30
17247,Lee Ritenour,1981-07-18,Lee Ritenour - Rit,21,20,29,20.0,27,Rit,13.0,7,-2,-6,-1,1,down,1981-05-30
17248,Lee Ritenour,1981-07-25,Lee Ritenour - Rit,27,21,29,20.0,29,Rit,13.0,8,0,-2,-6,0,stay,1981-05-30
17249,Lee Ritenour,1981-08-01,Lee Ritenour - Rit,29,27,32,20.0,29,Rit,13.0,9,-3,0,-2,1,down,1981-05-30
17250,Lee Ritenour,1981-08-08,Lee Ritenour - Rit,29,29,38,20.0,32,Rit,13.0,10,-6,-3,0,1,down,1981-05-30
17251,Lee Ritenour,1981-08-15,Lee Ritenour - Rit,32,29,38,20.0,38,Rit,13.0,11,0,-6,-3,0,stay,1981-05-30
17252,Lee Ritenour,1981-08-22,Lee Ritenour - Rit,38,32,44,20.0,38,Rit,13.0,12,-6,0,-6,1,down,1981-05-30
17253,Lee Ritenour,1981-08-29,Lee Ritenour - Rit,38,38,51,20.0,44,Rit,13.0,13,-7,-6,0,1,down,1981-05-30
17254,Gino Soccio,1981-05-30,Gino Soccio - Closer,51,51,35,26.0,45,Closer,12.0,0,10,6,0,1,up,1981-05-30
17255,Gino Soccio,1981-06-06,Gino Soccio - Closer,45,51,30,26.0,35,Closer,12.0,1,5,10,6,1,up,1981-05-30
17256,Gino Soccio,1981-06-13,Gino Soccio - Closer,35,45,26,26.0,30,Closer,12.0,2,4,5,10,1,up,1981-05-30
17257,Gino Soccio,1981-06-20,Gino Soccio - Closer,30,35,26,26.0,26,Closer,12.0,3,0,4,5,0,stay,1981-05-30
17258,Gino Soccio,1981-06-27,Gino Soccio - Closer,26,30,26,26.0,26,Closer,12.0,4,0,0,4,0,stay,1981-05-30
17259,Gino Soccio,1981-07-04,Gino Soccio - Closer,26,26,30,26.0,26,Closer,12.0,5,-4,0,0,1,down,1981-05-30
17260,Gino Soccio,1981-07-11,Gino Soccio - Closer,26,26,29,26.0,30,Closer,12.0,6,1,-4,0,1,up,1981-05-30
17261,Gino Soccio,1981-07-18,Gino Soccio - Closer,30,26,31,26.0,29,Closer,12.0,7,-2,1,-4,1,down,1981-05-30
17262,Gino Soccio,1981-07-25,Gino Soccio - Closer,29,30,37,26.0,31,Closer,12.0,8,-6,-2,1,1,down,1981-05-30
17263,Gino Soccio,1981-08-01,Gino Soccio - Closer,31,29,40,26.0,37,Closer,12.0,9,-3,-6,-2,1,down,1981-05-30
17264,Gino Soccio,1981-08-08,Gino Soccio - Closer,37,31,42,26.0,40,Closer,12.0,10,-2,-3,-6,1,down,1981-05-30
17265,Gino Soccio,1981-08-15,Gino Soccio - Closer,40,37,49,26.0,42,Closer,12.0,11,-7,-2,-3,1,down,1981-05-30
17266,Gino Soccio,1981-08-22,Gino Soccio - Closer,42,40,51,26.0,49,Closer,12.0,12,-2,-7,-2,1,down,1981-05-30
17267,Linx,1981-05-30,Linx - Intuition,51,51,41,39.0,46,Intuition,6.0,0,5,5,0,1,up,1981-05-30
17268,Linx,1981-06-06,Linx - Intuition,46,51,41,39.0,41,Intuition,6.0,1,0,5,5,0,stay,1981-05-30
17269,Linx,1981-06-13,Linx - Intuition,41,46,39,39.0,41,Intuition,6.0,2,2,0,5,1,up,1981-05-30
17270,Linx,1981-06-20,Linx - Intuition,41,41,39,39.0,39,Intuition,6.0,3,0,2,0,0,stay,1981-05-30
17271,Linx,1981-06-27,Linx - Intuition,39,41,43,39.0,39,Intuition,6.0,4,-4,0,2,1,down,1981-05-30
17272,Linx,1981-07-04,Linx - Intuition,39,39,43,39.0,43,Intuition,6.0,5,0,-4,0,0,stay,1981-05-30
17273,Linx,1981-07-11,Linx - Intuition,43,39,51,39.0,43,Intuition,6.0,6,-8,0,-4,1,down,1981-05-30
17274,Gary U.S. Bonds,1981-05-30,Gary U.S. Bonds - Dedication,51,51,43,34.0,48,Dedication,8.0,0,5,3,0,1,up,1981-05-30
17275,Gary U.S. Bonds,1981-06-06,Gary U.S. Bonds - Dedication,48,51,38,34.0,43,Dedication,8.0,1,5,5,3,1,up,1981-05-30
17276,Gary U.S. Bonds,1981-06-13,Gary U.S. Bonds - Dedication,43,48,38,34.0,38,Dedication,8.0,2,0,5,5,0,stay,1981-05-30
17277,Gary U.S. Bonds,1981-06-20,Gary U.S. Bonds - Dedication,38,43,34,34.0,38,Dedication,8.0,3,4,0,5,1,up,1981-05-30
17278,Gary U.S. Bonds,1981-06-27,Gary U.S. Bonds - Dedication,38,38,34,34.0,34,Dedication,8.0,4,0,4,0,0,stay,1981-05-30
17279,Gary U.S. Bonds,1981-07-04,Gary U.S. Bonds - Dedication,34,38,39,34.0,34,Dedication,8.0,5,-5,0,4,1,down,1981-05-30
17280,Gary U.S. Bonds,1981-07-11,Gary U.S. Bonds - Dedication,34,34,43,34.0,39,Dedication,8.0,6,-4,-5,0,1,down,1981-05-30
17281,Gary U.S. Bonds,1981-07-18,Gary U.S. Bonds - Dedication,39,34,45,34.0,43,Dedication,8.0,7,-2,-4,-5,1,down,1981-05-30
17282,Gary U.S. Bonds,1981-07-25,Gary U.S. Bonds - Dedication,43,39,51,34.0,45,Dedication,8.0,8,-6,-2,-4,1,down,1981-05-30
17283,Randy Crawford,1981-05-30,Randy Crawford - Secret Combination,51,51,40,12.0,50,Secret Combination,16.0,0,10,1,0,1,up,1981-05-30
17284,Randy Crawford,1981-06-06,Randy Crawford - Secret Combination,50,51,24,12.0,40,Secret Combination,16.0,1,16,10,1,1,up,1981-05-30
17285,Randy Crawford,1981-06-13,Randy Crawford - Secret Combination,40,50,18,12.0,24,Secret Combination,16.0,2,6,16,10,1,up,1981-05-30
17286,Randy Crawford,1981-06-20,Randy Crawford - Secret Combination,24,40,15,12.0,18,Secret Combination,16.0,3,3,6,16,1,up,1981-05-30
17287,Randy Crawford,1981-06-27,Randy Crawford - Secret Combination,18,24,12,12.0,15,Secret Combination,16.0,4,3,3,6,1,up,1981-05-30
17288,Randy Crawford,1981-07-04,Randy Crawford - Secret Combination,15,18,12,12.0,12,Secret Combination,16.0,5,0,3,3,0,stay,1981-05-30
17289,Randy Crawford,1981-07-11,Randy Crawford - Secret Combination,12,15,16,12.0,12,Secret Combination,16.0,6,-4,0,3,1,down,1981-05-30
17290,Randy Crawford,1981-07-18,Randy Crawford - Secret Combination,12,12,24,12.0,16,Secret Combination,16.0,7,-8,-4,0,1,down,1981-05-30
17291,Randy Crawford,1981-07-25,Randy Crawford - Secret Combination,16,12,24,12.0,24,Secret Combination,16.0,8,0,-8,-4,0,stay,1981-05-30
17292,Randy Crawford,1981-08-01,Randy Crawford - Secret Combination,24,16,26,12.0,24,Secret Combination,16.0,9,-2,0,-8,1,down,1981-05-30
17293,Randy Crawford,1981-08-08,Randy Crawford - Secret Combination,24,24,24,12.0,26,Secret Combination,16.0,10,2,-2,0,1,up,1981-05-30
17294,Randy Crawford,1981-08-15,Randy Crawford - Secret Combination,26,24,29,12.0,24,Secret Combination,16.0,11,-5,2,-2,1,down,1981-05-30
17295,Randy Crawford,1981-08-22,Randy Crawford - Secret Combination,24,26,31,12.0,29,Secret Combination,16.0,12,-2,-5,2,1,down,1981-05-30
17296,Randy Crawford,1981-08-29,Randy Crawford - Secret Combination,29,24,31,12.0,31,Secret Combination,16.0,13,0,-2,-5,0,stay,1981-05-30
17297,Randy Crawford,1981-09-05,Randy Crawford - Secret Combination,31,29,32,12.0,31,Secret Combination,16.0,14,-1,0,-2,1,down,1981-05-30
17298,Randy Crawford,1981-09-12,Randy Crawford - Secret Combination,31,31,43,12.0,32,Secret Combination,16.0,15,-11,-1,0,1,down,1981-05-30
17299,Randy Crawford,1981-09-19,Randy Crawford - Secret Combination,32,31,51,12.0,43,Secret Combination,16.0,16,-8,-11,-1,1,down,1981-05-30
17300,Webster Lewis,1981-06-06,Webster Lewis - Let Me Be The One,51,51,50,49.0,49,Let Me Be The One,1.0,0,-1,2,0,1,down,1981-06-06
17301,Webster Lewis,1981-06-13,Webster Lewis - Let Me Be The One,49,51,51,49.0,50,Let Me Be The One,1.0,1,-1,-1,2,1,down,1981-06-06
17302,Aurra,1981-06-13,Aurra - Send Your Love,51,51,41,22.0,45,Send Your Love,14.0,0,4,6,0,1,up,1981-06-13
17303,Aurra,1981-06-20,Aurra - Send Your Love,45,51,33,22.0,41,Send Your Love,14.0,1,8,4,6,1,up,1981-06-13
17304,Aurra,1981-06-27,Aurra - Send Your Love,41,45,29,22.0,33,Send Your Love,14.0,2,4,8,4,1,up,1981-06-13
17305,Aurra,1981-07-04,Aurra - Send Your Love,33,41,24,22.0,29,Send Your Love,14.0,3,5,4,8,1,up,1981-06-13
17306,Aurra,1981-07-11,Aurra - Send Your Love,29,33,23,22.0,24,Send Your Love,14.0,4,1,5,4,1,up,1981-06-13
17307,Aurra,1981-07-18,Aurra - Send Your Love,24,29,22,22.0,23,Send Your Love,14.0,5,1,1,5,1,up,1981-06-13
17308,Aurra,1981-07-25,Aurra - Send Your Love,23,24,25,22.0,22,Send Your Love,14.0,6,-3,1,1,1,down,1981-06-13
17309,Aurra,1981-08-01,Aurra - Send Your Love,22,23,31,22.0,25,Send Your Love,14.0,7,-6,-3,1,1,down,1981-06-13
17310,Aurra,1981-08-08,Aurra - Send Your Love,25,22,28,22.0,31,Send Your Love,14.0,8,3,-6,-3,1,up,1981-06-13
17311,Aurra,1981-08-15,Aurra - Send Your Love,31,25,28,22.0,28,Send Your Love,14.0,9,0,3,-6,0,stay,1981-06-13
17312,Aurra,1981-08-22,Aurra - Send Your Love,28,31,36,22.0,28,Send Your Love,14.0,10,-8,0,3,1,down,1981-06-13
17313,Aurra,1981-08-29,Aurra - Send Your Love,28,28,39,22.0,36,Send Your Love,14.0,11,-3,-8,0,1,down,1981-06-13
17314,Aurra,1981-09-05,Aurra - Send Your Love,36,28,46,22.0,39,Send Your Love,14.0,12,-7,-3,-8,1,down,1981-06-13
17315,Aurra,1981-09-12,Aurra - Send Your Love,39,36,48,22.0,46,Send Your Love,14.0,13,-2,-7,-3,1,down,1981-06-13
17316,Aurra,1981-09-19,Aurra - Send Your Love,46,39,51,22.0,48,Send Your Love,14.0,14,-3,-2,-7,1,down,1981-06-13
17317,Cameo,1981-06-20,Cameo - Knights Of The Sound Table,51,51,7,2.0,13,Knights Of The Sound Table,17.0,0,6,38,0,1,up,1981-06-20
17318,Cameo,1981-06-27,Cameo - Knights Of The Sound Table,13,51,5,2.0,7,Knights Of The Sound Table,17.0,1,2,6,38,1,up,1981-06-20
17319,Cameo,1981-07-04,Cameo - Knights Of The Sound Table,7,13,2,2.0,5,Knights Of The Sound Table,17.0,2,3,2,6,1,up,1981-06-20
17320,Cameo,1981-07-11,Cameo - Knights Of The Sound Table,5,7,2,2.0,2,Knights Of The Sound Table,17.0,3,0,3,2,0,stay,1981-06-20
17321,Cameo,1981-07-18,Cameo - Knights Of The Sound Table,2,5,2,2.0,2,Knights Of The Sound Table,17.0,4,0,0,3,0,stay,1981-06-20
17322,Cameo,1981-07-25,Cameo - Knights Of The Sound Table,2,2,3,2.0,2,Knights Of The Sound Table,17.0,5,-1,0,0,1,down,1981-06-20
17323,Cameo,1981-08-01,Cameo - Knights Of The Sound Table,2,2,5,2.0,3,Knights Of The Sound Table,17.0,6,-2,-1,0,1,down,1981-06-20
17324,Cameo,1981-08-08,Cameo - Knights Of The Sound Table,3,2,7,2.0,5,Knights Of The Sound Table,17.0,7,-2,-2,-1,1,down,1981-06-20
17325,Cameo,1981-08-15,Cameo - Knights Of The Sound Table,5,3,7,2.0,7,Knights Of The Sound Table,17.0,8,0,-2,-2,0,stay,1981-06-20
17326,Cameo,1981-08-22,Cameo - Knights Of The Sound Table,7,5,18,2.0,7,Knights Of The Sound Table,17.0,9,-11,0,-2,1,down,1981-06-20
17327,Cameo,1981-08-29,Cameo - Knights Of The Sound Table,7,7,19,2.0,18,Knights Of The Sound Table,17.0,10,-1,-11,0,1,down,1981-06-20
17328,Cameo,1981-09-05,Cameo - Knights Of The Sound Table,18,7,20,2.0,19,Knights Of The Sound Table,17.0,11,-1,-1,-11,1,down,1981-06-20
17329,Cameo,1981-09-12,Cameo - Knights Of The Sound Table,19,18,21,2.0,20,Knights Of The Sound Table,17.0,12,-1,-1,-1,1,down,1981-06-20
17330,Cameo,1981-09-19,Cameo - Knights Of The Sound Table,20,19,28,2.0,21,Knights Of The Sound Table,17.0,13,-7,-1,-1,1,down,1981-06-20
17331,Cameo,1981-09-26,Cameo - Knights Of The Sound Table,21,20,29,2.0,28,Knights Of The Sound Table,17.0,14,-1,-7,-1,1,down,1981-06-20
17332,Cameo,1981-10-03,Cameo - Knights Of The Sound Table,28,21,50,2.0,29,Knights Of The Sound Table,17.0,15,-21,-1,-7,1,down,1981-06-20
17333,Cameo,1981-10-10,Cameo - Knights Of The Sound Table,29,28,50,2.0,50,Knights Of The Sound Table,17.0,16,0,-21,-1,0,stay,1981-06-20
17334,Cameo,1981-10-17,Cameo - Knights Of The Sound Table,50,29,51,2.0,50,Knights Of The Sound Table,17.0,17,-1,0,-21,1,down,1981-06-20
17335,Teena Marie,1981-06-20,Teena Marie - It Must Be Magic,51,51,17,2.0,25,It Must Be Magic,25.0,0,8,26,0,1,up,1981-06-20
17336,Teena Marie,1981-06-27,Teena Marie - It Must Be Magic,25,51,11,2.0,17,It Must Be Magic,25.0,1,6,8,26,1,up,1981-06-20
17337,Teena Marie,1981-07-04,Teena Marie - It Must Be Magic,17,25,5,2.0,11,It Must Be Magic,25.0,2,6,6,8,1,up,1981-06-20
17338,Teena Marie,1981-07-11,Teena Marie - It Must Be Magic,11,17,4,2.0,5,It Must Be Magic,25.0,3,1,6,6,1,up,1981-06-20
17339,Teena Marie,1981-07-18,Teena Marie - It Must Be Magic,5,11,3,2.0,4,It Must Be Magic,25.0,4,1,1,6,1,up,1981-06-20
17340,Teena Marie,1981-07-25,Teena Marie - It Must Be Magic,4,5,2,2.0,3,It Must Be Magic,25.0,5,1,1,1,1,up,1981-06-20
17341,Teena Marie,1981-08-01,Teena Marie - It Must Be Magic,3,4,2,2.0,2,It Must Be Magic,25.0,6,0,1,1,0,stay,1981-06-20
17342,Teena Marie,1981-08-08,Teena Marie - It Must Be Magic,2,3,2,2.0,2,It Must Be Magic,25.0,7,0,0,1,0,stay,1981-06-20
17343,Teena Marie,1981-08-15,Teena Marie - It Must Be Magic,2,2,2,2.0,2,It Must Be Magic,25.0,8,0,0,0,0,stay,1981-06-20
17344,Teena Marie,1981-08-22,Teena Marie - It Must Be Magic,2,2,2,2.0,2,It Must Be Magic,25.0,9,0,0,0,0,stay,1981-06-20
17345,Teena Marie,1981-08-29,Teena Marie - It Must Be Magic,2,2,2,2.0,2,It Must Be Magic,25.0,10,0,0,0,0,stay,1981-06-20
17346,Teena Marie,1981-09-05,Teena Marie - It Must Be Magic,2,2,2,2.0,2,It Must Be Magic,25.0,11,0,0,0,0,stay,1981-06-20
17347,Teena Marie,1981-09-12,Teena Marie - It Must Be Magic,2,2,2,2.0,2,It Must Be Magic,25.0,12,0,0,0,0,stay,1981-06-20
17348,Teena Marie,1981-09-19,Teena Marie - It Must Be Magic,2,2,4,2.0,2,It Must Be Magic,25.0,13,-2,0,0,1,down,1981-06-20
17349,Teena Marie,1981-09-26,Teena Marie - It Must Be Magic,2,2,4,2.0,4,It Must Be Magic,25.0,14,0,-2,0,0,stay,1981-06-20
17350,Teena Marie,1981-10-03,Teena Marie - It Must Be Magic,4,2,5,2.0,4,It Must Be Magic,25.0,15,-1,0,-2,1,down,1981-06-20
17351,Teena Marie,1981-10-10,Teena Marie - It Must Be Magic,4,4,9,2.0,5,It Must Be Magic,25.0,16,-4,-1,0,1,down,1981-06-20
17352,Teena Marie,1981-10-17,Teena Marie - It Must Be Magic,5,4,11,2.0,9,It Must Be Magic,25.0,17,-2,-4,-1,1,down,1981-06-20
17353,Teena Marie,1981-10-24,Teena Marie - It Must Be Magic,9,5,17,2.0,11,It Must Be Magic,25.0,18,-6,-2,-4,1,down,1981-06-20
17354,Teena Marie,1981-10-31,Teena Marie - It Must Be Magic,11,9,26,2.0,17,It Must Be Magic,25.0,19,-9,-6,-2,1,down,1981-06-20
17355,Teena Marie,1981-11-07,Teena Marie - It Must Be Magic,17,11,28,2.0,26,It Must Be Magic,25.0,20,-2,-9,-6,1,down,1981-06-20
17356,Teena Marie,1981-11-14,Teena Marie - It Must Be Magic,26,17,30,2.0,28,It Must Be Magic,25.0,21,-2,-2,-9,1,down,1981-06-20
17357,Teena Marie,1981-11-21,Teena Marie - It Must Be Magic,28,26,31,2.0,30,It Must Be Magic,25.0,22,-1,-2,-2,1,down,1981-06-20
17358,Teena Marie,1981-11-28,Teena Marie - It Must Be Magic,30,28,38,2.0,31,It Must Be Magic,25.0,23,-7,-1,-2,1,down,1981-06-20
17359,Teena Marie,1981-12-05,Teena Marie - It Must Be Magic,31,30,50,2.0,38,It Must Be Magic,25.0,24,-12,-7,-1,1,down,1981-06-20
17360,Teena Marie,1981-12-12,Teena Marie - It Must Be Magic,38,31,51,2.0,50,It Must Be Magic,25.0,25,-1,-12,-7,1,down,1981-06-20
17361,The Fatback Band,1981-06-20,The Fatback Band - Tasty Jam,51,51,25,17.0,35,Tasty Jam,8.0,0,10,16,0,1,up,1981-06-20
17362,The Fatback Band,1981-06-27,The Fatback Band - Tasty Jam,35,51,19,17.0,25,Tasty Jam,8.0,1,6,10,16,1,up,1981-06-20
17363,The Fatback Band,1981-07-04,The Fatback Band - Tasty Jam,25,35,17,17.0,19,Tasty Jam,8.0,2,2,6,10,1,up,1981-06-20
17364,The Fatback Band,1981-07-11,The Fatback Band - Tasty Jam,19,25,17,17.0,17,Tasty Jam,8.0,3,0,2,6,0,stay,1981-06-20
17365,The Fatback Band,1981-07-18,The Fatback Band - Tasty Jam,17,19,17,17.0,17,Tasty Jam,8.0,4,0,0,2,0,stay,1981-06-20
17366,The Fatback Band,1981-07-25,The Fatback Band - Tasty Jam,17,17,18,17.0,17,Tasty Jam,8.0,5,-1,0,0,1,down,1981-06-20
17367,The Fatback Band,1981-08-01,The Fatback Band - Tasty Jam,17,17,22,17.0,18,Tasty Jam,8.0,6,-4,-1,0,1,down,1981-06-20
17368,The Fatback Band,1981-08-08,The Fatback Band - Tasty Jam,18,17,47,17.0,22,Tasty Jam,8.0,7,-25,-4,-1,1,down,1981-06-20
17369,The Fatback Band,1981-08-15,The Fatback Band - Tasty Jam,22,18,51,17.0,47,Tasty Jam,8.0,8,-4,-25,-4,1,down,1981-06-20
17370,Unlimited Touch,1981-06-20,Unlimited Touch - Unlimited Touch,51,51,42,35.0,47,Unlimited Touch,7.0,0,5,4,0,1,up,1981-06-20
17371,Unlimited Touch,1981-06-27,Unlimited Touch - Unlimited Touch,47,51,38,35.0,42,Unlimited Touch,7.0,1,4,5,4,1,up,1981-06-20
17372,Unlimited Touch,1981-07-04,Unlimited Touch - Unlimited Touch,42,47,35,35.0,38,Unlimited Touch,7.0,2,3,4,5,1,up,1981-06-20
17373,Unlimited Touch,1981-07-11,Unlimited Touch - Unlimited Touch,38,42,35,35.0,35,Unlimited Touch,7.0,3,0,3,4,0,stay,1981-06-20
17374,Unlimited Touch,1981-07-18,Unlimited Touch - Unlimited Touch,35,38,39,35.0,35,Unlimited Touch,7.0,4,-4,0,3,1,down,1981-06-20
17375,Unlimited Touch,1981-07-25,Unlimited Touch - Unlimited Touch,35,35,44,35.0,39,Unlimited Touch,7.0,5,-5,-4,0,1,down,1981-06-20
17376,Unlimited Touch,1981-08-01,Unlimited Touch - Unlimited Touch,39,35,44,35.0,44,Unlimited Touch,7.0,6,0,-5,-4,0,stay,1981-06-20
17377,Unlimited Touch,1981-08-08,Unlimited Touch - Unlimited Touch,44,39,51,35.0,44,Unlimited Touch,7.0,7,-7,0,-5,1,down,1981-06-20
17378,Walter Jackson,1981-06-20,Walter Jackson - Tell Me Where It Hurts,51,51,47,45.0,50,Tell Me Where It Hurts,3.0,0,3,1,0,1,up,1981-06-20
17379,Walter Jackson,1981-06-27,Walter Jackson - Tell Me Where It Hurts,50,51,45,45.0,47,Tell Me Where It Hurts,3.0,1,2,3,1,1,up,1981-06-20
17380,Walter Jackson,1981-07-04,Walter Jackson - Tell Me Where It Hurts,47,50,45,45.0,45,Tell Me Where It Hurts,3.0,2,0,2,3,0,stay,1981-06-20
17381,Walter Jackson,1981-07-11,Walter Jackson - Tell Me Where It Hurts,45,47,51,45.0,45,Tell Me Where It Hurts,3.0,3,-6,0,2,1,down,1981-06-20
17382,Dionne Warwick,1981-06-27,Dionne Warwick - Hot! Live And Otherwise,51,51,40,35.0,45,Hot! Live And Otherwise,7.0,0,5,6,0,1,up,1981-06-27
17383,Dionne Warwick,1981-07-04,Dionne Warwick - Hot! Live And Otherwise,45,51,36,35.0,40,Hot! Live And Otherwise,7.0,1,4,5,6,1,up,1981-06-27
17384,Dionne Warwick,1981-07-11,Dionne Warwick - Hot! Live And Otherwise,40,45,36,35.0,36,Hot! Live And Otherwise,7.0,2,0,4,5,0,stay,1981-06-27
17385,Dionne Warwick,1981-07-18,Dionne Warwick - Hot! Live And Otherwise,36,40,35,35.0,36,Hot! Live And Otherwise,7.0,3,1,0,4,1,up,1981-06-27
17386,Dionne Warwick,1981-07-25,Dionne Warwick - Hot! Live And Otherwise,36,36,36,35.0,35,Hot! Live And Otherwise,7.0,4,-1,1,0,1,down,1981-06-27
17387,Dionne Warwick,1981-08-01,Dionne Warwick - Hot! Live And Otherwise,35,36,39,35.0,36,Hot! Live And Otherwise,7.0,5,-3,-1,1,1,down,1981-06-27
17388,Dionne Warwick,1981-08-08,Dionne Warwick - Hot! Live And Otherwise,36,35,48,35.0,39,Hot! Live And Otherwise,7.0,6,-9,-3,-1,1,down,1981-06-27
17389,Dionne Warwick,1981-08-15,Dionne Warwick - Hot! Live And Otherwise,39,36,51,35.0,48,Hot! Live And Otherwise,7.0,7,-3,-9,-3,1,down,1981-06-27
17390,Johnny Guitar Watson,1981-06-27,"Johnny Guitar Watson - Johnny ""Guitar"" Watson And The Family Clone",51,51,49,49.0,49,"Johnny ""Guitar"" Watson And The Family Clone",1.0,0,0,2,0,0,stay,1981-06-27
17391,Johnny Guitar Watson,1981-07-04,"Johnny Guitar Watson - Johnny ""Guitar"" Watson And The Family Clone",49,51,51,49.0,49,"Johnny ""Guitar"" Watson And The Family Clone",1.0,1,-2,0,2,1,down,1981-06-27
17392,Maze Featuring Frankie Beverly,1981-07-04,Maze Featuring Frankie Beverly - Live In New Orleans,51,51,20,3.0,35,Live In New Orleans,34.0,0,15,16,0,1,up,1981-07-04
17393,Maze Featuring Frankie Beverly,1981-07-11,Maze Featuring Frankie Beverly - Live In New Orleans,35,51,12,3.0,20,Live In New Orleans,34.0,1,8,15,16,1,up,1981-07-04
17394,Maze Featuring Frankie Beverly,1981-07-18,Maze Featuring Frankie Beverly - Live In New Orleans,20,35,5,3.0,12,Live In New Orleans,34.0,2,7,8,15,1,up,1981-07-04
17395,Maze Featuring Frankie Beverly,1981-07-25,Maze Featuring Frankie Beverly - Live In New Orleans,12,20,4,3.0,5,Live In New Orleans,34.0,3,1,7,8,1,up,1981-07-04
17396,Maze Featuring Frankie Beverly,1981-08-01,Maze Featuring Frankie Beverly - Live In New Orleans,5,12,3,3.0,4,Live In New Orleans,34.0,4,1,1,7,1,up,1981-07-04
17397,Maze Featuring Frankie Beverly,1981-08-08,Maze Featuring Frankie Beverly - Live In New Orleans,4,5,3,3.0,3,Live In New Orleans,34.0,5,0,1,1,0,stay,1981-07-04
17398,Maze Featuring Frankie Beverly,1981-08-15,Maze Featuring Frankie Beverly - Live In New Orleans,3,4,3,3.0,3,Live In New Orleans,34.0,6,0,0,1,0,stay,1981-07-04
17399,Maze Featuring Frankie Beverly,1981-08-22,Maze Featuring Frankie Beverly - Live In New Orleans,3,3,3,3.0,3,Live In New Orleans,34.0,7,0,0,0,0,stay,1981-07-04
17400,Maze Featuring Frankie Beverly,1981-08-29,Maze Featuring Frankie Beverly - Live In New Orleans,3,3,3,3.0,3,Live In New Orleans,34.0,8,0,0,0,0,stay,1981-07-04
17401,Maze Featuring Frankie Beverly,1981-09-05,Maze Featuring Frankie Beverly - Live In New Orleans,3,3,12,3.0,3,Live In New Orleans,34.0,9,-9,0,0,1,down,1981-07-04
17402,Maze Featuring Frankie Beverly,1981-09-12,Maze Featuring Frankie Beverly - Live In New Orleans,3,3,12,3.0,12,Live In New Orleans,34.0,10,0,-9,0,0,stay,1981-07-04
17403,Maze Featuring Frankie Beverly,1981-09-19,Maze Featuring Frankie Beverly - Live In New Orleans,12,3,14,3.0,12,Live In New Orleans,34.0,11,-2,0,-9,1,down,1981-07-04
17404,Maze Featuring Frankie Beverly,1981-09-26,Maze Featuring Frankie Beverly - Live In New Orleans,12,12,14,3.0,14,Live In New Orleans,34.0,12,0,-2,0,0,stay,1981-07-04
17405,Maze Featuring Frankie Beverly,1981-10-03,Maze Featuring Frankie Beverly - Live In New Orleans,14,12,12,3.0,14,Live In New Orleans,34.0,13,2,0,-2,1,up,1981-07-04
17406,Maze Featuring Frankie Beverly,1981-10-10,Maze Featuring Frankie Beverly - Live In New Orleans,14,14,10,3.0,12,Live In New Orleans,34.0,14,2,2,0,1,up,1981-07-04
17407,Maze Featuring Frankie Beverly,1981-10-17,Maze Featuring Frankie Beverly - Live In New Orleans,12,14,9,3.0,10,Live In New Orleans,34.0,15,1,2,2,1,up,1981-07-04
17408,Maze Featuring Frankie Beverly,1981-10-24,Maze Featuring Frankie Beverly - Live In New Orleans,10,12,9,3.0,9,Live In New Orleans,34.0,16,0,1,2,0,stay,1981-07-04
17409,Maze Featuring Frankie Beverly,1981-10-31,Maze Featuring Frankie Beverly - Live In New Orleans,9,10,9,3.0,9,Live In New Orleans,34.0,17,0,0,1,0,stay,1981-07-04
17410,Maze Featuring Frankie Beverly,1981-11-07,Maze Featuring Frankie Beverly - Live In New Orleans,9,9,16,3.0,9,Live In New Orleans,34.0,18,-7,0,0,1,down,1981-07-04
17411,Maze Featuring Frankie Beverly,1981-11-14,Maze Featuring Frankie Beverly - Live In New Orleans,9,9,18,3.0,16,Live In New Orleans,34.0,19,-2,-7,0,1,down,1981-07-04
17412,Maze Featuring Frankie Beverly,1981-11-21,Maze Featuring Frankie Beverly - Live In New Orleans,16,9,19,3.0,18,Live In New Orleans,34.0,20,-1,-2,-7,1,down,1981-07-04
17413,Maze Featuring Frankie Beverly,1981-11-28,Maze Featuring Frankie Beverly - Live In New Orleans,18,16,23,3.0,19,Live In New Orleans,34.0,21,-4,-1,-2,1,down,1981-07-04
17414,Maze Featuring Frankie Beverly,1981-12-05,Maze Featuring Frankie Beverly - Live In New Orleans,19,18,23,3.0,23,Live In New Orleans,34.0,22,0,-4,-1,0,stay,1981-07-04
17415,Maze Featuring Frankie Beverly,1981-12-12,Maze Featuring Frankie Beverly - Live In New Orleans,23,19,26,3.0,23,Live In New Orleans,34.0,23,-3,0,-4,1,down,1981-07-04
17416,Maze Featuring Frankie Beverly,1981-12-19,Maze Featuring Frankie Beverly - Live In New Orleans,23,23,29,3.0,26,Live In New Orleans,34.0,24,-3,-3,0,1,down,1981-07-04
17417,Maze Featuring Frankie Beverly,1981-12-26,Maze Featuring Frankie Beverly - Live In New Orleans,26,23,29,3.0,29,Live In New Orleans,34.0,25,0,-3,-3,0,stay,1981-07-04
17418,Maze Featuring Frankie Beverly,1982-01-02,Maze Featuring Frankie Beverly - Live In New Orleans,29,26,32,3.0,29,Live In New Orleans,34.0,26,-3,0,-3,1,down,1981-07-04
17419,Maze Featuring Frankie Beverly,1982-01-09,Maze Featuring Frankie Beverly - Live In New Orleans,29,29,37,3.0,32,Live In New Orleans,34.0,27,-5,-3,0,1,down,1981-07-04
17420,Maze Featuring Frankie Beverly,1982-01-16,Maze Featuring Frankie Beverly - Live In New Orleans,32,29,30,3.0,37,Live In New Orleans,34.0,28,7,-5,-3,1,up,1981-07-04
17421,Maze Featuring Frankie Beverly,1982-01-23,Maze Featuring Frankie Beverly - Live In New Orleans,37,32,30,3.0,30,Live In New Orleans,34.0,29,0,7,-5,0,stay,1981-07-04
17422,Maze Featuring Frankie Beverly,1982-01-30,Maze Featuring Frankie Beverly - Live In New Orleans,30,37,30,3.0,30,Live In New Orleans,34.0,30,0,0,7,0,stay,1981-07-04
17423,Maze Featuring Frankie Beverly,1982-02-06,Maze Featuring Frankie Beverly - Live In New Orleans,30,30,27,3.0,30,Live In New Orleans,34.0,31,3,0,0,1,up,1981-07-04
17424,Maze Featuring Frankie Beverly,1982-02-13,Maze Featuring Frankie Beverly - Live In New Orleans,30,30,26,3.0,27,Live In New Orleans,34.0,32,1,3,0,1,up,1981-07-04
17425,Maze Featuring Frankie Beverly,1982-02-20,Maze Featuring Frankie Beverly - Live In New Orleans,27,30,40,3.0,26,Live In New Orleans,34.0,33,-14,1,3,1,down,1981-07-04
17426,Maze Featuring Frankie Beverly,1982-02-27,Maze Featuring Frankie Beverly - Live In New Orleans,26,27,51,3.0,40,Live In New Orleans,34.0,34,-11,-14,1,1,down,1981-07-04
17427,The Pointer Sisters,1981-07-04,The Pointer Sisters - Black & White,51,51,29,9.0,39,Black & White,20.0,0,10,12,0,1,up,1981-07-04
17428,The Pointer Sisters,1981-07-11,The Pointer Sisters - Black & White,39,51,20,9.0,29,Black & White,20.0,1,9,10,12,1,up,1981-07-04
17429,The Pointer Sisters,1981-07-18,The Pointer Sisters - Black & White,29,39,16,9.0,20,Black & White,20.0,2,4,9,10,1,up,1981-07-04
17430,The Pointer Sisters,1981-07-25,The Pointer Sisters - Black & White,20,29,12,9.0,16,Black & White,20.0,3,4,4,9,1,up,1981-07-04
17431,The Pointer Sisters,1981-08-01,The Pointer Sisters - Black & White,16,20,10,9.0,12,Black & White,20.0,4,2,4,4,1,up,1981-07-04
17432,The Pointer Sisters,1981-08-08,The Pointer Sisters - Black & White,12,16,10,9.0,10,Black & White,20.0,5,0,2,4,0,stay,1981-07-04
17433,The Pointer Sisters,1981-08-15,The Pointer Sisters - Black & White,10,12,10,9.0,10,Black & White,20.0,6,0,0,2,0,stay,1981-07-04
17434,The Pointer Sisters,1981-08-22,The Pointer Sisters - Black & White,10,10,9,9.0,10,Black & White,20.0,7,1,0,0,1,up,1981-07-04
17435,The Pointer Sisters,1981-08-29,The Pointer Sisters - Black & White,10,10,9,9.0,9,Black & White,20.0,8,0,1,0,0,stay,1981-07-04
17436,The Pointer Sisters,1981-09-05,The Pointer Sisters - Black & White,9,10,11,9.0,9,Black & White,20.0,9,-2,0,1,1,down,1981-07-04
17437,The Pointer Sisters,1981-09-12,The Pointer Sisters - Black & White,9,9,11,9.0,11,Black & White,20.0,10,0,-2,0,0,stay,1981-07-04
17438,The Pointer Sisters,1981-09-19,The Pointer Sisters - Black & White,11,9,12,9.0,11,Black & White,20.0,11,-1,0,-2,1,down,1981-07-04
17439,The Pointer Sisters,1981-09-26,The Pointer Sisters - Black & White,11,11,18,9.0,12,Black & White,20.0,12,-6,-1,0,1,down,1981-07-04
17440,The Pointer Sisters,1981-10-03,The Pointer Sisters - Black & White,12,11,18,9.0,18,Black & White,20.0,13,0,-6,-1,0,stay,1981-07-04
17441,The Pointer Sisters,1981-10-10,The Pointer Sisters - Black & White,18,12,22,9.0,18,Black & White,20.0,14,-4,0,-6,1,down,1981-07-04
17442,The Pointer Sisters,1981-10-17,The Pointer Sisters - Black & White,18,18,30,9.0,22,Black & White,20.0,15,-8,-4,0,1,down,1981-07-04
17443,The Pointer Sisters,1981-10-24,The Pointer Sisters - Black & White,22,18,30,9.0,30,Black & White,20.0,16,0,-8,-4,0,stay,1981-07-04
17444,The Pointer Sisters,1981-10-31,The Pointer Sisters - Black & White,30,22,31,9.0,30,Black & White,20.0,17,-1,0,-8,1,down,1981-07-04
17445,The Pointer Sisters,1981-11-07,The Pointer Sisters - Black & White,30,30,35,9.0,31,Black & White,20.0,18,-4,-1,0,1,down,1981-07-04
17446,The Pointer Sisters,1981-11-14,The Pointer Sisters - Black & White,31,30,37,9.0,35,Black & White,20.0,19,-2,-4,-1,1,down,1981-07-04
17447,The Pointer Sisters,1981-11-21,The Pointer Sisters - Black & White,35,31,51,9.0,37,Black & White,20.0,20,-14,-2,-4,1,down,1981-07-04
17448,Stars On,1981-07-11,Stars On - Stars On Long Play,51,51,39,30.0,46,Stars On Long Play,5.0,0,7,5,0,1,up,1981-07-11
17449,Stars On,1981-07-18,Stars On - Stars On Long Play,46,51,34,30.0,39,Stars On Long Play,5.0,1,5,7,5,1,up,1981-07-11
17450,Stars On,1981-07-25,Stars On - Stars On Long Play,39,46,30,30.0,34,Stars On Long Play,5.0,2,4,5,7,1,up,1981-07-11
17451,Stars On,1981-08-01,Stars On - Stars On Long Play,34,39,30,30.0,30,Stars On Long Play,5.0,3,0,4,5,0,stay,1981-07-11
17452,Stars On,1981-08-08,Stars On - Stars On Long Play,30,34,43,30.0,30,Stars On Long Play,5.0,4,-13,0,4,1,down,1981-07-11
17453,Stars On,1981-08-15,Stars On - Stars On Long Play,30,30,51,30.0,43,Stars On Long Play,5.0,5,-8,-13,0,1,down,1981-07-11
17454,Alicia Myers,1981-07-11,Alicia Myers - Alicia,51,51,42,41.0,47,Alicia,3.0,0,5,4,0,1,up,1981-07-11
17455,Alicia Myers,1981-07-18,Alicia Myers - Alicia,47,51,42,41.0,42,Alicia,3.0,1,0,5,4,0,stay,1981-07-11
17456,Alicia Myers,1981-07-25,Alicia Myers - Alicia,42,47,41,41.0,42,Alicia,3.0,2,1,0,5,1,up,1981-07-11
17457,Alicia Myers,1981-08-01,Alicia Myers - Alicia,42,42,51,41.0,41,Alicia,3.0,3,-10,1,0,1,down,1981-07-11
17458,Klique,1981-07-11,Klique - It's Winning Time,51,51,44,40.0,49,It's Winning Time,3.0,0,5,2,0,1,up,1981-07-11
17459,Klique,1981-07-18,Klique - It's Winning Time,49,51,40,40.0,44,It's Winning Time,3.0,1,4,5,2,1,up,1981-07-11
17460,Klique,1981-07-25,Klique - It's Winning Time,44,49,40,40.0,40,It's Winning Time,3.0,2,0,4,5,0,stay,1981-07-11
17461,Klique,1981-08-01,Klique - It's Winning Time,40,44,51,40.0,40,It's Winning Time,3.0,3,-11,0,4,1,down,1981-07-11
17462,Dazz Band,1981-07-11,Dazz Band - Let The Music Play,51,51,45,36.0,50,Let The Music Play,13.0,0,5,1,0,1,up,1981-07-11
17463,Dazz Band,1981-07-18,Dazz Band - Let The Music Play,50,51,44,36.0,45,Let The Music Play,13.0,1,1,5,1,1,up,1981-07-11
17464,Dazz Band,1981-07-25,Dazz Band - Let The Music Play,45,50,43,36.0,44,Let The Music Play,13.0,2,1,1,5,1,up,1981-07-11
17465,Dazz Band,1981-08-01,Dazz Band - Let The Music Play,44,45,41,36.0,43,Let The Music Play,13.0,3,2,1,1,1,up,1981-07-11
17466,Dazz Band,1981-08-08,Dazz Band - Let The Music Play,43,44,39,36.0,41,Let The Music Play,13.0,4,2,2,1,1,up,1981-07-11
17467,Dazz Band,1981-08-15,Dazz Band - Let The Music Play,41,43,39,36.0,39,Let The Music Play,13.0,5,0,2,2,0,stay,1981-07-11
17468,Dazz Band,1981-08-22,Dazz Band - Let The Music Play,39,41,37,36.0,39,Let The Music Play,13.0,6,2,0,2,1,up,1981-07-11
17469,Dazz Band,1981-08-29,Dazz Band - Let The Music Play,39,39,36,36.0,37,Let The Music Play,13.0,7,1,2,0,1,up,1981-07-11
17470,Dazz Band,1981-09-05,Dazz Band - Let The Music Play,37,39,36,36.0,36,Let The Music Play,13.0,8,0,1,2,0,stay,1981-07-11
17471,Dazz Band,1981-09-12,Dazz Band - Let The Music Play,36,37,41,36.0,36,Let The Music Play,13.0,9,-5,0,1,1,down,1981-07-11
17472,Dazz Band,1981-09-19,Dazz Band - Let The Music Play,36,36,41,36.0,41,Let The Music Play,13.0,10,0,-5,0,0,stay,1981-07-11
17473,Dazz Band,1981-09-26,Dazz Band - Let The Music Play,41,36,39,36.0,41,Let The Music Play,13.0,11,2,0,-5,1,up,1981-07-11
17474,Dazz Band,1981-10-03,Dazz Band - Let The Music Play,41,41,44,36.0,39,Let The Music Play,13.0,12,-5,2,0,1,down,1981-07-11
17475,Dazz Band,1981-10-10,Dazz Band - Let The Music Play,39,41,51,36.0,44,Let The Music Play,13.0,13,-7,-5,2,1,down,1981-07-11
17476,Commodores,1981-07-18,Commodores - In The Pocket,51,51,15,4.0,25,In The Pocket,35.0,0,10,26,0,1,up,1981-07-18
17477,Commodores,1981-07-25,Commodores - In The Pocket,25,51,5,4.0,15,In The Pocket,35.0,1,10,10,26,1,up,1981-07-18
17478,Commodores,1981-08-01,Commodores - In The Pocket,15,25,4,4.0,5,In The Pocket,35.0,2,1,10,10,1,up,1981-07-18
17479,Commodores,1981-08-08,Commodores - In The Pocket,5,15,4,4.0,4,In The Pocket,35.0,3,0,1,10,0,stay,1981-07-18
17480,Commodores,1981-08-15,Commodores - In The Pocket,4,5,4,4.0,4,In The Pocket,35.0,4,0,0,1,0,stay,1981-07-18
17481,Commodores,1981-08-22,Commodores - In The Pocket,4,4,4,4.0,4,In The Pocket,35.0,5,0,0,0,0,stay,1981-07-18
17482,Commodores,1981-08-29,Commodores - In The Pocket,4,4,4,4.0,4,In The Pocket,35.0,6,0,0,0,0,stay,1981-07-18
17483,Commodores,1981-09-05,Commodores - In The Pocket,4,4,4,4.0,4,In The Pocket,35.0,7,0,0,0,0,stay,1981-07-18
17484,Commodores,1981-09-12,Commodores - In The Pocket,4,4,7,4.0,4,In The Pocket,35.0,8,-3,0,0,1,down,1981-07-18
17485,Commodores,1981-09-19,Commodores - In The Pocket,4,4,10,4.0,7,In The Pocket,35.0,9,-3,-3,0,1,down,1981-07-18
17486,Commodores,1981-09-26,Commodores - In The Pocket,7,4,17,4.0,10,In The Pocket,35.0,10,-7,-3,-3,1,down,1981-07-18
17487,Commodores,1981-10-03,Commodores - In The Pocket,10,7,16,4.0,17,In The Pocket,35.0,11,1,-7,-3,1,up,1981-07-18
17488,Commodores,1981-10-10,Commodores - In The Pocket,17,10,14,4.0,16,In The Pocket,35.0,12,2,1,-7,1,up,1981-07-18
17489,Commodores,1981-10-17,Commodores - In The Pocket,16,17,12,4.0,14,In The Pocket,35.0,13,2,2,1,1,up,1981-07-18
17490,Commodores,1981-10-24,Commodores - In The Pocket,14,16,11,4.0,12,In The Pocket,35.0,14,1,2,2,1,up,1981-07-18
17491,Commodores,1981-10-31,Commodores - In The Pocket,12,14,11,4.0,11,In The Pocket,35.0,15,0,1,2,0,stay,1981-07-18
17492,Commodores,1981-11-07,Commodores - In The Pocket,11,12,11,4.0,11,In The Pocket,35.0,16,0,0,1,0,stay,1981-07-18
17493,Commodores,1981-11-14,Commodores - In The Pocket,11,11,12,4.0,11,In The Pocket,35.0,17,-1,0,0,1,down,1981-07-18
17494,Commodores,1981-11-21,Commodores - In The Pocket,11,11,12,4.0,12,In The Pocket,35.0,18,0,-1,0,0,stay,1981-07-18
17495,Commodores,1981-11-28,Commodores - In The Pocket,12,11,12,4.0,12,In The Pocket,35.0,19,0,0,-1,0,stay,1981-07-18
17496,Commodores,1981-12-05,Commodores - In The Pocket,12,12,12,4.0,12,In The Pocket,35.0,20,0,0,0,0,stay,1981-07-18
17497,Commodores,1981-12-12,Commodores - In The Pocket,12,12,20,4.0,12,In The Pocket,35.0,21,-8,0,0,1,down,1981-07-18
17498,Commodores,1981-12-19,Commodores - In The Pocket,12,12,23,4.0,20,In The Pocket,35.0,22,-3,-8,0,1,down,1981-07-18
17499,Commodores,1981-12-26,Commodores - In The Pocket,20,12,23,4.0,23,In The Pocket,35.0,23,0,-3,-8,0,stay,1981-07-18
17500,Commodores,1982-01-02,Commodores - In The Pocket,23,20,21,4.0,23,In The Pocket,35.0,24,2,0,-3,1,up,1981-07-18
17501,Commodores,1982-01-09,Commodores - In The Pocket,23,23,18,4.0,21,In The Pocket,35.0,25,3,2,0,1,up,1981-07-18
17502,Commodores,1982-01-16,Commodores - In The Pocket,21,23,18,4.0,18,In The Pocket,35.0,26,0,3,2,0,stay,1981-07-18
17503,Commodores,1982-01-23,Commodores - In The Pocket,18,21,29,4.0,18,In The Pocket,35.0,27,-11,0,3,1,down,1981-07-18
17504,Commodores,1982-01-30,Commodores - In The Pocket,18,18,36,4.0,29,In The Pocket,35.0,28,-7,-11,0,1,down,1981-07-18
17505,Commodores,1982-02-06,Commodores - In The Pocket,29,18,34,4.0,36,In The Pocket,35.0,29,2,-7,-11,1,up,1981-07-18
17506,Commodores,1982-02-13,Commodores - In The Pocket,36,29,34,4.0,34,In The Pocket,35.0,30,0,2,-7,0,stay,1981-07-18
17507,Commodores,1982-02-20,Commodores - In The Pocket,34,36,37,4.0,34,In The Pocket,35.0,31,-3,0,2,1,down,1981-07-18
17508,Commodores,1982-02-27,Commodores - In The Pocket,34,34,37,4.0,37,In The Pocket,35.0,32,0,-3,0,0,stay,1981-07-18
17509,Commodores,1982-03-06,Commodores - In The Pocket,37,34,43,4.0,37,In The Pocket,35.0,33,-6,0,-3,1,down,1981-07-18
17510,Commodores,1982-03-13,Commodores - In The Pocket,37,37,43,4.0,43,In The Pocket,35.0,34,0,-6,0,0,stay,1981-07-18
17511,Commodores,1982-03-20,Commodores - In The Pocket,43,37,51,4.0,43,In The Pocket,35.0,35,-8,0,-6,1,down,1981-07-18
17512,Stacy Lattisaw,1981-07-18,Stacy Lattisaw - With You,51,51,20,8.0,30,With You,15.0,0,10,21,0,1,up,1981-07-18
17513,Stacy Lattisaw,1981-07-25,Stacy Lattisaw - With You,30,51,14,8.0,20,With You,15.0,1,6,10,21,1,up,1981-07-18
17514,Stacy Lattisaw,1981-08-01,Stacy Lattisaw - With You,20,30,11,8.0,14,With You,15.0,2,3,6,10,1,up,1981-07-18
17515,Stacy Lattisaw,1981-08-08,Stacy Lattisaw - With You,14,20,9,8.0,11,With You,15.0,3,2,3,6,1,up,1981-07-18
17516,Stacy Lattisaw,1981-08-15,Stacy Lattisaw - With You,11,14,8,8.0,9,With You,15.0,4,1,2,3,1,up,1981-07-18
17517,Stacy Lattisaw,1981-08-22,Stacy Lattisaw - With You,9,11,8,8.0,8,With You,15.0,5,0,1,2,0,stay,1981-07-18
17518,Stacy Lattisaw,1981-08-29,Stacy Lattisaw - With You,8,9,13,8.0,8,With You,15.0,6,-5,0,1,1,down,1981-07-18
17519,Stacy Lattisaw,1981-09-05,Stacy Lattisaw - With You,8,8,13,8.0,13,With You,15.0,7,0,-5,0,0,stay,1981-07-18
17520,Stacy Lattisaw,1981-09-12,Stacy Lattisaw - With You,13,8,16,8.0,13,With You,15.0,8,-3,0,-5,1,down,1981-07-18
17521,Stacy Lattisaw,1981-09-19,Stacy Lattisaw - With You,13,13,18,8.0,16,With You,15.0,9,-2,-3,0,1,down,1981-07-18
17522,Stacy Lattisaw,1981-09-26,Stacy Lattisaw - With You,16,13,20,8.0,18,With You,15.0,10,-2,-2,-3,1,down,1981-07-18
17523,Stacy Lattisaw,1981-10-03,Stacy Lattisaw - With You,18,16,33,8.0,20,With You,15.0,11,-13,-2,-2,1,down,1981-07-18
17524,Stacy Lattisaw,1981-10-10,Stacy Lattisaw - With You,20,18,41,8.0,33,With You,15.0,12,-8,-13,-2,1,down,1981-07-18
17525,Stacy Lattisaw,1981-10-17,Stacy Lattisaw - With You,33,20,46,8.0,41,With You,15.0,13,-5,-8,-13,1,down,1981-07-18
17526,Stacy Lattisaw,1981-10-24,Stacy Lattisaw - With You,41,33,46,8.0,46,With You,15.0,14,0,-5,-8,0,stay,1981-07-18
17527,Stacy Lattisaw,1981-10-31,Stacy Lattisaw - With You,46,41,51,8.0,46,With You,15.0,15,-5,0,-5,1,down,1981-07-18
17528,Cheryl Lynn,1981-07-18,Cheryl Lynn - In The Night,51,51,28,14.0,38,In The Night,12.0,0,10,13,0,1,up,1981-07-18
17529,Cheryl Lynn,1981-07-25,Cheryl Lynn - In The Night,38,51,21,14.0,28,In The Night,12.0,1,7,10,13,1,up,1981-07-18
17530,Cheryl Lynn,1981-08-01,Cheryl Lynn - In The Night,28,38,18,14.0,21,In The Night,12.0,2,3,7,10,1,up,1981-07-18
17531,Cheryl Lynn,1981-08-08,Cheryl Lynn - In The Night,21,28,16,14.0,18,In The Night,12.0,3,2,3,7,1,up,1981-07-18
17532,Cheryl Lynn,1981-08-15,Cheryl Lynn - In The Night,18,21,14,14.0,16,In The Night,12.0,4,2,2,3,1,up,1981-07-18
17533,Cheryl Lynn,1981-08-22,Cheryl Lynn - In The Night,16,18,14,14.0,14,In The Night,12.0,5,0,2,2,0,stay,1981-07-18
17534,Cheryl Lynn,1981-08-29,Cheryl Lynn - In The Night,14,16,16,14.0,14,In The Night,12.0,6,-2,0,2,1,down,1981-07-18
17535,Cheryl Lynn,1981-09-05,Cheryl Lynn - In The Night,14,14,16,14.0,16,In The Night,12.0,7,0,-2,0,0,stay,1981-07-18
17536,Cheryl Lynn,1981-09-12,Cheryl Lynn - In The Night,16,14,20,14.0,16,In The Night,12.0,8,-4,0,-2,1,down,1981-07-18
17537,Cheryl Lynn,1981-09-19,Cheryl Lynn - In The Night,16,16,29,14.0,20,In The Night,12.0,9,-9,-4,0,1,down,1981-07-18
17538,Cheryl Lynn,1981-09-26,Cheryl Lynn - In The Night,20,16,38,14.0,29,In The Night,12.0,10,-9,-9,-4,1,down,1981-07-18
17539,Cheryl Lynn,1981-10-03,Cheryl Lynn - In The Night,29,20,50,14.0,38,In The Night,12.0,11,-12,-9,-9,1,down,1981-07-18
17540,Cheryl Lynn,1981-10-24,Cheryl Lynn - In The Night,38,29,51,14.0,50,In The Night,12.0,12,-1,-12,-9,1,down,1981-07-18
17541,Billy Ocean,1981-07-18,Billy Ocean - Nights (Feel Like Getting Down),51,51,32,27.0,40,Nights (Feel Like Getting Down),9.0,0,8,11,0,1,up,1981-07-18
17542,Billy Ocean,1981-07-25,Billy Ocean - Nights (Feel Like Getting Down),40,51,28,27.0,32,Nights (Feel Like Getting Down),9.0,1,4,8,11,1,up,1981-07-18
17543,Billy Ocean,1981-08-01,Billy Ocean - Nights (Feel Like Getting Down),32,40,28,27.0,28,Nights (Feel Like Getting Down),9.0,2,0,4,8,0,stay,1981-07-18
17544,Billy Ocean,1981-08-08,Billy Ocean - Nights (Feel Like Getting Down),28,32,27,27.0,28,Nights (Feel Like Getting Down),9.0,3,1,0,4,1,up,1981-07-18
17545,Billy Ocean,1981-08-15,Billy Ocean - Nights (Feel Like Getting Down),28,28,32,27.0,27,Nights (Feel Like Getting Down),9.0,4,-5,1,0,1,down,1981-07-18
17546,Billy Ocean,1981-08-22,Billy Ocean - Nights (Feel Like Getting Down),27,28,32,27.0,32,Nights (Feel Like Getting Down),9.0,5,0,-5,1,0,stay,1981-07-18
17547,Billy Ocean,1981-08-29,Billy Ocean - Nights (Feel Like Getting Down),32,27,34,27.0,32,Nights (Feel Like Getting Down),9.0,6,-2,0,-5,1,down,1981-07-18
17548,Billy Ocean,1981-09-05,Billy Ocean - Nights (Feel Like Getting Down),32,32,44,27.0,34,Nights (Feel Like Getting Down),9.0,7,-10,-2,0,1,down,1981-07-18
17549,Billy Ocean,1981-09-12,Billy Ocean - Nights (Feel Like Getting Down),34,32,44,27.0,44,Nights (Feel Like Getting Down),9.0,8,0,-10,-2,0,stay,1981-07-18
17550,Billy Ocean,1981-09-19,Billy Ocean - Nights (Feel Like Getting Down),44,34,51,27.0,44,Nights (Feel Like Getting Down),9.0,9,-7,0,-10,1,down,1981-07-18
17551,Kurtis Blow,1981-07-18,Kurtis Blow - Deuce,51,51,43,35.0,50,Deuce,6.0,0,7,1,0,1,up,1981-07-18
17552,Kurtis Blow,1981-07-25,Kurtis Blow - Deuce,50,51,39,35.0,43,Deuce,6.0,1,4,7,1,1,up,1981-07-18
17553,Kurtis Blow,1981-08-01,Kurtis Blow - Deuce,43,50,35,35.0,39,Deuce,6.0,2,4,4,7,1,up,1981-07-18
17554,Kurtis Blow,1981-08-08,Kurtis Blow - Deuce,39,43,35,35.0,35,Deuce,6.0,3,0,4,4,0,stay,1981-07-18
17555,Kurtis Blow,1981-08-15,Kurtis Blow - Deuce,35,39,43,35.0,35,Deuce,6.0,4,-8,0,4,1,down,1981-07-18
17556,Kurtis Blow,1981-08-22,Kurtis Blow - Deuce,35,35,49,35.0,43,Deuce,6.0,5,-6,-8,0,1,down,1981-07-18
17557,Kurtis Blow,1981-09-05,Kurtis Blow - Deuce,43,35,51,35.0,49,Deuce,6.0,6,-2,-6,-8,1,down,1981-07-18
17558,"Evelyn ""Champagne"" King",1981-07-25,"Evelyn ""Champagne"" King - I'm In Love",51,51,20,6.0,33,I'm In Love,19.0,0,13,18,0,1,up,1981-07-25
17559,"Evelyn ""Champagne"" King",1981-08-01,"Evelyn ""Champagne"" King - I'm In Love",33,51,9,6.0,20,I'm In Love,19.0,1,11,13,18,1,up,1981-07-25
17560,"Evelyn ""Champagne"" King",1981-08-08,"Evelyn ""Champagne"" King - I'm In Love",20,33,6,6.0,9,I'm In Love,19.0,2,3,11,13,1,up,1981-07-25
17561,"Evelyn ""Champagne"" King",1981-08-15,"Evelyn ""Champagne"" King - I'm In Love",9,20,6,6.0,6,I'm In Love,19.0,3,0,3,11,0,stay,1981-07-25
17562,"Evelyn ""Champagne"" King",1981-08-22,"Evelyn ""Champagne"" King - I'm In Love",6,9,6,6.0,6,I'm In Love,19.0,4,0,0,3,0,stay,1981-07-25
17563,"Evelyn ""Champagne"" King",1981-08-29,"Evelyn ""Champagne"" King - I'm In Love",6,6,6,6.0,6,I'm In Love,19.0,5,0,0,0,0,stay,1981-07-25
17564,"Evelyn ""Champagne"" King",1981-09-05,"Evelyn ""Champagne"" King - I'm In Love",6,6,6,6.0,6,I'm In Love,19.0,6,0,0,0,0,stay,1981-07-25
17565,"Evelyn ""Champagne"" King",1981-09-12,"Evelyn ""Champagne"" King - I'm In Love",6,6,6,6.0,6,I'm In Love,19.0,7,0,0,0,0,stay,1981-07-25
17566,"Evelyn ""Champagne"" King",1981-09-19,"Evelyn ""Champagne"" King - I'm In Love",6,6,6,6.0,6,I'm In Love,19.0,8,0,0,0,0,stay,1981-07-25
17567,"Evelyn ""Champagne"" King",1981-09-26,"Evelyn ""Champagne"" King - I'm In Love",6,6,6,6.0,6,I'm In Love,19.0,9,0,0,0,0,stay,1981-07-25
17568,"Evelyn ""Champagne"" King",1981-10-03,"Evelyn ""Champagne"" King - I'm In Love",6,6,6,6.0,6,I'm In Love,19.0,10,0,0,0,0,stay,1981-07-25
17569,"Evelyn ""Champagne"" King",1981-10-10,"Evelyn ""Champagne"" King - I'm In Love",6,6,11,6.0,6,I'm In Love,19.0,11,-5,0,0,1,down,1981-07-25
17570,"Evelyn ""Champagne"" King",1981-10-17,"Evelyn ""Champagne"" King - I'm In Love",6,6,15,6.0,11,I'm In Love,19.0,12,-4,-5,0,1,down,1981-07-25
17571,"Evelyn ""Champagne"" King",1981-10-24,"Evelyn ""Champagne"" King - I'm In Love",11,6,19,6.0,15,I'm In Love,19.0,13,-4,-4,-5,1,down,1981-07-25
17572,"Evelyn ""Champagne"" King",1981-10-31,"Evelyn ""Champagne"" King - I'm In Love",15,11,24,6.0,19,I'm In Love,19.0,14,-5,-4,-4,1,down,1981-07-25
17573,"Evelyn ""Champagne"" King",1981-11-07,"Evelyn ""Champagne"" King - I'm In Love",19,15,26,6.0,24,I'm In Love,19.0,15,-2,-5,-4,1,down,1981-07-25
17574,"Evelyn ""Champagne"" King",1981-11-14,"Evelyn ""Champagne"" King - I'm In Love",24,19,29,6.0,26,I'm In Love,19.0,16,-3,-2,-5,1,down,1981-07-25
17575,"Evelyn ""Champagne"" King",1981-11-21,"Evelyn ""Champagne"" King - I'm In Love",26,24,43,6.0,29,I'm In Love,19.0,17,-14,-3,-2,1,down,1981-07-25
17576,"Evelyn ""Champagne"" King",1981-11-28,"Evelyn ""Champagne"" King - I'm In Love",29,26,50,6.0,43,I'm In Love,19.0,18,-7,-14,-3,1,down,1981-07-25
17577,"Evelyn ""Champagne"" King",1981-12-05,"Evelyn ""Champagne"" King - I'm In Love",43,29,51,6.0,50,I'm In Love,19.0,19,-1,-7,-14,1,down,1981-07-25
17578,The Brothers Johnson,1981-07-25,The Brothers Johnson - Winners,51,51,22,10.0,36,Winners,13.0,0,14,15,0,1,up,1981-07-25
17579,The Brothers Johnson,1981-08-01,The Brothers Johnson - Winners,36,51,16,10.0,22,Winners,13.0,1,6,14,15,1,up,1981-07-25
17580,The Brothers Johnson,1981-08-08,The Brothers Johnson - Winners,22,36,13,10.0,16,Winners,13.0,2,3,6,14,1,up,1981-07-25
17581,The Brothers Johnson,1981-08-15,The Brothers Johnson - Winners,16,22,11,10.0,13,Winners,13.0,3,2,3,6,1,up,1981-07-25
17582,The Brothers Johnson,1981-08-22,The Brothers Johnson - Winners,13,16,11,10.0,11,Winners,13.0,4,0,2,3,0,stay,1981-07-25
17583,The Brothers Johnson,1981-08-29,The Brothers Johnson - Winners,11,13,10,10.0,11,Winners,13.0,5,1,0,2,1,up,1981-07-25
17584,The Brothers Johnson,1981-09-05,The Brothers Johnson - Winners,11,11,10,10.0,10,Winners,13.0,6,0,1,0,0,stay,1981-07-25
17585,The Brothers Johnson,1981-09-12,The Brothers Johnson - Winners,10,11,14,10.0,10,Winners,13.0,7,-4,0,1,1,down,1981-07-25
17586,The Brothers Johnson,1981-09-19,The Brothers Johnson - Winners,10,10,23,10.0,14,Winners,13.0,8,-9,-4,0,1,down,1981-07-25
17587,The Brothers Johnson,1981-09-26,The Brothers Johnson - Winners,14,10,27,10.0,23,Winners,13.0,9,-4,-9,-4,1,down,1981-07-25
17588,The Brothers Johnson,1981-10-03,The Brothers Johnson - Winners,23,14,49,10.0,27,Winners,13.0,10,-22,-4,-9,1,down,1981-07-25
17589,The Brothers Johnson,1981-10-10,The Brothers Johnson - Winners,27,23,49,10.0,49,Winners,13.0,11,0,-22,-4,0,stay,1981-07-25
17590,The Brothers Johnson,1981-10-17,The Brothers Johnson - Winners,49,27,48,10.0,49,Winners,13.0,12,1,0,-22,1,up,1981-07-25
17591,The Brothers Johnson,1981-10-24,The Brothers Johnson - Winners,49,49,51,10.0,48,Winners,13.0,13,-3,1,0,1,down,1981-07-25
17592,"Richard ""Dimples"" Fields",1981-07-25,"Richard ""Dimples"" Fields - Dimples",51,51,15,5.0,37,Dimples,16.0,0,22,14,0,1,up,1981-07-25
17593,"Richard ""Dimples"" Fields",1981-08-01,"Richard ""Dimples"" Fields - Dimples",37,51,6,5.0,15,Dimples,16.0,1,9,22,14,1,up,1981-07-25
17594,"Richard ""Dimples"" Fields",1981-08-08,"Richard ""Dimples"" Fields - Dimples",15,37,5,5.0,6,Dimples,16.0,2,1,9,22,1,up,1981-07-25
17595,"Richard ""Dimples"" Fields",1981-08-15,"Richard ""Dimples"" Fields - Dimples",6,15,5,5.0,5,Dimples,16.0,3,0,1,9,0,stay,1981-07-25
17596,"Richard ""Dimples"" Fields",1981-08-22,"Richard ""Dimples"" Fields - Dimples",5,6,5,5.0,5,Dimples,16.0,4,0,0,1,0,stay,1981-07-25
17597,"Richard ""Dimples"" Fields",1981-08-29,"Richard ""Dimples"" Fields - Dimples",5,5,5,5.0,5,Dimples,16.0,5,0,0,0,0,stay,1981-07-25
17598,"Richard ""Dimples"" Fields",1981-09-05,"Richard ""Dimples"" Fields - Dimples",5,5,5,5.0,5,Dimples,16.0,6,0,0,0,0,stay,1981-07-25
17599,"Richard ""Dimples"" Fields",1981-09-12,"Richard ""Dimples"" Fields - Dimples",5,5,5,5.0,5,Dimples,16.0,7,0,0,0,0,stay,1981-07-25
17600,"Richard ""Dimples"" Fields",1981-09-19,"Richard ""Dimples"" Fields - Dimples",5,5,5,5.0,5,Dimples,16.0,8,0,0,0,0,stay,1981-07-25
17601,"Richard ""Dimples"" Fields",1981-09-26,"Richard ""Dimples"" Fields - Dimples",5,5,7,5.0,5,Dimples,16.0,9,-2,0,0,1,down,1981-07-25
17602,"Richard ""Dimples"" Fields",1981-10-03,"Richard ""Dimples"" Fields - Dimples",5,5,7,5.0,7,Dimples,16.0,10,0,-2,0,0,stay,1981-07-25
17603,"Richard ""Dimples"" Fields",1981-10-10,"Richard ""Dimples"" Fields - Dimples",7,5,16,5.0,7,Dimples,16.0,11,-9,0,-2,1,down,1981-07-25
17604,"Richard ""Dimples"" Fields",1981-10-17,"Richard ""Dimples"" Fields - Dimples",7,7,27,5.0,16,Dimples,16.0,12,-11,-9,0,1,down,1981-07-25
17605,"Richard ""Dimples"" Fields",1981-10-24,"Richard ""Dimples"" Fields - Dimples",16,7,32,5.0,27,Dimples,16.0,13,-5,-11,-9,1,down,1981-07-25
17606,"Richard ""Dimples"" Fields",1981-10-31,"Richard ""Dimples"" Fields - Dimples",27,16,34,5.0,32,Dimples,16.0,14,-2,-5,-11,1,down,1981-07-25
17607,"Richard ""Dimples"" Fields",1981-11-07,"Richard ""Dimples"" Fields - Dimples",32,27,48,5.0,34,Dimples,16.0,15,-14,-2,-5,1,down,1981-07-25
17608,"Richard ""Dimples"" Fields",1981-11-14,"Richard ""Dimples"" Fields - Dimples",34,32,51,5.0,48,Dimples,16.0,16,-3,-14,-2,1,down,1981-07-25
17609,Rafael Cameron,1981-07-25,Rafael Cameron - Cameron's In Love,51,51,38,29.0,46,Cameron's In Love,9.0,0,8,5,0,1,up,1981-07-25
17610,Rafael Cameron,1981-08-01,Rafael Cameron - Cameron's In Love,46,51,34,29.0,38,Cameron's In Love,9.0,1,4,8,5,1,up,1981-07-25
17611,Rafael Cameron,1981-08-08,Rafael Cameron - Cameron's In Love,38,46,30,29.0,34,Cameron's In Love,9.0,2,4,4,8,1,up,1981-07-25
17612,Rafael Cameron,1981-08-15,Rafael Cameron - Cameron's In Love,34,38,30,29.0,30,Cameron's In Love,9.0,3,0,4,4,0,stay,1981-07-25
17613,Rafael Cameron,1981-08-22,Rafael Cameron - Cameron's In Love,30,34,29,29.0,30,Cameron's In Love,9.0,4,1,0,4,1,up,1981-07-25
17614,Rafael Cameron,1981-08-29,Rafael Cameron - Cameron's In Love,30,30,29,29.0,29,Cameron's In Love,9.0,5,0,1,0,0,stay,1981-07-25
17615,Rafael Cameron,1981-09-05,Rafael Cameron - Cameron's In Love,29,30,31,29.0,29,Cameron's In Love,9.0,6,-2,0,1,1,down,1981-07-25
17616,Rafael Cameron,1981-09-12,Rafael Cameron - Cameron's In Love,29,29,36,29.0,31,Cameron's In Love,9.0,7,-5,-2,0,1,down,1981-07-25
17617,Rafael Cameron,1981-09-19,Rafael Cameron - Cameron's In Love,31,29,36,29.0,36,Cameron's In Love,9.0,8,0,-5,-2,0,stay,1981-07-25
17618,Rafael Cameron,1981-09-26,Rafael Cameron - Cameron's In Love,36,31,51,29.0,36,Cameron's In Love,9.0,9,-15,0,-5,1,down,1981-07-25
17619,Roberta Flack,1981-07-25,Roberta Flack - Bustin' Loose,51,51,50,48.0,50,Bustin' Loose,2.0,0,0,1,0,0,stay,1981-07-25
17620,Roberta Flack,1981-08-01,Roberta Flack - Bustin' Loose,50,51,48,48.0,50,Bustin' Loose,2.0,1,2,0,1,1,up,1981-07-25
17621,Roberta Flack,1981-08-08,Roberta Flack - Bustin' Loose,50,50,51,48.0,48,Bustin' Loose,2.0,2,-3,2,0,1,down,1981-07-25
17622,Phyllis Hyman,1981-08-01,Phyllis Hyman - Can't We Fall In Love Again,51,51,25,11.0,35,Can't We Fall In Love Again,14.0,0,10,16,0,1,up,1981-08-01
17623,Phyllis Hyman,1981-08-08,Phyllis Hyman - Can't We Fall In Love Again,35,51,20,11.0,25,Can't We Fall In Love Again,14.0,1,5,10,16,1,up,1981-08-01
17624,Phyllis Hyman,1981-08-15,Phyllis Hyman - Can't We Fall In Love Again,25,35,17,11.0,20,Can't We Fall In Love Again,14.0,2,3,5,10,1,up,1981-08-01
17625,Phyllis Hyman,1981-08-22,Phyllis Hyman - Can't We Fall In Love Again,20,25,15,11.0,17,Can't We Fall In Love Again,14.0,3,2,3,5,1,up,1981-08-01
17626,Phyllis Hyman,1981-08-29,Phyllis Hyman - Can't We Fall In Love Again,17,20,15,11.0,15,Can't We Fall In Love Again,14.0,4,0,2,3,0,stay,1981-08-01
17627,Phyllis Hyman,1981-09-05,Phyllis Hyman - Can't We Fall In Love Again,15,17,15,11.0,15,Can't We Fall In Love Again,14.0,5,0,0,2,0,stay,1981-08-01
17628,Phyllis Hyman,1981-09-12,Phyllis Hyman - Can't We Fall In Love Again,15,15,13,11.0,15,Can't We Fall In Love Again,14.0,6,2,0,0,1,up,1981-08-01
17629,Phyllis Hyman,1981-09-19,Phyllis Hyman - Can't We Fall In Love Again,15,15,11,11.0,13,Can't We Fall In Love Again,14.0,7,2,2,0,1,up,1981-08-01
17630,Phyllis Hyman,1981-09-26,Phyllis Hyman - Can't We Fall In Love Again,13,15,11,11.0,11,Can't We Fall In Love Again,14.0,8,0,2,2,0,stay,1981-08-01
17631,Phyllis Hyman,1981-10-03,Phyllis Hyman - Can't We Fall In Love Again,11,13,27,11.0,11,Can't We Fall In Love Again,14.0,9,-16,0,2,1,down,1981-08-01
17632,Phyllis Hyman,1981-10-10,Phyllis Hyman - Can't We Fall In Love Again,11,11,31,11.0,27,Can't We Fall In Love Again,14.0,10,-4,-16,0,1,down,1981-08-01
17633,Phyllis Hyman,1981-10-17,Phyllis Hyman - Can't We Fall In Love Again,27,11,36,11.0,31,Can't We Fall In Love Again,14.0,11,-5,-4,-16,1,down,1981-08-01
17634,Phyllis Hyman,1981-10-24,Phyllis Hyman - Can't We Fall In Love Again,31,27,41,11.0,36,Can't We Fall In Love Again,14.0,12,-5,-5,-4,1,down,1981-08-01
17635,Phyllis Hyman,1981-10-31,Phyllis Hyman - Can't We Fall In Love Again,36,31,43,11.0,41,Can't We Fall In Love Again,14.0,13,-2,-5,-5,1,down,1981-08-01
17636,Phyllis Hyman,1981-11-07,Phyllis Hyman - Can't We Fall In Love Again,41,36,51,11.0,43,Can't We Fall In Love Again,14.0,14,-8,-2,-5,1,down,1981-08-01
17637,Carl Carlton,1981-08-01,Carl Carlton - Carl Carlton,51,51,36,3.0,42,Carl Carlton,20.0,0,6,9,0,1,up,1981-08-01
17638,Carl Carlton,1981-08-08,Carl Carlton - Carl Carlton,42,51,26,3.0,36,Carl Carlton,20.0,1,10,6,9,1,up,1981-08-01
17639,Carl Carlton,1981-08-15,Carl Carlton - Carl Carlton,36,42,16,3.0,26,Carl Carlton,20.0,2,10,10,6,1,up,1981-08-01
17640,Carl Carlton,1981-08-22,Carl Carlton - Carl Carlton,26,36,7,3.0,16,Carl Carlton,20.0,3,9,10,10,1,up,1981-08-01
17641,Carl Carlton,1981-08-29,Carl Carlton - Carl Carlton,16,26,7,3.0,7,Carl Carlton,20.0,4,0,9,10,0,stay,1981-08-01
17642,Carl Carlton,1981-09-05,Carl Carlton - Carl Carlton,7,16,3,3.0,7,Carl Carlton,20.0,5,4,0,9,1,up,1981-08-01
17643,Carl Carlton,1981-09-12,Carl Carlton - Carl Carlton,7,7,3,3.0,3,Carl Carlton,20.0,6,0,4,0,0,stay,1981-08-01
17644,Carl Carlton,1981-09-19,Carl Carlton - Carl Carlton,3,7,3,3.0,3,Carl Carlton,20.0,7,0,0,4,0,stay,1981-08-01
17645,Carl Carlton,1981-09-26,Carl Carlton - Carl Carlton,3,3,3,3.0,3,Carl Carlton,20.0,8,0,0,0,0,stay,1981-08-01
17646,Carl Carlton,1981-10-03,Carl Carlton - Carl Carlton,3,3,3,3.0,3,Carl Carlton,20.0,9,0,0,0,0,stay,1981-08-01
17647,Carl Carlton,1981-10-10,Carl Carlton - Carl Carlton,3,3,3,3.0,3,Carl Carlton,20.0,10,0,0,0,0,stay,1981-08-01
17648,Carl Carlton,1981-10-17,Carl Carlton - Carl Carlton,3,3,10,3.0,3,Carl Carlton,20.0,11,-7,0,0,1,down,1981-08-01
17649,Carl Carlton,1981-10-24,Carl Carlton - Carl Carlton,3,3,13,3.0,10,Carl Carlton,20.0,12,-3,-7,0,1,down,1981-08-01
17650,Carl Carlton,1981-10-31,Carl Carlton - Carl Carlton,10,3,13,3.0,13,Carl Carlton,20.0,13,0,-3,-7,0,stay,1981-08-01
17651,Carl Carlton,1981-11-07,Carl Carlton - Carl Carlton,13,10,20,3.0,13,Carl Carlton,20.0,14,-7,0,-3,1,down,1981-08-01
17652,Carl Carlton,1981-11-14,Carl Carlton - Carl Carlton,13,13,23,3.0,20,Carl Carlton,20.0,15,-3,-7,0,1,down,1981-08-01
17653,Carl Carlton,1981-11-21,Carl Carlton - Carl Carlton,20,13,23,3.0,23,Carl Carlton,20.0,16,0,-3,-7,0,stay,1981-08-01
17654,Carl Carlton,1981-11-28,Carl Carlton - Carl Carlton,23,20,34,3.0,23,Carl Carlton,20.0,17,-11,0,-3,1,down,1981-08-01
17655,Carl Carlton,1981-12-05,Carl Carlton - Carl Carlton,23,23,36,3.0,34,Carl Carlton,20.0,18,-2,-11,0,1,down,1981-08-01
17656,Carl Carlton,1981-12-12,Carl Carlton - Carl Carlton,34,23,37,3.0,36,Carl Carlton,20.0,19,-1,-2,-11,1,down,1981-08-01
17657,Carl Carlton,1981-12-19,Carl Carlton - Carl Carlton,36,34,51,3.0,37,Carl Carlton,20.0,20,-14,-1,-2,1,down,1981-08-01
17658,Frankie Smith,1981-08-01,Frankie Smith - Children Of Tomorrow,51,51,24,12.0,45,Children Of Tomorrow,10.0,0,21,6,0,1,up,1981-08-01
17659,Frankie Smith,1981-08-08,Frankie Smith - Children Of Tomorrow,45,51,14,12.0,24,Children Of Tomorrow,10.0,1,10,21,6,1,up,1981-08-01
17660,Frankie Smith,1981-08-15,Frankie Smith - Children Of Tomorrow,24,45,12,12.0,14,Children Of Tomorrow,10.0,2,2,10,21,1,up,1981-08-01
17661,Frankie Smith,1981-08-22,Frankie Smith - Children Of Tomorrow,14,24,12,12.0,12,Children Of Tomorrow,10.0,3,0,2,10,0,stay,1981-08-01
17662,Frankie Smith,1981-08-29,Frankie Smith - Children Of Tomorrow,12,14,14,12.0,12,Children Of Tomorrow,10.0,4,-2,0,2,1,down,1981-08-01
17663,Frankie Smith,1981-09-05,Frankie Smith - Children Of Tomorrow,12,12,14,12.0,14,Children Of Tomorrow,10.0,5,0,-2,0,0,stay,1981-08-01
17664,Frankie Smith,1981-09-12,Frankie Smith - Children Of Tomorrow,14,12,17,12.0,14,Children Of Tomorrow,10.0,6,-3,0,-2,1,down,1981-08-01
17665,Frankie Smith,1981-09-19,Frankie Smith - Children Of Tomorrow,14,14,20,12.0,17,Children Of Tomorrow,10.0,7,-3,-3,0,1,down,1981-08-01
17666,Frankie Smith,1981-09-26,Frankie Smith - Children Of Tomorrow,17,14,26,12.0,20,Children Of Tomorrow,10.0,8,-6,-3,-3,1,down,1981-08-01
17667,Frankie Smith,1981-10-03,Frankie Smith - Children Of Tomorrow,20,17,48,12.0,26,Children Of Tomorrow,10.0,9,-22,-6,-3,1,down,1981-08-01
17668,Frankie Smith,1981-10-10,Frankie Smith - Children Of Tomorrow,26,20,51,12.0,48,Children Of Tomorrow,10.0,10,-3,-22,-6,1,down,1981-08-01
17669,Peter Tosh,1981-08-01,Peter Tosh - Wanted Dread And Alive,51,51,42,40.0,46,Wanted Dread And Alive,3.0,0,4,5,0,1,up,1981-08-01
17670,Peter Tosh,1981-08-08,Peter Tosh - Wanted Dread And Alive,46,51,41,40.0,42,Wanted Dread And Alive,3.0,1,1,4,5,1,up,1981-08-01
17671,Peter Tosh,1981-08-15,Peter Tosh - Wanted Dread And Alive,42,46,40,40.0,41,Wanted Dread And Alive,3.0,2,1,1,4,1,up,1981-08-01
17672,Peter Tosh,1981-08-22,Peter Tosh - Wanted Dread And Alive,41,42,51,40.0,40,Wanted Dread And Alive,3.0,3,-11,1,1,1,down,1981-08-01
17673,Richard Pryor,1981-08-01,Richard Pryor - Reverend Durite,51,51,46,44.0,47,Reverend Durite,2.0,0,1,4,0,1,up,1981-08-01
17674,Richard Pryor,1981-08-08,Richard Pryor - Reverend Durite,47,51,44,44.0,46,Reverend Durite,2.0,1,2,1,4,1,up,1981-08-01
17675,Richard Pryor,1981-08-15,Richard Pryor - Reverend Durite,46,47,51,44.0,44,Reverend Durite,2.0,2,-7,2,1,1,down,1981-08-01
17676,Larry Graham,1981-08-08,Larry Graham - Just Be My Lady,51,51,23,8.0,43,Just Be My Lady,13.0,0,20,8,0,1,up,1981-08-08
17677,Larry Graham,1981-08-15,Larry Graham - Just Be My Lady,43,51,13,8.0,23,Just Be My Lady,13.0,1,10,20,8,1,up,1981-08-08
17678,Larry Graham,1981-08-22,Larry Graham - Just Be My Lady,23,43,10,8.0,13,Just Be My Lady,13.0,2,3,10,20,1,up,1981-08-08
17679,Larry Graham,1981-08-29,Larry Graham - Just Be My Lady,13,23,8,8.0,10,Just Be My Lady,13.0,3,2,3,10,1,up,1981-08-08
17680,Larry Graham,1981-09-05,Larry Graham - Just Be My Lady,10,13,8,8.0,8,Just Be My Lady,13.0,4,0,2,3,0,stay,1981-08-08
17681,Larry Graham,1981-09-12,Larry Graham - Just Be My Lady,8,10,8,8.0,8,Just Be My Lady,13.0,5,0,0,2,0,stay,1981-08-08
17682,Larry Graham,1981-09-19,Larry Graham - Just Be My Lady,8,8,8,8.0,8,Just Be My Lady,13.0,6,0,0,0,0,stay,1981-08-08
17683,Larry Graham,1981-09-26,Larry Graham - Just Be My Lady,8,8,8,8.0,8,Just Be My Lady,13.0,7,0,0,0,0,stay,1981-08-08
17684,Larry Graham,1981-10-03,Larry Graham - Just Be My Lady,8,8,11,8.0,8,Just Be My Lady,13.0,8,-3,0,0,1,down,1981-08-08
17685,Larry Graham,1981-10-10,Larry Graham - Just Be My Lady,8,8,21,8.0,11,Just Be My Lady,13.0,9,-10,-3,0,1,down,1981-08-08
17686,Larry Graham,1981-10-17,Larry Graham - Just Be My Lady,11,8,35,8.0,21,Just Be My Lady,13.0,10,-14,-10,-3,1,down,1981-08-08
17687,Larry Graham,1981-10-24,Larry Graham - Just Be My Lady,21,11,37,8.0,35,Just Be My Lady,13.0,11,-2,-14,-10,1,down,1981-08-08
17688,Larry Graham,1981-10-31,Larry Graham - Just Be My Lady,35,21,35,8.0,37,Just Be My Lady,13.0,12,2,-2,-14,1,up,1981-08-08
17689,Larry Graham,1981-11-07,Larry Graham - Just Be My Lady,37,35,51,8.0,35,Just Be My Lady,13.0,13,-16,2,-2,1,down,1981-08-08
17690,Soundtrack,1981-08-08,Soundtrack - Endless Love,51,51,25,9.0,45,Endless Love,15.0,0,20,6,0,1,up,1981-08-08
17691,Soundtrack,1981-08-15,Soundtrack - Endless Love,45,51,15,9.0,25,Endless Love,15.0,1,10,20,6,1,up,1981-08-08
17692,Soundtrack,1981-08-22,Soundtrack - Endless Love,25,45,13,9.0,15,Endless Love,15.0,2,2,10,20,1,up,1981-08-08
17693,Soundtrack,1981-08-29,Soundtrack - Endless Love,15,25,11,9.0,13,Endless Love,15.0,3,2,2,10,1,up,1981-08-08
17694,Soundtrack,1981-09-05,Soundtrack - Endless Love,13,15,9,9.0,11,Endless Love,15.0,4,2,2,2,1,up,1981-08-08
17695,Soundtrack,1981-09-12,Soundtrack - Endless Love,11,13,9,9.0,9,Endless Love,15.0,5,0,2,2,0,stay,1981-08-08
17696,Soundtrack,1981-09-19,Soundtrack - Endless Love,9,11,9,9.0,9,Endless Love,15.0,6,0,0,2,0,stay,1981-08-08
17697,Soundtrack,1981-09-26,Soundtrack - Endless Love,9,9,9,9.0,9,Endless Love,15.0,7,0,0,0,0,stay,1981-08-08
17698,Soundtrack,1981-10-03,Soundtrack - Endless Love,9,9,14,9.0,9,Endless Love,15.0,8,-5,0,0,1,down,1981-08-08
17699,Soundtrack,1981-10-10,Soundtrack - Endless Love,9,9,15,9.0,14,Endless Love,15.0,9,-1,-5,0,1,down,1981-08-08
17700,Soundtrack,1981-10-17,Soundtrack - Endless Love,14,9,21,9.0,15,Endless Love,15.0,10,-6,-1,-5,1,down,1981-08-08
17701,Soundtrack,1981-10-24,Soundtrack - Endless Love,15,14,24,9.0,21,Endless Love,15.0,11,-3,-6,-1,1,down,1981-08-08
17702,Soundtrack,1981-10-31,Soundtrack - Endless Love,21,15,27,9.0,24,Endless Love,15.0,12,-3,-3,-6,1,down,1981-08-08
17703,Soundtrack,1981-11-07,Soundtrack - Endless Love,24,21,32,9.0,27,Endless Love,15.0,13,-5,-3,-3,1,down,1981-08-08
17704,Soundtrack,1981-11-14,Soundtrack - Endless Love,27,24,32,9.0,32,Endless Love,15.0,14,0,-5,-3,0,stay,1981-08-08
17705,Soundtrack,1981-11-21,Soundtrack - Endless Love,32,27,51,9.0,32,Endless Love,15.0,15,-19,0,-5,1,down,1981-08-08
17706,Rene & Angela,1981-08-08,Rene & Angela - Wall To Wall,51,51,37,15.0,47,Wall To Wall,12.0,0,10,4,0,1,up,1981-08-08
17707,Rene & Angela,1981-08-15,Rene & Angela - Wall To Wall,47,51,27,15.0,37,Wall To Wall,12.0,1,10,10,4,1,up,1981-08-08
17708,Rene & Angela,1981-08-22,Rene & Angela - Wall To Wall,37,47,24,15.0,27,Wall To Wall,12.0,2,3,10,10,1,up,1981-08-08
17709,Rene & Angela,1981-08-29,Rene & Angela - Wall To Wall,27,37,24,15.0,24,Wall To Wall,12.0,3,0,3,10,0,stay,1981-08-08
17710,Rene & Angela,1981-09-05,Rene & Angela - Wall To Wall,24,27,22,15.0,24,Wall To Wall,12.0,4,2,0,3,1,up,1981-08-08
17711,Rene & Angela,1981-09-12,Rene & Angela - Wall To Wall,24,24,18,15.0,22,Wall To Wall,12.0,5,4,2,0,1,up,1981-08-08
17712,Rene & Angela,1981-09-19,Rene & Angela - Wall To Wall,22,24,16,15.0,18,Wall To Wall,12.0,6,2,4,2,1,up,1981-08-08
17713,Rene & Angela,1981-09-26,Rene & Angela - Wall To Wall,18,22,16,15.0,16,Wall To Wall,12.0,7,0,2,4,0,stay,1981-08-08
17714,Rene & Angela,1981-10-03,Rene & Angela - Wall To Wall,16,18,15,15.0,16,Wall To Wall,12.0,8,1,0,2,1,up,1981-08-08
17715,Rene & Angela,1981-10-10,Rene & Angela - Wall To Wall,16,16,23,15.0,15,Wall To Wall,12.0,9,-8,1,0,1,down,1981-08-08
17716,Rene & Angela,1981-10-17,Rene & Angela - Wall To Wall,15,16,33,15.0,23,Wall To Wall,12.0,10,-10,-8,1,1,down,1981-08-08
17717,Rene & Angela,1981-10-24,Rene & Angela - Wall To Wall,23,15,44,15.0,33,Wall To Wall,12.0,11,-11,-10,-8,1,down,1981-08-08
17718,Rene & Angela,1981-10-31,Rene & Angela - Wall To Wall,33,23,51,15.0,44,Wall To Wall,12.0,12,-7,-11,-10,1,down,1981-08-08
17719,Kraftwerk,1981-08-08,Kraftwerk - Computer World,51,51,45,32.0,49,Computer World,23.0,0,4,2,0,1,up,1981-08-08
17720,Kraftwerk,1981-08-15,Kraftwerk - Computer World,49,51,45,32.0,45,Computer World,23.0,1,0,4,2,0,stay,1981-08-08
17721,Kraftwerk,1981-08-22,Kraftwerk - Computer World,45,49,48,32.0,45,Computer World,23.0,2,-3,0,4,1,down,1981-08-08
17722,Kraftwerk,1981-10-03,Kraftwerk - Computer World,45,45,41,32.0,48,Computer World,23.0,3,7,-3,0,1,up,1981-08-08
17723,Kraftwerk,1981-10-10,Kraftwerk - Computer World,48,45,39,32.0,41,Computer World,23.0,4,2,7,-3,1,up,1981-08-08
17724,Kraftwerk,1981-10-17,Kraftwerk - Computer World,41,48,39,32.0,39,Computer World,23.0,5,0,2,7,0,stay,1981-08-08
17725,Kraftwerk,1981-10-24,Kraftwerk - Computer World,39,41,38,32.0,39,Computer World,23.0,6,1,0,2,1,up,1981-08-08
17726,Kraftwerk,1981-10-31,Kraftwerk - Computer World,39,39,38,32.0,38,Computer World,23.0,7,0,1,0,0,stay,1981-08-08
17727,Kraftwerk,1981-11-07,Kraftwerk - Computer World,38,39,36,32.0,38,Computer World,23.0,8,2,0,1,1,up,1981-08-08
17728,Kraftwerk,1981-11-14,Kraftwerk - Computer World,38,38,34,32.0,36,Computer World,23.0,9,2,2,0,1,up,1981-08-08
17729,Kraftwerk,1981-11-21,Kraftwerk - Computer World,36,38,33,32.0,34,Computer World,23.0,10,1,2,2,1,up,1981-08-08
17730,Kraftwerk,1981-11-28,Kraftwerk - Computer World,34,36,33,32.0,33,Computer World,23.0,11,0,1,2,0,stay,1981-08-08
17731,Kraftwerk,1981-12-05,Kraftwerk - Computer World,33,34,34,32.0,33,Computer World,23.0,12,-1,0,1,1,down,1981-08-08
17732,Kraftwerk,1981-12-12,Kraftwerk - Computer World,33,33,34,32.0,34,Computer World,23.0,13,0,-1,0,0,stay,1981-08-08
17733,Kraftwerk,1981-12-19,Kraftwerk - Computer World,34,33,32,32.0,34,Computer World,23.0,14,2,0,-1,1,up,1981-08-08
17734,Kraftwerk,1981-12-26,Kraftwerk - Computer World,34,34,32,32.0,32,Computer World,23.0,15,0,2,0,0,stay,1981-08-08
17735,Kraftwerk,1982-01-02,Kraftwerk - Computer World,32,34,43,32.0,32,Computer World,23.0,16,-11,0,2,1,down,1981-08-08
17736,Kraftwerk,1982-01-09,Kraftwerk - Computer World,32,32,42,32.0,43,Computer World,23.0,17,1,-11,0,1,up,1981-08-08
17737,Kraftwerk,1982-01-16,Kraftwerk - Computer World,43,32,41,32.0,42,Computer World,23.0,18,1,1,-11,1,up,1981-08-08
17738,Kraftwerk,1982-01-23,Kraftwerk - Computer World,42,43,39,32.0,41,Computer World,23.0,19,2,1,1,1,up,1981-08-08
17739,Kraftwerk,1982-01-30,Kraftwerk - Computer World,41,42,39,32.0,39,Computer World,23.0,20,0,2,1,0,stay,1981-08-08
17740,Kraftwerk,1982-02-06,Kraftwerk - Computer World,39,41,41,32.0,39,Computer World,23.0,21,-2,0,2,1,down,1981-08-08
17741,Kraftwerk,1982-02-13,Kraftwerk - Computer World,39,39,48,32.0,41,Computer World,23.0,22,-7,-2,0,1,down,1981-08-08
17742,Kraftwerk,1982-02-20,Kraftwerk - Computer World,41,39,51,32.0,48,Computer World,23.0,23,-3,-7,-2,1,down,1981-08-08
17743,Strikers,1981-08-08,Strikers - The Strikers,51,51,40,33.0,50,The Strikers,5.0,0,10,1,0,1,up,1981-08-08
17744,Strikers,1981-08-15,Strikers - The Strikers,50,51,36,33.0,40,The Strikers,5.0,1,4,10,1,1,up,1981-08-08
17745,Strikers,1981-08-22,Strikers - The Strikers,40,50,33,33.0,36,The Strikers,5.0,2,3,4,10,1,up,1981-08-08
17746,Strikers,1981-08-29,Strikers - The Strikers,36,40,33,33.0,33,The Strikers,5.0,3,0,3,4,0,stay,1981-08-08
17747,Strikers,1981-09-05,Strikers - The Strikers,33,36,45,33.0,33,The Strikers,5.0,4,-12,0,3,1,down,1981-08-08
17748,Strikers,1981-09-12,Strikers - The Strikers,33,33,51,33.0,45,The Strikers,5.0,5,-6,-12,0,1,down,1981-08-08
17749,Miles Davis,1981-08-15,Miles Davis - The Man With The Horn,51,51,24,13.0,34,The Man With The Horn,12.0,0,10,17,0,1,up,1981-08-15
17750,Miles Davis,1981-08-22,Miles Davis - The Man With The Horn,34,51,21,13.0,24,The Man With The Horn,12.0,1,3,10,17,1,up,1981-08-15
17751,Miles Davis,1981-08-29,Miles Davis - The Man With The Horn,24,34,17,13.0,21,The Man With The Horn,12.0,2,4,3,10,1,up,1981-08-15
17752,Miles Davis,1981-09-05,Miles Davis - The Man With The Horn,21,24,17,13.0,17,The Man With The Horn,12.0,3,0,4,3,0,stay,1981-08-15
17753,Miles Davis,1981-09-12,Miles Davis - The Man With The Horn,17,21,15,13.0,17,The Man With The Horn,12.0,4,2,0,4,1,up,1981-08-15
17754,Miles Davis,1981-09-19,Miles Davis - The Man With The Horn,17,17,13,13.0,15,The Man With The Horn,12.0,5,2,2,0,1,up,1981-08-15
17755,Miles Davis,1981-09-26,Miles Davis - The Man With The Horn,15,17,13,13.0,13,The Man With The Horn,12.0,6,0,2,2,0,stay,1981-08-15
17756,Miles Davis,1981-10-03,Miles Davis - The Man With The Horn,13,15,28,13.0,13,The Man With The Horn,12.0,7,-15,0,2,1,down,1981-08-15
17757,Miles Davis,1981-10-10,Miles Davis - The Man With The Horn,13,13,36,13.0,28,The Man With The Horn,12.0,8,-8,-15,0,1,down,1981-08-15
17758,Miles Davis,1981-10-17,Miles Davis - The Man With The Horn,28,13,41,13.0,36,The Man With The Horn,12.0,9,-5,-8,-15,1,down,1981-08-15
17759,Miles Davis,1981-10-24,Miles Davis - The Man With The Horn,36,28,39,13.0,41,The Man With The Horn,12.0,10,2,-5,-8,1,up,1981-08-15
17760,Miles Davis,1981-10-31,Miles Davis - The Man With The Horn,41,36,49,13.0,39,The Man With The Horn,12.0,11,-10,2,-5,1,down,1981-08-15
17761,Miles Davis,1981-11-07,Miles Davis - The Man With The Horn,39,41,51,13.0,49,The Man With The Horn,12.0,12,-2,-10,2,1,down,1981-08-15
17762,The Reddings,1981-08-15,The Reddings - Class,51,51,42,40.0,46,Class,5.0,0,4,5,0,1,up,1981-08-15
17763,The Reddings,1981-08-22,The Reddings - Class,46,51,42,40.0,42,Class,5.0,1,0,4,5,0,stay,1981-08-15
17764,The Reddings,1981-08-29,The Reddings - Class,42,46,40,40.0,42,Class,5.0,2,2,0,4,1,up,1981-08-15
17765,The Reddings,1981-09-05,The Reddings - Class,42,42,49,40.0,40,Class,5.0,3,-9,2,0,1,down,1981-08-15
17766,The Reddings,1981-09-12,The Reddings - Class,40,42,49,40.0,49,Class,5.0,4,0,-9,2,0,stay,1981-08-15
17767,The Reddings,1981-09-19,The Reddings - Class,49,40,51,40.0,49,Class,5.0,5,-2,0,-9,1,down,1981-08-15
17768,The Manhattans,1981-08-15,The Manhattans - Black Tie,51,51,37,21.0,50,Black Tie,10.0,0,13,1,0,1,up,1981-08-15
17769,The Manhattans,1981-08-22,The Manhattans - Black Tie,50,51,25,21.0,37,Black Tie,10.0,1,12,13,1,1,up,1981-08-15
17770,The Manhattans,1981-08-29,The Manhattans - Black Tie,37,50,21,21.0,25,Black Tie,10.0,2,4,12,13,1,up,1981-08-15
17771,The Manhattans,1981-09-05,The Manhattans - Black Tie,25,37,21,21.0,21,Black Tie,10.0,3,0,4,12,0,stay,1981-08-15
17772,The Manhattans,1981-09-12,The Manhattans - Black Tie,21,25,22,21.0,21,Black Tie,10.0,4,-1,0,4,1,down,1981-08-15
17773,The Manhattans,1981-09-19,The Manhattans - Black Tie,21,21,22,21.0,22,Black Tie,10.0,5,0,-1,0,0,stay,1981-08-15
17774,The Manhattans,1981-09-26,The Manhattans - Black Tie,22,21,23,21.0,22,Black Tie,10.0,6,-1,0,-1,1,down,1981-08-15
17775,The Manhattans,1981-10-03,The Manhattans - Black Tie,22,22,25,21.0,23,Black Tie,10.0,7,-2,-1,0,1,down,1981-08-15
17776,The Manhattans,1981-10-10,The Manhattans - Black Tie,23,22,37,21.0,25,Black Tie,10.0,8,-12,-2,-1,1,down,1981-08-15
17777,The Manhattans,1981-10-17,The Manhattans - Black Tie,25,23,42,21.0,37,Black Tie,10.0,9,-5,-12,-2,1,down,1981-08-15
17778,The Manhattans,1981-10-24,The Manhattans - Black Tie,37,25,51,21.0,42,Black Tie,10.0,10,-9,-5,-12,1,down,1981-08-15
17779,Jarreau,1981-08-22,Jarreau - Breakin' Away,51,51,16,1.0,35,Breakin' Away,42.0,0,19,16,0,1,up,1981-08-22
17780,Jarreau,1981-08-29,Jarreau - Breakin' Away,35,51,12,1.0,16,Breakin' Away,42.0,1,4,19,16,1,up,1981-08-22
17781,Jarreau,1981-09-05,Jarreau - Breakin' Away,16,35,7,1.0,12,Breakin' Away,42.0,2,5,4,19,1,up,1981-08-22
17782,Jarreau,1981-09-12,Jarreau - Breakin' Away,12,16,4,1.0,7,Breakin' Away,42.0,3,3,5,4,1,up,1981-08-22
17783,Jarreau,1981-09-19,Jarreau - Breakin' Away,7,12,2,1.0,4,Breakin' Away,42.0,4,2,3,5,1,up,1981-08-22
17784,Jarreau,1981-09-26,Jarreau - Breakin' Away,4,7,2,1.0,2,Breakin' Away,42.0,5,0,2,3,0,stay,1981-08-22
17785,Jarreau,1981-10-03,Jarreau - Breakin' Away,2,4,2,1.0,2,Breakin' Away,42.0,6,0,0,2,0,stay,1981-08-22
17786,Jarreau,1981-10-10,Jarreau - Breakin' Away,2,2,2,1.0,2,Breakin' Away,42.0,7,0,0,0,0,stay,1981-08-22
17787,Jarreau,1981-10-17,Jarreau - Breakin' Away,2,2,1,1.0,2,Breakin' Away,42.0,8,1,0,0,1,up,1981-08-22
17788,Jarreau,1981-10-24,Jarreau - Breakin' Away,2,2,1,1.0,1,Breakin' Away,42.0,9,0,1,0,0,stay,1981-08-22
17789,Jarreau,1981-10-31,Jarreau - Breakin' Away,1,2,3,1.0,1,Breakin' Away,42.0,10,-2,0,1,1,down,1981-08-22
17790,Jarreau,1981-11-07,Jarreau - Breakin' Away,1,1,4,1.0,3,Breakin' Away,42.0,11,-1,-2,0,1,down,1981-08-22
17791,Jarreau,1981-11-14,Jarreau - Breakin' Away,3,1,13,1.0,4,Breakin' Away,42.0,12,-9,-1,-2,1,down,1981-08-22
17792,Jarreau,1981-11-21,Jarreau - Breakin' Away,4,3,13,1.0,13,Breakin' Away,42.0,13,0,-9,-1,0,stay,1981-08-22
17793,Jarreau,1981-11-28,Jarreau - Breakin' Away,13,4,13,1.0,13,Breakin' Away,42.0,14,0,0,-9,0,stay,1981-08-22
17794,Jarreau,1981-12-05,Jarreau - Breakin' Away,13,13,17,1.0,13,Breakin' Away,42.0,15,-4,0,0,1,down,1981-08-22
17795,Jarreau,1981-12-12,Jarreau - Breakin' Away,13,13,17,1.0,17,Breakin' Away,42.0,16,0,-4,0,0,stay,1981-08-22
17796,Jarreau,1981-12-19,Jarreau - Breakin' Away,17,13,20,1.0,17,Breakin' Away,42.0,17,-3,0,-4,1,down,1981-08-22
17797,Jarreau,1981-12-26,Jarreau - Breakin' Away,17,17,20,1.0,20,Breakin' Away,42.0,18,0,-3,0,0,stay,1981-08-22
17798,Jarreau,1982-01-02,Jarreau - Breakin' Away,20,17,20,1.0,20,Breakin' Away,42.0,19,0,0,-3,0,stay,1981-08-22
17799,Jarreau,1982-01-09,Jarreau - Breakin' Away,20,20,20,1.0,20,Breakin' Away,42.0,20,0,0,0,0,stay,1981-08-22
17800,Jarreau,1982-01-16,Jarreau - Breakin' Away,20,20,19,1.0,20,Breakin' Away,42.0,21,1,0,0,1,up,1981-08-22
17801,Jarreau,1982-01-23,Jarreau - Breakin' Away,20,20,18,1.0,19,Breakin' Away,42.0,22,1,1,0,1,up,1981-08-22
17802,Jarreau,1982-01-30,Jarreau - Breakin' Away,19,20,27,1.0,18,Breakin' Away,42.0,23,-9,1,1,1,down,1981-08-22
17803,Jarreau,1982-02-06,Jarreau - Breakin' Away,18,19,31,1.0,27,Breakin' Away,42.0,24,-4,-9,1,1,down,1981-08-22
17804,Jarreau,1982-02-13,Jarreau - Breakin' Away,27,18,32,1.0,31,Breakin' Away,42.0,25,-1,-4,-9,1,down,1981-08-22
17805,Jarreau,1982-02-20,Jarreau - Breakin' Away,31,27,32,1.0,32,Breakin' Away,42.0,26,0,-1,-4,0,stay,1981-08-22
17806,Jarreau,1982-02-27,Jarreau - Breakin' Away,32,31,36,1.0,32,Breakin' Away,42.0,27,-4,0,-1,1,down,1981-08-22
17807,Jarreau,1982-03-06,Jarreau - Breakin' Away,32,32,34,1.0,36,Breakin' Away,42.0,28,2,-4,0,1,up,1981-08-22
17808,Jarreau,1982-03-13,Jarreau - Breakin' Away,36,32,31,1.0,34,Breakin' Away,42.0,29,3,2,-4,1,up,1981-08-22
17809,Jarreau,1982-03-20,Jarreau - Breakin' Away,34,36,28,1.0,31,Breakin' Away,42.0,30,3,3,2,1,up,1981-08-22
17810,Jarreau,1982-03-27,Jarreau - Breakin' Away,31,34,25,1.0,28,Breakin' Away,42.0,31,3,3,3,1,up,1981-08-22
17811,Jarreau,1982-04-03,Jarreau - Breakin' Away,28,31,22,1.0,25,Breakin' Away,42.0,32,3,3,3,1,up,1981-08-22
17812,Jarreau,1982-04-10,Jarreau - Breakin' Away,25,28,20,1.0,22,Breakin' Away,42.0,33,2,3,3,1,up,1981-08-22
17813,Jarreau,1982-04-17,Jarreau - Breakin' Away,22,25,20,1.0,20,Breakin' Away,42.0,34,0,2,3,0,stay,1981-08-22
17814,Jarreau,1982-04-24,Jarreau - Breakin' Away,20,22,30,1.0,20,Breakin' Away,42.0,35,-10,0,2,1,down,1981-08-22
17815,Jarreau,1982-05-01,Jarreau - Breakin' Away,20,20,32,1.0,30,Breakin' Away,42.0,36,-2,-10,0,1,down,1981-08-22
17816,Jarreau,1982-05-08,Jarreau - Breakin' Away,30,20,30,1.0,32,Breakin' Away,42.0,37,2,-2,-10,1,up,1981-08-22
17817,Jarreau,1982-05-15,Jarreau - Breakin' Away,32,30,36,1.0,30,Breakin' Away,42.0,38,-6,2,-2,1,down,1981-08-22
17818,Jarreau,1982-05-22,Jarreau - Breakin' Away,30,32,36,1.0,36,Breakin' Away,42.0,39,0,-6,2,0,stay,1981-08-22
17819,Jarreau,1982-05-29,Jarreau - Breakin' Away,36,30,44,1.0,36,Breakin' Away,42.0,40,-8,0,-6,1,down,1981-08-22
17820,Jarreau,1982-06-05,Jarreau - Breakin' Away,36,36,42,1.0,44,Breakin' Away,42.0,41,2,-8,0,1,up,1981-08-22
17821,Jarreau,1982-06-12,Jarreau - Breakin' Away,44,36,51,1.0,42,Breakin' Away,42.0,42,-9,2,-8,1,down,1981-08-22
17822,Jean Cairn,1981-08-22,Jean Cairn - Sweet And Wonderful,51,51,41,38.0,46,Sweet And Wonderful,5.0,0,5,5,0,1,up,1981-08-22
17823,Jean Cairn,1981-08-29,Jean Cairn - Sweet And Wonderful,46,51,38,38.0,41,Sweet And Wonderful,5.0,1,3,5,5,1,up,1981-08-22
17824,Jean Cairn,1981-09-05,Jean Cairn - Sweet And Wonderful,41,46,38,38.0,38,Sweet And Wonderful,5.0,2,0,3,5,0,stay,1981-08-22
17825,Jean Cairn,1981-09-12,Jean Cairn - Sweet And Wonderful,38,41,38,38.0,38,Sweet And Wonderful,5.0,3,0,0,3,0,stay,1981-08-22
17826,Jean Cairn,1981-09-19,Jean Cairn - Sweet And Wonderful,38,38,38,38.0,38,Sweet And Wonderful,5.0,4,0,0,0,0,stay,1981-08-22
17827,Jean Cairn,1981-09-26,Jean Cairn - Sweet And Wonderful,38,38,51,38.0,38,Sweet And Wonderful,5.0,5,-13,0,0,1,down,1981-08-22
17828,Millie Jackson,1981-08-22,Millie Jackson - Just A Lil' Bit Country,51,51,43,43.0,47,Just A Lil' Bit Country,2.0,0,4,4,0,1,up,1981-08-22
17829,Millie Jackson,1981-08-29,Millie Jackson - Just A Lil' Bit Country,47,51,43,43.0,43,Just A Lil' Bit Country,2.0,1,0,4,4,0,stay,1981-08-22
17830,Millie Jackson,1981-09-05,Millie Jackson - Just A Lil' Bit Country,43,47,51,43.0,43,Just A Lil' Bit Country,2.0,2,-8,0,4,1,down,1981-08-22
17831,The S.O.S. Band,1981-08-22,The S.O.S. Band - Too,51,51,40,30.0,48,Too,8.0,0,8,3,0,1,up,1981-08-22
17832,The S.O.S. Band,1981-08-29,The S.O.S. Band - Too,48,51,37,30.0,40,Too,8.0,1,3,8,3,1,up,1981-08-22
17833,The S.O.S. Band,1981-09-05,The S.O.S. Band - Too,40,48,37,30.0,37,Too,8.0,2,0,3,8,0,stay,1981-08-22
17834,The S.O.S. Band,1981-09-12,The S.O.S. Band - Too,37,40,34,30.0,37,Too,8.0,3,3,0,3,1,up,1981-08-22
17835,The S.O.S. Band,1981-09-19,The S.O.S. Band - Too,37,37,31,30.0,34,Too,8.0,4,3,3,0,1,up,1981-08-22
17836,The S.O.S. Band,1981-09-26,The S.O.S. Band - Too,34,37,31,30.0,31,Too,8.0,5,0,3,3,0,stay,1981-08-22
17837,The S.O.S. Band,1981-10-03,The S.O.S. Band - Too,31,34,30,30.0,31,Too,8.0,6,1,0,3,1,up,1981-08-22
17838,The S.O.S. Band,1981-10-10,The S.O.S. Band - Too,31,31,40,30.0,30,Too,8.0,7,-10,1,0,1,down,1981-08-22
17839,The S.O.S. Band,1981-10-17,The S.O.S. Band - Too,30,31,51,30.0,40,Too,8.0,8,-11,-10,1,1,down,1981-08-22
17840,Brook-lyn,1981-08-22,"Brook-lyn - The Brooklyn, Bronx & Queens Band",51,51,35,19.0,50,"The Brooklyn, Bronx & Queens Band",13.0,0,15,1,0,1,up,1981-08-22
17841,Brook-lyn,1981-08-29,"Brook-lyn - The Brooklyn, Bronx & Queens Band",50,51,32,19.0,35,"The Brooklyn, Bronx & Queens Band",13.0,1,3,15,1,1,up,1981-08-22
17842,Brook-lyn,1981-09-05,"Brook-lyn - The Brooklyn, Bronx & Queens Band",35,50,28,19.0,32,"The Brooklyn, Bronx & Queens Band",13.0,2,4,3,15,1,up,1981-08-22
17843,Brook-lyn,1981-09-12,"Brook-lyn - The Brooklyn, Bronx & Queens Band",32,35,24,19.0,28,"The Brooklyn, Bronx & Queens Band",13.0,3,4,4,3,1,up,1981-08-22
17844,Brook-lyn,1981-09-19,"Brook-lyn - The Brooklyn, Bronx & Queens Band",28,32,21,19.0,24,"The Brooklyn, Bronx & Queens Band",13.0,4,3,4,4,1,up,1981-08-22
17845,Brook-lyn,1981-09-26,"Brook-lyn - The Brooklyn, Bronx & Queens Band",24,28,21,19.0,21,"The Brooklyn, Bronx & Queens Band",13.0,5,0,3,4,0,stay,1981-08-22
17846,Brook-lyn,1981-10-03,"Brook-lyn - The Brooklyn, Bronx & Queens Band",21,24,21,19.0,21,"The Brooklyn, Bronx & Queens Band",13.0,6,0,0,3,0,stay,1981-08-22
17847,Brook-lyn,1981-10-10,"Brook-lyn - The Brooklyn, Bronx & Queens Band",21,21,19,19.0,21,"The Brooklyn, Bronx & Queens Band",13.0,7,2,0,0,1,up,1981-08-22
17848,Brook-lyn,1981-10-17,"Brook-lyn - The Brooklyn, Bronx & Queens Band",21,21,19,19.0,19,"The Brooklyn, Bronx & Queens Band",13.0,8,0,2,0,0,stay,1981-08-22
17849,Brook-lyn,1981-10-24,"Brook-lyn - The Brooklyn, Bronx & Queens Band",19,21,25,19.0,19,"The Brooklyn, Bronx & Queens Band",13.0,9,-6,0,2,1,down,1981-08-22
17850,Brook-lyn,1981-10-31,"Brook-lyn - The Brooklyn, Bronx & Queens Band",19,19,28,19.0,25,"The Brooklyn, Bronx & Queens Band",13.0,10,-3,-6,0,1,down,1981-08-22
17851,Brook-lyn,1981-11-07,"Brook-lyn - The Brooklyn, Bronx & Queens Band",25,19,33,19.0,28,"The Brooklyn, Bronx & Queens Band",13.0,11,-5,-3,-6,1,down,1981-08-22
17852,Brook-lyn,1981-11-14,"Brook-lyn - The Brooklyn, Bronx & Queens Band",28,25,33,19.0,33,"The Brooklyn, Bronx & Queens Band",13.0,12,0,-5,-3,0,stay,1981-08-22
17853,Brook-lyn,1981-11-21,"Brook-lyn - The Brooklyn, Bronx & Queens Band",33,28,51,19.0,33,"The Brooklyn, Bronx & Queens Band",13.0,13,-18,0,-5,1,down,1981-08-22
17854,Funkadelic,1981-08-29,Funkadelic - The Electric Spanking Of War Babies,51,51,41,41.0,46,The Electric Spanking Of War Babies,3.0,0,5,5,0,1,up,1981-08-29
17855,Funkadelic,1981-09-05,Funkadelic - The Electric Spanking Of War Babies,46,51,41,41.0,41,The Electric Spanking Of War Babies,3.0,1,0,5,5,0,stay,1981-08-29
17856,Funkadelic,1981-09-12,Funkadelic - The Electric Spanking Of War Babies,41,46,46,41.0,41,The Electric Spanking Of War Babies,3.0,2,-5,0,5,1,down,1981-08-29
17857,Funkadelic,1981-09-19,Funkadelic - The Electric Spanking Of War Babies,41,41,51,41.0,46,The Electric Spanking Of War Babies,3.0,3,-5,-5,0,1,down,1981-08-29
17858,Herb Alpert,1981-08-29,Herb Alpert - Magic Man,51,51,42,39.0,47,Magic Man,4.0,0,5,4,0,1,up,1981-08-29
17859,Herb Alpert,1981-09-05,Herb Alpert - Magic Man,47,51,39,39.0,42,Magic Man,4.0,1,3,5,4,1,up,1981-08-29
17860,Herb Alpert,1981-09-12,Herb Alpert - Magic Man,42,47,39,39.0,39,Magic Man,4.0,2,0,3,5,0,stay,1981-08-29
17861,Herb Alpert,1981-09-19,Herb Alpert - Magic Man,39,42,40,39.0,39,Magic Man,4.0,3,-1,0,3,1,down,1981-08-29
17862,Herb Alpert,1981-09-26,Herb Alpert - Magic Man,39,39,51,39.0,40,Magic Man,4.0,4,-11,-1,0,1,down,1981-08-29
17863,Billy Preston & Syreeta,1981-08-29,Billy Preston & Syreeta - Billy Preston & Syreeta,51,51,48,48.0,48,Billy Preston & Syreeta,1.0,0,0,3,0,0,stay,1981-08-29
17864,Billy Preston & Syreeta,1981-09-05,Billy Preston & Syreeta - Billy Preston & Syreeta,48,51,51,48.0,48,Billy Preston & Syreeta,1.0,1,-3,0,3,1,down,1981-08-29
17865,Roy Ayers,1981-08-29,"Roy Ayers - Africa, Center Of The World",51,51,44,43.0,49,"Africa, Center Of The World",4.0,0,5,2,0,1,up,1981-08-29
17866,Roy Ayers,1981-09-05,"Roy Ayers - Africa, Center Of The World",49,51,43,43.0,44,"Africa, Center Of The World",4.0,1,1,5,2,1,up,1981-08-29
17867,Roy Ayers,1981-09-12,"Roy Ayers - Africa, Center Of The World",44,49,47,43.0,43,"Africa, Center Of The World",4.0,2,-4,1,5,1,down,1981-08-29
17868,Roy Ayers,1981-09-19,"Roy Ayers - Africa, Center Of The World",43,44,47,43.0,47,"Africa, Center Of The World",4.0,3,0,-4,1,0,stay,1981-08-29
17869,Roy Ayers,1981-09-26,"Roy Ayers - Africa, Center Of The World",47,43,51,43.0,47,"Africa, Center Of The World",4.0,4,-4,0,-4,1,down,1981-08-29
17870,Third World,1981-08-29,Third World - Rock The World,51,51,51,50.0,50,Rock The World,0.0,0,-1,1,0,1,down,1981-08-29
17871,Aretha Franklin,1981-09-05,Aretha Franklin - Love All The Hurt Away,51,51,18,4.0,35,Love All The Hurt Away,18.0,0,17,16,0,1,up,1981-09-05
17872,Aretha Franklin,1981-09-12,Aretha Franklin - Love All The Hurt Away,35,51,10,4.0,18,Love All The Hurt Away,18.0,1,8,17,16,1,up,1981-09-05
17873,Aretha Franklin,1981-09-19,Aretha Franklin - Love All The Hurt Away,18,35,7,4.0,10,Love All The Hurt Away,18.0,2,3,8,17,1,up,1981-09-05
17874,Aretha Franklin,1981-09-26,Aretha Franklin - Love All The Hurt Away,10,18,5,4.0,7,Love All The Hurt Away,18.0,3,2,3,8,1,up,1981-09-05
17875,Aretha Franklin,1981-10-03,Aretha Franklin - Love All The Hurt Away,7,10,4,4.0,5,Love All The Hurt Away,18.0,4,1,2,3,1,up,1981-09-05
17876,Aretha Franklin,1981-10-10,Aretha Franklin - Love All The Hurt Away,5,7,4,4.0,4,Love All The Hurt Away,18.0,5,0,1,2,0,stay,1981-09-05
17877,Aretha Franklin,1981-10-17,Aretha Franklin - Love All The Hurt Away,4,5,4,4.0,4,Love All The Hurt Away,18.0,6,0,0,1,0,stay,1981-09-05
17878,Aretha Franklin,1981-10-24,Aretha Franklin - Love All The Hurt Away,4,4,12,4.0,4,Love All The Hurt Away,18.0,7,-8,0,0,1,down,1981-09-05
17879,Aretha Franklin,1981-10-31,Aretha Franklin - Love All The Hurt Away,4,4,12,4.0,12,Love All The Hurt Away,18.0,8,0,-8,0,0,stay,1981-09-05
17880,Aretha Franklin,1981-11-07,Aretha Franklin - Love All The Hurt Away,12,4,22,4.0,12,Love All The Hurt Away,18.0,9,-10,0,-8,1,down,1981-09-05
17881,Aretha Franklin,1981-11-14,Aretha Franklin - Love All The Hurt Away,12,12,27,4.0,22,Love All The Hurt Away,18.0,10,-5,-10,0,1,down,1981-09-05
17882,Aretha Franklin,1981-11-21,Aretha Franklin - Love All The Hurt Away,22,12,25,4.0,27,Love All The Hurt Away,18.0,11,2,-5,-10,1,up,1981-09-05
17883,Aretha Franklin,1981-11-28,Aretha Franklin - Love All The Hurt Away,27,22,25,4.0,25,Love All The Hurt Away,18.0,12,0,2,-5,0,stay,1981-09-05
17884,Aretha Franklin,1981-12-05,Aretha Franklin - Love All The Hurt Away,25,27,24,4.0,25,Love All The Hurt Away,18.0,13,1,0,2,1,up,1981-09-05
17885,Aretha Franklin,1981-12-12,Aretha Franklin - Love All The Hurt Away,25,25,24,4.0,24,Love All The Hurt Away,18.0,14,0,1,0,0,stay,1981-09-05
17886,Aretha Franklin,1981-12-19,Aretha Franklin - Love All The Hurt Away,24,25,24,4.0,24,Love All The Hurt Away,18.0,15,0,0,1,0,stay,1981-09-05
17887,Aretha Franklin,1981-12-26,Aretha Franklin - Love All The Hurt Away,24,24,24,4.0,24,Love All The Hurt Away,18.0,16,0,0,0,0,stay,1981-09-05
17888,Aretha Franklin,1982-01-02,Aretha Franklin - Love All The Hurt Away,24,24,25,4.0,24,Love All The Hurt Away,18.0,17,-1,0,0,1,down,1981-09-05
17889,Aretha Franklin,1982-01-09,Aretha Franklin - Love All The Hurt Away,24,24,51,4.0,25,Love All The Hurt Away,18.0,18,-26,-1,0,1,down,1981-09-05
17890,The Time,1981-09-05,The Time - The Time,51,51,40,7.0,45,The Time,33.0,0,5,6,0,1,up,1981-09-05
17891,The Time,1981-09-12,The Time - The Time,45,51,29,7.0,40,The Time,33.0,1,11,5,6,1,up,1981-09-05
17892,The Time,1981-09-19,The Time - The Time,40,45,19,7.0,29,The Time,33.0,2,10,11,5,1,up,1981-09-05
17893,The Time,1981-09-26,The Time - The Time,29,40,12,7.0,19,The Time,33.0,3,7,10,11,1,up,1981-09-05
17894,The Time,1981-10-03,The Time - The Time,19,29,10,7.0,12,The Time,33.0,4,2,7,10,1,up,1981-09-05
17895,The Time,1981-10-10,The Time - The Time,12,19,8,7.0,10,The Time,33.0,5,2,2,7,1,up,1981-09-05
17896,The Time,1981-10-17,The Time - The Time,10,12,7,7.0,8,The Time,33.0,6,1,2,2,1,up,1981-09-05
17897,The Time,1981-10-24,The Time - The Time,8,10,7,7.0,7,The Time,33.0,7,0,1,2,0,stay,1981-09-05
17898,The Time,1981-10-31,The Time - The Time,7,8,7,7.0,7,The Time,33.0,8,0,0,1,0,stay,1981-09-05
17899,The Time,1981-11-07,The Time - The Time,7,7,7,7.0,7,The Time,33.0,9,0,0,0,0,stay,1981-09-05
17900,The Time,1981-11-14,The Time - The Time,7,7,7,7.0,7,The Time,33.0,10,0,0,0,0,stay,1981-09-05
17901,The Time,1981-11-21,The Time - The Time,7,7,10,7.0,7,The Time,33.0,11,-3,0,0,1,down,1981-09-05
17902,The Time,1981-11-28,The Time - The Time,7,7,10,7.0,10,The Time,33.0,12,0,-3,0,0,stay,1981-09-05
17903,The Time,1981-12-05,The Time - The Time,10,7,13,7.0,10,The Time,33.0,13,-3,0,-3,1,down,1981-09-05
17904,The Time,1981-12-12,The Time - The Time,10,10,22,7.0,13,The Time,33.0,14,-9,-3,0,1,down,1981-09-05
17905,The Time,1981-12-19,The Time - The Time,13,10,21,7.0,22,The Time,33.0,15,1,-9,-3,1,up,1981-09-05
17906,The Time,1981-12-26,The Time - The Time,22,13,21,7.0,21,The Time,33.0,16,0,1,-9,0,stay,1981-09-05
17907,The Time,1982-01-02,The Time - The Time,21,22,24,7.0,21,The Time,33.0,17,-3,0,1,1,down,1981-09-05
17908,The Time,1982-01-09,The Time - The Time,21,21,24,7.0,24,The Time,33.0,18,0,-3,0,0,stay,1981-09-05
17909,The Time,1982-01-16,The Time - The Time,24,21,16,7.0,24,The Time,33.0,19,8,0,-3,1,up,1981-09-05
17910,The Time,1982-01-23,The Time - The Time,24,24,15,7.0,16,The Time,33.0,20,1,8,0,1,up,1981-09-05
17911,The Time,1982-01-30,The Time - The Time,16,24,15,7.0,15,The Time,33.0,21,0,1,8,0,stay,1981-09-05
17912,The Time,1982-02-06,The Time - The Time,15,16,14,7.0,15,The Time,33.0,22,1,0,1,1,up,1981-09-05
17913,The Time,1982-02-13,The Time - The Time,15,15,20,7.0,14,The Time,33.0,23,-6,1,0,1,down,1981-09-05
17914,The Time,1982-02-20,The Time - The Time,14,15,19,7.0,20,The Time,33.0,24,1,-6,1,1,up,1981-09-05
17915,The Time,1982-02-27,The Time - The Time,20,14,18,7.0,19,The Time,33.0,25,1,1,-6,1,up,1981-09-05
17916,The Time,1982-03-06,The Time - The Time,19,20,21,7.0,18,The Time,33.0,26,-3,1,1,1,down,1981-09-05
17917,The Time,1982-03-13,The Time - The Time,18,19,20,7.0,21,The Time,33.0,27,1,-3,1,1,up,1981-09-05
17918,The Time,1982-03-20,The Time - The Time,21,18,20,7.0,20,The Time,33.0,28,0,1,-3,0,stay,1981-09-05
17919,The Time,1982-03-27,The Time - The Time,20,21,22,7.0,20,The Time,33.0,29,-2,0,1,1,down,1981-09-05
17920,The Time,1982-04-03,The Time - The Time,20,20,23,7.0,22,The Time,33.0,30,-1,-2,0,1,down,1981-09-05
17921,The Time,1982-04-10,The Time - The Time,22,20,33,7.0,23,The Time,33.0,31,-10,-1,-2,1,down,1981-09-05
17922,The Time,1982-04-17,The Time - The Time,23,22,36,7.0,33,The Time,33.0,32,-3,-10,-1,1,down,1981-09-05
17923,The Time,1982-05-01,The Time - The Time,33,23,51,7.0,36,The Time,33.0,33,-15,-3,-10,1,down,1981-09-05
17924,Lee Oskar,1981-09-05,Lee Oskar - My Road Our Road,51,51,47,47.0,47,My Road Our Road,1.0,0,0,4,0,0,stay,1981-09-05
17925,Lee Oskar,1981-09-12,Lee Oskar - My Road Our Road,47,51,51,47.0,47,My Road Our Road,1.0,1,-4,0,4,1,down,1981-09-05
17926,The Temptations,1981-09-05,The Temptations - The Temptations,51,51,42,36.0,50,The Temptations,5.0,0,8,1,0,1,up,1981-09-05
17927,The Temptations,1981-09-12,The Temptations - The Temptations,50,51,37,36.0,42,The Temptations,5.0,1,5,8,1,1,up,1981-09-05
17928,The Temptations,1981-09-19,The Temptations - The Temptations,42,50,37,36.0,37,The Temptations,5.0,2,0,5,8,0,stay,1981-09-05
17929,The Temptations,1981-09-26,The Temptations - The Temptations,37,42,36,36.0,37,The Temptations,5.0,3,1,0,5,1,up,1981-09-05
17930,The Temptations,1981-10-03,The Temptations - The Temptations,37,37,36,36.0,36,The Temptations,5.0,4,0,1,0,0,stay,1981-09-05
17931,The Temptations,1981-10-10,The Temptations - The Temptations,36,37,51,36.0,36,The Temptations,5.0,5,-15,0,1,1,down,1981-09-05
17932,Brick,1981-09-12,Brick - Summer Heat,51,51,23,13.0,34,Summer Heat,8.0,0,11,17,0,1,up,1981-09-12
17933,Brick,1981-09-19,Brick - Summer Heat,34,51,17,13.0,23,Summer Heat,8.0,1,6,11,17,1,up,1981-09-12
17934,Brick,1981-09-26,Brick - Summer Heat,23,34,15,13.0,17,Summer Heat,8.0,2,2,6,11,1,up,1981-09-12
17935,Brick,1981-10-03,Brick - Summer Heat,17,23,13,13.0,15,Summer Heat,8.0,3,2,2,6,1,up,1981-09-12
17936,Brick,1981-10-10,Brick - Summer Heat,15,17,13,13.0,13,Summer Heat,8.0,4,0,2,2,0,stay,1981-09-12
17937,Brick,1981-10-17,Brick - Summer Heat,13,15,22,13.0,13,Summer Heat,8.0,5,-9,0,2,1,down,1981-09-12
17938,Brick,1981-10-24,Brick - Summer Heat,13,13,28,13.0,22,Summer Heat,8.0,6,-6,-9,0,1,down,1981-09-12
17939,Brick,1981-10-31,Brick - Summer Heat,22,13,37,13.0,28,Summer Heat,8.0,7,-9,-6,-9,1,down,1981-09-12
17940,Brick,1981-11-07,Brick - Summer Heat,28,22,51,13.0,37,Summer Heat,8.0,8,-14,-9,-6,1,down,1981-09-12
17941,Gladys Knight And The Pips,1981-09-12,Gladys Knight And The Pips - Touch,51,51,30,22.0,35,Touch,17.0,0,5,16,0,1,up,1981-09-12
17942,Gladys Knight And The Pips,1981-09-19,Gladys Knight And The Pips - Touch,35,51,26,22.0,30,Touch,17.0,1,4,5,16,1,up,1981-09-12
17943,Gladys Knight And The Pips,1981-09-26,Gladys Knight And The Pips - Touch,30,35,22,22.0,26,Touch,17.0,2,4,4,5,1,up,1981-09-12
17944,Gladys Knight And The Pips,1981-10-03,Gladys Knight And The Pips - Touch,26,30,22,22.0,22,Touch,17.0,3,0,4,4,0,stay,1981-09-12
17945,Gladys Knight And The Pips,1981-10-10,Gladys Knight And The Pips - Touch,22,26,32,22.0,22,Touch,17.0,4,-10,0,4,1,down,1981-09-12
17946,Gladys Knight And The Pips,1981-10-17,Gladys Knight And The Pips - Touch,22,22,32,22.0,32,Touch,17.0,5,0,-10,0,0,stay,1981-09-12
17947,Gladys Knight And The Pips,1981-10-24,Gladys Knight And The Pips - Touch,32,22,45,22.0,32,Touch,17.0,6,-13,0,-10,1,down,1981-09-12
17948,Gladys Knight And The Pips,1981-10-31,Gladys Knight And The Pips - Touch,32,32,44,22.0,45,Touch,17.0,7,1,-13,0,1,up,1981-09-12
17949,Gladys Knight And The Pips,1981-11-07,Gladys Knight And The Pips - Touch,45,32,42,22.0,44,Touch,17.0,8,2,1,-13,1,up,1981-09-12
17950,Gladys Knight And The Pips,1981-11-14,Gladys Knight And The Pips - Touch,44,45,42,22.0,42,Touch,17.0,9,0,2,1,0,stay,1981-09-12
17951,Gladys Knight And The Pips,1981-11-21,Gladys Knight And The Pips - Touch,42,44,41,22.0,42,Touch,17.0,10,1,0,2,1,up,1981-09-12
17952,Gladys Knight And The Pips,1981-11-28,Gladys Knight And The Pips - Touch,42,42,42,22.0,41,Touch,17.0,11,-1,1,0,1,down,1981-09-12
17953,Gladys Knight And The Pips,1981-12-05,Gladys Knight And The Pips - Touch,41,42,42,22.0,42,Touch,17.0,12,0,-1,1,0,stay,1981-09-12
17954,Gladys Knight And The Pips,1981-12-12,Gladys Knight And The Pips - Touch,42,41,49,22.0,42,Touch,17.0,13,-7,0,-1,1,down,1981-09-12
17955,Gladys Knight And The Pips,1982-02-06,Gladys Knight And The Pips - Touch,42,42,47,22.0,49,Touch,17.0,14,2,-7,0,1,up,1981-09-12
17956,Gladys Knight And The Pips,1982-02-13,Gladys Knight And The Pips - Touch,49,42,49,22.0,47,Touch,17.0,15,-2,2,-7,1,down,1981-09-12
17957,Gladys Knight And The Pips,1982-03-06,Gladys Knight And The Pips - Touch,47,49,49,22.0,49,Touch,17.0,16,0,-2,2,0,stay,1981-09-12
17958,Gladys Knight And The Pips,1982-03-13,Gladys Knight And The Pips - Touch,49,47,51,22.0,49,Touch,17.0,17,-2,0,-2,1,down,1981-09-12
17959,Four Tops,1981-09-12,Four Tops - Tonight,51,51,25,5.0,48,Tonight,20.0,0,23,3,0,1,up,1981-09-12
17960,Four Tops,1981-09-19,Four Tops - Tonight,48,51,15,5.0,25,Tonight,20.0,1,10,23,3,1,up,1981-09-12
17961,Four Tops,1981-09-26,Four Tops - Tonight,25,48,10,5.0,15,Tonight,20.0,2,5,10,23,1,up,1981-09-12
17962,Four Tops,1981-10-03,Four Tops - Tonight,15,25,8,5.0,10,Tonight,20.0,3,2,5,10,1,up,1981-09-12
17963,Four Tops,1981-10-10,Four Tops - Tonight,10,15,6,5.0,8,Tonight,20.0,4,2,2,5,1,up,1981-09-12
17964,Four Tops,1981-10-17,Four Tops - Tonight,8,10,5,5.0,6,Tonight,20.0,5,1,2,2,1,up,1981-09-12
17965,Four Tops,1981-10-24,Four Tops - Tonight,6,8,5,5.0,5,Tonight,20.0,6,0,1,2,0,stay,1981-09-12
17966,Four Tops,1981-10-31,Four Tops - Tonight,5,6,5,5.0,5,Tonight,20.0,7,0,0,1,0,stay,1981-09-12
17967,Four Tops,1981-11-07,Four Tops - Tonight,5,5,13,5.0,5,Tonight,20.0,8,-8,0,0,1,down,1981-09-12
17968,Four Tops,1981-11-14,Four Tops - Tonight,5,5,16,5.0,13,Tonight,20.0,9,-3,-8,0,1,down,1981-09-12
17969,Four Tops,1981-11-21,Four Tops - Tonight,13,5,17,5.0,16,Tonight,20.0,10,-1,-3,-8,1,down,1981-09-12
17970,Four Tops,1981-11-28,Four Tops - Tonight,16,13,26,5.0,17,Tonight,20.0,11,-9,-1,-3,1,down,1981-09-12
17971,Four Tops,1981-12-05,Four Tops - Tonight,17,16,30,5.0,26,Tonight,20.0,12,-4,-9,-1,1,down,1981-09-12
17972,Four Tops,1981-12-12,Four Tops - Tonight,26,17,35,5.0,30,Tonight,20.0,13,-5,-4,-9,1,down,1981-09-12
17973,Four Tops,1981-12-19,Four Tops - Tonight,30,26,46,5.0,35,Tonight,20.0,14,-11,-5,-4,1,down,1981-09-12
17974,Four Tops,1981-12-26,Four Tops - Tonight,35,30,46,5.0,46,Tonight,20.0,15,0,-11,-5,0,stay,1981-09-12
17975,Four Tops,1982-01-02,Four Tops - Tonight,46,35,47,5.0,46,Tonight,20.0,16,-1,0,-11,1,down,1981-09-12
17976,Four Tops,1982-01-09,Four Tops - Tonight,46,46,48,5.0,47,Tonight,20.0,17,-1,-1,0,1,down,1981-09-12
17977,Four Tops,1982-01-16,Four Tops - Tonight,47,46,49,5.0,48,Tonight,20.0,18,-1,-1,-1,1,down,1981-09-12
17978,Four Tops,1982-01-23,Four Tops - Tonight,48,47,49,5.0,49,Tonight,20.0,19,0,-1,-1,0,stay,1981-09-12
17979,Four Tops,1982-01-30,Four Tops - Tonight,49,48,51,5.0,49,Tonight,20.0,20,-2,0,-1,1,down,1981-09-12
17980,Ebonee Webb,1981-09-12,Ebonee Webb - Ebonee Webb,51,51,42,21.0,50,Ebonee Webb,10.0,0,8,1,0,1,up,1981-09-12
17981,Ebonee Webb,1981-09-19,Ebonee Webb - Ebonee Webb,50,51,39,21.0,42,Ebonee Webb,10.0,1,3,8,1,1,up,1981-09-12
17982,Ebonee Webb,1981-09-26,Ebonee Webb - Ebonee Webb,42,50,34,21.0,39,Ebonee Webb,10.0,2,5,3,8,1,up,1981-09-12
17983,Ebonee Webb,1981-10-03,Ebonee Webb - Ebonee Webb,39,42,31,21.0,34,Ebonee Webb,10.0,3,3,5,3,1,up,1981-09-12
17984,Ebonee Webb,1981-10-10,Ebonee Webb - Ebonee Webb,34,39,27,21.0,31,Ebonee Webb,10.0,4,4,3,5,1,up,1981-09-12
17985,Ebonee Webb,1981-10-17,Ebonee Webb - Ebonee Webb,31,34,24,21.0,27,Ebonee Webb,10.0,5,3,4,3,1,up,1981-09-12
17986,Ebonee Webb,1981-10-24,Ebonee Webb - Ebonee Webb,27,31,21,21.0,24,Ebonee Webb,10.0,6,3,3,4,1,up,1981-09-12
17987,Ebonee Webb,1981-10-31,Ebonee Webb - Ebonee Webb,24,27,21,21.0,21,Ebonee Webb,10.0,7,0,3,3,0,stay,1981-09-12
17988,Ebonee Webb,1981-11-07,Ebonee Webb - Ebonee Webb,21,24,34,21.0,21,Ebonee Webb,10.0,8,-13,0,3,1,down,1981-09-12
17989,Ebonee Webb,1981-11-14,Ebonee Webb - Ebonee Webb,21,21,35,21.0,34,Ebonee Webb,10.0,9,-1,-13,0,1,down,1981-09-12
17990,Ebonee Webb,1981-11-21,Ebonee Webb - Ebonee Webb,34,21,51,21.0,35,Ebonee Webb,10.0,10,-16,-1,-13,1,down,1981-09-12
17991,Luther Vandross,1981-09-19,Luther Vandross - Never Too Much,51,51,25,1.0,40,Never Too Much,41.0,0,15,11,0,1,up,1981-09-19
17992,Luther Vandross,1981-09-26,Luther Vandross - Never Too Much,40,51,19,1.0,25,Never Too Much,41.0,1,6,15,11,1,up,1981-09-19
17993,Luther Vandross,1981-10-03,Luther Vandross - Never Too Much,25,40,9,1.0,19,Never Too Much,41.0,2,10,6,15,1,up,1981-09-19
17994,Luther Vandross,1981-10-10,Luther Vandross - Never Too Much,19,25,5,1.0,9,Never Too Much,41.0,3,4,10,6,1,up,1981-09-19
17995,Luther Vandross,1981-10-17,Luther Vandross - Never Too Much,9,19,3,1.0,5,Never Too Much,41.0,4,2,4,10,1,up,1981-09-19
17996,Luther Vandross,1981-10-24,Luther Vandross - Never Too Much,5,9,3,1.0,3,Never Too Much,41.0,5,0,2,4,0,stay,1981-09-19
17997,Luther Vandross,1981-10-31,Luther Vandross - Never Too Much,3,5,2,1.0,3,Never Too Much,41.0,6,1,0,2,1,up,1981-09-19
17998,Luther Vandross,1981-11-07,Luther Vandross - Never Too Much,3,3,1,1.0,2,Never Too Much,41.0,7,1,1,0,1,up,1981-09-19
17999,Luther Vandross,1981-11-14,Luther Vandross - Never Too Much,2,3,2,1.0,1,Never Too Much,41.0,8,-1,1,1,1,down,1981-09-19
18000,Luther Vandross,1981-11-21,Luther Vandross - Never Too Much,1,2,4,1.0,2,Never Too Much,41.0,9,-2,-1,1,1,down,1981-09-19
18001,Luther Vandross,1981-11-28,Luther Vandross - Never Too Much,2,1,4,1.0,4,Never Too Much,41.0,10,0,-2,-1,0,stay,1981-09-19
18002,Luther Vandross,1981-12-05,Luther Vandross - Never Too Much,4,2,4,1.0,4,Never Too Much,41.0,11,0,0,-2,0,stay,1981-09-19
18003,Luther Vandross,1981-12-12,Luther Vandross - Never Too Much,4,4,4,1.0,4,Never Too Much,41.0,12,0,0,0,0,stay,1981-09-19
18004,Luther Vandross,1981-12-19,Luther Vandross - Never Too Much,4,4,4,1.0,4,Never Too Much,41.0,13,0,0,0,0,stay,1981-09-19
18005,Luther Vandross,1981-12-26,Luther Vandross - Never Too Much,4,4,4,1.0,4,Never Too Much,41.0,14,0,0,0,0,stay,1981-09-19
18006,Luther Vandross,1982-01-02,Luther Vandross - Never Too Much,4,4,4,1.0,4,Never Too Much,41.0,15,0,0,0,0,stay,1981-09-19
18007,Luther Vandross,1982-01-09,Luther Vandross - Never Too Much,4,4,3,1.0,4,Never Too Much,41.0,16,1,0,0,1,up,1981-09-19
18008,Luther Vandross,1982-01-16,Luther Vandross - Never Too Much,4,4,3,1.0,3,Never Too Much,41.0,17,0,1,0,0,stay,1981-09-19
18009,Luther Vandross,1982-01-23,Luther Vandross - Never Too Much,3,4,3,1.0,3,Never Too Much,41.0,18,0,0,1,0,stay,1981-09-19
18010,Luther Vandross,1982-01-30,Luther Vandross - Never Too Much,3,3,4,1.0,3,Never Too Much,41.0,19,-1,0,0,1,down,1981-09-19
18011,Luther Vandross,1982-02-06,Luther Vandross - Never Too Much,3,3,5,1.0,4,Never Too Much,41.0,20,-1,-1,0,1,down,1981-09-19
18012,Luther Vandross,1982-02-13,Luther Vandross - Never Too Much,4,3,5,1.0,5,Never Too Much,41.0,21,0,-1,-1,0,stay,1981-09-19
18013,Luther Vandross,1982-02-20,Luther Vandross - Never Too Much,5,4,5,1.0,5,Never Too Much,41.0,22,0,0,-1,0,stay,1981-09-19
18014,Luther Vandross,1982-02-27,Luther Vandross - Never Too Much,5,5,5,1.0,5,Never Too Much,41.0,23,0,0,0,0,stay,1981-09-19
18015,Luther Vandross,1982-03-06,Luther Vandross - Never Too Much,5,5,9,1.0,5,Never Too Much,41.0,24,-4,0,0,1,down,1981-09-19
18016,Luther Vandross,1982-03-13,Luther Vandross - Never Too Much,5,5,10,1.0,9,Never Too Much,41.0,25,-1,-4,0,1,down,1981-09-19
18017,Luther Vandross,1982-03-20,Luther Vandross - Never Too Much,9,5,10,1.0,10,Never Too Much,41.0,26,0,-1,-4,0,stay,1981-09-19
18018,Luther Vandross,1982-03-27,Luther Vandross - Never Too Much,10,9,13,1.0,10,Never Too Much,41.0,27,-3,0,-1,1,down,1981-09-19
18019,Luther Vandross,1982-04-03,Luther Vandross - Never Too Much,10,10,14,1.0,13,Never Too Much,41.0,28,-1,-3,0,1,down,1981-09-19
18020,Luther Vandross,1982-04-10,Luther Vandross - Never Too Much,13,10,15,1.0,14,Never Too Much,41.0,29,-1,-1,-3,1,down,1981-09-19
18021,Luther Vandross,1982-04-17,Luther Vandross - Never Too Much,14,13,29,1.0,15,Never Too Much,41.0,30,-14,-1,-1,1,down,1981-09-19
18022,Luther Vandross,1982-04-24,Luther Vandross - Never Too Much,15,14,29,1.0,29,Never Too Much,41.0,31,0,-14,-1,0,stay,1981-09-19
18023,Luther Vandross,1982-05-01,Luther Vandross - Never Too Much,29,15,36,1.0,29,Never Too Much,41.0,32,-7,0,-14,1,down,1981-09-19
18024,Luther Vandross,1982-05-08,Luther Vandross - Never Too Much,29,29,39,1.0,36,Never Too Much,41.0,33,-3,-7,0,1,down,1981-09-19
18025,Luther Vandross,1982-05-15,Luther Vandross - Never Too Much,36,29,39,1.0,39,Never Too Much,41.0,34,0,-3,-7,0,stay,1981-09-19
18026,Luther Vandross,1982-05-22,Luther Vandross - Never Too Much,39,36,40,1.0,39,Never Too Much,41.0,35,-1,0,-3,1,down,1981-09-19
18027,Luther Vandross,1982-05-29,Luther Vandross - Never Too Much,39,39,47,1.0,40,Never Too Much,41.0,36,-7,-1,0,1,down,1981-09-19
18028,Luther Vandross,1982-06-05,Luther Vandross - Never Too Much,40,39,47,1.0,47,Never Too Much,41.0,37,0,-7,-1,0,stay,1981-09-19
18029,Luther Vandross,1982-06-12,Luther Vandross - Never Too Much,47,40,48,1.0,47,Never Too Much,41.0,38,-1,0,-7,1,down,1981-09-19
18030,Luther Vandross,1982-10-30,Luther Vandross - Never Too Much,47,47,47,1.0,48,Never Too Much,41.0,39,1,-1,0,1,up,1981-09-19
18031,Luther Vandross,1982-11-06,Luther Vandross - Never Too Much,48,47,46,1.0,47,Never Too Much,41.0,40,1,1,-1,1,up,1981-09-19
18032,Luther Vandross,1982-11-13,Luther Vandross - Never Too Much,47,48,51,1.0,46,Never Too Much,41.0,41,-5,1,1,1,down,1981-09-19
18033,The Stylistics,1981-09-19,The Stylistics - Closer Than Close,51,51,44,44.0,50,Closer Than Close,2.0,0,6,1,0,1,up,1981-09-19
18034,The Stylistics,1981-09-26,The Stylistics - Closer Than Close,50,51,44,44.0,44,Closer Than Close,2.0,1,0,6,1,0,stay,1981-09-19
18035,The Stylistics,1981-10-03,The Stylistics - Closer Than Close,44,50,51,44.0,44,Closer Than Close,2.0,2,-7,0,6,1,down,1981-09-19
18036,Michael Henderson,1981-09-26,Michael Henderson - Slingshot,51,51,25,14.0,35,Slingshot,11.0,0,10,16,0,1,up,1981-09-26
18037,Michael Henderson,1981-10-03,Michael Henderson - Slingshot,35,51,19,14.0,25,Slingshot,11.0,1,6,10,16,1,up,1981-09-26
18038,Michael Henderson,1981-10-10,Michael Henderson - Slingshot,25,35,17,14.0,19,Slingshot,11.0,2,2,6,10,1,up,1981-09-26
18039,Michael Henderson,1981-10-17,Michael Henderson - Slingshot,19,25,14,14.0,17,Slingshot,11.0,3,3,2,6,1,up,1981-09-26
18040,Michael Henderson,1981-10-24,Michael Henderson - Slingshot,17,19,14,14.0,14,Slingshot,11.0,4,0,3,2,0,stay,1981-09-26
18041,Michael Henderson,1981-10-31,Michael Henderson - Slingshot,14,17,23,14.0,14,Slingshot,11.0,5,-9,0,3,1,down,1981-09-26
18042,Michael Henderson,1981-11-07,Michael Henderson - Slingshot,14,14,25,14.0,23,Slingshot,11.0,6,-2,-9,0,1,down,1981-09-26
18043,Michael Henderson,1981-11-14,Michael Henderson - Slingshot,23,14,28,14.0,25,Slingshot,11.0,7,-3,-2,-9,1,down,1981-09-26
18044,Michael Henderson,1981-11-21,Michael Henderson - Slingshot,25,23,42,14.0,28,Slingshot,11.0,8,-14,-3,-2,1,down,1981-09-26
18045,Michael Henderson,1981-11-28,Michael Henderson - Slingshot,28,25,39,14.0,42,Slingshot,11.0,9,3,-14,-3,1,up,1981-09-26
18046,Michael Henderson,1981-12-05,Michael Henderson - Slingshot,42,28,43,14.0,39,Slingshot,11.0,10,-4,3,-14,1,down,1981-09-26
18047,Michael Henderson,1981-12-12,Michael Henderson - Slingshot,39,42,51,14.0,43,Slingshot,11.0,11,-8,-4,3,1,down,1981-09-26
18048,Donald Byrd And The 125th Street N.Y.C.,1981-09-26,Donald Byrd And The 125th Street N.Y.C. - Love Byrd,51,51,32,15.0,42,Love Byrd,14.0,0,10,9,0,1,up,1981-09-26
18049,Donald Byrd And The 125th Street N.Y.C.,1981-10-03,Donald Byrd And The 125th Street N.Y.C. - Love Byrd,42,51,24,15.0,32,Love Byrd,14.0,1,8,10,9,1,up,1981-09-26
18050,Donald Byrd And The 125th Street N.Y.C.,1981-10-10,Donald Byrd And The 125th Street N.Y.C. - Love Byrd,32,42,20,15.0,24,Love Byrd,14.0,2,4,8,10,1,up,1981-09-26
18051,Donald Byrd And The 125th Street N.Y.C.,1981-10-17,Donald Byrd And The 125th Street N.Y.C. - Love Byrd,24,32,18,15.0,20,Love Byrd,14.0,3,2,4,8,1,up,1981-09-26
18052,Donald Byrd And The 125th Street N.Y.C.,1981-10-24,Donald Byrd And The 125th Street N.Y.C. - Love Byrd,20,24,18,15.0,18,Love Byrd,14.0,4,0,2,4,0,stay,1981-09-26
18053,Donald Byrd And The 125th Street N.Y.C.,1981-10-31,Donald Byrd And The 125th Street N.Y.C. - Love Byrd,18,20,15,15.0,18,Love Byrd,14.0,5,3,0,2,1,up,1981-09-26
18054,Donald Byrd And The 125th Street N.Y.C.,1981-11-07,Donald Byrd And The 125th Street N.Y.C. - Love Byrd,18,18,15,15.0,15,Love Byrd,14.0,6,0,3,0,0,stay,1981-09-26
18055,Donald Byrd And The 125th Street N.Y.C.,1981-11-14,Donald Byrd And The 125th Street N.Y.C. - Love Byrd,15,18,25,15.0,15,Love Byrd,14.0,7,-10,0,3,1,down,1981-09-26
18056,Donald Byrd And The 125th Street N.Y.C.,1981-11-21,Donald Byrd And The 125th Street N.Y.C. - Love Byrd,15,15,27,15.0,25,Love Byrd,14.0,8,-2,-10,0,1,down,1981-09-26
18057,Donald Byrd And The 125th Street N.Y.C.,1981-11-28,Donald Byrd And The 125th Street N.Y.C. - Love Byrd,25,15,28,15.0,27,Love Byrd,14.0,9,-1,-2,-10,1,down,1981-09-26
18058,Donald Byrd And The 125th Street N.Y.C.,1981-12-05,Donald Byrd And The 125th Street N.Y.C. - Love Byrd,27,25,33,15.0,28,Love Byrd,14.0,10,-5,-1,-2,1,down,1981-09-26
18059,Donald Byrd And The 125th Street N.Y.C.,1981-12-12,Donald Byrd And The 125th Street N.Y.C. - Love Byrd,28,27,36,15.0,33,Love Byrd,14.0,11,-3,-5,-1,1,down,1981-09-26
18060,Donald Byrd And The 125th Street N.Y.C.,1981-12-19,Donald Byrd And The 125th Street N.Y.C. - Love Byrd,33,28,43,15.0,36,Love Byrd,14.0,12,-7,-3,-5,1,down,1981-09-26
18061,Donald Byrd And The 125th Street N.Y.C.,1981-12-26,Donald Byrd And The 125th Street N.Y.C. - Love Byrd,36,33,43,15.0,43,Love Byrd,14.0,13,0,-7,-3,0,stay,1981-09-26
18062,Donald Byrd And The 125th Street N.Y.C.,1982-01-02,Donald Byrd And The 125th Street N.Y.C. - Love Byrd,43,36,51,15.0,43,Love Byrd,14.0,14,-8,0,-7,1,down,1981-09-26
18063,The Whispers,1981-09-26,The Whispers - This Kind Of Lovin',51,51,33,15.0,45,This Kind Of Lovin',11.0,0,12,6,0,1,up,1981-09-26
18064,The Whispers,1981-10-03,The Whispers - This Kind Of Lovin',45,51,26,15.0,33,This Kind Of Lovin',11.0,1,7,12,6,1,up,1981-09-26
18065,The Whispers,1981-10-10,The Whispers - This Kind Of Lovin',33,45,18,15.0,26,This Kind Of Lovin',11.0,2,8,7,12,1,up,1981-09-26
18066,The Whispers,1981-10-17,The Whispers - This Kind Of Lovin',26,33,16,15.0,18,This Kind Of Lovin',11.0,3,2,8,7,1,up,1981-09-26
18067,The Whispers,1981-10-24,The Whispers - This Kind Of Lovin',18,26,15,15.0,16,This Kind Of Lovin',11.0,4,1,2,8,1,up,1981-09-26
18068,The Whispers,1981-10-31,The Whispers - This Kind Of Lovin',16,18,22,15.0,15,This Kind Of Lovin',11.0,5,-7,1,2,1,down,1981-09-26
18069,The Whispers,1981-11-07,The Whispers - This Kind Of Lovin',15,16,21,15.0,22,This Kind Of Lovin',11.0,6,1,-7,1,1,up,1981-09-26
18070,The Whispers,1981-11-14,The Whispers - This Kind Of Lovin',22,15,26,15.0,21,This Kind Of Lovin',11.0,7,-5,1,-7,1,down,1981-09-26
18071,The Whispers,1981-11-21,The Whispers - This Kind Of Lovin',21,22,28,15.0,26,This Kind Of Lovin',11.0,8,-2,-5,1,1,down,1981-09-26
18072,The Whispers,1981-11-28,The Whispers - This Kind Of Lovin',26,21,37,15.0,28,This Kind Of Lovin',11.0,9,-9,-2,-5,1,down,1981-09-26
18073,The Whispers,1981-12-05,The Whispers - This Kind Of Lovin',28,26,37,15.0,37,This Kind Of Lovin',11.0,10,0,-9,-2,0,stay,1981-09-26
18074,The Whispers,1981-12-12,The Whispers - This Kind Of Lovin',37,28,51,15.0,37,This Kind Of Lovin',11.0,11,-14,0,-9,1,down,1981-09-26
18075,Dynasty,1981-09-26,Dynasty - The Second Adventure,51,51,43,42.0,48,The Second Adventure,2.0,0,5,3,0,1,up,1981-09-26
18076,Dynasty,1981-10-03,Dynasty - The Second Adventure,48,51,42,42.0,43,The Second Adventure,2.0,1,1,5,3,1,up,1981-09-26
18077,Dynasty,1981-10-10,Dynasty - The Second Adventure,43,48,51,42.0,42,The Second Adventure,2.0,2,-9,1,5,1,down,1981-09-26
18078,Natalie Cole,1981-09-26,Natalie Cole - Happy Love,51,51,42,37.0,49,Happy Love,5.0,0,7,2,0,1,up,1981-09-26
18079,Natalie Cole,1981-10-03,Natalie Cole - Happy Love,49,51,38,37.0,42,Happy Love,5.0,1,4,7,2,1,up,1981-09-26
18080,Natalie Cole,1981-10-10,Natalie Cole - Happy Love,42,49,38,37.0,38,Happy Love,5.0,2,0,4,7,0,stay,1981-09-26
18081,Natalie Cole,1981-10-17,Natalie Cole - Happy Love,38,42,37,37.0,38,Happy Love,5.0,3,1,0,4,1,up,1981-09-26
18082,Natalie Cole,1981-10-24,Natalie Cole - Happy Love,38,38,50,37.0,37,Happy Love,5.0,4,-13,1,0,1,down,1981-09-26
18083,Natalie Cole,1981-11-07,Natalie Cole - Happy Love,37,38,51,37.0,50,Happy Love,5.0,5,-1,-13,1,1,down,1981-09-26
18084,Bobby Broom,1981-09-26,Bobby Broom - Clean Sweep,51,51,51,50.0,50,Clean Sweep,0.0,0,-1,1,0,1,down,1981-09-26
18085,Roger,1981-10-03,Roger - The Many Facets Of Roger,51,51,20,1.0,35,The Many Facets Of Roger,27.0,0,15,16,0,1,up,1981-10-03
18086,Roger,1981-10-10,Roger - The Many Facets Of Roger,35,51,12,1.0,20,The Many Facets Of Roger,27.0,1,8,15,16,1,up,1981-10-03
18087,Roger,1981-10-17,Roger - The Many Facets Of Roger,20,35,8,1.0,12,The Many Facets Of Roger,27.0,2,4,8,15,1,up,1981-10-03
18088,Roger,1981-10-24,Roger - The Many Facets Of Roger,12,20,4,1.0,8,The Many Facets Of Roger,27.0,3,4,4,8,1,up,1981-10-03
18089,Roger,1981-10-31,Roger - The Many Facets Of Roger,8,12,1,1.0,4,The Many Facets Of Roger,27.0,4,3,4,4,1,up,1981-10-03
18090,Roger,1981-11-07,Roger - The Many Facets Of Roger,4,8,2,1.0,1,The Many Facets Of Roger,27.0,5,-1,3,4,1,down,1981-10-03
18091,Roger,1981-11-14,Roger - The Many Facets Of Roger,1,4,4,1.0,2,The Many Facets Of Roger,27.0,6,-2,-1,3,1,down,1981-10-03
18092,Roger,1981-11-21,Roger - The Many Facets Of Roger,2,1,5,1.0,4,The Many Facets Of Roger,27.0,7,-1,-2,-1,1,down,1981-10-03
18093,Roger,1981-11-28,Roger - The Many Facets Of Roger,4,2,5,1.0,5,The Many Facets Of Roger,27.0,8,0,-1,-2,0,stay,1981-10-03
18094,Roger,1981-12-05,Roger - The Many Facets Of Roger,5,4,5,1.0,5,The Many Facets Of Roger,27.0,9,0,0,-1,0,stay,1981-10-03
18095,Roger,1981-12-12,Roger - The Many Facets Of Roger,5,5,5,1.0,5,The Many Facets Of Roger,27.0,10,0,0,0,0,stay,1981-10-03
18096,Roger,1981-12-19,Roger - The Many Facets Of Roger,5,5,5,1.0,5,The Many Facets Of Roger,27.0,11,0,0,0,0,stay,1981-10-03
18097,Roger,1981-12-26,Roger - The Many Facets Of Roger,5,5,5,1.0,5,The Many Facets Of Roger,27.0,12,0,0,0,0,stay,1981-10-03
18098,Roger,1982-01-02,Roger - The Many Facets Of Roger,5,5,6,1.0,5,The Many Facets Of Roger,27.0,13,-1,0,0,1,down,1981-10-03
18099,Roger,1982-01-09,Roger - The Many Facets Of Roger,5,5,15,1.0,6,The Many Facets Of Roger,27.0,14,-9,-1,0,1,down,1981-10-03
18100,Roger,1982-01-16,Roger - The Many Facets Of Roger,6,5,15,1.0,15,The Many Facets Of Roger,27.0,15,0,-9,-1,0,stay,1981-10-03
18101,Roger,1982-01-23,Roger - The Many Facets Of Roger,15,6,17,1.0,15,The Many Facets Of Roger,27.0,16,-2,0,-9,1,down,1981-10-03
18102,Roger,1982-01-30,Roger - The Many Facets Of Roger,15,15,26,1.0,17,The Many Facets Of Roger,27.0,17,-9,-2,0,1,down,1981-10-03
18103,Roger,1982-02-06,Roger - The Many Facets Of Roger,17,15,24,1.0,26,The Many Facets Of Roger,27.0,18,2,-9,-2,1,up,1981-10-03
18104,Roger,1982-02-13,Roger - The Many Facets Of Roger,26,17,27,1.0,24,The Many Facets Of Roger,27.0,19,-3,2,-9,1,down,1981-10-03
18105,Roger,1982-02-20,Roger - The Many Facets Of Roger,24,26,27,1.0,27,The Many Facets Of Roger,27.0,20,0,-3,2,0,stay,1981-10-03
18106,Roger,1982-02-27,Roger - The Many Facets Of Roger,27,24,26,1.0,27,The Many Facets Of Roger,27.0,21,1,0,-3,1,up,1981-10-03
18107,Roger,1982-03-06,Roger - The Many Facets Of Roger,27,27,26,1.0,26,The Many Facets Of Roger,27.0,22,0,1,0,0,stay,1981-10-03
18108,Roger,1982-03-13,Roger - The Many Facets Of Roger,26,27,27,1.0,26,The Many Facets Of Roger,27.0,23,-1,0,1,1,down,1981-10-03
18109,Roger,1982-03-20,Roger - The Many Facets Of Roger,26,26,29,1.0,27,The Many Facets Of Roger,27.0,24,-2,-1,0,1,down,1981-10-03
18110,Roger,1982-03-27,Roger - The Many Facets Of Roger,27,26,39,1.0,29,The Many Facets Of Roger,27.0,25,-10,-2,-1,1,down,1981-10-03
18111,Roger,1982-04-03,Roger - The Many Facets Of Roger,29,27,40,1.0,39,The Many Facets Of Roger,27.0,26,-1,-10,-2,1,down,1981-10-03
18112,Roger,1982-04-10,Roger - The Many Facets Of Roger,39,29,51,1.0,40,The Many Facets Of Roger,27.0,27,-11,-1,-10,1,down,1981-10-03
18113,Teddy Pendergrass,1981-10-03,Teddy Pendergrass - It's Time For Love,51,51,17,6.0,37,It's Time For Love,31.0,0,20,14,0,1,up,1981-10-03
18114,Teddy Pendergrass,1981-10-10,Teddy Pendergrass - It's Time For Love,37,51,7,6.0,17,It's Time For Love,31.0,1,10,20,14,1,up,1981-10-03
18115,Teddy Pendergrass,1981-10-17,Teddy Pendergrass - It's Time For Love,17,37,6,6.0,7,It's Time For Love,31.0,2,1,10,20,1,up,1981-10-03
18116,Teddy Pendergrass,1981-10-24,Teddy Pendergrass - It's Time For Love,7,17,6,6.0,6,It's Time For Love,31.0,3,0,1,10,0,stay,1981-10-03
18117,Teddy Pendergrass,1981-10-31,Teddy Pendergrass - It's Time For Love,6,7,6,6.0,6,It's Time For Love,31.0,4,0,0,1,0,stay,1981-10-03
18118,Teddy Pendergrass,1981-11-07,Teddy Pendergrass - It's Time For Love,6,6,6,6.0,6,It's Time For Love,31.0,5,0,0,0,0,stay,1981-10-03
18119,Teddy Pendergrass,1981-11-14,Teddy Pendergrass - It's Time For Love,6,6,6,6.0,6,It's Time For Love,31.0,6,0,0,0,0,stay,1981-10-03
18120,Teddy Pendergrass,1981-11-21,Teddy Pendergrass - It's Time For Love,6,6,6,6.0,6,It's Time For Love,31.0,7,0,0,0,0,stay,1981-10-03
18121,Teddy Pendergrass,1981-11-28,Teddy Pendergrass - It's Time For Love,6,6,6,6.0,6,It's Time For Love,31.0,8,0,0,0,0,stay,1981-10-03
18122,Teddy Pendergrass,1981-12-05,Teddy Pendergrass - It's Time For Love,6,6,6,6.0,6,It's Time For Love,31.0,9,0,0,0,0,stay,1981-10-03
18123,Teddy Pendergrass,1981-12-12,Teddy Pendergrass - It's Time For Love,6,6,6,6.0,6,It's Time For Love,31.0,10,0,0,0,0,stay,1981-10-03
18124,Teddy Pendergrass,1981-12-19,Teddy Pendergrass - It's Time For Love,6,6,10,6.0,6,It's Time For Love,31.0,11,-4,0,0,1,down,1981-10-03
18125,Teddy Pendergrass,1981-12-26,Teddy Pendergrass - It's Time For Love,6,6,10,6.0,10,It's Time For Love,31.0,12,0,-4,0,0,stay,1981-10-03
18126,Teddy Pendergrass,1982-01-02,Teddy Pendergrass - It's Time For Love,10,6,9,6.0,10,It's Time For Love,31.0,13,1,0,-4,1,up,1981-10-03
18127,Teddy Pendergrass,1982-01-09,Teddy Pendergrass - It's Time For Love,10,10,9,6.0,9,It's Time For Love,31.0,14,0,1,0,0,stay,1981-10-03
18128,Teddy Pendergrass,1982-01-16,Teddy Pendergrass - It's Time For Love,9,10,9,6.0,9,It's Time For Love,31.0,15,0,0,1,0,stay,1981-10-03
18129,Teddy Pendergrass,1982-01-23,Teddy Pendergrass - It's Time For Love,9,9,8,6.0,9,It's Time For Love,31.0,16,1,0,0,1,up,1981-10-03
18130,Teddy Pendergrass,1982-01-30,Teddy Pendergrass - It's Time For Love,9,9,8,6.0,8,It's Time For Love,31.0,17,0,1,0,0,stay,1981-10-03
18131,Teddy Pendergrass,1982-02-06,Teddy Pendergrass - It's Time For Love,8,9,13,6.0,8,It's Time For Love,31.0,18,-5,0,1,1,down,1981-10-03
18132,Teddy Pendergrass,1982-02-13,Teddy Pendergrass - It's Time For Love,8,8,13,6.0,13,It's Time For Love,31.0,19,0,-5,0,0,stay,1981-10-03
18133,Teddy Pendergrass,1982-02-20,Teddy Pendergrass - It's Time For Love,13,8,21,6.0,13,It's Time For Love,31.0,20,-8,0,-5,1,down,1981-10-03
18134,Teddy Pendergrass,1982-02-27,Teddy Pendergrass - It's Time For Love,13,13,21,6.0,21,It's Time For Love,31.0,21,0,-8,0,0,stay,1981-10-03
18135,Teddy Pendergrass,1982-03-06,Teddy Pendergrass - It's Time For Love,21,13,24,6.0,21,It's Time For Love,31.0,22,-3,0,-8,1,down,1981-10-03
18136,Teddy Pendergrass,1982-03-13,Teddy Pendergrass - It's Time For Love,21,21,24,6.0,24,It's Time For Love,31.0,23,0,-3,0,0,stay,1981-10-03
18137,Teddy Pendergrass,1982-03-20,Teddy Pendergrass - It's Time For Love,24,21,26,6.0,24,It's Time For Love,31.0,24,-2,0,-3,1,down,1981-10-03
18138,Teddy Pendergrass,1982-03-27,Teddy Pendergrass - It's Time For Love,24,24,26,6.0,26,It's Time For Love,31.0,25,0,-2,0,0,stay,1981-10-03
18139,Teddy Pendergrass,1982-04-03,Teddy Pendergrass - It's Time For Love,26,24,29,6.0,26,It's Time For Love,31.0,26,-3,0,-2,1,down,1981-10-03
18140,Teddy Pendergrass,1982-04-10,Teddy Pendergrass - It's Time For Love,26,26,36,6.0,29,It's Time For Love,31.0,27,-7,-3,0,1,down,1981-10-03
18141,Teddy Pendergrass,1982-04-17,Teddy Pendergrass - It's Time For Love,29,26,34,6.0,36,It's Time For Love,31.0,28,2,-7,-3,1,up,1981-10-03
18142,Teddy Pendergrass,1982-04-24,Teddy Pendergrass - It's Time For Love,36,29,38,6.0,34,It's Time For Love,31.0,29,-4,2,-7,1,down,1981-10-03
18143,Teddy Pendergrass,1982-05-01,Teddy Pendergrass - It's Time For Love,34,36,47,6.0,38,It's Time For Love,31.0,30,-9,-4,2,1,down,1981-10-03
18144,Teddy Pendergrass,1982-05-08,Teddy Pendergrass - It's Time For Love,38,34,51,6.0,47,It's Time For Love,31.0,31,-4,-9,-4,1,down,1981-10-03
18145,Bob James,1981-10-03,Bob James - Sign Of The Times,51,51,32,27.0,40,Sign Of The Times,7.0,0,8,11,0,1,up,1981-10-03
18146,Bob James,1981-10-10,Bob James - Sign Of The Times,40,51,28,27.0,32,Sign Of The Times,7.0,1,4,8,11,1,up,1981-10-03
18147,Bob James,1981-10-17,Bob James - Sign Of The Times,32,40,28,27.0,28,Sign Of The Times,7.0,2,0,4,8,0,stay,1981-10-03
18148,Bob James,1981-10-24,Bob James - Sign Of The Times,28,32,27,27.0,28,Sign Of The Times,7.0,3,1,0,4,1,up,1981-10-03
18149,Bob James,1981-10-31,Bob James - Sign Of The Times,28,28,36,27.0,27,Sign Of The Times,7.0,4,-9,1,0,1,down,1981-10-03
18150,Bob James,1981-11-07,Bob James - Sign Of The Times,27,28,37,27.0,36,Sign Of The Times,7.0,5,-1,-9,1,1,down,1981-10-03
18151,Bob James,1981-11-14,Bob James - Sign Of The Times,36,27,50,27.0,37,Sign Of The Times,7.0,6,-13,-1,-9,1,down,1981-10-03
18152,Bob James,1981-11-21,Bob James - Sign Of The Times,37,36,51,27.0,50,Sign Of The Times,7.0,7,-1,-13,-1,1,down,1981-10-03
18153,Spyro Gyra,1981-10-03,Spyro Gyra - Freetime,51,51,37,29.0,41,Freetime,6.0,0,4,10,0,1,up,1981-10-03
18154,Spyro Gyra,1981-10-10,Spyro Gyra - Freetime,41,51,33,29.0,37,Freetime,6.0,1,4,4,10,1,up,1981-10-03
18155,Spyro Gyra,1981-10-17,Spyro Gyra - Freetime,37,41,29,29.0,33,Freetime,6.0,2,4,4,4,1,up,1981-10-03
18156,Spyro Gyra,1981-10-24,Spyro Gyra - Freetime,33,37,29,29.0,29,Freetime,6.0,3,0,4,4,0,stay,1981-10-03
18157,Spyro Gyra,1981-10-31,Spyro Gyra - Freetime,29,33,30,29.0,29,Freetime,6.0,4,-1,0,4,1,down,1981-10-03
18158,Spyro Gyra,1981-11-07,Spyro Gyra - Freetime,29,29,46,29.0,30,Freetime,6.0,5,-16,-1,0,1,down,1981-10-03
18159,Spyro Gyra,1981-11-14,Spyro Gyra - Freetime,30,29,51,29.0,46,Freetime,6.0,6,-5,-16,-1,1,down,1981-10-03
18160,One Way,1981-10-03,One Way - Fancy Dancer,51,51,35,11.0,45,Fancy Dancer,14.0,0,10,6,0,1,up,1981-10-03
18161,One Way,1981-10-10,One Way - Fancy Dancer,45,51,24,11.0,35,Fancy Dancer,14.0,1,11,10,6,1,up,1981-10-03
18162,One Way,1981-10-17,One Way - Fancy Dancer,35,45,20,11.0,24,Fancy Dancer,14.0,2,4,11,10,1,up,1981-10-03
18163,One Way,1981-10-24,One Way - Fancy Dancer,24,35,16,11.0,20,Fancy Dancer,14.0,3,4,4,11,1,up,1981-10-03
18164,One Way,1981-10-31,One Way - Fancy Dancer,20,24,14,11.0,16,Fancy Dancer,14.0,4,2,4,4,1,up,1981-10-03
18165,One Way,1981-11-07,One Way - Fancy Dancer,16,20,12,11.0,14,Fancy Dancer,14.0,5,2,2,4,1,up,1981-10-03
18166,One Way,1981-11-14,One Way - Fancy Dancer,14,16,11,11.0,12,Fancy Dancer,14.0,6,1,2,2,1,up,1981-10-03
18167,One Way,1981-11-21,One Way - Fancy Dancer,12,14,11,11.0,11,Fancy Dancer,14.0,7,0,1,2,0,stay,1981-10-03
18168,One Way,1981-11-28,One Way - Fancy Dancer,11,12,11,11.0,11,Fancy Dancer,14.0,8,0,0,1,0,stay,1981-10-03
18169,One Way,1981-12-05,One Way - Fancy Dancer,11,11,27,11.0,11,Fancy Dancer,14.0,9,-16,0,0,1,down,1981-10-03
18170,One Way,1981-12-12,One Way - Fancy Dancer,11,11,28,11.0,27,Fancy Dancer,14.0,10,-1,-16,0,1,down,1981-10-03
18171,One Way,1981-12-19,One Way - Fancy Dancer,27,11,28,11.0,28,Fancy Dancer,14.0,11,0,-1,-16,0,stay,1981-10-03
18172,One Way,1981-12-26,One Way - Fancy Dancer,28,27,28,11.0,28,Fancy Dancer,14.0,12,0,0,-1,0,stay,1981-10-03
18173,One Way,1982-01-02,One Way - Fancy Dancer,28,28,40,11.0,28,Fancy Dancer,14.0,13,-12,0,0,1,down,1981-10-03
18174,One Way,1982-01-09,One Way - Fancy Dancer,28,28,51,11.0,40,Fancy Dancer,14.0,14,-11,-12,0,1,down,1981-10-03
18175,Jermaine Jackson,1981-10-03,Jermaine Jackson - I Like Your Style,51,51,40,31.0,47,I Like Your Style,9.0,0,7,4,0,1,up,1981-10-03
18176,Jermaine Jackson,1981-10-10,Jermaine Jackson - I Like Your Style,47,51,35,31.0,40,I Like Your Style,9.0,1,5,7,4,1,up,1981-10-03
18177,Jermaine Jackson,1981-10-17,Jermaine Jackson - I Like Your Style,40,47,31,31.0,35,I Like Your Style,9.0,2,4,5,7,1,up,1981-10-03
18178,Jermaine Jackson,1981-10-24,Jermaine Jackson - I Like Your Style,35,40,31,31.0,31,I Like Your Style,9.0,3,0,4,5,0,stay,1981-10-03
18179,Jermaine Jackson,1981-10-31,Jermaine Jackson - I Like Your Style,31,35,41,31.0,31,I Like Your Style,9.0,4,-10,0,4,1,down,1981-10-03
18180,Jermaine Jackson,1981-11-07,Jermaine Jackson - I Like Your Style,31,31,41,31.0,41,I Like Your Style,9.0,5,0,-10,0,0,stay,1981-10-03
18181,Jermaine Jackson,1981-11-14,Jermaine Jackson - I Like Your Style,41,31,39,31.0,41,I Like Your Style,9.0,6,2,0,-10,1,up,1981-10-03
18182,Jermaine Jackson,1981-11-21,Jermaine Jackson - I Like Your Style,41,41,45,31.0,39,I Like Your Style,9.0,7,-6,2,0,1,down,1981-10-03
18183,Jermaine Jackson,1981-11-28,Jermaine Jackson - I Like Your Style,39,41,45,31.0,45,I Like Your Style,9.0,8,0,-6,2,0,stay,1981-10-03
18184,Jermaine Jackson,1981-12-05,Jermaine Jackson - I Like Your Style,45,39,51,31.0,45,I Like Your Style,9.0,9,-6,0,-6,1,down,1981-10-03
18185,Patti LaBelle,1981-10-03,Patti LaBelle - The Spirits In It,51,51,43,43.0,50,The Spirits In It,4.0,0,7,1,0,1,up,1981-10-03
18186,Patti LaBelle,1981-10-10,Patti LaBelle - The Spirits In It,50,51,43,43.0,43,The Spirits In It,4.0,1,0,7,1,0,stay,1981-10-03
18187,Patti LaBelle,1981-10-17,Patti LaBelle - The Spirits In It,43,50,44,43.0,43,The Spirits In It,4.0,2,-1,0,7,1,down,1981-10-03
18188,Patti LaBelle,1981-10-24,Patti LaBelle - The Spirits In It,43,43,48,43.0,44,The Spirits In It,4.0,3,-4,-1,0,1,down,1981-10-03
18189,Patti LaBelle,1981-10-31,Patti LaBelle - The Spirits In It,44,43,51,43.0,48,The Spirits In It,4.0,4,-3,-4,-1,1,down,1981-10-03
18190,Patti Austin,1981-10-10,Patti Austin - Every Home Should Have One,51,51,29,16.0,39,Every Home Should Have One,40.0,0,10,12,0,1,up,1981-10-10
18191,Patti Austin,1981-10-17,Patti Austin - Every Home Should Have One,39,51,23,16.0,29,Every Home Should Have One,40.0,1,6,10,12,1,up,1981-10-10
18192,Patti Austin,1981-10-24,Patti Austin - Every Home Should Have One,29,39,20,16.0,23,Every Home Should Have One,40.0,2,3,6,10,1,up,1981-10-10
18193,Patti Austin,1981-10-31,Patti Austin - Every Home Should Have One,23,29,18,16.0,20,Every Home Should Have One,40.0,3,2,3,6,1,up,1981-10-10
18194,Patti Austin,1981-11-07,Patti Austin - Every Home Should Have One,20,23,18,16.0,18,Every Home Should Have One,40.0,4,0,2,3,0,stay,1981-10-10
18195,Patti Austin,1981-11-14,Patti Austin - Every Home Should Have One,18,20,20,16.0,18,Every Home Should Have One,40.0,5,-2,0,2,1,down,1981-10-10
18196,Patti Austin,1981-11-21,Patti Austin - Every Home Should Have One,18,18,26,16.0,20,Every Home Should Have One,40.0,6,-6,-2,0,1,down,1981-10-10
18197,Patti Austin,1981-11-28,Patti Austin - Every Home Should Have One,20,18,36,16.0,26,Every Home Should Have One,40.0,7,-10,-6,-2,1,down,1981-10-10
18198,Patti Austin,1981-12-05,Patti Austin - Every Home Should Have One,26,20,39,16.0,36,Every Home Should Have One,40.0,8,-3,-10,-6,1,down,1981-10-10
18199,Patti Austin,1981-12-12,Patti Austin - Every Home Should Have One,36,26,39,16.0,39,Every Home Should Have One,40.0,9,0,-3,-10,0,stay,1981-10-10
18200,Patti Austin,1981-12-19,Patti Austin - Every Home Should Have One,39,36,50,16.0,39,Every Home Should Have One,40.0,10,-11,0,-3,1,down,1981-10-10
18201,Patti Austin,1982-10-30,Patti Austin - Every Home Should Have One,39,39,44,16.0,50,Every Home Should Have One,40.0,11,6,-11,0,1,up,1981-10-10
18202,Patti Austin,1982-11-06,Patti Austin - Every Home Should Have One,50,39,37,16.0,44,Every Home Should Have One,40.0,12,7,6,-11,1,up,1981-10-10
18203,Patti Austin,1982-11-13,Patti Austin - Every Home Should Have One,44,50,33,16.0,37,Every Home Should Have One,40.0,13,4,7,6,1,up,1981-10-10
18204,Patti Austin,1982-11-20,Patti Austin - Every Home Should Have One,37,44,33,16.0,33,Every Home Should Have One,40.0,14,0,4,7,0,stay,1981-10-10
18205,Patti Austin,1982-11-27,Patti Austin - Every Home Should Have One,33,37,31,16.0,33,Every Home Should Have One,40.0,15,2,0,4,1,up,1981-10-10
18206,Patti Austin,1982-12-04,Patti Austin - Every Home Should Have One,33,33,28,16.0,31,Every Home Should Have One,40.0,16,3,2,0,1,up,1981-10-10
18207,Patti Austin,1982-12-11,Patti Austin - Every Home Should Have One,31,33,28,16.0,28,Every Home Should Have One,40.0,17,0,3,2,0,stay,1981-10-10
18208,Patti Austin,1982-12-18,Patti Austin - Every Home Should Have One,28,31,25,16.0,28,Every Home Should Have One,40.0,18,3,0,3,1,up,1981-10-10
18209,Patti Austin,1982-12-25,Patti Austin - Every Home Should Have One,28,28,25,16.0,25,Every Home Should Have One,40.0,19,0,3,0,0,stay,1981-10-10
18210,Patti Austin,1983-01-01,Patti Austin - Every Home Should Have One,25,28,23,16.0,25,Every Home Should Have One,40.0,20,2,0,3,1,up,1981-10-10
18211,Patti Austin,1983-01-08,Patti Austin - Every Home Should Have One,25,25,22,16.0,23,Every Home Should Have One,40.0,21,1,2,0,1,up,1981-10-10
18212,Patti Austin,1983-01-15,Patti Austin - Every Home Should Have One,23,25,20,16.0,22,Every Home Should Have One,40.0,22,2,1,2,1,up,1981-10-10
18213,Patti Austin,1983-01-22,Patti Austin - Every Home Should Have One,22,23,18,16.0,20,Every Home Should Have One,40.0,23,2,2,1,1,up,1981-10-10
18214,Patti Austin,1983-01-29,Patti Austin - Every Home Should Have One,20,22,16,16.0,18,Every Home Should Have One,40.0,24,2,2,2,1,up,1981-10-10
18215,Patti Austin,1983-02-05,Patti Austin - Every Home Should Have One,18,20,16,16.0,16,Every Home Should Have One,40.0,25,0,2,2,0,stay,1981-10-10
18216,Patti Austin,1983-02-12,Patti Austin - Every Home Should Have One,16,18,18,16.0,16,Every Home Should Have One,40.0,26,-2,0,2,1,down,1981-10-10
18217,Patti Austin,1983-02-19,Patti Austin - Every Home Should Have One,16,16,21,16.0,18,Every Home Should Have One,40.0,27,-3,-2,0,1,down,1981-10-10
18218,Patti Austin,1983-02-26,Patti Austin - Every Home Should Have One,18,16,22,16.0,21,Every Home Should Have One,40.0,28,-1,-3,-2,1,down,1981-10-10
18219,Patti Austin,1983-03-05,Patti Austin - Every Home Should Have One,21,18,22,16.0,22,Every Home Should Have One,40.0,29,0,-1,-3,0,stay,1981-10-10
18220,Patti Austin,1983-03-12,Patti Austin - Every Home Should Have One,22,21,22,16.0,22,Every Home Should Have One,40.0,30,0,0,-1,0,stay,1981-10-10
18221,Patti Austin,1983-03-19,Patti Austin - Every Home Should Have One,22,22,25,16.0,22,Every Home Should Have One,40.0,31,-3,0,0,1,down,1981-10-10
18222,Patti Austin,1983-03-26,Patti Austin - Every Home Should Have One,22,22,24,16.0,25,Every Home Should Have One,40.0,32,1,-3,0,1,up,1981-10-10
18223,Patti Austin,1983-04-02,Patti Austin - Every Home Should Have One,25,22,24,16.0,24,Every Home Should Have One,40.0,33,0,1,-3,0,stay,1981-10-10
18224,Patti Austin,1983-04-09,Patti Austin - Every Home Should Have One,24,25,31,16.0,24,Every Home Should Have One,40.0,34,-7,0,1,1,down,1981-10-10
18225,Patti Austin,1983-04-16,Patti Austin - Every Home Should Have One,24,24,31,16.0,31,Every Home Should Have One,40.0,35,0,-7,0,0,stay,1981-10-10
18226,Patti Austin,1983-04-23,Patti Austin - Every Home Should Have One,31,24,33,16.0,31,Every Home Should Have One,40.0,36,-2,0,-7,1,down,1981-10-10
18227,Patti Austin,1983-04-30,Patti Austin - Every Home Should Have One,31,31,40,16.0,33,Every Home Should Have One,40.0,37,-7,-2,0,1,down,1981-10-10
18228,Patti Austin,1983-05-07,Patti Austin - Every Home Should Have One,33,31,49,16.0,40,Every Home Should Have One,40.0,38,-9,-7,-2,1,down,1981-10-10
18229,Patti Austin,1983-05-14,Patti Austin - Every Home Should Have One,40,33,49,16.0,49,Every Home Should Have One,40.0,39,0,-9,-7,0,stay,1981-10-10
18230,Patti Austin,1983-05-21,Patti Austin - Every Home Should Have One,49,40,51,16.0,49,Every Home Should Have One,40.0,40,-2,0,-9,1,down,1981-10-10
18231,Ronnie Laws,1981-10-10,Ronnie Laws - Solid Ground,51,51,30,17.0,45,Solid Ground,17.0,0,15,6,0,1,up,1981-10-10
18232,Ronnie Laws,1981-10-17,Ronnie Laws - Solid Ground,45,51,25,17.0,30,Solid Ground,17.0,1,5,15,6,1,up,1981-10-10
18233,Ronnie Laws,1981-10-24,Ronnie Laws - Solid Ground,30,45,22,17.0,25,Solid Ground,17.0,2,3,5,15,1,up,1981-10-10
18234,Ronnie Laws,1981-10-31,Ronnie Laws - Solid Ground,25,30,19,17.0,22,Solid Ground,17.0,3,3,3,5,1,up,1981-10-10
18235,Ronnie Laws,1981-11-07,Ronnie Laws - Solid Ground,22,25,17,17.0,19,Solid Ground,17.0,4,2,3,3,1,up,1981-10-10
18236,Ronnie Laws,1981-11-14,Ronnie Laws - Solid Ground,19,22,17,17.0,17,Solid Ground,17.0,5,0,2,3,0,stay,1981-10-10
18237,Ronnie Laws,1981-11-21,Ronnie Laws - Solid Ground,17,19,22,17.0,17,Solid Ground,17.0,6,-5,0,2,1,down,1981-10-10
18238,Ronnie Laws,1981-11-28,Ronnie Laws - Solid Ground,17,17,20,17.0,22,Solid Ground,17.0,7,2,-5,0,1,up,1981-10-10
18239,Ronnie Laws,1981-12-05,Ronnie Laws - Solid Ground,22,17,28,17.0,20,Solid Ground,17.0,8,-8,2,-5,1,down,1981-10-10
18240,Ronnie Laws,1981-12-12,Ronnie Laws - Solid Ground,20,22,31,17.0,28,Solid Ground,17.0,9,-3,-8,2,1,down,1981-10-10
18241,Ronnie Laws,1981-12-19,Ronnie Laws - Solid Ground,28,20,34,17.0,31,Solid Ground,17.0,10,-3,-3,-8,1,down,1981-10-10
18242,Ronnie Laws,1981-12-26,Ronnie Laws - Solid Ground,31,28,34,17.0,34,Solid Ground,17.0,11,0,-3,-3,0,stay,1981-10-10
18243,Ronnie Laws,1982-01-02,Ronnie Laws - Solid Ground,34,31,45,17.0,34,Solid Ground,17.0,12,-11,0,-3,1,down,1981-10-10
18244,Ronnie Laws,1982-01-09,Ronnie Laws - Solid Ground,34,34,45,17.0,45,Solid Ground,17.0,13,0,-11,0,0,stay,1981-10-10
18245,Ronnie Laws,1982-01-16,Ronnie Laws - Solid Ground,45,34,47,17.0,45,Solid Ground,17.0,14,-2,0,-11,1,down,1981-10-10
18246,Ronnie Laws,1982-01-23,Ronnie Laws - Solid Ground,45,45,47,17.0,47,Solid Ground,17.0,15,0,-2,0,0,stay,1981-10-10
18247,Ronnie Laws,1982-01-30,Ronnie Laws - Solid Ground,47,45,46,17.0,47,Solid Ground,17.0,16,1,0,-2,1,up,1981-10-10
18248,Ronnie Laws,1982-02-06,Ronnie Laws - Solid Ground,47,47,51,17.0,46,Solid Ground,17.0,17,-5,1,0,1,down,1981-10-10
18249,The Emotions,1981-10-10,The Emotions - New Affair,51,51,46,46.0,46,New Affair,1.0,0,0,5,0,0,stay,1981-10-10
18250,The Emotions,1981-10-17,The Emotions - New Affair,46,51,51,46.0,46,New Affair,1.0,1,-5,0,5,1,down,1981-10-10
18251,Rockie Robbins,1981-10-10,Rockie Robbins - I Believe In Love,51,51,47,47.0,47,I Believe In Love,1.0,0,0,4,0,0,stay,1981-10-10
18252,Rockie Robbins,1981-10-17,Rockie Robbins - I Believe In Love,47,51,51,47.0,47,I Believe In Love,1.0,1,-4,0,4,1,down,1981-10-10
18253,Slave,1981-10-17,Slave - Show Time,51,51,13,7.0,25,Show Time,24.0,0,12,26,0,1,up,1981-10-17
18254,Slave,1981-10-24,Slave - Show Time,25,51,10,7.0,13,Show Time,24.0,1,3,12,26,1,up,1981-10-17
18255,Slave,1981-10-31,Slave - Show Time,13,25,10,7.0,10,Show Time,24.0,2,0,3,12,0,stay,1981-10-17
18256,Slave,1981-11-07,Slave - Show Time,10,13,8,7.0,10,Show Time,24.0,3,2,0,3,1,up,1981-10-17
18257,Slave,1981-11-14,Slave - Show Time,10,10,8,7.0,8,Show Time,24.0,4,0,2,0,0,stay,1981-10-17
18258,Slave,1981-11-21,Slave - Show Time,8,10,7,7.0,8,Show Time,24.0,5,1,0,2,1,up,1981-10-17
18259,Slave,1981-11-28,Slave - Show Time,8,8,7,7.0,7,Show Time,24.0,6,0,1,0,0,stay,1981-10-17
18260,Slave,1981-12-05,Slave - Show Time,7,8,7,7.0,7,Show Time,24.0,7,0,0,1,0,stay,1981-10-17
18261,Slave,1981-12-12,Slave - Show Time,7,7,7,7.0,7,Show Time,24.0,8,0,0,0,0,stay,1981-10-17
18262,Slave,1981-12-19,Slave - Show Time,7,7,7,7.0,7,Show Time,24.0,9,0,0,0,0,stay,1981-10-17
18263,Slave,1981-12-26,Slave - Show Time,7,7,7,7.0,7,Show Time,24.0,10,0,0,0,0,stay,1981-10-17
18264,Slave,1982-01-02,Slave - Show Time,7,7,15,7.0,7,Show Time,24.0,11,-8,0,0,1,down,1981-10-17
18265,Slave,1982-01-09,Slave - Show Time,7,7,16,7.0,15,Show Time,24.0,12,-1,-8,0,1,down,1981-10-17
18266,Slave,1982-01-16,Slave - Show Time,15,7,20,7.0,16,Show Time,24.0,13,-4,-1,-8,1,down,1981-10-17
18267,Slave,1982-01-23,Slave - Show Time,16,15,20,7.0,20,Show Time,24.0,14,0,-4,-1,0,stay,1981-10-17
18268,Slave,1982-01-30,Slave - Show Time,20,16,18,7.0,20,Show Time,24.0,15,2,0,-4,1,up,1981-10-17
18269,Slave,1982-02-06,Slave - Show Time,20,20,30,7.0,18,Show Time,24.0,16,-12,2,0,1,down,1981-10-17
18270,Slave,1982-02-13,Slave - Show Time,18,20,31,7.0,30,Show Time,24.0,17,-1,-12,2,1,down,1981-10-17
18271,Slave,1982-02-20,Slave - Show Time,30,18,29,7.0,31,Show Time,24.0,18,2,-1,-12,1,up,1981-10-17
18272,Slave,1982-02-27,Slave - Show Time,31,30,29,7.0,29,Show Time,24.0,19,0,2,-1,0,stay,1981-10-17
18273,Slave,1982-03-06,Slave - Show Time,29,31,28,7.0,29,Show Time,24.0,20,1,0,2,1,up,1981-10-17
18274,Slave,1982-03-13,Slave - Show Time,29,29,28,7.0,28,Show Time,24.0,21,0,1,0,0,stay,1981-10-17
18275,Slave,1982-03-20,Slave - Show Time,28,29,34,7.0,28,Show Time,24.0,22,-6,0,1,1,down,1981-10-17
18276,Slave,1982-03-27,Slave - Show Time,28,28,38,7.0,34,Show Time,24.0,23,-4,-6,0,1,down,1981-10-17
18277,Slave,1982-04-03,Slave - Show Time,34,28,51,7.0,38,Show Time,24.0,24,-13,-4,-6,1,down,1981-10-17
18278,Gil Scott-Heron,1981-10-17,Gil Scott-Heron - Reflections,51,51,38,21.0,42,Reflections,23.0,0,4,9,0,1,up,1981-10-17
18279,Gil Scott-Heron,1981-10-24,Gil Scott-Heron - Reflections,42,51,34,21.0,38,Reflections,23.0,1,4,4,9,1,up,1981-10-17
18280,Gil Scott-Heron,1981-10-31,Gil Scott-Heron - Reflections,38,42,33,21.0,34,Reflections,23.0,2,1,4,4,1,up,1981-10-17
18281,Gil Scott-Heron,1981-11-07,Gil Scott-Heron - Reflections,34,38,44,21.0,33,Reflections,23.0,3,-11,1,4,1,down,1981-10-17
18282,Gil Scott-Heron,1981-11-14,Gil Scott-Heron - Reflections,33,34,40,21.0,44,Reflections,23.0,4,4,-11,1,1,up,1981-10-17
18283,Gil Scott-Heron,1981-11-21,Gil Scott-Heron - Reflections,44,33,49,21.0,40,Reflections,23.0,5,-9,4,-11,1,down,1981-10-17
18284,Gil Scott-Heron,1981-11-28,Gil Scott-Heron - Reflections,40,44,46,21.0,49,Reflections,23.0,6,3,-9,4,1,up,1981-10-17
18285,Gil Scott-Heron,1981-12-05,Gil Scott-Heron - Reflections,49,40,46,21.0,46,Reflections,23.0,7,0,3,-9,0,stay,1981-10-17
18286,Gil Scott-Heron,1981-12-12,Gil Scott-Heron - Reflections,46,49,45,21.0,46,Reflections,23.0,8,1,0,3,1,up,1981-10-17
18287,Gil Scott-Heron,1981-12-19,Gil Scott-Heron - Reflections,46,46,40,21.0,45,Reflections,23.0,9,5,1,0,1,up,1981-10-17
18288,Gil Scott-Heron,1981-12-26,Gil Scott-Heron - Reflections,45,46,40,21.0,40,Reflections,23.0,10,0,5,1,0,stay,1981-10-17
18289,Gil Scott-Heron,1982-01-02,Gil Scott-Heron - Reflections,40,45,35,21.0,40,Reflections,23.0,11,5,0,5,1,up,1981-10-17
18290,Gil Scott-Heron,1982-01-09,Gil Scott-Heron - Reflections,40,40,31,21.0,35,Reflections,23.0,12,4,5,0,1,up,1981-10-17
18291,Gil Scott-Heron,1982-01-16,Gil Scott-Heron - Reflections,35,40,27,21.0,31,Reflections,23.0,13,4,4,5,1,up,1981-10-17
18292,Gil Scott-Heron,1982-01-23,Gil Scott-Heron - Reflections,31,35,27,21.0,27,Reflections,23.0,14,0,4,4,0,stay,1981-10-17
18293,Gil Scott-Heron,1982-01-30,Gil Scott-Heron - Reflections,27,31,24,21.0,27,Reflections,23.0,15,3,0,4,1,up,1981-10-17
18294,Gil Scott-Heron,1982-02-06,Gil Scott-Heron - Reflections,27,27,21,21.0,24,Reflections,23.0,16,3,3,0,1,up,1981-10-17
18295,Gil Scott-Heron,1982-02-13,Gil Scott-Heron - Reflections,24,27,21,21.0,21,Reflections,23.0,17,0,3,3,0,stay,1981-10-17
18296,Gil Scott-Heron,1982-02-20,Gil Scott-Heron - Reflections,21,24,26,21.0,21,Reflections,23.0,18,-5,0,3,1,down,1981-10-17
18297,Gil Scott-Heron,1982-02-27,Gil Scott-Heron - Reflections,21,21,28,21.0,26,Reflections,23.0,19,-2,-5,0,1,down,1981-10-17
18298,Gil Scott-Heron,1982-03-06,Gil Scott-Heron - Reflections,26,21,27,21.0,28,Reflections,23.0,20,1,-2,-5,1,up,1981-10-17
18299,Gil Scott-Heron,1982-03-13,Gil Scott-Heron - Reflections,28,26,30,21.0,27,Reflections,23.0,21,-3,1,-2,1,down,1981-10-17
18300,Gil Scott-Heron,1982-03-20,Gil Scott-Heron - Reflections,27,28,42,21.0,30,Reflections,23.0,22,-12,-3,1,1,down,1981-10-17
18301,Gil Scott-Heron,1982-03-27,Gil Scott-Heron - Reflections,30,27,51,21.0,42,Reflections,23.0,23,-9,-12,-3,1,down,1981-10-17
18302,Herbie Hancock,1981-10-17,Herbie Hancock - Magic Windows,51,51,40,40.0,44,Magic Windows,2.0,0,4,7,0,1,up,1981-10-17
18303,Herbie Hancock,1981-10-24,Herbie Hancock - Magic Windows,44,51,40,40.0,40,Magic Windows,2.0,1,0,4,7,0,stay,1981-10-17
18304,Herbie Hancock,1981-10-31,Herbie Hancock - Magic Windows,40,44,51,40.0,40,Magic Windows,2.0,2,-11,0,4,1,down,1981-10-17
18305,Curtis Mayfield,1981-10-17,Curtis Mayfield - Love Is The Place,51,51,43,39.0,48,Love Is The Place,12.0,0,5,3,0,1,up,1981-10-17
18306,Curtis Mayfield,1981-10-24,Curtis Mayfield - Love Is The Place,48,51,43,39.0,43,Love Is The Place,12.0,1,0,5,3,0,stay,1981-10-17
18307,Curtis Mayfield,1981-10-31,Curtis Mayfield - Love Is The Place,43,48,39,39.0,43,Love Is The Place,12.0,2,4,0,5,1,up,1981-10-17
18308,Curtis Mayfield,1981-11-07,Curtis Mayfield - Love Is The Place,43,43,39,39.0,39,Love Is The Place,12.0,3,0,4,0,0,stay,1981-10-17
18309,Curtis Mayfield,1981-11-14,Curtis Mayfield - Love Is The Place,39,43,50,39.0,39,Love Is The Place,12.0,4,-11,0,4,1,down,1981-10-17
18310,Curtis Mayfield,1981-11-28,Curtis Mayfield - Love Is The Place,39,39,47,39.0,50,Love Is The Place,12.0,5,3,-11,0,1,up,1981-10-17
18311,Curtis Mayfield,1981-12-05,Curtis Mayfield - Love Is The Place,50,39,44,39.0,47,Love Is The Place,12.0,6,3,3,-11,1,up,1981-10-17
18312,Curtis Mayfield,1981-12-12,Curtis Mayfield - Love Is The Place,47,50,44,39.0,44,Love Is The Place,12.0,7,0,3,3,0,stay,1981-10-17
18313,Curtis Mayfield,1981-12-19,Curtis Mayfield - Love Is The Place,44,47,50,39.0,44,Love Is The Place,12.0,8,-6,0,3,1,down,1981-10-17
18314,Curtis Mayfield,1982-01-30,Curtis Mayfield - Love Is The Place,44,44,45,39.0,50,Love Is The Place,12.0,9,5,-6,0,1,up,1981-10-17
18315,Curtis Mayfield,1982-02-06,Curtis Mayfield - Love Is The Place,50,44,40,39.0,45,Love Is The Place,12.0,10,5,5,-6,1,up,1981-10-17
18316,Curtis Mayfield,1982-02-13,Curtis Mayfield - Love Is The Place,45,50,40,39.0,40,Love Is The Place,12.0,11,0,5,5,0,stay,1981-10-17
18317,Curtis Mayfield,1982-02-20,Curtis Mayfield - Love Is The Place,40,45,51,39.0,40,Love Is The Place,12.0,12,-11,0,5,1,down,1981-10-17
18318,Kool & The Gang,1981-10-24,Kool & The Gang - Something Special,51,51,8,1.0,17,Something Special,40.0,0,9,34,0,1,up,1981-10-24
18319,Kool & The Gang,1981-10-31,Kool & The Gang - Something Special,17,51,8,1.0,8,Something Special,40.0,1,0,9,34,0,stay,1981-10-24
18320,Kool & The Gang,1981-11-07,Kool & The Gang - Something Special,8,17,3,1.0,8,Something Special,40.0,2,5,0,9,1,up,1981-10-24
18321,Kool & The Gang,1981-11-14,Kool & The Gang - Something Special,8,8,1,1.0,3,Something Special,40.0,3,2,5,0,1,up,1981-10-24
18322,Kool & The Gang,1981-11-21,Kool & The Gang - Something Special,3,8,2,1.0,1,Something Special,40.0,4,-1,2,5,1,down,1981-10-24
18323,Kool & The Gang,1981-11-28,Kool & The Gang - Something Special,1,3,2,1.0,2,Something Special,40.0,5,0,-1,2,0,stay,1981-10-24
18324,Kool & The Gang,1981-12-05,Kool & The Gang - Something Special,2,1,2,1.0,2,Something Special,40.0,6,0,0,-1,0,stay,1981-10-24
18325,Kool & The Gang,1981-12-12,Kool & The Gang - Something Special,2,2,2,1.0,2,Something Special,40.0,7,0,0,0,0,stay,1981-10-24
18326,Kool & The Gang,1981-12-19,Kool & The Gang - Something Special,2,2,2,1.0,2,Something Special,40.0,8,0,0,0,0,stay,1981-10-24
18327,Kool & The Gang,1981-12-26,Kool & The Gang - Something Special,2,2,2,1.0,2,Something Special,40.0,9,0,0,0,0,stay,1981-10-24
18328,Kool & The Gang,1982-01-02,Kool & The Gang - Something Special,2,2,2,1.0,2,Something Special,40.0,10,0,0,0,0,stay,1981-10-24
18329,Kool & The Gang,1982-01-09,Kool & The Gang - Something Special,2,2,2,1.0,2,Something Special,40.0,11,0,0,0,0,stay,1981-10-24
18330,Kool & The Gang,1982-01-16,Kool & The Gang - Something Special,2,2,2,1.0,2,Something Special,40.0,12,0,0,0,0,stay,1981-10-24
18331,Kool & The Gang,1982-01-23,Kool & The Gang - Something Special,2,2,2,1.0,2,Something Special,40.0,13,0,0,0,0,stay,1981-10-24
18332,Kool & The Gang,1982-01-30,Kool & The Gang - Something Special,2,2,2,1.0,2,Something Special,40.0,14,0,0,0,0,stay,1981-10-24
18333,Kool & The Gang,1982-02-06,Kool & The Gang - Something Special,2,2,4,1.0,2,Something Special,40.0,15,-2,0,0,1,down,1981-10-24
18334,Kool & The Gang,1982-02-13,Kool & The Gang - Something Special,2,2,4,1.0,4,Something Special,40.0,16,0,-2,0,0,stay,1981-10-24
18335,Kool & The Gang,1982-02-20,Kool & The Gang - Something Special,4,2,4,1.0,4,Something Special,40.0,17,0,0,-2,0,stay,1981-10-24
18336,Kool & The Gang,1982-02-27,Kool & The Gang - Something Special,4,4,4,1.0,4,Something Special,40.0,18,0,0,0,0,stay,1981-10-24
18337,Kool & The Gang,1982-03-06,Kool & The Gang - Something Special,4,4,4,1.0,4,Something Special,40.0,19,0,0,0,0,stay,1981-10-24
18338,Kool & The Gang,1982-03-13,Kool & The Gang - Something Special,4,4,5,1.0,4,Something Special,40.0,20,-1,0,0,1,down,1981-10-24
18339,Kool & The Gang,1982-03-20,Kool & The Gang - Something Special,4,4,5,1.0,5,Something Special,40.0,21,0,-1,0,0,stay,1981-10-24
18340,Kool & The Gang,1982-03-27,Kool & The Gang - Something Special,5,4,7,1.0,5,Something Special,40.0,22,-2,0,-1,1,down,1981-10-24
18341,Kool & The Gang,1982-04-03,Kool & The Gang - Something Special,5,5,7,1.0,7,Something Special,40.0,23,0,-2,0,0,stay,1981-10-24
18342,Kool & The Gang,1982-04-10,Kool & The Gang - Something Special,7,5,9,1.0,7,Something Special,40.0,24,-2,0,-2,1,down,1981-10-24
18343,Kool & The Gang,1982-04-17,Kool & The Gang - Something Special,7,7,9,1.0,9,Something Special,40.0,25,0,-2,0,0,stay,1981-10-24
18344,Kool & The Gang,1982-04-24,Kool & The Gang - Something Special,9,7,8,1.0,9,Something Special,40.0,26,1,0,-2,1,up,1981-10-24
18345,Kool & The Gang,1982-05-01,Kool & The Gang - Something Special,9,9,18,1.0,8,Something Special,40.0,27,-10,1,0,1,down,1981-10-24
18346,Kool & The Gang,1982-05-08,Kool & The Gang - Something Special,8,9,17,1.0,18,Something Special,40.0,28,1,-10,1,1,up,1981-10-24
18347,Kool & The Gang,1982-05-15,Kool & The Gang - Something Special,18,8,17,1.0,17,Something Special,40.0,29,0,1,-10,0,stay,1981-10-24
18348,Kool & The Gang,1982-05-22,Kool & The Gang - Something Special,17,18,23,1.0,17,Something Special,40.0,30,-6,0,1,1,down,1981-10-24
18349,Kool & The Gang,1982-05-29,Kool & The Gang - Something Special,17,17,25,1.0,23,Something Special,40.0,31,-2,-6,0,1,down,1981-10-24
18350,Kool & The Gang,1982-06-05,Kool & The Gang - Something Special,23,17,26,1.0,25,Something Special,40.0,32,-1,-2,-6,1,down,1981-10-24
18351,Kool & The Gang,1982-06-12,Kool & The Gang - Something Special,25,23,34,1.0,26,Something Special,40.0,33,-8,-1,-2,1,down,1981-10-24
18352,Kool & The Gang,1982-06-19,Kool & The Gang - Something Special,26,25,33,1.0,34,Something Special,40.0,34,1,-8,-1,1,up,1981-10-24
18353,Kool & The Gang,1982-06-26,Kool & The Gang - Something Special,34,26,33,1.0,33,Something Special,40.0,35,0,1,-8,0,stay,1981-10-24
18354,Kool & The Gang,1982-07-03,Kool & The Gang - Something Special,33,34,33,1.0,33,Something Special,40.0,36,0,0,1,0,stay,1981-10-24
18355,Kool & The Gang,1982-07-10,Kool & The Gang - Something Special,33,33,47,1.0,33,Something Special,40.0,37,-14,0,0,1,down,1981-10-24
18356,Kool & The Gang,1982-07-17,Kool & The Gang - Something Special,33,33,47,1.0,47,Something Special,40.0,38,0,-14,0,0,stay,1981-10-24
18357,Kool & The Gang,1982-07-24,Kool & The Gang - Something Special,47,33,48,1.0,47,Something Special,40.0,39,-1,0,-14,1,down,1981-10-24
18358,Kool & The Gang,1982-07-31,Kool & The Gang - Something Special,47,47,51,1.0,48,Something Special,40.0,40,-3,-1,0,1,down,1981-10-24
18359,The Crusaders,1981-10-24,The Crusaders - Standing Tall,51,51,33,29.0,45,Standing Tall,8.0,0,12,6,0,1,up,1981-10-24
18360,The Crusaders,1981-10-31,The Crusaders - Standing Tall,45,51,29,29.0,33,Standing Tall,8.0,1,4,12,6,1,up,1981-10-24
18361,The Crusaders,1981-11-07,The Crusaders - Standing Tall,33,45,29,29.0,29,Standing Tall,8.0,2,0,4,12,0,stay,1981-10-24
18362,The Crusaders,1981-11-14,The Crusaders - Standing Tall,29,33,31,29.0,29,Standing Tall,8.0,3,-2,0,4,1,down,1981-10-24
18363,The Crusaders,1981-11-21,The Crusaders - Standing Tall,29,29,29,29.0,31,Standing Tall,8.0,4,2,-2,0,1,up,1981-10-24
18364,The Crusaders,1981-11-28,The Crusaders - Standing Tall,31,29,44,29.0,29,Standing Tall,8.0,5,-15,2,-2,1,down,1981-10-24
18365,The Crusaders,1981-12-05,The Crusaders - Standing Tall,29,31,45,29.0,44,Standing Tall,8.0,6,-1,-15,2,1,down,1981-10-24
18366,The Crusaders,1981-12-12,The Crusaders - Standing Tall,44,29,46,29.0,45,Standing Tall,8.0,7,-1,-1,-15,1,down,1981-10-24
18367,The Crusaders,1981-12-19,The Crusaders - Standing Tall,45,44,51,29.0,46,Standing Tall,8.0,8,-5,-1,-1,1,down,1981-10-24
18368,Pieces Of A Dream,1981-10-24,Pieces Of A Dream - Pieces Of A Dream,51,51,42,37.0,47,Pieces Of A Dream,6.0,0,5,4,0,1,up,1981-10-24
18369,Pieces Of A Dream,1981-10-31,Pieces Of A Dream - Pieces Of A Dream,47,51,42,37.0,42,Pieces Of A Dream,6.0,1,0,5,4,0,stay,1981-10-24
18370,Pieces Of A Dream,1981-11-07,Pieces Of A Dream - Pieces Of A Dream,42,47,38,37.0,42,Pieces Of A Dream,6.0,2,4,0,5,1,up,1981-10-24
18371,Pieces Of A Dream,1981-11-14,Pieces Of A Dream - Pieces Of A Dream,42,42,38,37.0,38,Pieces Of A Dream,6.0,3,0,4,0,0,stay,1981-10-24
18372,Pieces Of A Dream,1981-11-21,Pieces Of A Dream - Pieces Of A Dream,38,42,37,37.0,38,Pieces Of A Dream,6.0,4,1,0,4,1,up,1981-10-24
18373,Pieces Of A Dream,1981-11-28,Pieces Of A Dream - Pieces Of A Dream,38,38,49,37.0,37,Pieces Of A Dream,6.0,5,-12,1,0,1,down,1981-10-24
18374,Pieces Of A Dream,1981-12-05,Pieces Of A Dream - Pieces Of A Dream,37,38,51,37.0,49,Pieces Of A Dream,6.0,6,-2,-12,1,1,down,1981-10-24
18375,Diana Ross,1981-10-31,Diana Ross - All The Greatest Hits,51,51,17,14.0,26,All The Greatest Hits,17.0,0,9,25,0,1,up,1981-10-31
18376,Diana Ross,1981-11-07,Diana Ross - All The Greatest Hits,26,51,14,14.0,17,All The Greatest Hits,17.0,1,3,9,25,1,up,1981-10-31
18377,Diana Ross,1981-11-14,Diana Ross - All The Greatest Hits,17,26,14,14.0,14,All The Greatest Hits,17.0,2,0,3,9,0,stay,1981-10-31
18378,Diana Ross,1981-11-21,Diana Ross - All The Greatest Hits,14,17,14,14.0,14,All The Greatest Hits,17.0,3,0,0,3,0,stay,1981-10-31
18379,Diana Ross,1981-11-28,Diana Ross - All The Greatest Hits,14,14,22,14.0,14,All The Greatest Hits,17.0,4,-8,0,0,1,down,1981-10-31
18380,Diana Ross,1981-12-05,Diana Ross - All The Greatest Hits,14,14,22,14.0,22,All The Greatest Hits,17.0,5,0,-8,0,0,stay,1981-10-31
18381,Diana Ross,1981-12-12,Diana Ross - All The Greatest Hits,22,14,30,14.0,22,All The Greatest Hits,17.0,6,-8,0,-8,1,down,1981-10-31
18382,Diana Ross,1981-12-19,Diana Ross - All The Greatest Hits,22,22,30,14.0,30,All The Greatest Hits,17.0,7,0,-8,0,0,stay,1981-10-31
18383,Diana Ross,1981-12-26,Diana Ross - All The Greatest Hits,30,22,30,14.0,30,All The Greatest Hits,17.0,8,0,0,-8,0,stay,1981-10-31
18384,Diana Ross,1982-01-02,Diana Ross - All The Greatest Hits,30,30,42,14.0,30,All The Greatest Hits,17.0,9,-12,0,0,1,down,1981-10-31
18385,Diana Ross,1982-01-09,Diana Ross - All The Greatest Hits,30,30,40,14.0,42,All The Greatest Hits,17.0,10,2,-12,0,1,up,1981-10-31
18386,Diana Ross,1982-01-16,Diana Ross - All The Greatest Hits,42,30,39,14.0,40,All The Greatest Hits,17.0,11,1,2,-12,1,up,1981-10-31
18387,Diana Ross,1982-01-23,Diana Ross - All The Greatest Hits,40,42,37,14.0,39,All The Greatest Hits,17.0,12,2,1,2,1,up,1981-10-31
18388,Diana Ross,1982-01-30,Diana Ross - All The Greatest Hits,39,40,38,14.0,37,All The Greatest Hits,17.0,13,-1,2,1,1,down,1981-10-31
18389,Diana Ross,1982-02-06,Diana Ross - All The Greatest Hits,37,39,38,14.0,38,All The Greatest Hits,17.0,14,0,-1,2,0,stay,1981-10-31
18390,Diana Ross,1982-02-13,Diana Ross - All The Greatest Hits,38,37,50,14.0,38,All The Greatest Hits,17.0,15,-12,0,-1,1,down,1981-10-31
18391,Diana Ross,1982-02-20,Diana Ross - All The Greatest Hits,38,38,50,14.0,50,All The Greatest Hits,17.0,16,0,-12,0,0,stay,1981-10-31
18392,Diana Ross,1982-02-27,Diana Ross - All The Greatest Hits,50,38,51,14.0,50,All The Greatest Hits,17.0,17,-1,0,-12,1,down,1981-10-31
18393,The Isley Brothers,1981-10-31,The Isley Brothers - Inside You,51,51,16,8.0,35,Inside You,15.0,0,19,16,0,1,up,1981-10-31
18394,The Isley Brothers,1981-11-07,The Isley Brothers - Inside You,35,51,10,8.0,16,Inside You,15.0,1,6,19,16,1,up,1981-10-31
18395,The Isley Brothers,1981-11-14,The Isley Brothers - Inside You,16,35,9,8.0,10,Inside You,15.0,2,1,6,19,1,up,1981-10-31
18396,The Isley Brothers,1981-11-21,The Isley Brothers - Inside You,10,16,8,8.0,9,Inside You,15.0,3,1,1,6,1,up,1981-10-31
18397,The Isley Brothers,1981-11-28,The Isley Brothers - Inside You,9,10,8,8.0,8,Inside You,15.0,4,0,1,1,0,stay,1981-10-31
18398,The Isley Brothers,1981-12-05,The Isley Brothers - Inside You,8,9,9,8.0,8,Inside You,15.0,5,-1,0,1,1,down,1981-10-31
18399,The Isley Brothers,1981-12-12,The Isley Brothers - Inside You,8,8,12,8.0,9,Inside You,15.0,6,-3,-1,0,1,down,1981-10-31
18400,The Isley Brothers,1981-12-19,The Isley Brothers - Inside You,9,8,19,8.0,12,Inside You,15.0,7,-7,-3,-1,1,down,1981-10-31
18401,The Isley Brothers,1981-12-26,The Isley Brothers - Inside You,12,9,19,8.0,19,Inside You,15.0,8,0,-7,-3,0,stay,1981-10-31
18402,The Isley Brothers,1982-01-02,The Isley Brothers - Inside You,19,12,19,8.0,19,Inside You,15.0,9,0,0,-7,0,stay,1981-10-31
18403,The Isley Brothers,1982-01-09,The Isley Brothers - Inside You,19,19,27,8.0,19,Inside You,15.0,10,-8,0,0,1,down,1981-10-31
18404,The Isley Brothers,1982-01-16,The Isley Brothers - Inside You,19,19,43,8.0,27,Inside You,15.0,11,-16,-8,0,1,down,1981-10-31
18405,The Isley Brothers,1982-01-23,The Isley Brothers - Inside You,27,19,45,8.0,43,Inside You,15.0,12,-2,-16,-8,1,down,1981-10-31
18406,The Isley Brothers,1982-01-30,The Isley Brothers - Inside You,43,27,48,8.0,45,Inside You,15.0,13,-3,-2,-16,1,down,1981-10-31
18407,The Isley Brothers,1982-02-06,The Isley Brothers - Inside You,45,43,48,8.0,48,Inside You,15.0,14,0,-3,-2,0,stay,1981-10-31
18408,The Isley Brothers,1982-02-13,The Isley Brothers - Inside You,48,45,51,8.0,48,Inside You,15.0,15,-3,0,-3,1,down,1981-10-31
18409,Ashford & Simpson,1981-10-31,Ashford & Simpson - Performance,51,51,45,45.0,49,Performance,2.0,0,4,2,0,1,up,1981-10-31
18410,Ashford & Simpson,1981-11-07,Ashford & Simpson - Performance,49,51,45,45.0,45,Performance,2.0,1,0,4,2,0,stay,1981-10-31
18411,Ashford & Simpson,1981-11-14,Ashford & Simpson - Performance,45,49,51,45.0,45,Performance,2.0,2,-6,0,4,1,down,1981-10-31
18412,Shalamar,1981-10-31,Shalamar - Go For It,51,51,32,18.0,50,Go For It,14.0,0,18,1,0,1,up,1981-10-31
18413,Shalamar,1981-11-07,Shalamar - Go For It,50,51,24,18.0,32,Go For It,14.0,1,8,18,1,1,up,1981-10-31
18414,Shalamar,1981-11-14,Shalamar - Go For It,32,50,21,18.0,24,Go For It,14.0,2,3,8,18,1,up,1981-10-31
18415,Shalamar,1981-11-21,Shalamar - Go For It,24,32,18,18.0,21,Go For It,14.0,3,3,3,8,1,up,1981-10-31
18416,Shalamar,1981-11-28,Shalamar - Go For It,21,24,18,18.0,18,Go For It,14.0,4,0,3,3,0,stay,1981-10-31
18417,Shalamar,1981-12-05,Shalamar - Go For It,18,21,29,18.0,18,Go For It,14.0,5,-11,0,3,1,down,1981-10-31
18418,Shalamar,1981-12-12,Shalamar - Go For It,18,18,33,18.0,29,Go For It,14.0,6,-4,-11,0,1,down,1981-10-31
18419,Shalamar,1981-12-19,Shalamar - Go For It,29,18,31,18.0,33,Go For It,14.0,7,2,-4,-11,1,up,1981-10-31
18420,Shalamar,1981-12-26,Shalamar - Go For It,33,29,31,18.0,31,Go For It,14.0,8,0,2,-4,0,stay,1981-10-31
18421,Shalamar,1982-01-02,Shalamar - Go For It,31,33,31,18.0,31,Go For It,14.0,9,0,0,2,0,stay,1981-10-31
18422,Shalamar,1982-01-09,Shalamar - Go For It,31,31,38,18.0,31,Go For It,14.0,10,-7,0,0,1,down,1981-10-31
18423,Shalamar,1982-01-16,Shalamar - Go For It,31,31,37,18.0,38,Go For It,14.0,11,1,-7,0,1,up,1981-10-31
18424,Shalamar,1982-01-23,Shalamar - Go For It,38,31,44,18.0,37,Go For It,14.0,12,-7,1,-7,1,down,1981-10-31
18425,Shalamar,1982-01-30,Shalamar - Go For It,37,38,47,18.0,44,Go For It,14.0,13,-3,-7,1,1,down,1981-10-31
18426,Shalamar,1982-02-06,Shalamar - Go For It,44,37,51,18.0,47,Go For It,14.0,14,-4,-3,-7,1,down,1981-10-31
18427,Prince,1981-11-07,Prince - Controversy,51,51,9,3.0,25,Controversy,31.0,0,16,26,0,1,up,1981-11-07
18428,Prince,1981-11-14,Prince - Controversy,25,51,3,3.0,9,Controversy,31.0,1,6,16,26,1,up,1981-11-07
18429,Prince,1981-11-21,Prince - Controversy,9,25,3,3.0,3,Controversy,31.0,2,0,6,16,0,stay,1981-11-07
18430,Prince,1981-11-28,Prince - Controversy,3,9,3,3.0,3,Controversy,31.0,3,0,0,6,0,stay,1981-11-07
18431,Prince,1981-12-05,Prince - Controversy,3,3,3,3.0,3,Controversy,31.0,4,0,0,0,0,stay,1981-11-07
18432,Prince,1981-12-12,Prince - Controversy,3,3,3,3.0,3,Controversy,31.0,5,0,0,0,0,stay,1981-11-07
18433,Prince,1981-12-19,Prince - Controversy,3,3,3,3.0,3,Controversy,31.0,6,0,0,0,0,stay,1981-11-07
18434,Prince,1981-12-26,Prince - Controversy,3,3,3,3.0,3,Controversy,31.0,7,0,0,0,0,stay,1981-11-07
18435,Prince,1982-01-02,Prince - Controversy,3,3,3,3.0,3,Controversy,31.0,8,0,0,0,0,stay,1981-11-07
18436,Prince,1982-01-09,Prince - Controversy,3,3,6,3.0,3,Controversy,31.0,9,-3,0,0,1,down,1981-11-07
18437,Prince,1982-01-16,Prince - Controversy,3,3,14,3.0,6,Controversy,31.0,10,-8,-3,0,1,down,1981-11-07
18438,Prince,1982-01-23,Prince - Controversy,6,3,16,3.0,14,Controversy,31.0,11,-2,-8,-3,1,down,1981-11-07
18439,Prince,1982-01-30,Prince - Controversy,14,6,16,3.0,16,Controversy,31.0,12,0,-2,-8,0,stay,1981-11-07
18440,Prince,1982-02-06,Prince - Controversy,16,14,29,3.0,16,Controversy,31.0,13,-13,0,-2,1,down,1981-11-07
18441,Prince,1982-02-13,Prince - Controversy,16,16,29,3.0,29,Controversy,31.0,14,0,-13,0,0,stay,1981-11-07
18442,Prince,1982-02-20,Prince - Controversy,29,16,28,3.0,29,Controversy,31.0,15,1,0,-13,1,up,1981-11-07
18443,Prince,1982-02-27,Prince - Controversy,29,29,27,3.0,28,Controversy,31.0,16,1,1,0,1,up,1981-11-07
18444,Prince,1982-03-06,Prince - Controversy,28,29,23,3.0,27,Controversy,31.0,17,4,1,1,1,up,1981-11-07
18445,Prince,1982-03-13,Prince - Controversy,27,28,19,3.0,23,Controversy,31.0,18,4,4,1,1,up,1981-11-07
18446,Prince,1982-03-20,Prince - Controversy,23,27,17,3.0,19,Controversy,31.0,19,2,4,4,1,up,1981-11-07
18447,Prince,1982-03-27,Prince - Controversy,19,23,15,3.0,17,Controversy,31.0,20,2,2,4,1,up,1981-11-07
18448,Prince,1982-04-03,Prince - Controversy,17,19,13,3.0,15,Controversy,31.0,21,2,2,2,1,up,1981-11-07
18449,Prince,1982-04-10,Prince - Controversy,15,17,13,3.0,13,Controversy,31.0,22,0,2,2,0,stay,1981-11-07
18450,Prince,1982-04-17,Prince - Controversy,13,15,15,3.0,13,Controversy,31.0,23,-2,0,2,1,down,1981-11-07
18451,Prince,1982-04-24,Prince - Controversy,13,13,25,3.0,15,Controversy,31.0,24,-10,-2,0,1,down,1981-11-07
18452,Prince,1982-05-01,Prince - Controversy,15,13,31,3.0,25,Controversy,31.0,25,-6,-10,-2,1,down,1981-11-07
18453,Prince,1982-05-08,Prince - Controversy,25,15,31,3.0,31,Controversy,31.0,26,0,-6,-10,0,stay,1981-11-07
18454,Prince,1982-05-15,Prince - Controversy,31,25,37,3.0,31,Controversy,31.0,27,-6,0,-6,1,down,1981-11-07
18455,Prince,1982-05-22,Prince - Controversy,31,31,45,3.0,37,Controversy,31.0,28,-8,-6,0,1,down,1981-11-07
18456,Prince,1982-05-29,Prince - Controversy,37,31,45,3.0,45,Controversy,31.0,29,0,-8,-6,0,stay,1981-11-07
18457,Prince,1982-06-05,Prince - Controversy,45,37,46,3.0,45,Controversy,31.0,30,-1,0,-8,1,down,1981-11-07
18458,Prince,1982-06-12,Prince - Controversy,45,45,51,3.0,46,Controversy,31.0,31,-5,-1,0,1,down,1981-11-07
18459,Earl Klugh,1981-11-07,Earl Klugh - Crazy For You,51,51,30,14.0,40,Crazy For You,16.0,0,10,11,0,1,up,1981-11-07
18460,Earl Klugh,1981-11-14,Earl Klugh - Crazy For You,40,51,22,14.0,30,Crazy For You,16.0,1,8,10,11,1,up,1981-11-07
18461,Earl Klugh,1981-11-21,Earl Klugh - Crazy For You,30,40,16,14.0,22,Crazy For You,16.0,2,6,8,10,1,up,1981-11-07
18462,Earl Klugh,1981-11-28,Earl Klugh - Crazy For You,22,30,14,14.0,16,Crazy For You,16.0,3,2,6,8,1,up,1981-11-07
18463,Earl Klugh,1981-12-05,Earl Klugh - Crazy For You,16,22,14,14.0,14,Crazy For You,16.0,4,0,2,6,0,stay,1981-11-07
18464,Earl Klugh,1981-12-12,Earl Klugh - Crazy For You,14,16,14,14.0,14,Crazy For You,16.0,5,0,0,2,0,stay,1981-11-07
18465,Earl Klugh,1981-12-19,Earl Klugh - Crazy For You,14,14,25,14.0,14,Crazy For You,16.0,6,-11,0,0,1,down,1981-11-07
18466,Earl Klugh,1981-12-26,Earl Klugh - Crazy For You,14,14,25,14.0,25,Crazy For You,16.0,7,0,-11,0,0,stay,1981-11-07
18467,Earl Klugh,1982-01-02,Earl Klugh - Crazy For You,25,14,26,14.0,25,Crazy For You,16.0,8,-1,0,-11,1,down,1981-11-07
18468,Earl Klugh,1982-01-09,Earl Klugh - Crazy For You,25,25,29,14.0,26,Crazy For You,16.0,9,-3,-1,0,1,down,1981-11-07
18469,Earl Klugh,1982-01-16,Earl Klugh - Crazy For You,26,25,33,14.0,29,Crazy For You,16.0,10,-4,-3,-1,1,down,1981-11-07
18470,Earl Klugh,1982-01-23,Earl Klugh - Crazy For You,29,26,33,14.0,33,Crazy For You,16.0,11,0,-4,-3,0,stay,1981-11-07
18471,Earl Klugh,1982-01-30,Earl Klugh - Crazy For You,33,29,32,14.0,33,Crazy For You,16.0,12,1,0,-4,1,up,1981-11-07
18472,Earl Klugh,1982-02-06,Earl Klugh - Crazy For You,33,33,32,14.0,32,Crazy For You,16.0,13,0,1,0,0,stay,1981-11-07
18473,Earl Klugh,1982-02-13,Earl Klugh - Crazy For You,32,33,49,14.0,32,Crazy For You,16.0,14,-17,0,1,1,down,1981-11-07
18474,Earl Klugh,1982-02-20,Earl Klugh - Crazy For You,32,32,49,14.0,49,Crazy For You,16.0,15,0,-17,0,0,stay,1981-11-07
18475,Earl Klugh,1982-02-27,Earl Klugh - Crazy For You,49,32,51,14.0,49,Crazy For You,16.0,16,-2,0,-17,1,down,1981-11-07
18476,Bob Marley,1981-11-07,Bob Marley - Chances Are,51,51,40,32.0,46,Chances Are,5.0,0,6,5,0,1,up,1981-11-07
18477,Bob Marley,1981-11-14,Bob Marley - Chances Are,46,51,36,32.0,40,Chances Are,5.0,1,4,6,5,1,up,1981-11-07
18478,Bob Marley,1981-11-21,Bob Marley - Chances Are,40,46,32,32.0,36,Chances Are,5.0,2,4,4,6,1,up,1981-11-07
18479,Bob Marley,1981-11-28,Bob Marley - Chances Are,36,40,32,32.0,32,Chances Are,5.0,3,0,4,4,0,stay,1981-11-07
18480,Bob Marley,1981-12-05,Bob Marley - Chances Are,32,36,41,32.0,32,Chances Are,5.0,4,-9,0,4,1,down,1981-11-07
18481,Bob Marley,1981-12-12,Bob Marley - Chances Are,32,32,51,32.0,41,Chances Are,5.0,5,-10,-9,0,1,down,1981-11-07
18482,Barry White,1981-11-07,Barry White - Beware,51,51,43,40.0,47,Beware,10.0,0,4,4,0,1,up,1981-11-07
18483,Barry White,1981-11-14,Barry White - Beware,47,51,41,40.0,43,Beware,10.0,1,2,4,4,1,up,1981-11-07
18484,Barry White,1981-11-21,Barry White - Beware,43,47,40,40.0,41,Beware,10.0,2,1,2,4,1,up,1981-11-07
18485,Barry White,1981-11-28,Barry White - Beware,41,43,40,40.0,40,Beware,10.0,3,0,1,2,0,stay,1981-11-07
18486,Barry White,1981-12-05,Barry White - Beware,40,41,46,40.0,40,Beware,10.0,4,-6,0,1,1,down,1981-11-07
18487,Barry White,1982-01-09,Barry White - Beware,40,40,46,40.0,46,Beware,10.0,5,0,-6,0,0,stay,1981-11-07
18488,Barry White,1982-01-16,Barry White - Beware,46,40,48,40.0,46,Beware,10.0,6,-2,0,-6,1,down,1981-11-07
18489,Barry White,1982-01-23,Barry White - Beware,46,46,48,40.0,48,Beware,10.0,7,0,-2,0,0,stay,1981-11-07
18490,Barry White,1982-01-30,Barry White - Beware,48,46,50,40.0,48,Beware,10.0,8,-2,0,-2,1,down,1981-11-07
18491,Barry White,1982-02-06,Barry White - Beware,48,48,50,40.0,50,Beware,10.0,9,0,-2,0,0,stay,1981-11-07
18492,Barry White,1982-02-13,Barry White - Beware,50,48,51,40.0,50,Beware,10.0,10,-1,0,-2,1,down,1981-11-07
18493,Diana Ross,1981-11-14,Diana Ross - Why Do Fools Fall In Love,51,51,10,4.0,23,Why Do Fools Fall In Love,29.0,0,13,28,0,1,up,1981-11-14
18494,Diana Ross,1981-11-21,Diana Ross - Why Do Fools Fall In Love,23,51,9,4.0,10,Why Do Fools Fall In Love,29.0,1,1,13,28,1,up,1981-11-14
18495,Diana Ross,1981-11-28,Diana Ross - Why Do Fools Fall In Love,10,23,9,4.0,9,Why Do Fools Fall In Love,29.0,2,0,1,13,0,stay,1981-11-14
18496,Diana Ross,1981-12-05,Diana Ross - Why Do Fools Fall In Love,9,10,8,4.0,9,Why Do Fools Fall In Love,29.0,3,1,0,1,1,up,1981-11-14
18497,Diana Ross,1981-12-12,Diana Ross - Why Do Fools Fall In Love,9,9,8,4.0,8,Why Do Fools Fall In Love,29.0,4,0,1,0,0,stay,1981-11-14
18498,Diana Ross,1981-12-19,Diana Ross - Why Do Fools Fall In Love,8,9,6,4.0,8,Why Do Fools Fall In Love,29.0,5,2,0,1,1,up,1981-11-14
18499,Diana Ross,1981-12-26,Diana Ross - Why Do Fools Fall In Love,8,8,6,4.0,6,Why Do Fools Fall In Love,29.0,6,0,2,0,0,stay,1981-11-14
18500,Diana Ross,1982-01-02,Diana Ross - Why Do Fools Fall In Love,6,8,5,4.0,6,Why Do Fools Fall In Love,29.0,7,1,0,2,1,up,1981-11-14
18501,Diana Ross,1982-01-09,Diana Ross - Why Do Fools Fall In Love,6,6,4,4.0,5,Why Do Fools Fall In Love,29.0,8,1,1,0,1,up,1981-11-14
18502,Diana Ross,1982-01-16,Diana Ross - Why Do Fools Fall In Love,5,6,4,4.0,4,Why Do Fools Fall In Love,29.0,9,0,1,1,0,stay,1981-11-14
18503,Diana Ross,1982-01-23,Diana Ross - Why Do Fools Fall In Love,4,5,9,4.0,4,Why Do Fools Fall In Love,29.0,10,-5,0,1,1,down,1981-11-14
18504,Diana Ross,1982-01-30,Diana Ross - Why Do Fools Fall In Love,4,4,9,4.0,9,Why Do Fools Fall In Love,29.0,11,0,-5,0,0,stay,1981-11-14
18505,Diana Ross,1982-02-06,Diana Ross - Why Do Fools Fall In Love,9,4,8,4.0,9,Why Do Fools Fall In Love,29.0,12,1,0,-5,1,up,1981-11-14
18506,Diana Ross,1982-02-13,Diana Ross - Why Do Fools Fall In Love,9,9,8,4.0,8,Why Do Fools Fall In Love,29.0,13,0,1,0,0,stay,1981-11-14
18507,Diana Ross,1982-02-20,Diana Ross - Why Do Fools Fall In Love,8,9,7,4.0,8,Why Do Fools Fall In Love,29.0,14,1,0,1,1,up,1981-11-14
18508,Diana Ross,1982-02-27,Diana Ross - Why Do Fools Fall In Love,8,8,7,4.0,7,Why Do Fools Fall In Love,29.0,15,0,1,0,0,stay,1981-11-14
18509,Diana Ross,1982-03-06,Diana Ross - Why Do Fools Fall In Love,7,8,11,4.0,7,Why Do Fools Fall In Love,29.0,16,-4,0,1,1,down,1981-11-14
18510,Diana Ross,1982-03-13,Diana Ross - Why Do Fools Fall In Love,7,7,11,4.0,11,Why Do Fools Fall In Love,29.0,17,0,-4,0,0,stay,1981-11-14
18511,Diana Ross,1982-03-20,Diana Ross - Why Do Fools Fall In Love,11,7,11,4.0,11,Why Do Fools Fall In Love,29.0,18,0,0,-4,0,stay,1981-11-14
18512,Diana Ross,1982-03-27,Diana Ross - Why Do Fools Fall In Love,11,11,14,4.0,11,Why Do Fools Fall In Love,29.0,19,-3,0,0,1,down,1981-11-14
18513,Diana Ross,1982-04-03,Diana Ross - Why Do Fools Fall In Love,11,11,15,4.0,14,Why Do Fools Fall In Love,29.0,20,-1,-3,0,1,down,1981-11-14
18514,Diana Ross,1982-04-10,Diana Ross - Why Do Fools Fall In Love,14,11,16,4.0,15,Why Do Fools Fall In Love,29.0,21,-1,-1,-3,1,down,1981-11-14
18515,Diana Ross,1982-04-17,Diana Ross - Why Do Fools Fall In Love,15,14,17,4.0,16,Why Do Fools Fall In Love,29.0,22,-1,-1,-1,1,down,1981-11-14
18516,Diana Ross,1982-04-24,Diana Ross - Why Do Fools Fall In Love,16,15,26,4.0,17,Why Do Fools Fall In Love,29.0,23,-9,-1,-1,1,down,1981-11-14
18517,Diana Ross,1982-05-01,Diana Ross - Why Do Fools Fall In Love,17,16,30,4.0,26,Why Do Fools Fall In Love,29.0,24,-4,-9,-1,1,down,1981-11-14
18518,Diana Ross,1982-05-08,Diana Ross - Why Do Fools Fall In Love,26,17,40,4.0,30,Why Do Fools Fall In Love,29.0,25,-10,-4,-9,1,down,1981-11-14
18519,Diana Ross,1982-05-15,Diana Ross - Why Do Fools Fall In Love,30,26,48,4.0,40,Why Do Fools Fall In Love,29.0,26,-8,-10,-4,1,down,1981-11-14
18520,Diana Ross,1982-05-22,Diana Ross - Why Do Fools Fall In Love,40,30,48,4.0,48,Why Do Fools Fall In Love,29.0,27,0,-8,-10,0,stay,1981-11-14
18521,Diana Ross,1982-05-29,Diana Ross - Why Do Fools Fall In Love,48,40,49,4.0,48,Why Do Fools Fall In Love,29.0,28,-1,0,-8,1,down,1981-11-14
18522,Diana Ross,1982-06-05,Diana Ross - Why Do Fools Fall In Love,48,48,51,4.0,49,Why Do Fools Fall In Love,29.0,29,-2,-1,0,1,down,1981-11-14
18523,"Earth, Wind & Fire",1981-11-14,"Earth, Wind & Fire - Raise",51,51,5,1.0,27,Raise,22.0,0,22,24,0,1,up,1981-11-14
18524,"Earth, Wind & Fire",1981-11-21,"Earth, Wind & Fire - Raise",27,51,1,1.0,5,Raise,22.0,1,4,22,24,1,up,1981-11-14
18525,"Earth, Wind & Fire",1981-11-28,"Earth, Wind & Fire - Raise",5,27,1,1.0,1,Raise,22.0,2,0,4,22,0,stay,1981-11-14
18526,"Earth, Wind & Fire",1981-12-05,"Earth, Wind & Fire - Raise",1,5,1,1.0,1,Raise,22.0,3,0,0,4,0,stay,1981-11-14
18527,"Earth, Wind & Fire",1981-12-12,"Earth, Wind & Fire - Raise",1,1,1,1.0,1,Raise,22.0,4,0,0,0,0,stay,1981-11-14
18528,"Earth, Wind & Fire",1981-12-19,"Earth, Wind & Fire - Raise",1,1,1,1.0,1,Raise,22.0,5,0,0,0,0,stay,1981-11-14
18529,"Earth, Wind & Fire",1981-12-26,"Earth, Wind & Fire - Raise",1,1,1,1.0,1,Raise,22.0,6,0,0,0,0,stay,1981-11-14
18530,"Earth, Wind & Fire",1982-01-02,"Earth, Wind & Fire - Raise",1,1,1,1.0,1,Raise,22.0,7,0,0,0,0,stay,1981-11-14
18531,"Earth, Wind & Fire",1982-01-09,"Earth, Wind & Fire - Raise",1,1,1,1.0,1,Raise,22.0,8,0,0,0,0,stay,1981-11-14
18532,"Earth, Wind & Fire",1982-01-16,"Earth, Wind & Fire - Raise",1,1,1,1.0,1,Raise,22.0,9,0,0,0,0,stay,1981-11-14
18533,"Earth, Wind & Fire",1982-01-23,"Earth, Wind & Fire - Raise",1,1,1,1.0,1,Raise,22.0,10,0,0,0,0,stay,1981-11-14
18534,"Earth, Wind & Fire",1982-01-30,"Earth, Wind & Fire - Raise",1,1,1,1.0,1,Raise,22.0,11,0,0,0,0,stay,1981-11-14
18535,"Earth, Wind & Fire",1982-02-06,"Earth, Wind & Fire - Raise",1,1,3,1.0,1,Raise,22.0,12,-2,0,0,1,down,1981-11-14
18536,"Earth, Wind & Fire",1982-02-13,"Earth, Wind & Fire - Raise",1,1,3,1.0,3,Raise,22.0,13,0,-2,0,0,stay,1981-11-14
18537,"Earth, Wind & Fire",1982-02-20,"Earth, Wind & Fire - Raise",3,1,3,1.0,3,Raise,22.0,14,0,0,-2,0,stay,1981-11-14
18538,"Earth, Wind & Fire",1982-02-27,"Earth, Wind & Fire - Raise",3,3,3,1.0,3,Raise,22.0,15,0,0,0,0,stay,1981-11-14
18539,"Earth, Wind & Fire",1982-03-06,"Earth, Wind & Fire - Raise",3,3,6,1.0,3,Raise,22.0,16,-3,0,0,1,down,1981-11-14
18540,"Earth, Wind & Fire",1982-03-13,"Earth, Wind & Fire - Raise",3,3,13,1.0,6,Raise,22.0,17,-7,-3,0,1,down,1981-11-14
18541,"Earth, Wind & Fire",1982-03-20,"Earth, Wind & Fire - Raise",6,3,16,1.0,13,Raise,22.0,18,-3,-7,-3,1,down,1981-11-14
18542,"Earth, Wind & Fire",1982-03-27,"Earth, Wind & Fire - Raise",13,6,23,1.0,16,Raise,22.0,19,-7,-3,-7,1,down,1981-11-14
18543,"Earth, Wind & Fire",1982-04-03,"Earth, Wind & Fire - Raise",16,13,33,1.0,23,Raise,22.0,20,-10,-7,-3,1,down,1981-11-14
18544,"Earth, Wind & Fire",1982-04-10,"Earth, Wind & Fire - Raise",23,16,46,1.0,33,Raise,22.0,21,-13,-10,-7,1,down,1981-11-14
18545,"Earth, Wind & Fire",1982-04-17,"Earth, Wind & Fire - Raise",33,23,51,1.0,46,Raise,22.0,22,-5,-13,-10,1,down,1981-11-14
18546,Rufus And Chaka Khan,1981-11-14,Rufus And Chaka Khan - Camouflage,51,51,24,15.0,31,Camouflage,12.0,0,7,20,0,1,up,1981-11-14
18547,Rufus And Chaka Khan,1981-11-21,Rufus And Chaka Khan - Camouflage,31,51,20,15.0,24,Camouflage,12.0,1,4,7,20,1,up,1981-11-14
18548,Rufus And Chaka Khan,1981-11-28,Rufus And Chaka Khan - Camouflage,24,31,17,15.0,20,Camouflage,12.0,2,3,4,7,1,up,1981-11-14
18549,Rufus And Chaka Khan,1981-12-05,Rufus And Chaka Khan - Camouflage,20,24,15,15.0,17,Camouflage,12.0,3,2,3,4,1,up,1981-11-14
18550,Rufus And Chaka Khan,1981-12-12,Rufus And Chaka Khan - Camouflage,17,20,15,15.0,15,Camouflage,12.0,4,0,2,3,0,stay,1981-11-14
18551,Rufus And Chaka Khan,1981-12-19,Rufus And Chaka Khan - Camouflage,15,17,15,15.0,15,Camouflage,12.0,5,0,0,2,0,stay,1981-11-14
18552,Rufus And Chaka Khan,1981-12-26,Rufus And Chaka Khan - Camouflage,15,15,15,15.0,15,Camouflage,12.0,6,0,0,0,0,stay,1981-11-14
18553,Rufus And Chaka Khan,1982-01-02,Rufus And Chaka Khan - Camouflage,15,15,17,15.0,15,Camouflage,12.0,7,-2,0,0,1,down,1981-11-14
18554,Rufus And Chaka Khan,1982-01-09,Rufus And Chaka Khan - Camouflage,15,15,17,15.0,17,Camouflage,12.0,8,0,-2,0,0,stay,1981-11-14
18555,Rufus And Chaka Khan,1982-01-16,Rufus And Chaka Khan - Camouflage,17,15,31,15.0,17,Camouflage,12.0,9,-14,0,-2,1,down,1981-11-14
18556,Rufus And Chaka Khan,1982-01-23,Rufus And Chaka Khan - Camouflage,17,17,46,15.0,31,Camouflage,12.0,10,-15,-14,0,1,down,1981-11-14
18557,Rufus And Chaka Khan,1982-01-30,Rufus And Chaka Khan - Camouflage,31,17,44,15.0,46,Camouflage,12.0,11,2,-15,-14,1,up,1981-11-14
18558,Rufus And Chaka Khan,1982-02-06,Rufus And Chaka Khan - Camouflage,46,31,51,15.0,44,Camouflage,12.0,12,-7,2,-15,1,down,1981-11-14
18559,Harold Melvin And The Blue Notes,1981-11-14,Harold Melvin And The Blue Notes - All Things Happen In Time,51,51,47,47.0,47,All Things Happen In Time,1.0,0,0,4,0,0,stay,1981-11-14
18560,Harold Melvin And The Blue Notes,1981-11-21,Harold Melvin And The Blue Notes - All Things Happen In Time,47,51,51,47.0,47,All Things Happen In Time,1.0,1,-4,0,4,1,down,1981-11-14
18561,"Grover Washington, Jr.",1981-11-14,"Grover Washington, Jr. - Anthology",51,51,44,44.0,49,Anthology,2.0,0,5,2,0,1,up,1981-11-14
18562,"Grover Washington, Jr.",1981-11-21,"Grover Washington, Jr. - Anthology",49,51,44,44.0,44,Anthology,2.0,1,0,5,2,0,stay,1981-11-14
18563,"Grover Washington, Jr.",1981-11-28,"Grover Washington, Jr. - Anthology",44,49,51,44.0,44,Anthology,2.0,2,-7,0,5,1,down,1981-11-14
18564,Barkays,1981-11-21,Barkays - Night Cruisin,51,51,21,6.0,43,Night Cruisin,28.0,0,22,8,0,1,up,1981-11-21
18565,Barkays,1981-11-28,Barkays - Night Cruisin,43,51,16,6.0,21,Night Cruisin,28.0,1,5,22,8,1,up,1981-11-21
18566,Barkays,1981-12-05,Barkays - Night Cruisin,21,43,10,6.0,16,Night Cruisin,28.0,2,6,5,22,1,up,1981-11-21
18567,Barkays,1981-12-12,Barkays - Night Cruisin,16,21,9,6.0,10,Night Cruisin,28.0,3,1,6,5,1,up,1981-11-21
18568,Barkays,1981-12-19,Barkays - Night Cruisin,10,16,8,6.0,9,Night Cruisin,28.0,4,1,1,6,1,up,1981-11-21
18569,Barkays,1981-12-26,Barkays - Night Cruisin,9,10,8,6.0,8,Night Cruisin,28.0,5,0,1,1,0,stay,1981-11-21
18570,Barkays,1982-01-02,Barkays - Night Cruisin,8,9,8,6.0,8,Night Cruisin,28.0,6,0,0,1,0,stay,1981-11-21
18571,Barkays,1982-01-09,Barkays - Night Cruisin,8,8,7,6.0,8,Night Cruisin,28.0,7,1,0,0,1,up,1981-11-21
18572,Barkays,1982-01-16,Barkays - Night Cruisin,8,8,7,6.0,7,Night Cruisin,28.0,8,0,1,0,0,stay,1981-11-21
18573,Barkays,1982-01-23,Barkays - Night Cruisin,7,8,7,6.0,7,Night Cruisin,28.0,9,0,0,1,0,stay,1981-11-21
18574,Barkays,1982-01-30,Barkays - Night Cruisin,7,7,7,6.0,7,Night Cruisin,28.0,10,0,0,0,0,stay,1981-11-21
18575,Barkays,1982-02-06,Barkays - Night Cruisin,7,7,6,6.0,7,Night Cruisin,28.0,11,1,0,0,1,up,1981-11-21
18576,Barkays,1982-02-13,Barkays - Night Cruisin,7,7,6,6.0,6,Night Cruisin,28.0,12,0,1,0,0,stay,1981-11-21
18577,Barkays,1982-02-20,Barkays - Night Cruisin,6,7,10,6.0,6,Night Cruisin,28.0,13,-4,0,1,1,down,1981-11-21
18578,Barkays,1982-02-27,Barkays - Night Cruisin,6,6,12,6.0,10,Night Cruisin,28.0,14,-2,-4,0,1,down,1981-11-21
18579,Barkays,1982-03-06,Barkays - Night Cruisin,10,6,12,6.0,12,Night Cruisin,28.0,15,0,-2,-4,0,stay,1981-11-21
18580,Barkays,1982-03-13,Barkays - Night Cruisin,12,10,21,6.0,12,Night Cruisin,28.0,16,-9,0,-2,1,down,1981-11-21
18581,Barkays,1982-03-20,Barkays - Night Cruisin,12,12,21,6.0,21,Night Cruisin,28.0,17,0,-9,0,0,stay,1981-11-21
18582,Barkays,1982-03-27,Barkays - Night Cruisin,21,12,19,6.0,21,Night Cruisin,28.0,18,2,0,-9,1,up,1981-11-21
18583,Barkays,1982-04-03,Barkays - Night Cruisin,21,21,18,6.0,19,Night Cruisin,28.0,19,1,2,0,1,up,1981-11-21
18584,Barkays,1982-04-10,Barkays - Night Cruisin,19,21,18,6.0,18,Night Cruisin,28.0,20,0,1,2,0,stay,1981-11-21
18585,Barkays,1982-04-17,Barkays - Night Cruisin,18,19,28,6.0,18,Night Cruisin,28.0,21,-10,0,1,1,down,1981-11-21
18586,Barkays,1982-04-24,Barkays - Night Cruisin,18,18,28,6.0,28,Night Cruisin,28.0,22,0,-10,0,0,stay,1981-11-21
18587,Barkays,1982-05-01,Barkays - Night Cruisin,28,18,28,6.0,28,Night Cruisin,28.0,23,0,0,-10,0,stay,1981-11-21
18588,Barkays,1982-05-08,Barkays - Night Cruisin,28,28,38,6.0,28,Night Cruisin,28.0,24,-10,0,0,1,down,1981-11-21
18589,Barkays,1982-05-15,Barkays - Night Cruisin,28,28,40,6.0,38,Night Cruisin,28.0,25,-2,-10,0,1,down,1981-11-21
18590,Barkays,1982-05-22,Barkays - Night Cruisin,38,28,43,6.0,40,Night Cruisin,28.0,26,-3,-2,-10,1,down,1981-11-21
18591,Barkays,1982-05-29,Barkays - Night Cruisin,40,38,48,6.0,43,Night Cruisin,28.0,27,-5,-3,-2,1,down,1981-11-21
18592,Barkays,1982-06-05,Barkays - Night Cruisin,43,40,51,6.0,48,Night Cruisin,28.0,28,-3,-5,-3,1,down,1981-11-21
18593,Bobby Womack,1981-11-21,Bobby Womack - The Poet,51,51,35,1.0,45,The Poet,30.0,0,10,6,0,1,up,1981-11-21
18594,Bobby Womack,1981-11-28,Bobby Womack - The Poet,45,51,31,1.0,35,The Poet,30.0,1,4,10,6,1,up,1981-11-21
18595,Bobby Womack,1981-12-05,Bobby Womack - The Poet,35,45,21,1.0,31,The Poet,30.0,2,10,4,10,1,up,1981-11-21
18596,Bobby Womack,1981-12-12,Bobby Womack - The Poet,31,35,19,1.0,21,The Poet,30.0,3,2,10,4,1,up,1981-11-21
18597,Bobby Womack,1981-12-19,Bobby Womack - The Poet,21,31,17,1.0,19,The Poet,30.0,4,2,2,10,1,up,1981-11-21
18598,Bobby Womack,1981-12-26,Bobby Womack - The Poet,19,21,17,1.0,17,The Poet,30.0,5,0,2,2,0,stay,1981-11-21
18599,Bobby Womack,1982-01-02,Bobby Womack - The Poet,17,19,16,1.0,17,The Poet,30.0,6,1,0,2,1,up,1981-11-21
18600,Bobby Womack,1982-01-09,Bobby Womack - The Poet,17,17,14,1.0,16,The Poet,30.0,7,2,1,0,1,up,1981-11-21
18601,Bobby Womack,1982-01-16,Bobby Womack - The Poet,16,17,8,1.0,14,The Poet,30.0,8,6,2,1,1,up,1981-11-21
18602,Bobby Womack,1982-01-23,Bobby Womack - The Poet,14,16,6,1.0,8,The Poet,30.0,9,2,6,2,1,up,1981-11-21
18603,Bobby Womack,1982-01-30,Bobby Womack - The Poet,8,14,6,1.0,6,The Poet,30.0,10,0,2,6,0,stay,1981-11-21
18604,Bobby Womack,1982-02-06,Bobby Womack - The Poet,6,8,2,1.0,6,The Poet,30.0,11,4,0,2,1,up,1981-11-21
18605,Bobby Womack,1982-02-13,Bobby Womack - The Poet,6,6,1,1.0,2,The Poet,30.0,12,1,4,0,1,up,1981-11-21
18606,Bobby Womack,1982-02-20,Bobby Womack - The Poet,2,6,1,1.0,1,The Poet,30.0,13,0,1,4,0,stay,1981-11-21
18607,Bobby Womack,1982-02-27,Bobby Womack - The Poet,1,2,1,1.0,1,The Poet,30.0,14,0,0,1,0,stay,1981-11-21
18608,Bobby Womack,1982-03-06,Bobby Womack - The Poet,1,1,1,1.0,1,The Poet,30.0,15,0,0,0,0,stay,1981-11-21
18609,Bobby Womack,1982-03-13,Bobby Womack - The Poet,1,1,1,1.0,1,The Poet,30.0,16,0,0,0,0,stay,1981-11-21
18610,Bobby Womack,1982-03-20,Bobby Womack - The Poet,1,1,3,1.0,1,The Poet,30.0,17,-2,0,0,1,down,1981-11-21
18611,Bobby Womack,1982-03-27,Bobby Womack - The Poet,1,1,3,1.0,3,The Poet,30.0,18,0,-2,0,0,stay,1981-11-21
18612,Bobby Womack,1982-04-03,Bobby Womack - The Poet,3,1,10,1.0,3,The Poet,30.0,19,-7,0,-2,1,down,1981-11-21
18613,Bobby Womack,1982-04-10,Bobby Womack - The Poet,3,3,10,1.0,10,The Poet,30.0,20,0,-7,0,0,stay,1981-11-21
18614,Bobby Womack,1982-04-17,Bobby Womack - The Poet,10,3,10,1.0,10,The Poet,30.0,21,0,0,-7,0,stay,1981-11-21
18615,Bobby Womack,1982-04-24,Bobby Womack - The Poet,10,10,14,1.0,10,The Poet,30.0,22,-4,0,0,1,down,1981-11-21
18616,Bobby Womack,1982-05-01,Bobby Womack - The Poet,10,10,24,1.0,14,The Poet,30.0,23,-10,-4,0,1,down,1981-11-21
18617,Bobby Womack,1982-05-08,Bobby Womack - The Poet,14,10,25,1.0,24,The Poet,30.0,24,-1,-10,-4,1,down,1981-11-21
18618,Bobby Womack,1982-05-15,Bobby Womack - The Poet,24,14,30,1.0,25,The Poet,30.0,25,-5,-1,-10,1,down,1981-11-21
18619,Bobby Womack,1982-05-22,Bobby Womack - The Poet,25,24,34,1.0,30,The Poet,30.0,26,-4,-5,-1,1,down,1981-11-21
18620,Bobby Womack,1982-05-29,Bobby Womack - The Poet,30,25,34,1.0,34,The Poet,30.0,27,0,-4,-5,0,stay,1981-11-21
18621,Bobby Womack,1982-06-05,Bobby Womack - The Poet,34,30,40,1.0,34,The Poet,30.0,28,-6,0,-4,1,down,1981-11-21
18622,Bobby Womack,1982-06-12,Bobby Womack - The Poet,34,34,48,1.0,40,The Poet,30.0,29,-8,-6,0,1,down,1981-11-21
18623,Bobby Womack,1982-06-19,Bobby Womack - The Poet,40,34,51,1.0,48,The Poet,30.0,30,-3,-8,-6,1,down,1981-11-21
18624,Melba Moore,1981-11-21,Melba Moore - What A Woman Needs,51,51,46,46.0,46,What A Woman Needs,1.0,0,0,5,0,0,stay,1981-11-21
18625,Melba Moore,1981-11-28,Melba Moore - What A Woman Needs,46,51,51,46.0,46,What A Woman Needs,1.0,1,-5,0,5,1,down,1981-11-21
18626,GQ,1981-11-21,GQ - Face To Face,51,51,38,18.0,48,Face To Face,12.0,0,10,3,0,1,up,1981-11-21
18627,GQ,1981-11-28,GQ - Face To Face,48,51,30,18.0,38,Face To Face,12.0,1,8,10,3,1,up,1981-11-21
18628,GQ,1981-12-05,GQ - Face To Face,38,48,25,18.0,30,Face To Face,12.0,2,5,8,10,1,up,1981-11-21
18629,GQ,1981-12-12,GQ - Face To Face,30,38,21,18.0,25,Face To Face,12.0,3,4,5,8,1,up,1981-11-21
18630,GQ,1981-12-19,GQ - Face To Face,25,30,18,18.0,21,Face To Face,12.0,4,3,4,5,1,up,1981-11-21
18631,GQ,1981-12-26,GQ - Face To Face,21,25,18,18.0,18,Face To Face,12.0,5,0,3,4,0,stay,1981-11-21
18632,GQ,1982-01-02,GQ - Face To Face,18,21,18,18.0,18,Face To Face,12.0,6,0,0,3,0,stay,1981-11-21
18633,GQ,1982-01-09,GQ - Face To Face,18,18,32,18.0,18,Face To Face,12.0,7,-14,0,0,1,down,1981-11-21
18634,GQ,1982-01-16,GQ - Face To Face,18,18,34,18.0,32,Face To Face,12.0,8,-2,-14,0,1,down,1981-11-21
18635,GQ,1982-01-23,GQ - Face To Face,32,18,42,18.0,34,Face To Face,12.0,9,-8,-2,-14,1,down,1981-11-21
18636,GQ,1982-01-30,GQ - Face To Face,34,32,42,18.0,42,Face To Face,12.0,10,0,-8,-2,0,stay,1981-11-21
18637,GQ,1982-02-06,GQ - Face To Face,42,34,45,18.0,42,Face To Face,12.0,11,-3,0,-8,1,down,1981-11-21
18638,GQ,1982-02-13,GQ - Face To Face,42,42,51,18.0,45,Face To Face,12.0,12,-6,-3,0,1,down,1981-11-21
18639,Skyy,1981-11-21,Skyy - Skyy Line,51,51,39,1.0,49,Skyy Line,34.0,0,10,2,0,1,up,1981-11-21
18640,Skyy,1981-11-28,Skyy - Skyy Line,49,51,29,1.0,39,Skyy Line,34.0,1,10,10,2,1,up,1981-11-21
18641,Skyy,1981-12-05,Skyy - Skyy Line,39,49,19,1.0,29,Skyy Line,34.0,2,10,10,10,1,up,1981-11-21
18642,Skyy,1981-12-12,Skyy - Skyy Line,29,39,18,1.0,19,Skyy Line,34.0,3,1,10,10,1,up,1981-11-21
18643,Skyy,1981-12-19,Skyy - Skyy Line,19,29,13,1.0,18,Skyy Line,34.0,4,5,1,10,1,up,1981-11-21
18644,Skyy,1981-12-26,Skyy - Skyy Line,18,19,13,1.0,13,Skyy Line,34.0,5,0,5,1,0,stay,1981-11-21
18645,Skyy,1982-01-02,Skyy - Skyy Line,13,18,11,1.0,13,Skyy Line,34.0,6,2,0,5,1,up,1981-11-21
18646,Skyy,1982-01-09,Skyy - Skyy Line,13,13,8,1.0,11,Skyy Line,34.0,7,3,2,0,1,up,1981-11-21
18647,Skyy,1982-01-16,Skyy - Skyy Line,11,13,6,1.0,8,Skyy Line,34.0,8,2,3,2,1,up,1981-11-21
18648,Skyy,1982-01-23,Skyy - Skyy Line,8,11,4,1.0,6,Skyy Line,34.0,9,2,2,3,1,up,1981-11-21
18649,Skyy,1982-01-30,Skyy - Skyy Line,6,8,3,1.0,4,Skyy Line,34.0,10,1,2,2,1,up,1981-11-21
18650,Skyy,1982-02-06,Skyy - Skyy Line,4,6,1,1.0,3,Skyy Line,34.0,11,2,1,2,1,up,1981-11-21
18651,Skyy,1982-02-13,Skyy - Skyy Line,3,4,2,1.0,1,Skyy Line,34.0,12,-1,2,1,1,down,1981-11-21
18652,Skyy,1982-02-20,Skyy - Skyy Line,1,3,2,1.0,2,Skyy Line,34.0,13,0,-1,2,0,stay,1981-11-21
18653,Skyy,1982-02-27,Skyy - Skyy Line,2,1,2,1.0,2,Skyy Line,34.0,14,0,0,-1,0,stay,1981-11-21
18654,Skyy,1982-03-06,Skyy - Skyy Line,2,2,2,1.0,2,Skyy Line,34.0,15,0,0,0,0,stay,1981-11-21
18655,Skyy,1982-03-13,Skyy - Skyy Line,2,2,2,1.0,2,Skyy Line,34.0,16,0,0,0,0,stay,1981-11-21
18656,Skyy,1982-03-20,Skyy - Skyy Line,2,2,1,1.0,2,Skyy Line,34.0,17,1,0,0,1,up,1981-11-21
18657,Skyy,1982-03-27,Skyy - Skyy Line,2,2,1,1.0,1,Skyy Line,34.0,18,0,1,0,0,stay,1981-11-21
18658,Skyy,1982-04-03,Skyy - Skyy Line,1,2,1,1.0,1,Skyy Line,34.0,19,0,0,1,0,stay,1981-11-21
18659,Skyy,1982-04-10,Skyy - Skyy Line,1,1,5,1.0,1,Skyy Line,34.0,20,-4,0,0,1,down,1981-11-21
18660,Skyy,1982-04-17,Skyy - Skyy Line,1,1,6,1.0,5,Skyy Line,34.0,21,-1,-4,0,1,down,1981-11-21
18661,Skyy,1982-04-24,Skyy - Skyy Line,5,1,6,1.0,6,Skyy Line,34.0,22,0,-1,-4,0,stay,1981-11-21
18662,Skyy,1982-05-01,Skyy - Skyy Line,6,5,14,1.0,6,Skyy Line,34.0,23,-8,0,-1,1,down,1981-11-21
18663,Skyy,1982-05-08,Skyy - Skyy Line,6,6,23,1.0,14,Skyy Line,34.0,24,-9,-8,0,1,down,1981-11-21
18664,Skyy,1982-05-15,Skyy - Skyy Line,14,6,26,1.0,23,Skyy Line,34.0,25,-3,-9,-8,1,down,1981-11-21
18665,Skyy,1982-05-22,Skyy - Skyy Line,23,14,26,1.0,26,Skyy Line,34.0,26,0,-3,-9,0,stay,1981-11-21
18666,Skyy,1982-05-29,Skyy - Skyy Line,26,23,28,1.0,26,Skyy Line,34.0,27,-2,0,-3,1,down,1981-11-21
18667,Skyy,1982-06-05,Skyy - Skyy Line,26,26,37,1.0,28,Skyy Line,34.0,28,-9,-2,0,1,down,1981-11-21
18668,Skyy,1982-06-12,Skyy - Skyy Line,28,26,37,1.0,37,Skyy Line,34.0,29,0,-9,-2,0,stay,1981-11-21
18669,Skyy,1982-06-19,Skyy - Skyy Line,37,28,36,1.0,37,Skyy Line,34.0,30,1,0,-9,1,up,1981-11-21
18670,Skyy,1982-06-26,Skyy - Skyy Line,37,37,38,1.0,36,Skyy Line,34.0,31,-2,1,0,1,down,1981-11-21
18671,Skyy,1982-07-03,Skyy - Skyy Line,36,37,38,1.0,38,Skyy Line,34.0,32,0,-2,1,0,stay,1981-11-21
18672,Skyy,1982-07-10,Skyy - Skyy Line,38,36,50,1.0,38,Skyy Line,34.0,33,-12,0,-2,1,down,1981-11-21
18673,Skyy,1982-08-07,Skyy - Skyy Line,38,38,51,1.0,50,Skyy Line,34.0,34,-1,-12,0,1,down,1981-11-21
18674,George Benson,1981-11-28,George Benson - The George Benson Collection,51,51,19,5.0,30,The George Benson Collection,26.0,0,11,21,0,1,up,1981-11-28
18675,George Benson,1981-12-05,George Benson - The George Benson Collection,30,51,11,5.0,19,The George Benson Collection,26.0,1,8,11,21,1,up,1981-11-28
18676,George Benson,1981-12-12,George Benson - The George Benson Collection,19,30,10,5.0,11,The George Benson Collection,26.0,2,1,8,11,1,up,1981-11-28
18677,George Benson,1981-12-19,George Benson - The George Benson Collection,11,19,9,5.0,10,The George Benson Collection,26.0,3,1,1,8,1,up,1981-11-28
18678,George Benson,1981-12-26,George Benson - The George Benson Collection,10,11,9,5.0,9,The George Benson Collection,26.0,4,0,1,1,0,stay,1981-11-28
18679,George Benson,1982-01-02,George Benson - The George Benson Collection,9,10,7,5.0,9,The George Benson Collection,26.0,5,2,0,1,1,up,1981-11-28
18680,George Benson,1982-01-09,George Benson - The George Benson Collection,9,9,5,5.0,7,The George Benson Collection,26.0,6,2,2,0,1,up,1981-11-28
18681,George Benson,1982-01-16,George Benson - The George Benson Collection,7,9,5,5.0,5,The George Benson Collection,26.0,7,0,2,2,0,stay,1981-11-28
18682,George Benson,1982-01-23,George Benson - The George Benson Collection,5,7,5,5.0,5,The George Benson Collection,26.0,8,0,0,2,0,stay,1981-11-28
18683,George Benson,1982-01-30,George Benson - The George Benson Collection,5,5,5,5.0,5,The George Benson Collection,26.0,9,0,0,0,0,stay,1981-11-28
18684,George Benson,1982-02-06,George Benson - The George Benson Collection,5,5,7,5.0,5,The George Benson Collection,26.0,10,-2,0,0,1,down,1981-11-28
18685,George Benson,1982-02-13,George Benson - The George Benson Collection,5,5,14,5.0,7,The George Benson Collection,26.0,11,-7,-2,0,1,down,1981-11-28
18686,George Benson,1982-02-20,George Benson - The George Benson Collection,7,5,14,5.0,14,The George Benson Collection,26.0,12,0,-7,-2,0,stay,1981-11-28
18687,George Benson,1982-02-27,George Benson - The George Benson Collection,14,7,15,5.0,14,The George Benson Collection,26.0,13,-1,0,-7,1,down,1981-11-28
18688,George Benson,1982-03-06,George Benson - The George Benson Collection,14,14,19,5.0,15,The George Benson Collection,26.0,14,-4,-1,0,1,down,1981-11-28
18689,George Benson,1982-03-13,George Benson - The George Benson Collection,15,14,22,5.0,19,The George Benson Collection,26.0,15,-3,-4,-1,1,down,1981-11-28
18690,George Benson,1982-03-20,George Benson - The George Benson Collection,19,15,22,5.0,22,The George Benson Collection,26.0,16,0,-3,-4,0,stay,1981-11-28
18691,George Benson,1982-03-27,George Benson - The George Benson Collection,22,19,24,5.0,22,The George Benson Collection,26.0,17,-2,0,-3,1,down,1981-11-28
18692,George Benson,1982-04-03,George Benson - The George Benson Collection,22,22,24,5.0,24,The George Benson Collection,26.0,18,0,-2,0,0,stay,1981-11-28
18693,George Benson,1982-04-10,George Benson - The George Benson Collection,24,22,25,5.0,24,The George Benson Collection,26.0,19,-1,0,-2,1,down,1981-11-28
18694,George Benson,1982-04-17,George Benson - The George Benson Collection,24,24,30,5.0,25,The George Benson Collection,26.0,20,-5,-1,0,1,down,1981-11-28
18695,George Benson,1982-04-24,George Benson - The George Benson Collection,25,24,33,5.0,30,The George Benson Collection,26.0,21,-3,-5,-1,1,down,1981-11-28
18696,George Benson,1982-05-01,George Benson - The George Benson Collection,30,25,35,5.0,33,The George Benson Collection,26.0,22,-2,-3,-5,1,down,1981-11-28
18697,George Benson,1982-05-08,George Benson - The George Benson Collection,33,30,35,5.0,35,The George Benson Collection,26.0,23,0,-2,-3,0,stay,1981-11-28
18698,George Benson,1982-05-15,George Benson - The George Benson Collection,35,33,38,5.0,35,The George Benson Collection,26.0,24,-3,0,-2,1,down,1981-11-28
18699,George Benson,1982-05-22,George Benson - The George Benson Collection,35,35,46,5.0,38,The George Benson Collection,26.0,25,-8,-3,0,1,down,1981-11-28
18700,George Benson,1982-05-29,George Benson - The George Benson Collection,38,35,51,5.0,46,The George Benson Collection,26.0,26,-5,-8,-3,1,down,1981-11-28
18701,The Jacksons,1981-11-28,The Jacksons - Jacksons Live,51,51,21,10.0,34,Jacksons Live,17.0,0,13,17,0,1,up,1981-11-28
18702,The Jacksons,1981-12-05,The Jacksons - Jacksons Live,34,51,16,10.0,21,Jacksons Live,17.0,1,5,13,17,1,up,1981-11-28
18703,The Jacksons,1981-12-12,The Jacksons - Jacksons Live,21,34,11,10.0,16,Jacksons Live,17.0,2,5,5,13,1,up,1981-11-28
18704,The Jacksons,1981-12-19,The Jacksons - Jacksons Live,16,21,11,10.0,11,Jacksons Live,17.0,3,0,5,5,0,stay,1981-11-28
18705,The Jacksons,1981-12-26,The Jacksons - Jacksons Live,11,16,11,10.0,11,Jacksons Live,17.0,4,0,0,5,0,stay,1981-11-28
18706,The Jacksons,1982-01-02,The Jacksons - Jacksons Live,11,11,10,10.0,11,Jacksons Live,17.0,5,1,0,0,1,up,1981-11-28
18707,The Jacksons,1982-01-09,The Jacksons - Jacksons Live,11,11,10,10.0,10,Jacksons Live,17.0,6,0,1,0,0,stay,1981-11-28
18708,The Jacksons,1982-01-16,The Jacksons - Jacksons Live,10,11,10,10.0,10,Jacksons Live,17.0,7,0,0,1,0,stay,1981-11-28
18709,The Jacksons,1982-01-23,The Jacksons - Jacksons Live,10,10,10,10.0,10,Jacksons Live,17.0,8,0,0,0,0,stay,1981-11-28
18710,The Jacksons,1982-01-30,The Jacksons - Jacksons Live,10,10,22,10.0,10,Jacksons Live,17.0,9,-12,0,0,1,down,1981-11-28
18711,The Jacksons,1982-02-06,The Jacksons - Jacksons Live,10,10,18,10.0,22,Jacksons Live,17.0,10,4,-12,0,1,up,1981-11-28
18712,The Jacksons,1982-02-13,The Jacksons - Jacksons Live,22,10,18,10.0,18,Jacksons Live,17.0,11,0,4,-12,0,stay,1981-11-28
18713,The Jacksons,1982-02-20,The Jacksons - Jacksons Live,18,22,17,10.0,18,Jacksons Live,17.0,12,1,0,4,1,up,1981-11-28
18714,The Jacksons,1982-02-27,The Jacksons - Jacksons Live,18,18,24,10.0,17,Jacksons Live,17.0,13,-7,1,0,1,down,1981-11-28
18715,The Jacksons,1982-03-06,The Jacksons - Jacksons Live,17,18,25,10.0,24,Jacksons Live,17.0,14,-1,-7,1,1,down,1981-11-28
18716,The Jacksons,1982-03-13,The Jacksons - Jacksons Live,24,17,26,10.0,25,Jacksons Live,17.0,15,-1,-1,-7,1,down,1981-11-28
18717,The Jacksons,1982-03-20,The Jacksons - Jacksons Live,25,24,27,10.0,26,Jacksons Live,17.0,16,-1,-1,-1,1,down,1981-11-28
18718,The Jacksons,1982-03-27,The Jacksons - Jacksons Live,26,25,51,10.0,27,Jacksons Live,17.0,17,-24,-1,-1,1,down,1981-11-28
18719,Angela Bofill,1981-11-28,Angela Bofill - Something About You,51,51,24,13.0,36,Something About You,22.0,0,12,15,0,1,up,1981-11-28
18720,Angela Bofill,1981-12-05,Angela Bofill - Something About You,36,51,18,13.0,24,Something About You,22.0,1,6,12,15,1,up,1981-11-28
18721,Angela Bofill,1981-12-12,Angela Bofill - Something About You,24,36,16,13.0,18,Something About You,22.0,2,2,6,12,1,up,1981-11-28
18722,Angela Bofill,1981-12-19,Angela Bofill - Something About You,18,24,14,13.0,16,Something About You,22.0,3,2,2,6,1,up,1981-11-28
18723,Angela Bofill,1981-12-26,Angela Bofill - Something About You,16,18,14,13.0,14,Something About You,22.0,4,0,2,2,0,stay,1981-11-28
18724,Angela Bofill,1982-01-02,Angela Bofill - Something About You,14,16,13,13.0,14,Something About You,22.0,5,1,0,2,1,up,1981-11-28
18725,Angela Bofill,1982-01-09,Angela Bofill - Something About You,14,14,13,13.0,13,Something About You,22.0,6,0,1,0,0,stay,1981-11-28
18726,Angela Bofill,1982-01-16,Angela Bofill - Something About You,13,14,13,13.0,13,Something About You,22.0,7,0,0,1,0,stay,1981-11-28
18727,Angela Bofill,1982-01-23,Angela Bofill - Something About You,13,13,13,13.0,13,Something About You,22.0,8,0,0,0,0,stay,1981-11-28
18728,Angela Bofill,1982-01-30,Angela Bofill - Something About You,13,13,13,13.0,13,Something About You,22.0,9,0,0,0,0,stay,1981-11-28
18729,Angela Bofill,1982-02-06,Angela Bofill - Something About You,13,13,26,13.0,13,Something About You,22.0,10,-13,0,0,1,down,1981-11-28
18730,Angela Bofill,1982-02-13,Angela Bofill - Something About You,13,13,28,13.0,26,Something About You,22.0,11,-2,-13,0,1,down,1981-11-28
18731,Angela Bofill,1982-02-20,Angela Bofill - Something About You,26,13,36,13.0,28,Something About You,22.0,12,-8,-2,-13,1,down,1981-11-28
18732,Angela Bofill,1982-02-27,Angela Bofill - Something About You,28,26,35,13.0,36,Something About You,22.0,13,1,-8,-2,1,up,1981-11-28
18733,Angela Bofill,1982-03-06,Angela Bofill - Something About You,36,28,35,13.0,35,Something About You,22.0,14,0,1,-8,0,stay,1981-11-28
18734,Angela Bofill,1982-03-13,Angela Bofill - Something About You,35,36,34,13.0,35,Something About You,22.0,15,1,0,1,1,up,1981-11-28
18735,Angela Bofill,1982-03-20,Angela Bofill - Something About You,35,35,32,13.0,34,Something About You,22.0,16,2,1,0,1,up,1981-11-28
18736,Angela Bofill,1982-03-27,Angela Bofill - Something About You,34,35,30,13.0,32,Something About You,22.0,17,2,2,1,1,up,1981-11-28
18737,Angela Bofill,1982-04-03,Angela Bofill - Something About You,32,34,36,13.0,30,Something About You,22.0,18,-6,2,2,1,down,1981-11-28
18738,Angela Bofill,1982-04-10,Angela Bofill - Something About You,30,32,42,13.0,36,Something About You,22.0,19,-6,-6,2,1,down,1981-11-28
18739,Angela Bofill,1982-04-17,Angela Bofill - Something About You,36,30,40,13.0,42,Something About You,22.0,20,2,-6,-6,1,up,1981-11-28
18740,Angela Bofill,1982-04-24,Angela Bofill - Something About You,42,36,40,13.0,40,Something About You,22.0,21,0,2,-6,0,stay,1981-11-28
18741,Angela Bofill,1982-05-01,Angela Bofill - Something About You,40,42,51,13.0,40,Something About You,22.0,22,-11,0,2,1,down,1981-11-28
18742,Gwen McCrae,1981-11-28,Gwen McCrae - Gwen McCrae,51,51,43,38.0,47,Gwen McCrae,5.0,0,4,4,0,1,up,1981-11-28
18743,Gwen McCrae,1981-12-05,Gwen McCrae - Gwen McCrae,47,51,38,38.0,43,Gwen McCrae,5.0,1,5,4,4,1,up,1981-11-28
18744,Gwen McCrae,1981-12-12,Gwen McCrae - Gwen McCrae,43,47,38,38.0,38,Gwen McCrae,5.0,2,0,5,4,0,stay,1981-11-28
18745,Gwen McCrae,1981-12-19,Gwen McCrae - Gwen McCrae,38,43,38,38.0,38,Gwen McCrae,5.0,3,0,0,5,0,stay,1981-11-28
18746,Gwen McCrae,1981-12-26,Gwen McCrae - Gwen McCrae,38,38,38,38.0,38,Gwen McCrae,5.0,4,0,0,0,0,stay,1981-11-28
18747,Gwen McCrae,1982-01-02,Gwen McCrae - Gwen McCrae,38,38,51,38.0,38,Gwen McCrae,5.0,5,-13,0,0,1,down,1981-11-28
18748,Switch,1981-11-28,Switch - Switch V,51,51,48,48.0,48,Switch V,1.0,0,0,3,0,0,stay,1981-11-28
18749,Switch,1981-12-05,Switch - Switch V,48,51,51,48.0,48,Switch V,1.0,1,-3,0,3,1,down,1981-11-28
18750,Peabo Bryson,1981-12-05,Peabo Bryson - I Am Love,51,51,20,6.0,35,I Am Love,27.0,0,15,16,0,1,up,1981-12-05
18751,Peabo Bryson,1981-12-12,Peabo Bryson - I Am Love,35,51,13,6.0,20,I Am Love,27.0,1,7,15,16,1,up,1981-12-05
18752,Peabo Bryson,1981-12-19,Peabo Bryson - I Am Love,20,35,12,6.0,13,I Am Love,27.0,2,1,7,15,1,up,1981-12-05
18753,Peabo Bryson,1981-12-26,Peabo Bryson - I Am Love,13,20,12,6.0,12,I Am Love,27.0,3,0,1,7,0,stay,1981-12-05
18754,Peabo Bryson,1982-01-02,Peabo Bryson - I Am Love,12,13,12,6.0,12,I Am Love,27.0,4,0,0,1,0,stay,1981-12-05
18755,Peabo Bryson,1982-01-09,Peabo Bryson - I Am Love,12,12,11,6.0,12,I Am Love,27.0,5,1,0,0,1,up,1981-12-05
18756,Peabo Bryson,1982-01-16,Peabo Bryson - I Am Love,12,12,11,6.0,11,I Am Love,27.0,6,0,1,0,0,stay,1981-12-05
18757,Peabo Bryson,1982-01-23,Peabo Bryson - I Am Love,11,12,11,6.0,11,I Am Love,27.0,7,0,0,1,0,stay,1981-12-05
18758,Peabo Bryson,1982-01-30,Peabo Bryson - I Am Love,11,11,10,6.0,11,I Am Love,27.0,8,1,0,0,1,up,1981-12-05
18759,Peabo Bryson,1982-02-06,Peabo Bryson - I Am Love,11,11,9,6.0,10,I Am Love,27.0,9,1,1,0,1,up,1981-12-05
18760,Peabo Bryson,1982-02-13,Peabo Bryson - I Am Love,10,11,9,6.0,9,I Am Love,27.0,10,0,1,1,0,stay,1981-12-05
18761,Peabo Bryson,1982-02-20,Peabo Bryson - I Am Love,9,10,8,6.0,9,I Am Love,27.0,11,1,0,1,1,up,1981-12-05
18762,Peabo Bryson,1982-02-27,Peabo Bryson - I Am Love,9,9,8,6.0,8,I Am Love,27.0,12,0,1,0,0,stay,1981-12-05
18763,Peabo Bryson,1982-03-06,Peabo Bryson - I Am Love,8,9,7,6.0,8,I Am Love,27.0,13,1,0,1,1,up,1981-12-05
18764,Peabo Bryson,1982-03-13,Peabo Bryson - I Am Love,8,8,6,6.0,7,I Am Love,27.0,14,1,1,0,1,up,1981-12-05
18765,Peabo Bryson,1982-03-20,Peabo Bryson - I Am Love,7,8,6,6.0,6,I Am Love,27.0,15,0,1,1,0,stay,1981-12-05
18766,Peabo Bryson,1982-03-27,Peabo Bryson - I Am Love,6,7,11,6.0,6,I Am Love,27.0,16,-5,0,1,1,down,1981-12-05
18767,Peabo Bryson,1982-04-03,Peabo Bryson - I Am Love,6,6,12,6.0,11,I Am Love,27.0,17,-1,-5,0,1,down,1981-12-05
18768,Peabo Bryson,1982-04-10,Peabo Bryson - I Am Love,11,6,12,6.0,12,I Am Love,27.0,18,0,-1,-5,0,stay,1981-12-05
18769,Peabo Bryson,1982-04-17,Peabo Bryson - I Am Love,12,11,13,6.0,12,I Am Love,27.0,19,-1,0,-1,1,down,1981-12-05
18770,Peabo Bryson,1982-04-24,Peabo Bryson - I Am Love,12,12,24,6.0,13,I Am Love,27.0,20,-11,-1,0,1,down,1981-12-05
18771,Peabo Bryson,1982-05-01,Peabo Bryson - I Am Love,13,12,26,6.0,24,I Am Love,27.0,21,-2,-11,-1,1,down,1981-12-05
18772,Peabo Bryson,1982-05-08,Peabo Bryson - I Am Love,24,13,27,6.0,26,I Am Love,27.0,22,-1,-2,-11,1,down,1981-12-05
18773,Peabo Bryson,1982-05-15,Peabo Bryson - I Am Love,26,24,31,6.0,27,I Am Love,27.0,23,-4,-1,-2,1,down,1981-12-05
18774,Peabo Bryson,1982-05-22,Peabo Bryson - I Am Love,27,26,31,6.0,31,I Am Love,27.0,24,0,-4,-1,0,stay,1981-12-05
18775,Peabo Bryson,1982-05-29,Peabo Bryson - I Am Love,31,27,36,6.0,31,I Am Love,27.0,25,-5,0,-4,1,down,1981-12-05
18776,Peabo Bryson,1982-06-05,Peabo Bryson - I Am Love,31,31,44,6.0,36,I Am Love,27.0,26,-8,-5,0,1,down,1981-12-05
18777,Peabo Bryson,1982-06-12,Peabo Bryson - I Am Love,36,31,51,6.0,44,I Am Love,27.0,27,-7,-8,-5,1,down,1981-12-05
18778,LTD,1981-12-05,LTD - Love Magic,51,51,31,21.0,41,Love Magic,25.0,0,10,10,0,1,up,1981-12-05
18779,LTD,1981-12-12,LTD - Love Magic,41,51,25,21.0,31,Love Magic,25.0,1,6,10,10,1,up,1981-12-05
18780,LTD,1981-12-19,LTD - Love Magic,31,41,22,21.0,25,Love Magic,25.0,2,3,6,10,1,up,1981-12-05
18781,LTD,1981-12-26,LTD - Love Magic,25,31,22,21.0,22,Love Magic,25.0,3,0,3,6,0,stay,1981-12-05
18782,LTD,1982-01-02,LTD - Love Magic,22,25,22,21.0,22,Love Magic,25.0,4,0,0,3,0,stay,1981-12-05
18783,LTD,1982-01-09,LTD - Love Magic,22,22,21,21.0,22,Love Magic,25.0,5,1,0,0,1,up,1981-12-05
18784,LTD,1982-01-16,LTD - Love Magic,22,22,21,21.0,21,Love Magic,25.0,6,0,1,0,0,stay,1981-12-05
18785,LTD,1982-01-23,LTD - Love Magic,21,22,34,21.0,21,Love Magic,25.0,7,-13,0,1,1,down,1981-12-05
18786,LTD,1982-01-30,LTD - Love Magic,21,21,34,21.0,34,Love Magic,25.0,8,0,-13,0,0,stay,1981-12-05
18787,LTD,1982-02-06,LTD - Love Magic,34,21,35,21.0,34,Love Magic,25.0,9,-1,0,-13,1,down,1981-12-05
18788,LTD,1982-02-13,LTD - Love Magic,34,34,45,21.0,35,Love Magic,25.0,10,-10,-1,0,1,down,1981-12-05
18789,LTD,1982-02-20,LTD - Love Magic,35,34,45,21.0,45,Love Magic,25.0,11,0,-10,-1,0,stay,1981-12-05
18790,LTD,1982-02-27,LTD - Love Magic,45,35,50,21.0,45,Love Magic,25.0,12,-5,0,-10,1,down,1981-12-05
18791,LTD,1982-03-06,LTD - Love Magic,45,45,47,21.0,50,Love Magic,25.0,13,3,-5,0,1,up,1981-12-05
18792,LTD,1982-03-13,LTD - Love Magic,50,45,47,21.0,47,Love Magic,25.0,14,0,3,-5,0,stay,1981-12-05
18793,LTD,1982-03-20,LTD - Love Magic,47,50,45,21.0,47,Love Magic,25.0,15,2,0,3,1,up,1981-12-05
18794,LTD,1982-03-27,LTD - Love Magic,47,47,45,21.0,45,Love Magic,25.0,16,0,2,0,0,stay,1981-12-05
18795,LTD,1982-04-03,LTD - Love Magic,45,47,42,21.0,45,Love Magic,25.0,17,3,0,2,1,up,1981-12-05
18796,LTD,1982-04-10,LTD - Love Magic,45,45,40,21.0,42,Love Magic,25.0,18,2,3,0,1,up,1981-12-05
18797,LTD,1982-04-17,LTD - Love Magic,42,45,41,21.0,40,Love Magic,25.0,19,-1,2,3,1,down,1981-12-05
18798,LTD,1982-04-24,LTD - Love Magic,40,42,41,21.0,41,Love Magic,25.0,20,0,-1,2,0,stay,1981-12-05
18799,LTD,1982-05-01,LTD - Love Magic,41,40,44,21.0,41,Love Magic,25.0,21,-3,0,-1,1,down,1981-12-05
18800,LTD,1982-05-08,LTD - Love Magic,41,41,44,21.0,44,Love Magic,25.0,22,0,-3,0,0,stay,1981-12-05
18801,LTD,1982-05-15,LTD - Love Magic,44,41,43,21.0,44,Love Magic,25.0,23,1,0,-3,1,up,1981-12-05
18802,LTD,1982-05-22,LTD - Love Magic,44,44,47,21.0,43,Love Magic,25.0,24,-4,1,0,1,down,1981-12-05
18803,LTD,1982-05-29,LTD - Love Magic,43,44,51,21.0,47,Love Magic,25.0,25,-4,-4,1,1,down,1981-12-05
18804,Chocolate Milk,1981-12-12,Chocolate Milk - Blue Jeans,51,51,29,22.0,35,Blue Jeans,12.0,0,6,16,0,1,up,1981-12-12
18805,Chocolate Milk,1981-12-19,Chocolate Milk - Blue Jeans,35,51,26,22.0,29,Blue Jeans,12.0,1,3,6,16,1,up,1981-12-12
18806,Chocolate Milk,1981-12-26,Chocolate Milk - Blue Jeans,29,35,26,22.0,26,Blue Jeans,12.0,2,0,3,6,0,stay,1981-12-12
18807,Chocolate Milk,1982-01-02,Chocolate Milk - Blue Jeans,26,29,23,22.0,26,Blue Jeans,12.0,3,3,0,3,1,up,1981-12-12
18808,Chocolate Milk,1982-01-09,Chocolate Milk - Blue Jeans,26,26,22,22.0,23,Blue Jeans,12.0,4,1,3,0,1,up,1981-12-12
18809,Chocolate Milk,1982-01-16,Chocolate Milk - Blue Jeans,23,26,26,22.0,22,Blue Jeans,12.0,5,-4,1,3,1,down,1981-12-12
18810,Chocolate Milk,1982-01-23,Chocolate Milk - Blue Jeans,22,23,41,22.0,26,Blue Jeans,12.0,6,-15,-4,1,1,down,1981-12-12
18811,Chocolate Milk,1982-01-30,Chocolate Milk - Blue Jeans,26,22,41,22.0,41,Blue Jeans,12.0,7,0,-15,-4,0,stay,1981-12-12
18812,Chocolate Milk,1982-02-06,Chocolate Milk - Blue Jeans,41,26,39,22.0,41,Blue Jeans,12.0,8,2,0,-15,1,up,1981-12-12
18813,Chocolate Milk,1982-02-13,Chocolate Milk - Blue Jeans,41,41,37,22.0,39,Blue Jeans,12.0,9,2,2,0,1,up,1981-12-12
18814,Chocolate Milk,1982-02-20,Chocolate Milk - Blue Jeans,39,41,43,22.0,37,Blue Jeans,12.0,10,-6,2,2,1,down,1981-12-12
18815,Chocolate Milk,1982-02-27,Chocolate Milk - Blue Jeans,37,39,46,22.0,43,Blue Jeans,12.0,11,-3,-6,2,1,down,1981-12-12
18816,Chocolate Milk,1982-03-06,Chocolate Milk - Blue Jeans,43,37,51,22.0,46,Blue Jeans,12.0,12,-5,-3,-6,1,down,1981-12-12
18817,"Grover Washington, Jr.",1981-12-12,"Grover Washington, Jr. - Come Morning",51,51,23,10.0,40,Come Morning,25.0,0,17,11,0,1,up,1981-12-12
18818,"Grover Washington, Jr.",1981-12-19,"Grover Washington, Jr. - Come Morning",40,51,16,10.0,23,Come Morning,25.0,1,7,17,11,1,up,1981-12-12
18819,"Grover Washington, Jr.",1981-12-26,"Grover Washington, Jr. - Come Morning",23,40,16,10.0,16,Come Morning,25.0,2,0,7,17,0,stay,1981-12-12
18820,"Grover Washington, Jr.",1982-01-02,"Grover Washington, Jr. - Come Morning",16,23,14,10.0,16,Come Morning,25.0,3,2,0,7,1,up,1981-12-12
18821,"Grover Washington, Jr.",1982-01-09,"Grover Washington, Jr. - Come Morning",16,16,12,10.0,14,Come Morning,25.0,4,2,2,0,1,up,1981-12-12
18822,"Grover Washington, Jr.",1982-01-16,"Grover Washington, Jr. - Come Morning",14,16,12,10.0,12,Come Morning,25.0,5,0,2,2,0,stay,1981-12-12
18823,"Grover Washington, Jr.",1982-01-23,"Grover Washington, Jr. - Come Morning",12,14,12,10.0,12,Come Morning,25.0,6,0,0,2,0,stay,1981-12-12
18824,"Grover Washington, Jr.",1982-01-30,"Grover Washington, Jr. - Come Morning",12,12,11,10.0,12,Come Morning,25.0,7,1,0,0,1,up,1981-12-12
18825,"Grover Washington, Jr.",1982-02-06,"Grover Washington, Jr. - Come Morning",12,12,10,10.0,11,Come Morning,25.0,8,1,1,0,1,up,1981-12-12
18826,"Grover Washington, Jr.",1982-02-13,"Grover Washington, Jr. - Come Morning",11,12,10,10.0,10,Come Morning,25.0,9,0,1,1,0,stay,1981-12-12
18827,"Grover Washington, Jr.",1982-02-20,"Grover Washington, Jr. - Come Morning",10,11,12,10.0,10,Come Morning,25.0,10,-2,0,1,1,down,1981-12-12
18828,"Grover Washington, Jr.",1982-02-27,"Grover Washington, Jr. - Come Morning",10,10,13,10.0,12,Come Morning,25.0,11,-1,-2,0,1,down,1981-12-12
18829,"Grover Washington, Jr.",1982-03-06,"Grover Washington, Jr. - Come Morning",12,10,13,10.0,13,Come Morning,25.0,12,0,-1,-2,0,stay,1981-12-12
18830,"Grover Washington, Jr.",1982-03-13,"Grover Washington, Jr. - Come Morning",13,12,14,10.0,13,Come Morning,25.0,13,-1,0,-1,1,down,1981-12-12
18831,"Grover Washington, Jr.",1982-03-20,"Grover Washington, Jr. - Come Morning",13,13,14,10.0,14,Come Morning,25.0,14,0,-1,0,0,stay,1981-12-12
18832,"Grover Washington, Jr.",1982-03-27,"Grover Washington, Jr. - Come Morning",14,13,16,10.0,14,Come Morning,25.0,15,-2,0,-1,1,down,1981-12-12
18833,"Grover Washington, Jr.",1982-04-03,"Grover Washington, Jr. - Come Morning",14,14,20,10.0,16,Come Morning,25.0,16,-4,-2,0,1,down,1981-12-12
18834,"Grover Washington, Jr.",1982-04-10,"Grover Washington, Jr. - Come Morning",16,14,28,10.0,20,Come Morning,25.0,17,-8,-4,-2,1,down,1981-12-12
18835,"Grover Washington, Jr.",1982-04-17,"Grover Washington, Jr. - Come Morning",20,16,33,10.0,28,Come Morning,25.0,18,-5,-8,-4,1,down,1981-12-12
18836,"Grover Washington, Jr.",1982-04-24,"Grover Washington, Jr. - Come Morning",28,20,32,10.0,33,Come Morning,25.0,19,1,-5,-8,1,up,1981-12-12
18837,"Grover Washington, Jr.",1982-05-01,"Grover Washington, Jr. - Come Morning",33,28,42,10.0,32,Come Morning,25.0,20,-10,1,-5,1,down,1981-12-12
18838,"Grover Washington, Jr.",1982-05-08,"Grover Washington, Jr. - Come Morning",32,33,47,10.0,42,Come Morning,25.0,21,-5,-10,1,1,down,1981-12-12
18839,"Grover Washington, Jr.",1982-05-15,"Grover Washington, Jr. - Come Morning",42,32,47,10.0,47,Come Morning,25.0,22,0,-5,-10,0,stay,1981-12-12
18840,"Grover Washington, Jr.",1982-05-22,"Grover Washington, Jr. - Come Morning",47,42,49,10.0,47,Come Morning,25.0,23,-2,0,-5,1,down,1981-12-12
18841,"Grover Washington, Jr.",1982-05-29,"Grover Washington, Jr. - Come Morning",47,47,50,10.0,49,Come Morning,25.0,24,-1,-2,0,1,down,1981-12-12
18842,"Grover Washington, Jr.",1982-06-05,"Grover Washington, Jr. - Come Morning",49,47,51,10.0,50,Come Morning,25.0,25,-1,-1,-2,1,down,1981-12-12
18843,Lakeside,1981-12-12,Lakeside - Keep On Moving Straight Ahead,51,51,41,32.0,47,Keep On Moving Straight Ahead,10.0,0,6,4,0,1,up,1981-12-12
18844,Lakeside,1981-12-19,Lakeside - Keep On Moving Straight Ahead,47,51,36,32.0,41,Keep On Moving Straight Ahead,10.0,1,5,6,4,1,up,1981-12-12
18845,Lakeside,1981-12-26,Lakeside - Keep On Moving Straight Ahead,41,47,36,32.0,36,Keep On Moving Straight Ahead,10.0,2,0,5,6,0,stay,1981-12-12
18846,Lakeside,1982-01-02,Lakeside - Keep On Moving Straight Ahead,36,41,33,32.0,36,Keep On Moving Straight Ahead,10.0,3,3,0,5,1,up,1981-12-12
18847,Lakeside,1982-01-09,Lakeside - Keep On Moving Straight Ahead,36,36,33,32.0,33,Keep On Moving Straight Ahead,10.0,4,0,3,0,0,stay,1981-12-12
18848,Lakeside,1982-01-16,Lakeside - Keep On Moving Straight Ahead,33,36,32,32.0,33,Keep On Moving Straight Ahead,10.0,5,1,0,3,1,up,1981-12-12
18849,Lakeside,1982-01-23,Lakeside - Keep On Moving Straight Ahead,33,33,32,32.0,32,Keep On Moving Straight Ahead,10.0,6,0,1,0,0,stay,1981-12-12
18850,Lakeside,1982-01-30,Lakeside - Keep On Moving Straight Ahead,32,33,37,32.0,32,Keep On Moving Straight Ahead,10.0,7,-5,0,1,1,down,1981-12-12
18851,Lakeside,1982-02-06,Lakeside - Keep On Moving Straight Ahead,32,32,37,32.0,37,Keep On Moving Straight Ahead,10.0,8,0,-5,0,0,stay,1981-12-12
18852,Lakeside,1982-02-13,Lakeside - Keep On Moving Straight Ahead,37,32,41,32.0,37,Keep On Moving Straight Ahead,10.0,9,-4,0,-5,1,down,1981-12-12
18853,Lakeside,1982-02-20,Lakeside - Keep On Moving Straight Ahead,37,37,51,32.0,41,Keep On Moving Straight Ahead,10.0,10,-10,-4,0,1,down,1981-12-12
18854,The Spinners,1981-12-12,The Spinners - Can't Shake This Feeling,51,51,42,34.0,48,Can't Shake This Feeling,5.0,0,6,3,0,1,up,1981-12-12
18855,The Spinners,1981-12-19,The Spinners - Can't Shake This Feeling,48,51,37,34.0,42,Can't Shake This Feeling,5.0,1,5,6,3,1,up,1981-12-12
18856,The Spinners,1981-12-26,The Spinners - Can't Shake This Feeling,42,48,37,34.0,37,Can't Shake This Feeling,5.0,2,0,5,6,0,stay,1981-12-12
18857,The Spinners,1982-01-02,The Spinners - Can't Shake This Feeling,37,42,34,34.0,37,Can't Shake This Feeling,5.0,3,3,0,5,1,up,1981-12-12
18858,The Spinners,1982-01-09,The Spinners - Can't Shake This Feeling,37,37,34,34.0,34,Can't Shake This Feeling,5.0,4,0,3,0,0,stay,1981-12-12
18859,The Spinners,1982-01-16,The Spinners - Can't Shake This Feeling,34,37,51,34.0,34,Can't Shake This Feeling,5.0,5,-17,0,3,1,down,1981-12-12
18860,Booker T. Jones,1981-12-12,Booker T. Jones - I Want You,51,51,49,49.0,49,I Want You,4.0,0,0,2,0,0,stay,1981-12-12
18861,Booker T. Jones,1981-12-19,Booker T. Jones - I Want You,49,51,49,49.0,49,I Want You,4.0,1,0,0,2,0,stay,1981-12-12
18862,Booker T. Jones,1981-12-26,Booker T. Jones - I Want You,49,49,49,49.0,49,I Want You,4.0,2,0,0,0,0,stay,1981-12-12
18863,Booker T. Jones,1982-01-02,Booker T. Jones - I Want You,49,49,49,49.0,49,I Want You,4.0,3,0,0,0,0,stay,1981-12-12
18864,Booker T. Jones,1982-01-09,Booker T. Jones - I Want You,49,49,51,49.0,49,I Want You,4.0,4,-2,0,0,1,down,1981-12-12
18865,The Jones Girls,1981-12-19,The Jones Girls - Get As Much Love As You Can,51,51,33,25.0,40,Get As Much Love As You Can,13.0,0,7,11,0,1,up,1981-12-19
18866,The Jones Girls,1981-12-26,The Jones Girls - Get As Much Love As You Can,40,51,33,25.0,33,Get As Much Love As You Can,13.0,1,0,7,11,0,stay,1981-12-19
18867,The Jones Girls,1982-01-02,The Jones Girls - Get As Much Love As You Can,33,40,30,25.0,33,Get As Much Love As You Can,13.0,2,3,0,7,1,up,1981-12-19
18868,The Jones Girls,1982-01-09,The Jones Girls - Get As Much Love As You Can,33,33,30,25.0,30,Get As Much Love As You Can,13.0,3,0,3,0,0,stay,1981-12-19
18869,The Jones Girls,1982-01-16,The Jones Girls - Get As Much Love As You Can,30,33,28,25.0,30,Get As Much Love As You Can,13.0,4,2,0,3,1,up,1981-12-19
18870,The Jones Girls,1982-01-23,The Jones Girls - Get As Much Love As You Can,30,30,28,25.0,28,Get As Much Love As You Can,13.0,5,0,2,0,0,stay,1981-12-19
18871,The Jones Girls,1982-01-30,The Jones Girls - Get As Much Love As You Can,28,30,28,25.0,28,Get As Much Love As You Can,13.0,6,0,0,2,0,stay,1981-12-19
18872,The Jones Girls,1982-02-06,The Jones Girls - Get As Much Love As You Can,28,28,25,25.0,28,Get As Much Love As You Can,13.0,7,3,0,0,1,up,1981-12-19
18873,The Jones Girls,1982-02-13,The Jones Girls - Get As Much Love As You Can,28,28,25,25.0,25,Get As Much Love As You Can,13.0,8,0,3,0,0,stay,1981-12-19
18874,The Jones Girls,1982-02-20,The Jones Girls - Get As Much Love As You Can,25,28,30,25.0,25,Get As Much Love As You Can,13.0,9,-5,0,3,1,down,1981-12-19
18875,The Jones Girls,1982-02-27,The Jones Girls - Get As Much Love As You Can,25,25,40,25.0,30,Get As Much Love As You Can,13.0,10,-10,-5,0,1,down,1981-12-19
18876,The Jones Girls,1982-03-06,The Jones Girls - Get As Much Love As You Can,30,25,40,25.0,40,Get As Much Love As You Can,13.0,11,0,-10,-5,0,stay,1981-12-19
18877,The Jones Girls,1982-03-13,The Jones Girls - Get As Much Love As You Can,40,30,39,25.0,40,Get As Much Love As You Can,13.0,12,1,0,-10,1,up,1981-12-19
18878,The Jones Girls,1982-03-20,The Jones Girls - Get As Much Love As You Can,40,40,51,25.0,39,Get As Much Love As You Can,13.0,13,-12,1,0,1,down,1981-12-19
18879,Bill Summers,1981-12-19,Bill Summers - Jam The Box!,51,51,35,15.0,43,Jam The Box!,19.0,0,8,8,0,1,up,1981-12-19
18880,Bill Summers,1981-12-26,Bill Summers - Jam The Box!,43,51,35,15.0,35,Jam The Box!,19.0,1,0,8,8,0,stay,1981-12-19
18881,Bill Summers,1982-01-02,Bill Summers - Jam The Box!,35,43,29,15.0,35,Jam The Box!,19.0,2,6,0,8,1,up,1981-12-19
18882,Bill Summers,1982-01-09,Bill Summers - Jam The Box!,35,35,26,15.0,29,Jam The Box!,19.0,3,3,6,0,1,up,1981-12-19
18883,Bill Summers,1982-01-16,Bill Summers - Jam The Box!,29,35,23,15.0,26,Jam The Box!,19.0,4,3,3,6,1,up,1981-12-19
18884,Bill Summers,1982-01-23,Bill Summers - Jam The Box!,26,29,21,15.0,23,Jam The Box!,19.0,5,2,3,3,1,up,1981-12-19
18885,Bill Summers,1982-01-30,Bill Summers - Jam The Box!,23,26,17,15.0,21,Jam The Box!,19.0,6,4,2,3,1,up,1981-12-19
18886,Bill Summers,1982-02-06,Bill Summers - Jam The Box!,21,23,16,15.0,17,Jam The Box!,19.0,7,1,4,2,1,up,1981-12-19
18887,Bill Summers,1982-02-13,Bill Summers - Jam The Box!,17,21,15,15.0,16,Jam The Box!,19.0,8,1,1,4,1,up,1981-12-19
18888,Bill Summers,1982-02-20,Bill Summers - Jam The Box!,16,17,15,15.0,15,Jam The Box!,19.0,9,0,1,1,0,stay,1981-12-19
18889,Bill Summers,1982-02-27,Bill Summers - Jam The Box!,15,16,23,15.0,15,Jam The Box!,19.0,10,-8,0,1,1,down,1981-12-19
18890,Bill Summers,1982-03-06,Bill Summers - Jam The Box!,15,15,29,15.0,23,Jam The Box!,19.0,11,-6,-8,0,1,down,1981-12-19
18891,Bill Summers,1982-03-13,Bill Summers - Jam The Box!,23,15,29,15.0,29,Jam The Box!,19.0,12,0,-6,-8,0,stay,1981-12-19
18892,Bill Summers,1982-03-20,Bill Summers - Jam The Box!,29,23,36,15.0,29,Jam The Box!,19.0,13,-7,0,-6,1,down,1981-12-19
18893,Bill Summers,1982-03-27,Bill Summers - Jam The Box!,29,29,34,15.0,36,Jam The Box!,19.0,14,2,-7,0,1,up,1981-12-19
18894,Bill Summers,1982-04-03,Bill Summers - Jam The Box!,36,29,38,15.0,34,Jam The Box!,19.0,15,-4,2,-7,1,down,1981-12-19
18895,Bill Summers,1982-04-10,Bill Summers - Jam The Box!,34,36,38,15.0,38,Jam The Box!,19.0,16,0,-4,2,0,stay,1981-12-19
18896,Bill Summers,1982-04-17,Bill Summers - Jam The Box!,38,34,46,15.0,38,Jam The Box!,19.0,17,-8,0,-4,1,down,1981-12-19
18897,Bill Summers,1982-04-24,Bill Summers - Jam The Box!,38,38,50,15.0,46,Jam The Box!,19.0,18,-4,-8,0,1,down,1981-12-19
18898,Bill Summers,1982-05-01,Bill Summers - Jam The Box!,46,38,51,15.0,50,Jam The Box!,19.0,19,-1,-4,-8,1,down,1981-12-19
18899,Rodney Franklin,1981-12-19,Rodney Franklin - Endless Flight,51,51,47,47.0,47,Endless Flight,2.0,0,0,4,0,0,stay,1981-12-19
18900,Rodney Franklin,1981-12-26,Rodney Franklin - Endless Flight,47,51,47,47.0,47,Endless Flight,2.0,1,0,0,4,0,stay,1981-12-19
18901,Rodney Franklin,1982-01-02,Rodney Franklin - Endless Flight,47,47,51,47.0,47,Endless Flight,2.0,2,-4,0,0,1,down,1981-12-19
18902,Chic,1981-12-19,Chic - Take It Off,51,51,42,36.0,48,Take It Off,9.0,0,6,3,0,1,up,1981-12-19
18903,Chic,1981-12-26,Chic - Take It Off,48,51,42,36.0,42,Take It Off,9.0,1,0,6,3,0,stay,1981-12-19
18904,Chic,1982-01-02,Chic - Take It Off,42,48,39,36.0,42,Take It Off,9.0,2,3,0,6,1,up,1981-12-19
18905,Chic,1982-01-09,Chic - Take It Off,42,42,36,36.0,39,Take It Off,9.0,3,3,3,0,1,up,1981-12-19
18906,Chic,1982-01-16,Chic - Take It Off,39,42,36,36.0,36,Take It Off,9.0,4,0,3,3,0,stay,1981-12-19
18907,Chic,1982-01-23,Chic - Take It Off,36,39,43,36.0,36,Take It Off,9.0,5,-7,0,3,1,down,1981-12-19
18908,Chic,1982-01-30,Chic - Take It Off,36,36,43,36.0,43,Take It Off,9.0,6,0,-7,0,0,stay,1981-12-19
18909,Chic,1982-02-06,Chic - Take It Off,43,36,43,36.0,43,Take It Off,9.0,7,0,0,-7,0,stay,1981-12-19
18910,Chic,1982-02-13,Chic - Take It Off,43,43,47,36.0,43,Take It Off,9.0,8,-4,0,0,1,down,1981-12-19
18911,Chic,1982-02-20,Chic - Take It Off,43,43,51,36.0,47,Take It Off,9.0,9,-4,-4,0,1,down,1981-12-19
18912,Twennynine Featuring Lenny White,1981-12-19,Twennynine Featuring Lenny White - Just Like Dreamin,51,51,45,41.0,50,Just Like Dreamin,5.0,0,5,1,0,1,up,1981-12-19
18913,Twennynine Featuring Lenny White,1981-12-26,Twennynine Featuring Lenny White - Just Like Dreamin,50,51,45,41.0,45,Just Like Dreamin,5.0,1,0,5,1,0,stay,1981-12-19
18914,Twennynine Featuring Lenny White,1982-01-02,Twennynine Featuring Lenny White - Just Like Dreamin,45,50,41,41.0,45,Just Like Dreamin,5.0,2,4,0,5,1,up,1981-12-19
18915,Twennynine Featuring Lenny White,1982-01-09,Twennynine Featuring Lenny White - Just Like Dreamin,45,45,41,41.0,41,Just Like Dreamin,5.0,3,0,4,0,0,stay,1981-12-19
18916,Twennynine Featuring Lenny White,1982-01-16,Twennynine Featuring Lenny White - Just Like Dreamin,41,45,44,41.0,41,Just Like Dreamin,5.0,4,-3,0,4,1,down,1981-12-19
18917,Twennynine Featuring Lenny White,1982-01-23,Twennynine Featuring Lenny White - Just Like Dreamin,41,41,51,41.0,44,Just Like Dreamin,5.0,5,-7,-3,0,1,down,1981-12-19
18918,ConFunkShun,1981-12-26,ConFunkShun - Con Funk Shun 7,51,51,41,17.0,41,Con Funk Shun 7,14.0,0,0,10,0,0,stay,1981-12-26
18919,ConFunkShun,1982-01-02,ConFunkShun - Con Funk Shun 7,41,51,28,17.0,41,Con Funk Shun 7,14.0,1,13,0,10,1,up,1981-12-26
18920,ConFunkShun,1982-01-09,ConFunkShun - Con Funk Shun 7,41,41,23,17.0,28,Con Funk Shun 7,14.0,2,5,13,0,1,up,1981-12-26
18921,ConFunkShun,1982-01-16,ConFunkShun - Con Funk Shun 7,28,41,22,17.0,23,Con Funk Shun 7,14.0,3,1,5,13,1,up,1981-12-26
18922,ConFunkShun,1982-01-23,ConFunkShun - Con Funk Shun 7,23,28,19,17.0,22,Con Funk Shun 7,14.0,4,3,1,5,1,up,1981-12-26
18923,ConFunkShun,1982-01-30,ConFunkShun - Con Funk Shun 7,22,23,19,17.0,19,Con Funk Shun 7,14.0,5,0,3,1,0,stay,1981-12-26
18924,ConFunkShun,1982-02-06,ConFunkShun - Con Funk Shun 7,19,22,17,17.0,19,Con Funk Shun 7,14.0,6,2,0,3,1,up,1981-12-26
18925,ConFunkShun,1982-02-13,ConFunkShun - Con Funk Shun 7,19,19,17,17.0,17,Con Funk Shun 7,14.0,7,0,2,0,0,stay,1981-12-26
18926,ConFunkShun,1982-02-20,ConFunkShun - Con Funk Shun 7,17,19,23,17.0,17,Con Funk Shun 7,14.0,8,-6,0,2,1,down,1981-12-26
18927,ConFunkShun,1982-02-27,ConFunkShun - Con Funk Shun 7,17,17,25,17.0,23,Con Funk Shun 7,14.0,9,-2,-6,0,1,down,1981-12-26
18928,ConFunkShun,1982-03-06,ConFunkShun - Con Funk Shun 7,23,17,36,17.0,25,Con Funk Shun 7,14.0,10,-11,-2,-6,1,down,1981-12-26
18929,ConFunkShun,1982-03-13,ConFunkShun - Con Funk Shun 7,25,23,40,17.0,36,Con Funk Shun 7,14.0,11,-4,-11,-2,1,down,1981-12-26
18930,ConFunkShun,1982-03-20,ConFunkShun - Con Funk Shun 7,36,25,50,17.0,40,Con Funk Shun 7,14.0,12,-10,-4,-11,1,down,1981-12-26
18931,ConFunkShun,1982-04-17,ConFunkShun - Con Funk Shun 7,40,36,50,17.0,50,Con Funk Shun 7,14.0,13,0,-10,-4,0,stay,1981-12-26
18932,ConFunkShun,1982-04-24,ConFunkShun - Con Funk Shun 7,50,40,51,17.0,50,Con Funk Shun 7,14.0,14,-1,0,-10,1,down,1981-12-26
18933,Tom Browne,1981-12-26,Tom Browne - Yours Truly,51,51,44,20.0,44,Yours Truly,10.0,0,0,7,0,0,stay,1981-12-26
18934,Tom Browne,1982-01-02,Tom Browne - Yours Truly,44,51,36,20.0,44,Yours Truly,10.0,1,8,0,7,1,up,1981-12-26
18935,Tom Browne,1982-01-09,Tom Browne - Yours Truly,44,44,28,20.0,36,Yours Truly,10.0,2,8,8,0,1,up,1981-12-26
18936,Tom Browne,1982-01-16,Tom Browne - Yours Truly,36,44,25,20.0,28,Yours Truly,10.0,3,3,8,8,1,up,1981-12-26
18937,Tom Browne,1982-01-23,Tom Browne - Yours Truly,28,36,22,20.0,25,Yours Truly,10.0,4,3,3,8,1,up,1981-12-26
18938,Tom Browne,1982-01-30,Tom Browne - Yours Truly,25,28,20,20.0,22,Yours Truly,10.0,5,2,3,3,1,up,1981-12-26
18939,Tom Browne,1982-02-06,Tom Browne - Yours Truly,22,25,20,20.0,20,Yours Truly,10.0,6,0,2,3,0,stay,1981-12-26
18940,Tom Browne,1982-02-13,Tom Browne - Yours Truly,20,22,22,20.0,20,Yours Truly,10.0,7,-2,0,2,1,down,1981-12-26
18941,Tom Browne,1982-02-20,Tom Browne - Yours Truly,20,20,41,20.0,22,Yours Truly,10.0,8,-19,-2,0,1,down,1981-12-26
18942,Tom Browne,1982-02-27,Tom Browne - Yours Truly,22,20,41,20.0,41,Yours Truly,10.0,9,0,-19,-2,0,stay,1981-12-26
18943,Tom Browne,1982-03-06,Tom Browne - Yours Truly,41,22,51,20.0,41,Yours Truly,10.0,10,-10,0,-19,1,down,1981-12-26
18944,Stevie Woods,1981-12-26,Stevie Woods - Take Me To Your Heaven,51,51,48,44.0,48,Take Me To Your Heaven,3.0,0,0,3,0,0,stay,1981-12-26
18945,Stevie Woods,1982-01-02,Stevie Woods - Take Me To Your Heaven,48,51,44,44.0,48,Take Me To Your Heaven,3.0,1,4,0,3,1,up,1981-12-26
18946,Stevie Woods,1982-01-09,Stevie Woods - Take Me To Your Heaven,48,48,44,44.0,44,Take Me To Your Heaven,3.0,2,0,4,0,0,stay,1981-12-26
18947,Stevie Woods,1982-01-16,Stevie Woods - Take Me To Your Heaven,44,48,51,44.0,44,Take Me To Your Heaven,3.0,3,-7,0,4,1,down,1981-12-26
18948,Lakeside,1981-12-26,Lakeside - Your Wish Is My Command,51,51,50,9.0,50,Your Wish Is My Command,28.0,0,0,1,0,0,stay,1981-12-26
18949,Lakeside,1982-01-02,Lakeside - Your Wish Is My Command,50,51,38,9.0,50,Your Wish Is My Command,28.0,1,12,0,1,1,up,1981-12-26
18950,Lakeside,1982-01-09,Lakeside - Your Wish Is My Command,50,50,35,9.0,38,Your Wish Is My Command,28.0,2,3,12,0,1,up,1981-12-26
18951,Lakeside,1982-01-16,Lakeside - Your Wish Is My Command,38,50,29,9.0,35,Your Wish Is My Command,28.0,3,6,3,12,1,up,1981-12-26
18952,Lakeside,1982-01-23,Lakeside - Your Wish Is My Command,35,38,26,9.0,29,Your Wish Is My Command,28.0,4,3,6,3,1,up,1981-12-26
18953,Lakeside,1982-01-30,Lakeside - Your Wish Is My Command,29,35,21,9.0,26,Your Wish Is My Command,28.0,5,5,3,6,1,up,1981-12-26
18954,Lakeside,1982-02-06,Lakeside - Your Wish Is My Command,26,29,19,9.0,21,Your Wish Is My Command,28.0,6,2,5,3,1,up,1981-12-26
18955,Lakeside,1982-02-13,Lakeside - Your Wish Is My Command,21,26,16,9.0,19,Your Wish Is My Command,28.0,7,3,2,5,1,up,1981-12-26
18956,Lakeside,1982-02-20,Lakeside - Your Wish Is My Command,19,21,13,9.0,16,Your Wish Is My Command,28.0,8,3,3,2,1,up,1981-12-26
18957,Lakeside,1982-02-27,Lakeside - Your Wish Is My Command,16,19,11,9.0,13,Your Wish Is My Command,28.0,9,2,3,3,1,up,1981-12-26
18958,Lakeside,1982-03-06,Lakeside - Your Wish Is My Command,13,16,10,9.0,11,Your Wish Is My Command,28.0,10,1,2,3,1,up,1981-12-26
18959,Lakeside,1982-03-13,Lakeside - Your Wish Is My Command,11,13,9,9.0,10,Your Wish Is My Command,28.0,11,1,1,2,1,up,1981-12-26
18960,Lakeside,1982-03-20,Lakeside - Your Wish Is My Command,10,11,9,9.0,9,Your Wish Is My Command,28.0,12,0,1,1,0,stay,1981-12-26
18961,Lakeside,1982-03-27,Lakeside - Your Wish Is My Command,9,10,9,9.0,9,Your Wish Is My Command,28.0,13,0,0,1,0,stay,1981-12-26
18962,Lakeside,1982-04-03,Lakeside - Your Wish Is My Command,9,9,9,9.0,9,Your Wish Is My Command,28.0,14,0,0,0,0,stay,1981-12-26
18963,Lakeside,1982-04-10,Lakeside - Your Wish Is My Command,9,9,11,9.0,9,Your Wish Is My Command,28.0,15,-2,0,0,1,down,1981-12-26
18964,Lakeside,1982-04-17,Lakeside - Your Wish Is My Command,9,9,12,9.0,11,Your Wish Is My Command,28.0,16,-1,-2,0,1,down,1981-12-26
18965,Lakeside,1982-04-24,Lakeside - Your Wish Is My Command,11,9,19,9.0,12,Your Wish Is My Command,28.0,17,-7,-1,-2,1,down,1981-12-26
18966,Lakeside,1982-05-01,Lakeside - Your Wish Is My Command,12,11,25,9.0,19,Your Wish Is My Command,28.0,18,-6,-7,-1,1,down,1981-12-26
18967,Lakeside,1982-05-08,Lakeside - Your Wish Is My Command,19,12,26,9.0,25,Your Wish Is My Command,28.0,19,-1,-6,-7,1,down,1981-12-26
18968,Lakeside,1982-05-15,Lakeside - Your Wish Is My Command,25,19,32,9.0,26,Your Wish Is My Command,28.0,20,-6,-1,-6,1,down,1981-12-26
18969,Lakeside,1982-05-22,Lakeside - Your Wish Is My Command,26,25,32,9.0,32,Your Wish Is My Command,28.0,21,0,-6,-1,0,stay,1981-12-26
18970,Lakeside,1982-05-29,Lakeside - Your Wish Is My Command,32,26,32,9.0,32,Your Wish Is My Command,28.0,22,0,0,-6,0,stay,1981-12-26
18971,Lakeside,1982-06-05,Lakeside - Your Wish Is My Command,32,32,32,9.0,32,Your Wish Is My Command,28.0,23,0,0,0,0,stay,1981-12-26
18972,Lakeside,1982-06-12,Lakeside - Your Wish Is My Command,32,32,31,9.0,32,Your Wish Is My Command,28.0,24,1,0,0,1,up,1981-12-26
18973,Lakeside,1982-06-19,Lakeside - Your Wish Is My Command,32,32,31,9.0,31,Your Wish Is My Command,28.0,25,0,1,0,0,stay,1981-12-26
18974,Lakeside,1982-06-26,Lakeside - Your Wish Is My Command,31,32,31,9.0,31,Your Wish Is My Command,28.0,26,0,0,1,0,stay,1981-12-26
18975,Lakeside,1982-07-03,Lakeside - Your Wish Is My Command,31,31,35,9.0,31,Your Wish Is My Command,28.0,27,-4,0,0,1,down,1981-12-26
18976,Lakeside,1982-07-10,Lakeside - Your Wish Is My Command,31,31,51,9.0,35,Your Wish Is My Command,28.0,28,-16,-4,0,1,down,1981-12-26
18977,Daryl Hall John Oates,1982-01-09,Daryl Hall John Oates - Private Eyes,51,51,19,11.0,37,Private Eyes,14.0,0,18,14,0,1,up,1982-01-09
18978,Daryl Hall John Oates,1982-01-16,Daryl Hall John Oates - Private Eyes,37,51,17,11.0,19,Private Eyes,14.0,1,2,18,14,1,up,1982-01-09
18979,Daryl Hall John Oates,1982-01-23,Daryl Hall John Oates - Private Eyes,19,37,14,11.0,17,Private Eyes,14.0,2,3,2,18,1,up,1982-01-09
18980,Daryl Hall John Oates,1982-01-30,Daryl Hall John Oates - Private Eyes,17,19,12,11.0,14,Private Eyes,14.0,3,2,3,2,1,up,1982-01-09
18981,Daryl Hall John Oates,1982-02-06,Daryl Hall John Oates - Private Eyes,14,17,12,11.0,12,Private Eyes,14.0,4,0,2,3,0,stay,1982-01-09
18982,Daryl Hall John Oates,1982-02-13,Daryl Hall John Oates - Private Eyes,12,14,11,11.0,12,Private Eyes,14.0,5,1,0,2,1,up,1982-01-09
18983,Daryl Hall John Oates,1982-02-20,Daryl Hall John Oates - Private Eyes,12,12,11,11.0,11,Private Eyes,14.0,6,0,1,0,0,stay,1982-01-09
18984,Daryl Hall John Oates,1982-02-27,Daryl Hall John Oates - Private Eyes,11,12,14,11.0,11,Private Eyes,14.0,7,-3,0,1,1,down,1982-01-09
18985,Daryl Hall John Oates,1982-03-06,Daryl Hall John Oates - Private Eyes,11,11,20,11.0,14,Private Eyes,14.0,8,-6,-3,0,1,down,1982-01-09
18986,Daryl Hall John Oates,1982-03-13,Daryl Hall John Oates - Private Eyes,14,11,25,11.0,20,Private Eyes,14.0,9,-5,-6,-3,1,down,1982-01-09
18987,Daryl Hall John Oates,1982-03-20,Daryl Hall John Oates - Private Eyes,20,14,25,11.0,25,Private Eyes,14.0,10,0,-5,-6,0,stay,1982-01-09
18988,Daryl Hall John Oates,1982-03-27,Daryl Hall John Oates - Private Eyes,25,20,27,11.0,25,Private Eyes,14.0,11,-2,0,-5,1,down,1982-01-09
18989,Daryl Hall John Oates,1982-04-03,Daryl Hall John Oates - Private Eyes,25,25,47,11.0,27,Private Eyes,14.0,12,-20,-2,0,1,down,1982-01-09
18990,Daryl Hall John Oates,1982-04-10,Daryl Hall John Oates - Private Eyes,27,25,49,11.0,47,Private Eyes,14.0,13,-2,-20,-2,1,down,1982-01-09
18991,Daryl Hall John Oates,1982-04-17,Daryl Hall John Oates - Private Eyes,47,27,51,11.0,49,Private Eyes,14.0,14,-2,-2,-20,1,down,1982-01-09
18992,Tom Tom Club,1982-01-09,Tom Tom Club - Tom Tom Club,51,51,49,2.0,50,Tom Tom Club,22.0,0,1,1,0,1,up,1982-01-09
18993,Tom Tom Club,1982-01-16,Tom Tom Club - Tom Tom Club,50,51,42,2.0,49,Tom Tom Club,22.0,1,7,1,1,1,up,1982-01-09
18994,Tom Tom Club,1982-01-23,Tom Tom Club - Tom Tom Club,49,50,31,2.0,42,Tom Tom Club,22.0,2,11,7,1,1,up,1982-01-09
18995,Tom Tom Club,1982-01-30,Tom Tom Club - Tom Tom Club,42,49,25,2.0,31,Tom Tom Club,22.0,3,6,11,7,1,up,1982-01-09
18996,Tom Tom Club,1982-02-06,Tom Tom Club - Tom Tom Club,31,42,15,2.0,25,Tom Tom Club,22.0,4,10,6,11,1,up,1982-01-09
18997,Tom Tom Club,1982-02-13,Tom Tom Club - Tom Tom Club,25,31,12,2.0,15,Tom Tom Club,22.0,5,3,10,6,1,up,1982-01-09
18998,Tom Tom Club,1982-02-20,Tom Tom Club - Tom Tom Club,15,25,9,2.0,12,Tom Tom Club,22.0,6,3,3,10,1,up,1982-01-09
18999,Tom Tom Club,1982-02-27,Tom Tom Club - Tom Tom Club,12,15,9,2.0,9,Tom Tom Club,22.0,7,0,3,3,0,stay,1982-01-09
19000,Tom Tom Club,1982-03-06,Tom Tom Club - Tom Tom Club,9,12,3,2.0,9,Tom Tom Club,22.0,8,6,0,3,1,up,1982-01-09
19001,Tom Tom Club,1982-03-13,Tom Tom Club - Tom Tom Club,9,9,3,2.0,3,Tom Tom Club,22.0,9,0,6,0,0,stay,1982-01-09
19002,Tom Tom Club,1982-03-20,Tom Tom Club - Tom Tom Club,3,9,2,2.0,3,Tom Tom Club,22.0,10,1,0,6,1,up,1982-01-09
19003,Tom Tom Club,1982-03-27,Tom Tom Club - Tom Tom Club,3,3,2,2.0,2,Tom Tom Club,22.0,11,0,1,0,0,stay,1982-01-09
19004,Tom Tom Club,1982-04-03,Tom Tom Club - Tom Tom Club,2,3,2,2.0,2,Tom Tom Club,22.0,12,0,0,1,0,stay,1982-01-09
19005,Tom Tom Club,1982-04-10,Tom Tom Club - Tom Tom Club,2,2,6,2.0,2,Tom Tom Club,22.0,13,-4,0,0,1,down,1982-01-09
19006,Tom Tom Club,1982-04-17,Tom Tom Club - Tom Tom Club,2,2,8,2.0,6,Tom Tom Club,22.0,14,-2,-4,0,1,down,1982-01-09
19007,Tom Tom Club,1982-04-24,Tom Tom Club - Tom Tom Club,6,2,9,2.0,8,Tom Tom Club,22.0,15,-1,-2,-4,1,down,1982-01-09
19008,Tom Tom Club,1982-05-01,Tom Tom Club - Tom Tom Club,8,6,19,2.0,9,Tom Tom Club,22.0,16,-10,-1,-2,1,down,1982-01-09
19009,Tom Tom Club,1982-05-08,Tom Tom Club - Tom Tom Club,9,8,24,2.0,19,Tom Tom Club,22.0,17,-5,-10,-1,1,down,1982-01-09
19010,Tom Tom Club,1982-05-15,Tom Tom Club - Tom Tom Club,19,9,34,2.0,24,Tom Tom Club,22.0,18,-10,-5,-10,1,down,1982-01-09
19011,Tom Tom Club,1982-05-22,Tom Tom Club - Tom Tom Club,24,19,35,2.0,34,Tom Tom Club,22.0,19,-1,-10,-5,1,down,1982-01-09
19012,Tom Tom Club,1982-05-29,Tom Tom Club - Tom Tom Club,34,24,41,2.0,35,Tom Tom Club,22.0,20,-6,-1,-10,1,down,1982-01-09
19013,Tom Tom Club,1982-06-05,Tom Tom Club - Tom Tom Club,35,34,45,2.0,41,Tom Tom Club,22.0,21,-4,-6,-1,1,down,1982-01-09
19014,Tom Tom Club,1982-06-12,Tom Tom Club - Tom Tom Club,41,35,51,2.0,45,Tom Tom Club,22.0,22,-6,-4,-6,1,down,1982-01-09
19015,Central Line,1982-01-16,Central Line - Central Line,51,51,35,23.0,39,Central Line,9.0,0,4,12,0,1,up,1982-01-16
19016,Central Line,1982-01-23,Central Line - Central Line,39,51,25,23.0,35,Central Line,9.0,1,10,4,12,1,up,1982-01-16
19017,Central Line,1982-01-30,Central Line - Central Line,35,39,23,23.0,25,Central Line,9.0,2,2,10,4,1,up,1982-01-16
19018,Central Line,1982-02-06,Central Line - Central Line,25,35,23,23.0,23,Central Line,9.0,3,0,2,10,0,stay,1982-01-16
19019,Central Line,1982-02-13,Central Line - Central Line,23,25,24,23.0,23,Central Line,9.0,4,-1,0,2,1,down,1982-01-16
19020,Central Line,1982-02-20,Central Line - Central Line,23,23,31,23.0,24,Central Line,9.0,5,-7,-1,0,1,down,1982-01-16
19021,Central Line,1982-02-27,Central Line - Central Line,24,23,43,23.0,31,Central Line,9.0,6,-12,-7,-1,1,down,1982-01-16
19022,Central Line,1982-03-06,Central Line - Central Line,31,24,45,23.0,43,Central Line,9.0,7,-2,-12,-7,1,down,1982-01-16
19023,Central Line,1982-03-13,Central Line - Central Line,43,31,49,23.0,45,Central Line,9.0,8,-4,-2,-12,1,down,1982-01-16
19024,Central Line,1982-03-20,Central Line - Central Line,45,43,51,23.0,49,Central Line,9.0,9,-2,-4,-2,1,down,1982-01-16
19025,"Ray, Goodman & Brown",1982-01-16,"Ray, Goodman & Brown - Stay",51,51,38,33.0,43,Stay,9.0,0,5,8,0,1,up,1982-01-16
19026,"Ray, Goodman & Brown",1982-01-23,"Ray, Goodman & Brown - Stay",43,51,38,33.0,38,Stay,9.0,1,0,5,8,0,stay,1982-01-16
19027,"Ray, Goodman & Brown",1982-01-30,"Ray, Goodman & Brown - Stay",38,43,33,33.0,38,Stay,9.0,2,5,0,5,1,up,1982-01-16
19028,"Ray, Goodman & Brown",1982-02-06,"Ray, Goodman & Brown - Stay",38,38,33,33.0,33,Stay,9.0,3,0,5,0,0,stay,1982-01-16
19029,"Ray, Goodman & Brown",1982-02-13,"Ray, Goodman & Brown - Stay",33,38,33,33.0,33,Stay,9.0,4,0,0,5,0,stay,1982-01-16
19030,"Ray, Goodman & Brown",1982-02-20,"Ray, Goodman & Brown - Stay",33,33,35,33.0,33,Stay,9.0,5,-2,0,0,1,down,1982-01-16
19031,"Ray, Goodman & Brown",1982-02-27,"Ray, Goodman & Brown - Stay",33,33,33,33.0,35,Stay,9.0,6,2,-2,0,1,up,1982-01-16
19032,"Ray, Goodman & Brown",1982-03-06,"Ray, Goodman & Brown - Stay",35,33,42,33.0,33,Stay,9.0,7,-9,2,-2,1,down,1982-01-16
19033,"Ray, Goodman & Brown",1982-03-13,"Ray, Goodman & Brown - Stay",33,35,48,33.0,42,Stay,9.0,8,-6,-9,2,1,down,1982-01-16
19034,"Ray, Goodman & Brown",1982-03-20,"Ray, Goodman & Brown - Stay",42,33,51,33.0,48,Stay,9.0,9,-3,-6,-9,1,down,1982-01-16
19035,Syreeta,1982-01-16,Syreeta - Set My Love In Motion,51,51,45,40.0,50,Set My Love In Motion,5.0,0,5,1,0,1,up,1982-01-16
19036,Syreeta,1982-01-23,Syreeta - Set My Love In Motion,50,51,40,40.0,45,Set My Love In Motion,5.0,1,5,5,1,1,up,1982-01-16
19037,Syreeta,1982-01-30,Syreeta - Set My Love In Motion,45,50,40,40.0,40,Set My Love In Motion,5.0,2,0,5,5,0,stay,1982-01-16
19038,Syreeta,1982-02-06,Syreeta - Set My Love In Motion,40,45,44,40.0,40,Set My Love In Motion,5.0,3,-4,0,5,1,down,1982-01-16
19039,Syreeta,1982-02-13,Syreeta - Set My Love In Motion,40,40,44,40.0,44,Set My Love In Motion,5.0,4,0,-4,0,0,stay,1982-01-16
19040,Syreeta,1982-02-20,Syreeta - Set My Love In Motion,44,40,51,40.0,44,Set My Love In Motion,5.0,5,-7,0,-4,1,down,1982-01-16
19041,Sugarhill Gang,1982-01-23,Sugarhill Gang - 8th Wonder,51,51,36,15.0,46,8th Wonder,13.0,0,10,5,0,1,up,1982-01-23
19042,Sugarhill Gang,1982-01-30,Sugarhill Gang - 8th Wonder,46,51,29,15.0,36,8th Wonder,13.0,1,7,10,5,1,up,1982-01-23
19043,Sugarhill Gang,1982-02-06,Sugarhill Gang - 8th Wonder,36,46,22,15.0,29,8th Wonder,13.0,2,7,7,10,1,up,1982-01-23
19044,Sugarhill Gang,1982-02-13,Sugarhill Gang - 8th Wonder,29,36,19,15.0,22,8th Wonder,13.0,3,3,7,7,1,up,1982-01-23
19045,Sugarhill Gang,1982-02-20,Sugarhill Gang - 8th Wonder,22,29,18,15.0,19,8th Wonder,13.0,4,1,3,7,1,up,1982-01-23
19046,Sugarhill Gang,1982-02-27,Sugarhill Gang - 8th Wonder,19,22,16,15.0,18,8th Wonder,13.0,5,2,1,3,1,up,1982-01-23
19047,Sugarhill Gang,1982-03-06,Sugarhill Gang - 8th Wonder,18,19,16,15.0,16,8th Wonder,13.0,6,0,2,1,0,stay,1982-01-23
19048,Sugarhill Gang,1982-03-13,Sugarhill Gang - 8th Wonder,16,18,15,15.0,16,8th Wonder,13.0,7,1,0,2,1,up,1982-01-23
19049,Sugarhill Gang,1982-03-20,Sugarhill Gang - 8th Wonder,16,16,23,15.0,15,8th Wonder,13.0,8,-8,1,0,1,down,1982-01-23
19050,Sugarhill Gang,1982-03-27,Sugarhill Gang - 8th Wonder,15,16,29,15.0,23,8th Wonder,13.0,9,-6,-8,1,1,down,1982-01-23
19051,Sugarhill Gang,1982-04-03,Sugarhill Gang - 8th Wonder,23,15,35,15.0,29,8th Wonder,13.0,10,-6,-6,-8,1,down,1982-01-23
19052,Sugarhill Gang,1982-04-10,Sugarhill Gang - 8th Wonder,29,23,34,15.0,35,8th Wonder,13.0,11,1,-6,-6,1,up,1982-01-23
19053,Sugarhill Gang,1982-04-17,Sugarhill Gang - 8th Wonder,35,29,39,15.0,34,8th Wonder,13.0,12,-5,1,-6,1,down,1982-01-23
19054,Sugarhill Gang,1982-04-24,Sugarhill Gang - 8th Wonder,34,35,51,15.0,39,8th Wonder,13.0,13,-12,-5,1,1,down,1982-01-23
19055,Johnny Guitar Watson,1982-01-23,Johnny Guitar Watson - That's What Time It Is,51,51,51,50.0,50,That's What Time It Is,0.0,0,-1,1,0,1,down,1982-01-23
19056,The Whispers,1982-01-30,The Whispers - Love Is Where You Find It,51,51,14,1.0,24,Love Is Where You Find It,30.0,0,10,27,0,1,up,1982-01-30
19057,The Whispers,1982-02-06,The Whispers - Love Is Where You Find It,24,51,11,1.0,14,Love Is Where You Find It,30.0,1,3,10,27,1,up,1982-01-30
19058,The Whispers,1982-02-13,The Whispers - Love Is Where You Find It,14,24,7,1.0,11,Love Is Where You Find It,30.0,2,4,3,10,1,up,1982-01-30
19059,The Whispers,1982-02-20,The Whispers - Love Is Where You Find It,11,14,6,1.0,7,Love Is Where You Find It,30.0,3,1,4,3,1,up,1982-01-30
19060,The Whispers,1982-02-27,The Whispers - Love Is Where You Find It,7,11,6,1.0,6,Love Is Where You Find It,30.0,4,0,1,4,0,stay,1982-01-30
19061,The Whispers,1982-03-06,The Whispers - Love Is Where You Find It,6,7,5,1.0,6,Love Is Where You Find It,30.0,5,1,0,1,1,up,1982-01-30
19062,The Whispers,1982-03-13,The Whispers - Love Is Where You Find It,6,6,4,1.0,5,Love Is Where You Find It,30.0,6,1,1,0,1,up,1982-01-30
19063,The Whispers,1982-03-20,The Whispers - Love Is Where You Find It,5,6,4,1.0,4,Love Is Where You Find It,30.0,7,0,1,1,0,stay,1982-01-30
19064,The Whispers,1982-03-27,The Whispers - Love Is Where You Find It,4,5,4,1.0,4,Love Is Where You Find It,30.0,8,0,0,1,0,stay,1982-01-30
19065,The Whispers,1982-04-03,The Whispers - Love Is Where You Find It,4,4,3,1.0,4,Love Is Where You Find It,30.0,9,1,0,0,1,up,1982-01-30
19066,The Whispers,1982-04-10,The Whispers - Love Is Where You Find It,4,4,1,1.0,3,Love Is Where You Find It,30.0,10,2,1,0,1,up,1982-01-30
19067,The Whispers,1982-04-17,The Whispers - Love Is Where You Find It,3,4,2,1.0,1,Love Is Where You Find It,30.0,11,-1,2,1,1,down,1982-01-30
19068,The Whispers,1982-04-24,The Whispers - Love Is Where You Find It,1,3,4,1.0,2,Love Is Where You Find It,30.0,12,-2,-1,2,1,down,1982-01-30
19069,The Whispers,1982-05-01,The Whispers - Love Is Where You Find It,2,1,4,1.0,4,Love Is Where You Find It,30.0,13,0,-2,-1,0,stay,1982-01-30
19070,The Whispers,1982-05-08,The Whispers - Love Is Where You Find It,4,2,11,1.0,4,Love Is Where You Find It,30.0,14,-7,0,-2,1,down,1982-01-30
19071,The Whispers,1982-05-15,The Whispers - Love Is Where You Find It,4,4,11,1.0,11,Love Is Where You Find It,30.0,15,0,-7,0,0,stay,1982-01-30
19072,The Whispers,1982-05-22,The Whispers - Love Is Where You Find It,11,4,12,1.0,11,Love Is Where You Find It,30.0,16,-1,0,-7,1,down,1982-01-30
19073,The Whispers,1982-05-29,The Whispers - Love Is Where You Find It,11,11,16,1.0,12,Love Is Where You Find It,30.0,17,-4,-1,0,1,down,1982-01-30
19074,The Whispers,1982-06-05,The Whispers - Love Is Where You Find It,12,11,22,1.0,16,Love Is Where You Find It,30.0,18,-6,-4,-1,1,down,1982-01-30
19075,The Whispers,1982-06-12,The Whispers - Love Is Where You Find It,16,12,24,1.0,22,Love Is Where You Find It,30.0,19,-2,-6,-4,1,down,1982-01-30
19076,The Whispers,1982-06-19,The Whispers - Love Is Where You Find It,22,16,24,1.0,24,Love Is Where You Find It,30.0,20,0,-2,-6,0,stay,1982-01-30
19077,The Whispers,1982-06-26,The Whispers - Love Is Where You Find It,24,22,28,1.0,24,Love Is Where You Find It,30.0,21,-4,0,-2,1,down,1982-01-30
19078,The Whispers,1982-07-03,The Whispers - Love Is Where You Find It,24,24,28,1.0,28,Love Is Where You Find It,30.0,22,0,-4,0,0,stay,1982-01-30
19079,The Whispers,1982-07-10,The Whispers - Love Is Where You Find It,28,24,27,1.0,28,Love Is Where You Find It,30.0,23,1,0,-4,1,up,1982-01-30
19080,The Whispers,1982-07-17,The Whispers - Love Is Where You Find It,28,28,29,1.0,27,Love Is Where You Find It,30.0,24,-2,1,0,1,down,1982-01-30
19081,The Whispers,1982-07-24,The Whispers - Love Is Where You Find It,27,28,28,1.0,29,Love Is Where You Find It,30.0,25,1,-2,1,1,up,1982-01-30
19082,The Whispers,1982-07-31,The Whispers - Love Is Where You Find It,29,27,38,1.0,28,Love Is Where You Find It,30.0,26,-10,1,-2,1,down,1982-01-30
19083,The Whispers,1982-08-07,The Whispers - Love Is Where You Find It,28,29,42,1.0,38,Love Is Where You Find It,30.0,27,-4,-10,1,1,down,1982-01-30
19084,The Whispers,1982-08-14,The Whispers - Love Is Where You Find It,38,28,44,1.0,42,Love Is Where You Find It,30.0,28,-2,-4,-10,1,down,1982-01-30
19085,The Whispers,1982-08-21,The Whispers - Love Is Where You Find It,42,38,47,1.0,44,Love Is Where You Find It,30.0,29,-3,-2,-4,1,down,1982-01-30
19086,The Whispers,1982-08-28,The Whispers - Love Is Where You Find It,44,42,51,1.0,47,Love Is Where You Find It,30.0,30,-4,-3,-2,1,down,1982-01-30
19087,Michael Franks,1982-02-13,Michael Franks - Objects Of Desire,51,51,38,30.0,42,Objects Of Desire,7.0,0,4,9,0,1,up,1982-02-13
19088,Michael Franks,1982-02-20,Michael Franks - Objects Of Desire,42,51,33,30.0,38,Objects Of Desire,7.0,1,5,4,9,1,up,1982-02-13
19089,Michael Franks,1982-02-27,Michael Franks - Objects Of Desire,38,42,30,30.0,33,Objects Of Desire,7.0,2,3,5,4,1,up,1982-02-13
19090,Michael Franks,1982-03-06,Michael Franks - Objects Of Desire,33,38,30,30.0,30,Objects Of Desire,7.0,3,0,3,5,0,stay,1982-02-13
19091,Michael Franks,1982-03-13,Michael Franks - Objects Of Desire,30,33,33,30.0,30,Objects Of Desire,7.0,4,-3,0,3,1,down,1982-02-13
19092,Michael Franks,1982-03-20,Michael Franks - Objects Of Desire,30,30,37,30.0,33,Objects Of Desire,7.0,5,-4,-3,0,1,down,1982-02-13
19093,Michael Franks,1982-03-27,Michael Franks - Objects Of Desire,33,30,50,30.0,37,Objects Of Desire,7.0,6,-13,-4,-3,1,down,1982-02-13
19094,Michael Franks,1982-04-10,Michael Franks - Objects Of Desire,37,33,51,30.0,50,Objects Of Desire,7.0,7,-1,-13,-4,1,down,1982-02-13
19095,Various Artists,1982-02-13,Various Artists - Echoes Of An Era,51,51,42,38.0,46,Echoes Of An Era,3.0,0,4,5,0,1,up,1982-02-13
19096,Various Artists,1982-02-20,Various Artists - Echoes Of An Era,46,51,38,38.0,42,Echoes Of An Era,3.0,1,4,4,5,1,up,1982-02-13
19097,Various Artists,1982-02-27,Various Artists - Echoes Of An Era,42,46,38,38.0,38,Echoes Of An Era,3.0,2,0,4,4,0,stay,1982-02-13
19098,Various Artists,1982-03-06,Various Artists - Echoes Of An Era,38,42,51,38.0,38,Echoes Of An Era,3.0,3,-13,0,4,1,down,1982-02-13
19099,Olivia Newton-John,1982-02-13,Olivia Newton-John - Physical,51,51,43,32.0,49,Physical,6.0,0,6,2,0,1,up,1982-02-13
19100,Olivia Newton-John,1982-02-20,Olivia Newton-John - Physical,49,51,39,32.0,43,Physical,6.0,1,4,6,2,1,up,1982-02-13
19101,Olivia Newton-John,1982-02-27,Olivia Newton-John - Physical,43,49,32,32.0,39,Physical,6.0,2,7,4,6,1,up,1982-02-13
19102,Olivia Newton-John,1982-03-06,Olivia Newton-John - Physical,39,43,32,32.0,32,Physical,6.0,3,0,7,4,0,stay,1982-02-13
19103,Olivia Newton-John,1982-03-13,Olivia Newton-John - Physical,32,39,41,32.0,32,Physical,6.0,4,-9,0,7,1,down,1982-02-13
19104,Olivia Newton-John,1982-03-20,Olivia Newton-John - Physical,32,32,41,32.0,41,Physical,6.0,5,0,-9,0,0,stay,1982-02-13
19105,Olivia Newton-John,1982-03-27,Olivia Newton-John - Physical,41,32,51,32.0,41,Physical,6.0,6,-10,0,-9,1,down,1982-02-13
19106,Smokey Robinson,1982-02-20,Smokey Robinson - Yes It's You Lady,51,51,16,6.0,30,Yes It's You Lady,20.0,0,14,21,0,1,up,1982-02-20
19107,Smokey Robinson,1982-02-27,Smokey Robinson - Yes It's You Lady,30,51,10,6.0,16,Yes It's You Lady,20.0,1,6,14,21,1,up,1982-02-20
19108,Smokey Robinson,1982-03-06,Smokey Robinson - Yes It's You Lady,16,30,8,6.0,10,Yes It's You Lady,20.0,2,2,6,14,1,up,1982-02-20
19109,Smokey Robinson,1982-03-13,Smokey Robinson - Yes It's You Lady,10,16,7,6.0,8,Yes It's You Lady,20.0,3,1,2,6,1,up,1982-02-20
19110,Smokey Robinson,1982-03-20,Smokey Robinson - Yes It's You Lady,8,10,7,6.0,7,Yes It's You Lady,20.0,4,0,1,2,0,stay,1982-02-20
19111,Smokey Robinson,1982-03-27,Smokey Robinson - Yes It's You Lady,7,8,6,6.0,7,Yes It's You Lady,20.0,5,1,0,1,1,up,1982-02-20
19112,Smokey Robinson,1982-04-03,Smokey Robinson - Yes It's You Lady,7,7,6,6.0,6,Yes It's You Lady,20.0,6,0,1,0,0,stay,1982-02-20
19113,Smokey Robinson,1982-04-10,Smokey Robinson - Yes It's You Lady,6,7,7,6.0,6,Yes It's You Lady,20.0,7,-1,0,1,1,down,1982-02-20
19114,Smokey Robinson,1982-04-17,Smokey Robinson - Yes It's You Lady,6,6,7,6.0,7,Yes It's You Lady,20.0,8,0,-1,0,0,stay,1982-02-20
19115,Smokey Robinson,1982-04-24,Smokey Robinson - Yes It's You Lady,7,6,7,6.0,7,Yes It's You Lady,20.0,9,0,0,-1,0,stay,1982-02-20
19116,Smokey Robinson,1982-05-01,Smokey Robinson - Yes It's You Lady,7,7,8,6.0,7,Yes It's You Lady,20.0,10,-1,0,0,1,down,1982-02-20
19117,Smokey Robinson,1982-05-08,Smokey Robinson - Yes It's You Lady,7,7,18,6.0,8,Yes It's You Lady,20.0,11,-10,-1,0,1,down,1982-02-20
19118,Smokey Robinson,1982-05-15,Smokey Robinson - Yes It's You Lady,8,7,28,6.0,18,Yes It's You Lady,20.0,12,-10,-10,-1,1,down,1982-02-20
19119,Smokey Robinson,1982-05-22,Smokey Robinson - Yes It's You Lady,18,8,28,6.0,28,Yes It's You Lady,20.0,13,0,-10,-10,0,stay,1982-02-20
19120,Smokey Robinson,1982-05-29,Smokey Robinson - Yes It's You Lady,28,18,29,6.0,28,Yes It's You Lady,20.0,14,-1,0,-10,1,down,1982-02-20
19121,Smokey Robinson,1982-06-05,Smokey Robinson - Yes It's You Lady,28,28,35,6.0,29,Yes It's You Lady,20.0,15,-6,-1,0,1,down,1982-02-20
19122,Smokey Robinson,1982-06-12,Smokey Robinson - Yes It's You Lady,29,28,40,6.0,35,Yes It's You Lady,20.0,16,-5,-6,-1,1,down,1982-02-20
19123,Smokey Robinson,1982-06-19,Smokey Robinson - Yes It's You Lady,35,29,41,6.0,40,Yes It's You Lady,20.0,17,-1,-5,-6,1,down,1982-02-20
19124,Smokey Robinson,1982-06-26,Smokey Robinson - Yes It's You Lady,40,35,43,6.0,41,Yes It's You Lady,20.0,18,-2,-1,-5,1,down,1982-02-20
19125,Smokey Robinson,1982-07-03,Smokey Robinson - Yes It's You Lady,41,40,43,6.0,43,Yes It's You Lady,20.0,19,0,-2,-1,0,stay,1982-02-20
19126,Smokey Robinson,1982-07-10,Smokey Robinson - Yes It's You Lady,43,41,51,6.0,43,Yes It's You Lady,20.0,20,-8,0,-2,1,down,1982-02-20
19127,Sister Sledge,1982-02-20,Sister Sledge - The Sisters,51,51,22,17.0,35,The Sisters,10.0,0,13,16,0,1,up,1982-02-20
19128,Sister Sledge,1982-02-27,Sister Sledge - The Sisters,35,51,19,17.0,22,The Sisters,10.0,1,3,13,16,1,up,1982-02-20
19129,Sister Sledge,1982-03-06,Sister Sledge - The Sisters,22,35,17,17.0,19,The Sisters,10.0,2,2,3,13,1,up,1982-02-20
19130,Sister Sledge,1982-03-13,Sister Sledge - The Sisters,19,22,17,17.0,17,The Sisters,10.0,3,0,2,3,0,stay,1982-02-20
19131,Sister Sledge,1982-03-20,Sister Sledge - The Sisters,17,19,18,17.0,17,The Sisters,10.0,4,-1,0,2,1,down,1982-02-20
19132,Sister Sledge,1982-03-27,Sister Sledge - The Sisters,17,17,21,17.0,18,The Sisters,10.0,5,-3,-1,0,1,down,1982-02-20
19133,Sister Sledge,1982-04-03,Sister Sledge - The Sisters,18,17,21,17.0,21,The Sisters,10.0,6,0,-3,-1,0,stay,1982-02-20
19134,Sister Sledge,1982-04-10,Sister Sledge - The Sisters,21,18,29,17.0,21,The Sisters,10.0,7,-8,0,-3,1,down,1982-02-20
19135,Sister Sledge,1982-04-17,Sister Sledge - The Sisters,21,21,38,17.0,29,The Sisters,10.0,8,-9,-8,0,1,down,1982-02-20
19136,Sister Sledge,1982-04-24,Sister Sledge - The Sisters,29,21,39,17.0,38,The Sisters,10.0,9,-1,-9,-8,1,down,1982-02-20
19137,Sister Sledge,1982-05-01,Sister Sledge - The Sisters,38,29,51,17.0,39,The Sisters,10.0,10,-12,-1,-9,1,down,1982-02-20
19138,Aurra,1982-02-20,Aurra - A Little Love,51,51,25,12.0,39,A Little Love,13.0,0,14,12,0,1,up,1982-02-20
19139,Aurra,1982-02-27,Aurra - A Little Love,39,51,22,12.0,25,A Little Love,13.0,1,3,14,12,1,up,1982-02-20
19140,Aurra,1982-03-06,Aurra - A Little Love,25,39,14,12.0,22,A Little Love,13.0,2,8,3,14,1,up,1982-02-20
19141,Aurra,1982-03-13,Aurra - A Little Love,22,25,12,12.0,14,A Little Love,13.0,3,2,8,3,1,up,1982-02-20
19142,Aurra,1982-03-20,Aurra - A Little Love,14,22,12,12.0,12,A Little Love,13.0,4,0,2,8,0,stay,1982-02-20
19143,Aurra,1982-03-27,Aurra - A Little Love,12,14,12,12.0,12,A Little Love,13.0,5,0,0,2,0,stay,1982-02-20
19144,Aurra,1982-04-03,Aurra - A Little Love,12,12,19,12.0,12,A Little Love,13.0,6,-7,0,0,1,down,1982-02-20
19145,Aurra,1982-04-10,Aurra - A Little Love,12,12,22,12.0,19,A Little Love,13.0,7,-3,-7,0,1,down,1982-02-20
19146,Aurra,1982-04-17,Aurra - A Little Love,19,12,26,12.0,22,A Little Love,13.0,8,-4,-3,-7,1,down,1982-02-20
19147,Aurra,1982-04-24,Aurra - A Little Love,22,19,31,12.0,26,A Little Love,13.0,9,-5,-4,-3,1,down,1982-02-20
19148,Aurra,1982-05-01,Aurra - A Little Love,26,22,33,12.0,31,A Little Love,13.0,10,-2,-5,-4,1,down,1982-02-20
19149,Aurra,1982-05-08,Aurra - A Little Love,31,26,42,12.0,33,A Little Love,13.0,11,-9,-2,-5,1,down,1982-02-20
19150,Aurra,1982-05-15,Aurra - A Little Love,33,31,42,12.0,42,A Little Love,13.0,12,0,-9,-2,0,stay,1982-02-20
19151,Aurra,1982-05-22,Aurra - A Little Love,42,33,51,12.0,42,A Little Love,13.0,13,-9,0,-9,1,down,1982-02-20
19152,Irene Cara,1982-02-20,Irene Cara - Anyone Can See,51,51,42,39.0,46,Anyone Can See,4.0,0,4,5,0,1,up,1982-02-20
19153,Irene Cara,1982-02-27,Irene Cara - Anyone Can See,46,51,39,39.0,42,Anyone Can See,4.0,1,3,4,5,1,up,1982-02-20
19154,Irene Cara,1982-03-06,Irene Cara - Anyone Can See,42,46,39,39.0,39,Anyone Can See,4.0,2,0,3,4,0,stay,1982-02-20
19155,Irene Cara,1982-03-13,Irene Cara - Anyone Can See,39,42,42,39.0,39,Anyone Can See,4.0,3,-3,0,3,1,down,1982-02-20
19156,Irene Cara,1982-03-20,Irene Cara - Anyone Can See,39,39,51,39.0,42,Anyone Can See,4.0,4,-9,-3,0,1,down,1982-02-20
19157,Shalamar,1982-02-27,Shalamar - Friends,51,51,20,1.0,24,Friends,31.0,0,4,27,0,1,up,1982-02-27
19158,Shalamar,1982-03-06,Shalamar - Friends,24,51,18,1.0,20,Friends,31.0,1,2,4,27,1,up,1982-02-27
19159,Shalamar,1982-03-13,Shalamar - Friends,20,24,16,1.0,18,Friends,31.0,2,2,2,4,1,up,1982-02-27
19160,Shalamar,1982-03-20,Shalamar - Friends,18,20,13,1.0,16,Friends,31.0,3,3,2,2,1,up,1982-02-27
19161,Shalamar,1982-03-27,Shalamar - Friends,16,18,8,1.0,13,Friends,31.0,4,5,3,2,1,up,1982-02-27
19162,Shalamar,1982-04-03,Shalamar - Friends,13,16,5,1.0,8,Friends,31.0,5,3,5,3,1,up,1982-02-27
19163,Shalamar,1982-04-10,Shalamar - Friends,8,13,2,1.0,5,Friends,31.0,6,3,3,5,1,up,1982-02-27
19164,Shalamar,1982-04-17,Shalamar - Friends,5,8,1,1.0,2,Friends,31.0,7,1,3,3,1,up,1982-02-27
19165,Shalamar,1982-04-24,Shalamar - Friends,2,5,1,1.0,1,Friends,31.0,8,0,1,3,0,stay,1982-02-27
19166,Shalamar,1982-05-01,Shalamar - Friends,1,2,2,1.0,1,Friends,31.0,9,-1,0,1,1,down,1982-02-27
19167,Shalamar,1982-05-08,Shalamar - Friends,1,1,8,1.0,2,Friends,31.0,10,-6,-1,0,1,down,1982-02-27
19168,Shalamar,1982-05-15,Shalamar - Friends,2,1,8,1.0,8,Friends,31.0,11,0,-6,-1,0,stay,1982-02-27
19169,Shalamar,1982-05-22,Shalamar - Friends,8,2,8,1.0,8,Friends,31.0,12,0,0,-6,0,stay,1982-02-27
19170,Shalamar,1982-05-29,Shalamar - Friends,8,8,9,1.0,8,Friends,31.0,13,-1,0,0,1,down,1982-02-27
19171,Shalamar,1982-06-05,Shalamar - Friends,8,8,13,1.0,9,Friends,31.0,14,-4,-1,0,1,down,1982-02-27
19172,Shalamar,1982-06-12,Shalamar - Friends,9,8,16,1.0,13,Friends,31.0,15,-3,-4,-1,1,down,1982-02-27
19173,Shalamar,1982-06-19,Shalamar - Friends,13,9,16,1.0,16,Friends,31.0,16,0,-3,-4,0,stay,1982-02-27
19174,Shalamar,1982-06-26,Shalamar - Friends,16,13,23,1.0,16,Friends,31.0,17,-7,0,-3,1,down,1982-02-27
19175,Shalamar,1982-07-03,Shalamar - Friends,16,16,23,1.0,23,Friends,31.0,18,0,-7,0,0,stay,1982-02-27
19176,Shalamar,1982-07-10,Shalamar - Friends,23,16,28,1.0,23,Friends,31.0,19,-5,0,-7,1,down,1982-02-27
19177,Shalamar,1982-07-17,Shalamar - Friends,23,23,28,1.0,28,Friends,31.0,20,0,-5,0,0,stay,1982-02-27
19178,Shalamar,1982-07-24,Shalamar - Friends,28,23,37,1.0,28,Friends,31.0,21,-9,0,-5,1,down,1982-02-27
19179,Shalamar,1982-07-31,Shalamar - Friends,28,28,35,1.0,37,Friends,31.0,22,2,-9,0,1,up,1982-02-27
19180,Shalamar,1982-08-07,Shalamar - Friends,37,28,35,1.0,35,Friends,31.0,23,0,2,-9,0,stay,1982-02-27
19181,Shalamar,1982-08-14,Shalamar - Friends,35,37,36,1.0,35,Friends,31.0,24,-1,0,2,1,down,1982-02-27
19182,Shalamar,1982-08-21,Shalamar - Friends,35,35,36,1.0,36,Friends,31.0,25,0,-1,0,0,stay,1982-02-27
19183,Shalamar,1982-08-28,Shalamar - Friends,36,35,37,1.0,36,Friends,31.0,26,-1,0,-1,1,down,1982-02-27
19184,Shalamar,1982-09-04,Shalamar - Friends,36,36,48,1.0,37,Friends,31.0,27,-11,-1,0,1,down,1982-02-27
19185,Shalamar,1982-09-11,Shalamar - Friends,37,36,48,1.0,48,Friends,31.0,28,0,-11,-1,0,stay,1982-02-27
19186,Shalamar,1982-09-18,Shalamar - Friends,48,37,47,1.0,48,Friends,31.0,29,1,0,-11,1,up,1982-02-27
19187,Shalamar,1982-09-25,Shalamar - Friends,48,48,47,1.0,47,Friends,31.0,30,0,1,0,0,stay,1982-02-27
19188,Shalamar,1982-10-02,Shalamar - Friends,47,48,51,1.0,47,Friends,31.0,31,-4,0,1,1,down,1982-02-27
19189,"Richard ""Dimples"" Fields",1982-02-27,"Richard ""Dimples"" Fields - Mr. Look So Good",51,51,31,3.0,44,Mr. Look So Good,23.0,0,13,7,0,1,up,1982-02-27
19190,"Richard ""Dimples"" Fields",1982-03-06,"Richard ""Dimples"" Fields - Mr. Look So Good",44,51,22,3.0,31,Mr. Look So Good,23.0,1,9,13,7,1,up,1982-02-27
19191,"Richard ""Dimples"" Fields",1982-03-13,"Richard ""Dimples"" Fields - Mr. Look So Good",31,44,18,3.0,22,Mr. Look So Good,23.0,2,4,9,13,1,up,1982-02-27
19192,"Richard ""Dimples"" Fields",1982-03-20,"Richard ""Dimples"" Fields - Mr. Look So Good",22,31,15,3.0,18,Mr. Look So Good,23.0,3,3,4,9,1,up,1982-02-27
19193,"Richard ""Dimples"" Fields",1982-03-27,"Richard ""Dimples"" Fields - Mr. Look So Good",18,22,10,3.0,15,Mr. Look So Good,23.0,4,5,3,4,1,up,1982-02-27
19194,"Richard ""Dimples"" Fields",1982-04-03,"Richard ""Dimples"" Fields - Mr. Look So Good",15,18,8,3.0,10,Mr. Look So Good,23.0,5,2,5,3,1,up,1982-02-27
19195,"Richard ""Dimples"" Fields",1982-04-10,"Richard ""Dimples"" Fields - Mr. Look So Good",10,15,3,3.0,8,Mr. Look So Good,23.0,6,5,2,5,1,up,1982-02-27
19196,"Richard ""Dimples"" Fields",1982-04-17,"Richard ""Dimples"" Fields - Mr. Look So Good",8,10,3,3.0,3,Mr. Look So Good,23.0,7,0,5,2,0,stay,1982-02-27
19197,"Richard ""Dimples"" Fields",1982-04-24,"Richard ""Dimples"" Fields - Mr. Look So Good",3,8,3,3.0,3,Mr. Look So Good,23.0,8,0,0,5,0,stay,1982-02-27
19198,"Richard ""Dimples"" Fields",1982-05-01,"Richard ""Dimples"" Fields - Mr. Look So Good",3,3,3,3.0,3,Mr. Look So Good,23.0,9,0,0,0,0,stay,1982-02-27
19199,"Richard ""Dimples"" Fields",1982-05-08,"Richard ""Dimples"" Fields - Mr. Look So Good",3,3,3,3.0,3,Mr. Look So Good,23.0,10,0,0,0,0,stay,1982-02-27
19200,"Richard ""Dimples"" Fields",1982-05-15,"Richard ""Dimples"" Fields - Mr. Look So Good",3,3,10,3.0,3,Mr. Look So Good,23.0,11,-7,0,0,1,down,1982-02-27
19201,"Richard ""Dimples"" Fields",1982-05-22,"Richard ""Dimples"" Fields - Mr. Look So Good",3,3,11,3.0,10,Mr. Look So Good,23.0,12,-1,-7,0,1,down,1982-02-27
19202,"Richard ""Dimples"" Fields",1982-05-29,"Richard ""Dimples"" Fields - Mr. Look So Good",10,3,12,3.0,11,Mr. Look So Good,23.0,13,-1,-1,-7,1,down,1982-02-27
19203,"Richard ""Dimples"" Fields",1982-06-05,"Richard ""Dimples"" Fields - Mr. Look So Good",11,10,19,3.0,12,Mr. Look So Good,23.0,14,-7,-1,-1,1,down,1982-02-27
19204,"Richard ""Dimples"" Fields",1982-06-12,"Richard ""Dimples"" Fields - Mr. Look So Good",12,11,19,3.0,19,Mr. Look So Good,23.0,15,0,-7,-1,0,stay,1982-02-27
19205,"Richard ""Dimples"" Fields",1982-06-19,"Richard ""Dimples"" Fields - Mr. Look So Good",19,12,27,3.0,19,Mr. Look So Good,23.0,16,-8,0,-7,1,down,1982-02-27
19206,"Richard ""Dimples"" Fields",1982-06-26,"Richard ""Dimples"" Fields - Mr. Look So Good",19,19,27,3.0,27,Mr. Look So Good,23.0,17,0,-8,0,0,stay,1982-02-27
19207,"Richard ""Dimples"" Fields",1982-07-03,"Richard ""Dimples"" Fields - Mr. Look So Good",27,19,26,3.0,27,Mr. Look So Good,23.0,18,1,0,-8,1,up,1982-02-27
19208,"Richard ""Dimples"" Fields",1982-07-10,"Richard ""Dimples"" Fields - Mr. Look So Good",27,27,33,3.0,26,Mr. Look So Good,23.0,19,-7,1,0,1,down,1982-02-27
19209,"Richard ""Dimples"" Fields",1982-07-17,"Richard ""Dimples"" Fields - Mr. Look So Good",26,27,38,3.0,33,Mr. Look So Good,23.0,20,-5,-7,1,1,down,1982-02-27
19210,"Richard ""Dimples"" Fields",1982-07-24,"Richard ""Dimples"" Fields - Mr. Look So Good",33,26,42,3.0,38,Mr. Look So Good,23.0,21,-4,-5,-7,1,down,1982-02-27
19211,"Richard ""Dimples"" Fields",1982-07-31,"Richard ""Dimples"" Fields - Mr. Look So Good",38,33,45,3.0,42,Mr. Look So Good,23.0,22,-3,-4,-5,1,down,1982-02-27
19212,"Richard ""Dimples"" Fields",1982-08-07,"Richard ""Dimples"" Fields - Mr. Look So Good",42,38,51,3.0,45,Mr. Look So Good,23.0,23,-6,-3,-4,1,down,1982-02-27
19213,Kleeer,1982-02-27,Kleeer - Taste The Music,51,51,42,31.0,46,Taste The Music,7.0,0,4,5,0,1,up,1982-02-27
19214,Kleeer,1982-03-06,Kleeer - Taste The Music,46,51,38,31.0,42,Taste The Music,7.0,1,4,4,5,1,up,1982-02-27
19215,Kleeer,1982-03-13,Kleeer - Taste The Music,42,46,35,31.0,38,Taste The Music,7.0,2,3,4,4,1,up,1982-02-27
19216,Kleeer,1982-03-20,Kleeer - Taste The Music,38,42,31,31.0,35,Taste The Music,7.0,3,4,3,4,1,up,1982-02-27
19217,Kleeer,1982-03-27,Kleeer - Taste The Music,35,38,31,31.0,31,Taste The Music,7.0,4,0,4,3,0,stay,1982-02-27
19218,Kleeer,1982-04-03,Kleeer - Taste The Music,31,35,39,31.0,31,Taste The Music,7.0,5,-8,0,4,1,down,1982-02-27
19219,Kleeer,1982-04-10,Kleeer - Taste The Music,31,31,39,31.0,39,Taste The Music,7.0,6,0,-8,0,0,stay,1982-02-27
19220,Kleeer,1982-04-17,Kleeer - Taste The Music,39,31,51,31.0,39,Taste The Music,7.0,7,-12,0,-8,1,down,1982-02-27
19221,Brandi Wells,1982-02-27,Brandi Wells - Watch Out,51,51,44,37.0,47,Watch Out,6.0,0,3,4,0,1,up,1982-02-27
19222,Brandi Wells,1982-03-06,Brandi Wells - Watch Out,47,51,37,37.0,44,Watch Out,6.0,1,7,3,4,1,up,1982-02-27
19223,Brandi Wells,1982-03-13,Brandi Wells - Watch Out,44,47,37,37.0,37,Watch Out,6.0,2,0,7,3,0,stay,1982-02-27
19224,Brandi Wells,1982-03-20,Brandi Wells - Watch Out,37,44,43,37.0,37,Watch Out,6.0,3,-6,0,7,1,down,1982-02-27
19225,Brandi Wells,1982-03-27,Brandi Wells - Watch Out,37,37,42,37.0,43,Watch Out,6.0,4,1,-6,0,1,up,1982-02-27
19226,Brandi Wells,1982-04-03,Brandi Wells - Watch Out,43,37,49,37.0,42,Watch Out,6.0,5,-7,1,-6,1,down,1982-02-27
19227,Brandi Wells,1982-04-10,Brandi Wells - Watch Out,42,43,51,37.0,49,Watch Out,6.0,6,-2,-7,1,1,down,1982-02-27
19228,Fuse One,1982-02-27,Fuse One - Silk,51,51,45,44.0,48,Silk,2.0,0,3,3,0,1,up,1982-02-27
19229,Fuse One,1982-03-06,Fuse One - Silk,48,51,44,44.0,45,Silk,2.0,1,1,3,3,1,up,1982-02-27
19230,Fuse One,1982-03-13,Fuse One - Silk,45,48,51,44.0,44,Silk,2.0,2,-7,1,3,1,down,1982-02-27
19231,Z.Z. Hill,1982-03-06,Z.Z. Hill - Down Home,51,51,41,17.0,47,Down Home,58.0,0,6,4,0,1,up,1982-03-06
19232,Z.Z. Hill,1982-03-13,Z.Z. Hill - Down Home,47,51,36,17.0,41,Down Home,58.0,1,5,6,4,1,up,1982-03-06
19233,Z.Z. Hill,1982-03-20,Z.Z. Hill - Down Home,41,47,33,17.0,36,Down Home,58.0,2,3,5,6,1,up,1982-03-06
19234,Z.Z. Hill,1982-03-27,Z.Z. Hill - Down Home,36,41,28,17.0,33,Down Home,58.0,3,5,3,5,1,up,1982-03-06
19235,Z.Z. Hill,1982-04-03,Z.Z. Hill - Down Home,33,36,28,17.0,28,Down Home,58.0,4,0,5,3,0,stay,1982-03-06
19236,Z.Z. Hill,1982-04-10,Z.Z. Hill - Down Home,28,33,26,17.0,28,Down Home,58.0,5,2,0,5,1,up,1982-03-06
19237,Z.Z. Hill,1982-04-17,Z.Z. Hill - Down Home,28,28,23,17.0,26,Down Home,58.0,6,3,2,0,1,up,1982-03-06
19238,Z.Z. Hill,1982-04-24,Z.Z. Hill - Down Home,26,28,23,17.0,23,Down Home,58.0,7,0,3,2,0,stay,1982-03-06
19239,Z.Z. Hill,1982-05-01,Z.Z. Hill - Down Home,23,26,22,17.0,23,Down Home,58.0,8,1,0,3,1,up,1982-03-06
19240,Z.Z. Hill,1982-05-08,Z.Z. Hill - Down Home,23,23,19,17.0,22,Down Home,58.0,9,3,1,0,1,up,1982-03-06
19241,Z.Z. Hill,1982-05-15,Z.Z. Hill - Down Home,22,23,19,17.0,19,Down Home,58.0,10,0,3,1,0,stay,1982-03-06
19242,Z.Z. Hill,1982-05-22,Z.Z. Hill - Down Home,19,22,19,17.0,19,Down Home,58.0,11,0,0,3,0,stay,1982-03-06
19243,Z.Z. Hill,1982-05-29,Z.Z. Hill - Down Home,19,19,18,17.0,19,Down Home,58.0,12,1,0,0,1,up,1982-03-06
19244,Z.Z. Hill,1982-06-05,Z.Z. Hill - Down Home,19,19,17,17.0,18,Down Home,58.0,13,1,1,0,1,up,1982-03-06
19245,Z.Z. Hill,1982-06-12,Z.Z. Hill - Down Home,18,19,17,17.0,17,Down Home,58.0,14,0,1,1,0,stay,1982-03-06
19246,Z.Z. Hill,1982-06-19,Z.Z. Hill - Down Home,17,18,17,17.0,17,Down Home,58.0,15,0,0,1,0,stay,1982-03-06
19247,Z.Z. Hill,1982-06-26,Z.Z. Hill - Down Home,17,17,24,17.0,17,Down Home,58.0,16,-7,0,0,1,down,1982-03-06
19248,Z.Z. Hill,1982-07-03,Z.Z. Hill - Down Home,17,17,24,17.0,24,Down Home,58.0,17,0,-7,0,0,stay,1982-03-06
19249,Z.Z. Hill,1982-07-10,Z.Z. Hill - Down Home,24,17,23,17.0,24,Down Home,58.0,18,1,0,-7,1,up,1982-03-06
19250,Z.Z. Hill,1982-07-17,Z.Z. Hill - Down Home,24,24,23,17.0,23,Down Home,58.0,19,0,1,0,0,stay,1982-03-06
19251,Z.Z. Hill,1982-07-24,Z.Z. Hill - Down Home,23,24,23,17.0,23,Down Home,58.0,20,0,0,1,0,stay,1982-03-06
19252,Z.Z. Hill,1982-07-31,Z.Z. Hill - Down Home,23,23,25,17.0,23,Down Home,58.0,21,-2,0,0,1,down,1982-03-06
19253,Z.Z. Hill,1982-08-07,Z.Z. Hill - Down Home,23,23,34,17.0,25,Down Home,58.0,22,-9,-2,0,1,down,1982-03-06
19254,Z.Z. Hill,1982-08-14,Z.Z. Hill - Down Home,25,23,35,17.0,34,Down Home,58.0,23,-1,-9,-2,1,down,1982-03-06
19255,Z.Z. Hill,1982-08-21,Z.Z. Hill - Down Home,34,25,34,17.0,35,Down Home,58.0,24,1,-1,-9,1,up,1982-03-06
19256,Z.Z. Hill,1982-08-28,Z.Z. Hill - Down Home,35,34,34,17.0,34,Down Home,58.0,25,0,1,-1,0,stay,1982-03-06
19257,Z.Z. Hill,1982-09-04,Z.Z. Hill - Down Home,34,35,34,17.0,34,Down Home,58.0,26,0,0,1,0,stay,1982-03-06
19258,Z.Z. Hill,1982-09-11,Z.Z. Hill - Down Home,34,34,32,17.0,34,Down Home,58.0,27,2,0,0,1,up,1982-03-06
19259,Z.Z. Hill,1982-09-18,Z.Z. Hill - Down Home,34,34,32,17.0,32,Down Home,58.0,28,0,2,0,0,stay,1982-03-06
19260,Z.Z. Hill,1982-09-25,Z.Z. Hill - Down Home,32,34,34,17.0,32,Down Home,58.0,29,-2,0,2,1,down,1982-03-06
19261,Z.Z. Hill,1982-10-02,Z.Z. Hill - Down Home,32,32,34,17.0,34,Down Home,58.0,30,0,-2,0,0,stay,1982-03-06
19262,Z.Z. Hill,1982-10-09,Z.Z. Hill - Down Home,34,32,33,17.0,34,Down Home,58.0,31,1,0,-2,1,up,1982-03-06
19263,Z.Z. Hill,1982-10-16,Z.Z. Hill - Down Home,34,34,47,17.0,33,Down Home,58.0,32,-14,1,0,1,down,1982-03-06
19264,Z.Z. Hill,1982-10-23,Z.Z. Hill - Down Home,33,34,47,17.0,47,Down Home,58.0,33,0,-14,1,0,stay,1982-03-06
19265,Z.Z. Hill,1982-10-30,Z.Z. Hill - Down Home,47,33,43,17.0,47,Down Home,58.0,34,4,0,-14,1,up,1982-03-06
19266,Z.Z. Hill,1982-11-06,Z.Z. Hill - Down Home,47,47,39,17.0,43,Down Home,58.0,35,4,4,0,1,up,1982-03-06
19267,Z.Z. Hill,1982-11-13,Z.Z. Hill - Down Home,43,47,36,17.0,39,Down Home,58.0,36,3,4,4,1,up,1982-03-06
19268,Z.Z. Hill,1982-11-20,Z.Z. Hill - Down Home,39,43,34,17.0,36,Down Home,58.0,37,2,3,4,1,up,1982-03-06
19269,Z.Z. Hill,1982-11-27,Z.Z. Hill - Down Home,36,39,34,17.0,34,Down Home,58.0,38,0,2,3,0,stay,1982-03-06
19270,Z.Z. Hill,1982-12-04,Z.Z. Hill - Down Home,34,36,39,17.0,34,Down Home,58.0,39,-5,0,2,1,down,1982-03-06
19271,Z.Z. Hill,1982-12-11,Z.Z. Hill - Down Home,34,34,50,17.0,39,Down Home,58.0,40,-11,-5,0,1,down,1982-03-06
19272,Z.Z. Hill,1983-01-29,Z.Z. Hill - Down Home,39,34,45,17.0,50,Down Home,58.0,41,5,-11,-5,1,up,1982-03-06
19273,Z.Z. Hill,1983-02-05,Z.Z. Hill - Down Home,50,39,44,17.0,45,Down Home,58.0,42,1,5,-11,1,up,1982-03-06
19274,Z.Z. Hill,1983-02-12,Z.Z. Hill - Down Home,45,50,42,17.0,44,Down Home,58.0,43,2,1,5,1,up,1982-03-06
19275,Z.Z. Hill,1983-02-19,Z.Z. Hill - Down Home,44,45,42,17.0,42,Down Home,58.0,44,0,2,1,0,stay,1982-03-06
19276,Z.Z. Hill,1983-02-26,Z.Z. Hill - Down Home,42,44,37,17.0,42,Down Home,58.0,45,5,0,2,1,up,1982-03-06
19277,Z.Z. Hill,1983-03-05,Z.Z. Hill - Down Home,42,42,37,17.0,37,Down Home,58.0,46,0,5,0,0,stay,1982-03-06
19278,Z.Z. Hill,1983-03-12,Z.Z. Hill - Down Home,37,42,40,17.0,37,Down Home,58.0,47,-3,0,5,1,down,1982-03-06
19279,Z.Z. Hill,1983-03-19,Z.Z. Hill - Down Home,37,37,43,17.0,40,Down Home,58.0,48,-3,-3,0,1,down,1982-03-06
19280,Z.Z. Hill,1983-03-26,Z.Z. Hill - Down Home,40,37,39,17.0,43,Down Home,58.0,49,4,-3,-3,1,up,1982-03-06
19281,Z.Z. Hill,1983-04-02,Z.Z. Hill - Down Home,43,40,39,17.0,39,Down Home,58.0,50,0,4,-3,0,stay,1982-03-06
19282,Z.Z. Hill,1983-04-09,Z.Z. Hill - Down Home,39,43,48,17.0,39,Down Home,58.0,51,-9,0,4,1,down,1982-03-06
19283,Z.Z. Hill,1983-04-16,Z.Z. Hill - Down Home,39,39,47,17.0,48,Down Home,58.0,52,1,-9,0,1,up,1982-03-06
19284,Z.Z. Hill,1983-04-23,Z.Z. Hill - Down Home,48,39,46,17.0,47,Down Home,58.0,53,1,1,-9,1,up,1982-03-06
19285,Z.Z. Hill,1983-04-30,Z.Z. Hill - Down Home,47,48,45,17.0,46,Down Home,58.0,54,1,1,1,1,up,1982-03-06
19286,Z.Z. Hill,1983-05-07,Z.Z. Hill - Down Home,46,47,49,17.0,45,Down Home,58.0,55,-4,1,1,1,down,1982-03-06
19287,Z.Z. Hill,1983-06-04,Z.Z. Hill - Down Home,45,46,45,17.0,49,Down Home,58.0,56,4,-4,1,1,up,1982-03-06
19288,Z.Z. Hill,1983-06-11,Z.Z. Hill - Down Home,49,45,45,17.0,45,Down Home,58.0,57,0,4,-4,0,stay,1982-03-06
19289,Z.Z. Hill,1983-06-18,Z.Z. Hill - Down Home,45,49,51,17.0,45,Down Home,58.0,58,-6,0,4,1,down,1982-03-06
19290,Bettye LaVette,1982-03-06,Bettye LaVette - Tell Me A Lie,51,51,48,48.0,48,Tell Me A Lie,1.0,0,0,3,0,0,stay,1982-03-06
19291,Bettye LaVette,1982-03-13,Bettye LaVette - Tell Me A Lie,48,51,51,48.0,48,Tell Me A Lie,1.0,1,-3,0,3,1,down,1982-03-06
19292,George Duke,1982-03-13,George Duke - Dream On,51,51,23,17.0,31,Dream On,11.0,0,8,20,0,1,up,1982-03-13
19293,George Duke,1982-03-20,George Duke - Dream On,31,51,19,17.0,23,Dream On,11.0,1,4,8,20,1,up,1982-03-13
19294,George Duke,1982-03-27,George Duke - Dream On,23,31,17,17.0,19,Dream On,11.0,2,2,4,8,1,up,1982-03-13
19295,George Duke,1982-04-03,George Duke - Dream On,19,23,17,17.0,17,Dream On,11.0,3,0,2,4,0,stay,1982-03-13
19296,George Duke,1982-04-10,George Duke - Dream On,17,19,17,17.0,17,Dream On,11.0,4,0,0,2,0,stay,1982-03-13
19297,George Duke,1982-04-17,George Duke - Dream On,17,17,27,17.0,17,Dream On,11.0,5,-10,0,0,1,down,1982-03-13
19298,George Duke,1982-04-24,George Duke - Dream On,17,17,27,17.0,27,Dream On,11.0,6,0,-10,0,0,stay,1982-03-13
19299,George Duke,1982-05-01,George Duke - Dream On,27,17,29,17.0,27,Dream On,11.0,7,-2,0,-10,1,down,1982-03-13
19300,George Duke,1982-05-08,George Duke - Dream On,27,27,32,17.0,29,Dream On,11.0,8,-3,-2,0,1,down,1982-03-13
19301,George Duke,1982-05-15,George Duke - Dream On,29,27,35,17.0,32,Dream On,11.0,9,-3,-3,-2,1,down,1982-03-13
19302,George Duke,1982-05-22,George Duke - Dream On,32,29,38,17.0,35,Dream On,11.0,10,-3,-3,-3,1,down,1982-03-13
19303,George Duke,1982-05-29,George Duke - Dream On,35,32,51,17.0,38,Dream On,11.0,11,-13,-3,-3,1,down,1982-03-13
19304,The Chi-lites,1982-03-13,The Chi-lites - Me And You,51,51,45,31.0,46,Me And You,8.0,0,1,5,0,1,up,1982-03-13
19305,The Chi-lites,1982-03-20,The Chi-lites - Me And You,46,51,40,31.0,45,Me And You,8.0,1,5,1,5,1,up,1982-03-13
19306,The Chi-lites,1982-03-27,The Chi-lites - Me And You,45,46,36,31.0,40,Me And You,8.0,2,4,5,1,1,up,1982-03-13
19307,The Chi-lites,1982-04-03,The Chi-lites - Me And You,40,45,31,31.0,36,Me And You,8.0,3,5,4,5,1,up,1982-03-13
19308,The Chi-lites,1982-04-10,The Chi-lites - Me And You,36,40,31,31.0,31,Me And You,8.0,4,0,5,4,0,stay,1982-03-13
19309,The Chi-lites,1982-04-17,The Chi-lites - Me And You,31,36,35,31.0,31,Me And You,8.0,5,-4,0,5,1,down,1982-03-13
19310,The Chi-lites,1982-04-24,The Chi-lites - Me And You,31,31,35,31.0,35,Me And You,8.0,6,0,-4,0,0,stay,1982-03-13
19311,The Chi-lites,1982-05-01,The Chi-lites - Me And You,35,31,38,31.0,35,Me And You,8.0,7,-3,0,-4,1,down,1982-03-13
19312,The Chi-lites,1982-05-08,The Chi-lites - Me And You,35,35,51,31.0,38,Me And You,8.0,8,-13,-3,0,1,down,1982-03-13
19313,Ernie Watts,1982-03-13,Ernie Watts - Chariots Of Fire,51,51,46,46.0,50,Chariots Of Fire,3.0,0,4,1,0,1,up,1982-03-13
19314,Ernie Watts,1982-03-20,Ernie Watts - Chariots Of Fire,50,51,46,46.0,46,Chariots Of Fire,3.0,1,0,4,1,0,stay,1982-03-13
19315,Ernie Watts,1982-03-27,Ernie Watts - Chariots Of Fire,46,50,46,46.0,46,Chariots Of Fire,3.0,2,0,0,4,0,stay,1982-03-13
19316,Ernie Watts,1982-04-03,Ernie Watts - Chariots Of Fire,46,46,51,46.0,46,Chariots Of Fire,3.0,3,-5,0,0,1,down,1982-03-13
19317,Millie Jackson,1982-03-20,Millie Jackson - Live And Outrageous (Rated XXX),51,51,24,11.0,38,Live And Outrageous (Rated XXX),17.0,0,14,13,0,1,up,1982-03-20
19318,Millie Jackson,1982-03-27,Millie Jackson - Live And Outrageous (Rated XXX),38,51,18,11.0,24,Live And Outrageous (Rated XXX),17.0,1,6,14,13,1,up,1982-03-20
19319,Millie Jackson,1982-04-03,Millie Jackson - Live And Outrageous (Rated XXX),24,38,16,11.0,18,Live And Outrageous (Rated XXX),17.0,2,2,6,14,1,up,1982-03-20
19320,Millie Jackson,1982-04-10,Millie Jackson - Live And Outrageous (Rated XXX),18,24,14,11.0,16,Live And Outrageous (Rated XXX),17.0,3,2,2,6,1,up,1982-03-20
19321,Millie Jackson,1982-04-17,Millie Jackson - Live And Outrageous (Rated XXX),16,18,11,11.0,14,Live And Outrageous (Rated XXX),17.0,4,3,2,2,1,up,1982-03-20
19322,Millie Jackson,1982-04-24,Millie Jackson - Live And Outrageous (Rated XXX),14,16,11,11.0,11,Live And Outrageous (Rated XXX),17.0,5,0,3,2,0,stay,1982-03-20
19323,Millie Jackson,1982-05-01,Millie Jackson - Live And Outrageous (Rated XXX),11,14,21,11.0,11,Live And Outrageous (Rated XXX),17.0,6,-10,0,3,1,down,1982-03-20
19324,Millie Jackson,1982-05-08,Millie Jackson - Live And Outrageous (Rated XXX),11,11,21,11.0,21,Live And Outrageous (Rated XXX),17.0,7,0,-10,0,0,stay,1982-03-20
19325,Millie Jackson,1982-05-15,Millie Jackson - Live And Outrageous (Rated XXX),21,11,25,11.0,21,Live And Outrageous (Rated XXX),17.0,8,-4,0,-10,1,down,1982-03-20
19326,Millie Jackson,1982-05-22,Millie Jackson - Live And Outrageous (Rated XXX),21,21,25,11.0,25,Live And Outrageous (Rated XXX),17.0,9,0,-4,0,0,stay,1982-03-20
19327,Millie Jackson,1982-05-29,Millie Jackson - Live And Outrageous (Rated XXX),25,21,31,11.0,25,Live And Outrageous (Rated XXX),17.0,10,-6,0,-4,1,down,1982-03-20
19328,Millie Jackson,1982-06-05,Millie Jackson - Live And Outrageous (Rated XXX),25,25,28,11.0,31,Live And Outrageous (Rated XXX),17.0,11,3,-6,0,1,up,1982-03-20
19329,Millie Jackson,1982-06-12,Millie Jackson - Live And Outrageous (Rated XXX),31,25,28,11.0,28,Live And Outrageous (Rated XXX),17.0,12,0,3,-6,0,stay,1982-03-20
19330,Millie Jackson,1982-06-19,Millie Jackson - Live And Outrageous (Rated XXX),28,31,32,11.0,28,Live And Outrageous (Rated XXX),17.0,13,-4,0,3,1,down,1982-03-20
19331,Millie Jackson,1982-06-26,Millie Jackson - Live And Outrageous (Rated XXX),28,28,35,11.0,32,Live And Outrageous (Rated XXX),17.0,14,-3,-4,0,1,down,1982-03-20
19332,Millie Jackson,1982-07-03,Millie Jackson - Live And Outrageous (Rated XXX),32,28,36,11.0,35,Live And Outrageous (Rated XXX),17.0,15,-1,-3,-4,1,down,1982-03-20
19333,Millie Jackson,1982-07-10,Millie Jackson - Live And Outrageous (Rated XXX),35,32,45,11.0,36,Live And Outrageous (Rated XXX),17.0,16,-9,-1,-3,1,down,1982-03-20
19334,Millie Jackson,1982-07-17,Millie Jackson - Live And Outrageous (Rated XXX),36,35,51,11.0,45,Live And Outrageous (Rated XXX),17.0,17,-6,-9,-1,1,down,1982-03-20
19335,T-Connection,1982-03-20,T-Connection - Pure + Natural,51,51,39,31.0,44,Pure + Natural,8.0,0,5,7,0,1,up,1982-03-20
19336,T-Connection,1982-03-27,T-Connection - Pure + Natural,44,51,35,31.0,39,Pure + Natural,8.0,1,4,5,7,1,up,1982-03-20
19337,T-Connection,1982-04-03,T-Connection - Pure + Natural,39,44,32,31.0,35,Pure + Natural,8.0,2,3,4,5,1,up,1982-03-20
19338,T-Connection,1982-04-10,T-Connection - Pure + Natural,35,39,32,31.0,32,Pure + Natural,8.0,3,0,3,4,0,stay,1982-03-20
19339,T-Connection,1982-04-17,T-Connection - Pure + Natural,32,35,31,31.0,32,Pure + Natural,8.0,4,1,0,3,1,up,1982-03-20
19340,T-Connection,1982-04-24,T-Connection - Pure + Natural,32,32,34,31.0,31,Pure + Natural,8.0,5,-3,1,0,1,down,1982-03-20
19341,T-Connection,1982-05-01,T-Connection - Pure + Natural,31,32,34,31.0,34,Pure + Natural,8.0,6,0,-3,1,0,stay,1982-03-20
19342,T-Connection,1982-05-08,T-Connection - Pure + Natural,34,31,41,31.0,34,Pure + Natural,8.0,7,-7,0,-3,1,down,1982-03-20
19343,T-Connection,1982-05-15,T-Connection - Pure + Natural,34,34,51,31.0,41,Pure + Natural,8.0,8,-10,-7,0,1,down,1982-03-20
19344,Imagination,1982-03-20,Imagination - Body Talk,51,51,49,46.0,50,Body Talk,3.0,0,1,1,0,1,up,1982-03-20
19345,Imagination,1982-03-27,Imagination - Body Talk,50,51,47,46.0,49,Body Talk,3.0,1,2,1,1,1,up,1982-03-20
19346,Imagination,1982-04-03,Imagination - Body Talk,49,50,46,46.0,47,Body Talk,3.0,2,1,2,1,1,up,1982-03-20
19347,Imagination,1982-04-10,Imagination - Body Talk,47,49,51,46.0,46,Body Talk,3.0,3,-5,1,2,1,down,1982-03-20
19348,Atlantic Starr,1982-03-27,Atlantic Starr - Brilliance,51,51,20,1.0,35,Brilliance,33.0,0,15,16,0,1,up,1982-03-27
19349,Atlantic Starr,1982-04-03,Atlantic Starr - Brilliance,35,51,11,1.0,20,Brilliance,33.0,1,9,15,16,1,up,1982-03-27
19350,Atlantic Starr,1982-04-10,Atlantic Starr - Brilliance,20,35,8,1.0,11,Brilliance,33.0,2,3,9,15,1,up,1982-03-27
19351,Atlantic Starr,1982-04-17,Atlantic Starr - Brilliance,11,20,5,1.0,8,Brilliance,33.0,3,3,3,9,1,up,1982-03-27
19352,Atlantic Starr,1982-04-24,Atlantic Starr - Brilliance,8,11,2,1.0,5,Brilliance,33.0,4,3,3,3,1,up,1982-03-27
19353,Atlantic Starr,1982-05-01,Atlantic Starr - Brilliance,5,8,1,1.0,2,Brilliance,33.0,5,1,3,3,1,up,1982-03-27
19354,Atlantic Starr,1982-05-08,Atlantic Starr - Brilliance,2,5,1,1.0,1,Brilliance,33.0,6,0,1,3,0,stay,1982-03-27
19355,Atlantic Starr,1982-05-15,Atlantic Starr - Brilliance,1,2,1,1.0,1,Brilliance,33.0,7,0,0,1,0,stay,1982-03-27
19356,Atlantic Starr,1982-05-22,Atlantic Starr - Brilliance,1,1,3,1.0,1,Brilliance,33.0,8,-2,0,0,1,down,1982-03-27
19357,Atlantic Starr,1982-05-29,Atlantic Starr - Brilliance,1,1,7,1.0,3,Brilliance,33.0,9,-4,-2,0,1,down,1982-03-27
19358,Atlantic Starr,1982-06-05,Atlantic Starr - Brilliance,3,1,7,1.0,7,Brilliance,33.0,10,0,-4,-2,0,stay,1982-03-27
19359,Atlantic Starr,1982-06-12,Atlantic Starr - Brilliance,7,3,7,1.0,7,Brilliance,33.0,11,0,0,-4,0,stay,1982-03-27
19360,Atlantic Starr,1982-06-19,Atlantic Starr - Brilliance,7,7,6,1.0,7,Brilliance,33.0,12,1,0,0,1,up,1982-03-27
19361,Atlantic Starr,1982-06-26,Atlantic Starr - Brilliance,7,7,6,1.0,6,Brilliance,33.0,13,0,1,0,0,stay,1982-03-27
19362,Atlantic Starr,1982-07-03,Atlantic Starr - Brilliance,6,7,6,1.0,6,Brilliance,33.0,14,0,0,1,0,stay,1982-03-27
19363,Atlantic Starr,1982-07-10,Atlantic Starr - Brilliance,6,6,8,1.0,6,Brilliance,33.0,15,-2,0,0,1,down,1982-03-27
19364,Atlantic Starr,1982-07-17,Atlantic Starr - Brilliance,6,6,9,1.0,8,Brilliance,33.0,16,-1,-2,0,1,down,1982-03-27
19365,Atlantic Starr,1982-07-24,Atlantic Starr - Brilliance,8,6,10,1.0,9,Brilliance,33.0,17,-1,-1,-2,1,down,1982-03-27
19366,Atlantic Starr,1982-07-31,Atlantic Starr - Brilliance,9,8,8,1.0,10,Brilliance,33.0,18,2,-1,-1,1,up,1982-03-27
19367,Atlantic Starr,1982-08-07,Atlantic Starr - Brilliance,10,9,8,1.0,8,Brilliance,33.0,19,0,2,-1,0,stay,1982-03-27
19368,Atlantic Starr,1982-08-14,Atlantic Starr - Brilliance,8,10,18,1.0,8,Brilliance,33.0,20,-10,0,2,1,down,1982-03-27
19369,Atlantic Starr,1982-08-21,Atlantic Starr - Brilliance,8,8,18,1.0,18,Brilliance,33.0,21,0,-10,0,0,stay,1982-03-27
19370,Atlantic Starr,1982-08-28,Atlantic Starr - Brilliance,18,8,21,1.0,18,Brilliance,33.0,22,-3,0,-10,1,down,1982-03-27
19371,Atlantic Starr,1982-09-04,Atlantic Starr - Brilliance,18,18,21,1.0,21,Brilliance,33.0,23,0,-3,0,0,stay,1982-03-27
19372,Atlantic Starr,1982-09-11,Atlantic Starr - Brilliance,21,18,22,1.0,21,Brilliance,33.0,24,-1,0,-3,1,down,1982-03-27
19373,Atlantic Starr,1982-09-18,Atlantic Starr - Brilliance,21,21,30,1.0,22,Brilliance,33.0,25,-8,-1,0,1,down,1982-03-27
19374,Atlantic Starr,1982-09-25,Atlantic Starr - Brilliance,22,21,30,1.0,30,Brilliance,33.0,26,0,-8,-1,0,stay,1982-03-27
19375,Atlantic Starr,1982-10-02,Atlantic Starr - Brilliance,30,22,33,1.0,30,Brilliance,33.0,27,-3,0,-8,1,down,1982-03-27
19376,Atlantic Starr,1982-10-09,Atlantic Starr - Brilliance,30,30,37,1.0,33,Brilliance,33.0,28,-4,-3,0,1,down,1982-03-27
19377,Atlantic Starr,1982-10-16,Atlantic Starr - Brilliance,33,30,46,1.0,37,Brilliance,33.0,29,-9,-4,-3,1,down,1982-03-27
19378,Atlantic Starr,1982-10-23,Atlantic Starr - Brilliance,37,33,46,1.0,46,Brilliance,33.0,30,0,-9,-4,0,stay,1982-03-27
19379,Atlantic Starr,1982-10-30,Atlantic Starr - Brilliance,46,37,46,1.0,46,Brilliance,33.0,31,0,0,-9,0,stay,1982-03-27
19380,Atlantic Starr,1982-11-06,Atlantic Starr - Brilliance,46,46,44,1.0,46,Brilliance,33.0,32,2,0,0,1,up,1982-03-27
19381,Atlantic Starr,1982-11-13,Atlantic Starr - Brilliance,46,46,51,1.0,44,Brilliance,33.0,33,-7,2,0,1,down,1982-03-27
19382,War,1982-03-27,War - Outlaw,51,51,32,15.0,38,Outlaw,27.0,0,6,13,0,1,up,1982-03-27
19383,War,1982-04-03,War - Outlaw,38,51,27,15.0,32,Outlaw,27.0,1,5,6,13,1,up,1982-03-27
19384,War,1982-04-10,War - Outlaw,32,38,21,15.0,27,Outlaw,27.0,2,6,5,6,1,up,1982-03-27
19385,War,1982-04-17,War - Outlaw,27,32,19,15.0,21,Outlaw,27.0,3,2,6,5,1,up,1982-03-27
19386,War,1982-04-24,War - Outlaw,21,27,17,15.0,19,Outlaw,27.0,4,2,2,6,1,up,1982-03-27
19387,War,1982-05-01,War - Outlaw,19,21,15,15.0,17,Outlaw,27.0,5,2,2,2,1,up,1982-03-27
19388,War,1982-05-08,War - Outlaw,17,19,15,15.0,15,Outlaw,27.0,6,0,2,2,0,stay,1982-03-27
19389,War,1982-05-15,War - Outlaw,15,17,15,15.0,15,Outlaw,27.0,7,0,0,2,0,stay,1982-03-27
19390,War,1982-05-22,War - Outlaw,15,15,29,15.0,15,Outlaw,27.0,8,-14,0,0,1,down,1982-03-27
19391,War,1982-05-29,War - Outlaw,15,15,42,15.0,29,Outlaw,27.0,9,-13,-14,0,1,down,1982-03-27
19392,War,1982-06-05,War - Outlaw,29,15,38,15.0,42,Outlaw,27.0,10,4,-13,-14,1,up,1982-03-27
19393,War,1982-06-12,War - Outlaw,42,29,30,15.0,38,Outlaw,27.0,11,8,4,-13,1,up,1982-03-27
19394,War,1982-06-19,War - Outlaw,38,42,23,15.0,30,Outlaw,27.0,12,7,8,4,1,up,1982-03-27
19395,War,1982-06-26,War - Outlaw,30,38,21,15.0,23,Outlaw,27.0,13,2,7,8,1,up,1982-03-27
19396,War,1982-07-03,War - Outlaw,23,30,17,15.0,21,Outlaw,27.0,14,4,2,7,1,up,1982-03-27
19397,War,1982-07-10,War - Outlaw,21,23,17,15.0,17,Outlaw,27.0,15,0,4,2,0,stay,1982-03-27
19398,War,1982-07-17,War - Outlaw,17,21,26,15.0,17,Outlaw,27.0,16,-9,0,4,1,down,1982-03-27
19399,War,1982-07-24,War - Outlaw,17,17,25,15.0,26,Outlaw,27.0,17,1,-9,0,1,up,1982-03-27
19400,War,1982-07-31,War - Outlaw,26,17,22,15.0,25,Outlaw,27.0,18,3,1,-9,1,up,1982-03-27
19401,War,1982-08-07,War - Outlaw,25,26,22,15.0,22,Outlaw,27.0,19,0,3,1,0,stay,1982-03-27
19402,War,1982-08-14,War - Outlaw,22,25,20,15.0,22,Outlaw,27.0,20,2,0,3,1,up,1982-03-27
19403,War,1982-08-21,War - Outlaw,22,22,20,15.0,20,Outlaw,27.0,21,0,2,0,0,stay,1982-03-27
19404,War,1982-08-28,War - Outlaw,20,22,22,15.0,20,Outlaw,27.0,22,-2,0,2,1,down,1982-03-27
19405,War,1982-09-04,War - Outlaw,20,20,23,15.0,22,Outlaw,27.0,23,-1,-2,0,1,down,1982-03-27
19406,War,1982-09-11,War - Outlaw,22,20,30,15.0,23,Outlaw,27.0,24,-7,-1,-2,1,down,1982-03-27
19407,War,1982-09-18,War - Outlaw,23,22,34,15.0,30,Outlaw,27.0,25,-4,-7,-1,1,down,1982-03-27
19408,War,1982-09-25,War - Outlaw,30,23,35,15.0,34,Outlaw,27.0,26,-1,-4,-7,1,down,1982-03-27
19409,War,1982-10-02,War - Outlaw,34,30,51,15.0,35,Outlaw,27.0,27,-16,-1,-4,1,down,1982-03-27
19410,Third World,1982-03-27,Third World - You've Got The Power,51,51,33,20.0,44,You've Got The Power,16.0,0,11,7,0,1,up,1982-03-27
19411,Third World,1982-04-03,Third World - You've Got The Power,44,51,26,20.0,33,You've Got The Power,16.0,1,7,11,7,1,up,1982-03-27
19412,Third World,1982-04-10,Third World - You've Got The Power,33,44,24,20.0,26,You've Got The Power,16.0,2,2,7,11,1,up,1982-03-27
19413,Third World,1982-04-17,Third World - You've Got The Power,26,33,22,20.0,24,You've Got The Power,16.0,3,2,2,7,1,up,1982-03-27
19414,Third World,1982-04-24,Third World - You've Got The Power,24,26,22,20.0,22,You've Got The Power,16.0,4,0,2,2,0,stay,1982-03-27
19415,Third World,1982-05-01,Third World - You've Got The Power,22,24,20,20.0,22,You've Got The Power,16.0,5,2,0,2,1,up,1982-03-27
19416,Third World,1982-05-08,Third World - You've Got The Power,22,22,20,20.0,20,You've Got The Power,16.0,6,0,2,0,0,stay,1982-03-27
19417,Third World,1982-05-15,Third World - You've Got The Power,20,22,20,20.0,20,You've Got The Power,16.0,7,0,0,2,0,stay,1982-03-27
19418,Third World,1982-05-22,Third World - You've Got The Power,20,20,33,20.0,20,You've Got The Power,16.0,8,-13,0,0,1,down,1982-03-27
19419,Third World,1982-05-29,Third World - You've Got The Power,20,20,33,20.0,33,You've Got The Power,16.0,9,0,-13,0,0,stay,1982-03-27
19420,Third World,1982-06-05,Third World - You've Got The Power,33,20,31,20.0,33,You've Got The Power,16.0,10,2,0,-13,1,up,1982-03-27
19421,Third World,1982-06-12,Third World - You've Got The Power,33,33,46,20.0,31,You've Got The Power,16.0,11,-15,2,0,1,down,1982-03-27
19422,Third World,1982-06-19,Third World - You've Got The Power,31,33,44,20.0,46,You've Got The Power,16.0,12,2,-15,2,1,up,1982-03-27
19423,Third World,1982-06-26,Third World - You've Got The Power,46,31,44,20.0,44,You've Got The Power,16.0,13,0,2,-15,0,stay,1982-03-27
19424,Third World,1982-07-03,Third World - You've Got The Power,44,46,50,20.0,44,You've Got The Power,16.0,14,-6,0,2,1,down,1982-03-27
19425,Third World,1982-07-17,Third World - You've Got The Power,44,44,49,20.0,50,You've Got The Power,16.0,15,1,-6,0,1,up,1982-03-27
19426,Third World,1982-07-24,Third World - You've Got The Power,50,44,51,20.0,49,You've Got The Power,16.0,16,-2,1,-6,1,down,1982-03-27
19427,Chaz Jankel,1982-03-27,Chaz Jankel - Questionnaire,51,51,43,42.0,47,Questionnaire,5.0,0,4,4,0,1,up,1982-03-27
19428,Chaz Jankel,1982-04-03,Chaz Jankel - Questionnaire,47,51,43,42.0,43,Questionnaire,5.0,1,0,4,4,0,stay,1982-03-27
19429,Chaz Jankel,1982-04-10,Chaz Jankel - Questionnaire,43,47,43,42.0,43,Questionnaire,5.0,2,0,0,4,0,stay,1982-03-27
19430,Chaz Jankel,1982-04-17,Chaz Jankel - Questionnaire,43,43,42,42.0,43,Questionnaire,5.0,3,1,0,0,1,up,1982-03-27
19431,Chaz Jankel,1982-04-24,Chaz Jankel - Questionnaire,43,43,48,42.0,42,Questionnaire,5.0,4,-6,1,0,1,down,1982-03-27
19432,Chaz Jankel,1982-05-01,Chaz Jankel - Questionnaire,42,43,51,42.0,48,Questionnaire,5.0,5,-3,-6,1,1,down,1982-03-27
19433,Zoom,1982-03-27,Zoom - Saturday Saturday Night,51,51,44,44.0,48,Saturday Saturday Night,2.0,0,4,3,0,1,up,1982-03-27
19434,Zoom,1982-04-03,Zoom - Saturday Saturday Night,48,51,44,44.0,44,Saturday Saturday Night,2.0,1,0,4,3,0,stay,1982-03-27
19435,Zoom,1982-04-10,Zoom - Saturday Saturday Night,44,48,51,44.0,44,Saturday Saturday Night,2.0,2,-7,0,4,1,down,1982-03-27
19436,Ramsey Lewis,1982-03-27,Ramsey Lewis - Live At The Savoy,51,51,50,50.0,50,Live At The Savoy,2.0,0,0,1,0,0,stay,1982-03-27
19437,Ramsey Lewis,1982-04-03,Ramsey Lewis - Live At The Savoy,50,51,51,50.0,50,Live At The Savoy,2.0,1,-1,0,1,1,down,1982-03-27
19438,Ramsey Lewis,1982-04-24,Ramsey Lewis - Live At The Savoy,50,50,51,50.0,51,Live At The Savoy,2.0,2,0,-1,0,0,stay,1982-03-27
19439,O'Bryan,1982-04-03,O'Bryan - Doin' Alright,51,51,25,10.0,37,Doin' Alright,18.0,0,12,14,0,1,up,1982-04-03
19440,O'Bryan,1982-04-10,O'Bryan - Doin' Alright,37,51,19,10.0,25,Doin' Alright,18.0,1,6,12,14,1,up,1982-04-03
19441,O'Bryan,1982-04-17,O'Bryan - Doin' Alright,25,37,14,10.0,19,Doin' Alright,18.0,2,5,6,12,1,up,1982-04-03
19442,O'Bryan,1982-04-24,O'Bryan - Doin' Alright,19,25,12,10.0,14,Doin' Alright,18.0,3,2,5,6,1,up,1982-04-03
19443,O'Bryan,1982-05-01,O'Bryan - Doin' Alright,14,19,10,10.0,12,Doin' Alright,18.0,4,2,2,5,1,up,1982-04-03
19444,O'Bryan,1982-05-08,O'Bryan - Doin' Alright,12,14,10,10.0,10,Doin' Alright,18.0,5,0,2,2,0,stay,1982-04-03
19445,O'Bryan,1982-05-15,O'Bryan - Doin' Alright,10,12,12,10.0,10,Doin' Alright,18.0,6,-2,0,2,1,down,1982-04-03
19446,O'Bryan,1982-05-22,O'Bryan - Doin' Alright,10,10,21,10.0,12,Doin' Alright,18.0,7,-9,-2,0,1,down,1982-04-03
19447,O'Bryan,1982-05-29,O'Bryan - Doin' Alright,12,10,24,10.0,21,Doin' Alright,18.0,8,-3,-9,-2,1,down,1982-04-03
19448,O'Bryan,1982-06-05,O'Bryan - Doin' Alright,21,12,24,10.0,24,Doin' Alright,18.0,9,0,-3,-9,0,stay,1982-04-03
19449,O'Bryan,1982-06-12,O'Bryan - Doin' Alright,24,21,29,10.0,24,Doin' Alright,18.0,10,-5,0,-3,1,down,1982-04-03
19450,O'Bryan,1982-06-19,O'Bryan - Doin' Alright,24,24,29,10.0,29,Doin' Alright,18.0,11,0,-5,0,0,stay,1982-04-03
19451,O'Bryan,1982-06-26,O'Bryan - Doin' Alright,29,24,29,10.0,29,Doin' Alright,18.0,12,0,0,-5,0,stay,1982-04-03
19452,O'Bryan,1982-07-03,O'Bryan - Doin' Alright,29,29,32,10.0,29,Doin' Alright,18.0,13,-3,0,0,1,down,1982-04-03
19453,O'Bryan,1982-07-10,O'Bryan - Doin' Alright,29,29,32,10.0,32,Doin' Alright,18.0,14,0,-3,0,0,stay,1982-04-03
19454,O'Bryan,1982-07-17,O'Bryan - Doin' Alright,32,29,39,10.0,32,Doin' Alright,18.0,15,-7,0,-3,1,down,1982-04-03
19455,O'Bryan,1982-07-24,O'Bryan - Doin' Alright,32,32,46,10.0,39,Doin' Alright,18.0,16,-7,-7,0,1,down,1982-04-03
19456,O'Bryan,1982-07-31,O'Bryan - Doin' Alright,39,32,46,10.0,46,Doin' Alright,18.0,17,0,-7,-7,0,stay,1982-04-03
19457,O'Bryan,1982-08-07,O'Bryan - Doin' Alright,46,39,51,10.0,46,Doin' Alright,18.0,18,-5,0,-7,1,down,1982-04-03
19458,One Way,1982-04-03,One Way - Who's Foolin' Who,51,51,30,8.0,41,Who's Foolin' Who,24.0,0,11,10,0,1,up,1982-04-03
19459,One Way,1982-04-10,One Way - Who's Foolin' Who,41,51,23,8.0,30,Who's Foolin' Who,24.0,1,7,11,10,1,up,1982-04-03
19460,One Way,1982-04-17,One Way - Who's Foolin' Who,30,41,16,8.0,23,Who's Foolin' Who,24.0,2,7,7,11,1,up,1982-04-03
19461,One Way,1982-04-24,One Way - Who's Foolin' Who,23,30,13,8.0,16,Who's Foolin' Who,24.0,3,3,7,7,1,up,1982-04-03
19462,One Way,1982-05-01,One Way - Who's Foolin' Who,16,23,11,8.0,13,Who's Foolin' Who,24.0,4,2,3,7,1,up,1982-04-03
19463,One Way,1982-05-08,One Way - Who's Foolin' Who,13,16,9,8.0,11,Who's Foolin' Who,24.0,5,2,2,3,1,up,1982-04-03
19464,One Way,1982-05-15,One Way - Who's Foolin' Who,11,13,9,8.0,9,Who's Foolin' Who,24.0,6,0,2,2,0,stay,1982-04-03
19465,One Way,1982-05-22,One Way - Who's Foolin' Who,9,11,9,8.0,9,Who's Foolin' Who,24.0,7,0,0,2,0,stay,1982-04-03
19466,One Way,1982-05-29,One Way - Who's Foolin' Who,9,9,8,8.0,9,Who's Foolin' Who,24.0,8,1,0,0,1,up,1982-04-03
19467,One Way,1982-06-05,One Way - Who's Foolin' Who,9,9,8,8.0,8,Who's Foolin' Who,24.0,9,0,1,0,0,stay,1982-04-03
19468,One Way,1982-06-12,One Way - Who's Foolin' Who,8,9,8,8.0,8,Who's Foolin' Who,24.0,10,0,0,1,0,stay,1982-04-03
19469,One Way,1982-06-19,One Way - Who's Foolin' Who,8,8,8,8.0,8,Who's Foolin' Who,24.0,11,0,0,0,0,stay,1982-04-03
19470,One Way,1982-06-26,One Way - Who's Foolin' Who,8,8,12,8.0,8,Who's Foolin' Who,24.0,12,-4,0,0,1,down,1982-04-03
19471,One Way,1982-07-03,One Way - Who's Foolin' Who,8,8,12,8.0,12,Who's Foolin' Who,24.0,13,0,-4,0,0,stay,1982-04-03
19472,One Way,1982-07-10,One Way - Who's Foolin' Who,12,8,13,8.0,12,Who's Foolin' Who,24.0,14,-1,0,-4,1,down,1982-04-03
19473,One Way,1982-07-17,One Way - Who's Foolin' Who,12,12,14,8.0,13,Who's Foolin' Who,24.0,15,-1,-1,0,1,down,1982-04-03
19474,One Way,1982-07-24,One Way - Who's Foolin' Who,13,12,20,8.0,14,Who's Foolin' Who,24.0,16,-6,-1,-1,1,down,1982-04-03
19475,One Way,1982-07-31,One Way - Who's Foolin' Who,14,13,20,8.0,20,Who's Foolin' Who,24.0,17,0,-6,-1,0,stay,1982-04-03
19476,One Way,1982-08-07,One Way - Who's Foolin' Who,20,14,23,8.0,20,Who's Foolin' Who,24.0,18,-3,0,-6,1,down,1982-04-03
19477,One Way,1982-08-14,One Way - Who's Foolin' Who,20,20,37,8.0,23,Who's Foolin' Who,24.0,19,-14,-3,0,1,down,1982-04-03
19478,One Way,1982-08-21,One Way - Who's Foolin' Who,23,20,37,8.0,37,Who's Foolin' Who,24.0,20,0,-14,-3,0,stay,1982-04-03
19479,One Way,1982-08-28,One Way - Who's Foolin' Who,37,23,36,8.0,37,Who's Foolin' Who,24.0,21,1,0,-14,1,up,1982-04-03
19480,One Way,1982-09-04,One Way - Who's Foolin' Who,37,37,47,8.0,36,Who's Foolin' Who,24.0,22,-11,1,0,1,down,1982-04-03
19481,One Way,1982-09-11,One Way - Who's Foolin' Who,36,37,47,8.0,47,Who's Foolin' Who,24.0,23,0,-11,1,0,stay,1982-04-03
19482,One Way,1982-09-18,One Way - Who's Foolin' Who,47,36,51,8.0,47,Who's Foolin' Who,24.0,24,-4,0,-11,1,down,1982-04-03
19483,Dazz Band,1982-04-03,Dazz Band - Keep It Live,51,51,37,1.0,48,Keep It Live,32.0,0,11,3,0,1,up,1982-04-03
19484,Dazz Band,1982-04-10,Dazz Band - Keep It Live,48,51,30,1.0,37,Keep It Live,32.0,1,7,11,3,1,up,1982-04-03
19485,Dazz Band,1982-04-17,Dazz Band - Keep It Live,37,48,24,1.0,30,Keep It Live,32.0,2,6,7,11,1,up,1982-04-03
19486,Dazz Band,1982-04-24,Dazz Band - Keep It Live,30,37,16,1.0,24,Keep It Live,32.0,3,8,6,7,1,up,1982-04-03
19487,Dazz Band,1982-05-01,Dazz Band - Keep It Live,24,30,9,1.0,16,Keep It Live,32.0,4,7,8,6,1,up,1982-04-03
19488,Dazz Band,1982-05-08,Dazz Band - Keep It Live,16,24,7,1.0,9,Keep It Live,32.0,5,2,7,8,1,up,1982-04-03
19489,Dazz Band,1982-05-15,Dazz Band - Keep It Live,9,16,7,1.0,7,Keep It Live,32.0,6,0,2,7,0,stay,1982-04-03
19490,Dazz Band,1982-05-22,Dazz Band - Keep It Live,7,9,7,1.0,7,Keep It Live,32.0,7,0,0,2,0,stay,1982-04-03
19491,Dazz Band,1982-05-29,Dazz Band - Keep It Live,7,7,6,1.0,7,Keep It Live,32.0,8,1,0,0,1,up,1982-04-03
19492,Dazz Band,1982-06-05,Dazz Band - Keep It Live,7,7,3,1.0,6,Keep It Live,32.0,9,3,1,0,1,up,1982-04-03
19493,Dazz Band,1982-06-12,Dazz Band - Keep It Live,6,7,1,1.0,3,Keep It Live,32.0,10,2,3,1,1,up,1982-04-03
19494,Dazz Band,1982-06-19,Dazz Band - Keep It Live,3,6,2,1.0,1,Keep It Live,32.0,11,-1,2,3,1,down,1982-04-03
19495,Dazz Band,1982-06-26,Dazz Band - Keep It Live,1,3,4,1.0,2,Keep It Live,32.0,12,-2,-1,2,1,down,1982-04-03
19496,Dazz Band,1982-07-03,Dazz Band - Keep It Live,2,1,4,1.0,4,Keep It Live,32.0,13,0,-2,-1,0,stay,1982-04-03
19497,Dazz Band,1982-07-10,Dazz Band - Keep It Live,4,2,3,1.0,4,Keep It Live,32.0,14,1,0,-2,1,up,1982-04-03
19498,Dazz Band,1982-07-17,Dazz Band - Keep It Live,4,4,6,1.0,3,Keep It Live,32.0,15,-3,1,0,1,down,1982-04-03
19499,Dazz Band,1982-07-24,Dazz Band - Keep It Live,3,4,6,1.0,6,Keep It Live,32.0,16,0,-3,1,0,stay,1982-04-03
19500,Dazz Band,1982-07-31,Dazz Band - Keep It Live,6,3,6,1.0,6,Keep It Live,32.0,17,0,0,-3,0,stay,1982-04-03
19501,Dazz Band,1982-08-07,Dazz Band - Keep It Live,6,6,6,1.0,6,Keep It Live,32.0,18,0,0,0,0,stay,1982-04-03
19502,Dazz Band,1982-08-14,Dazz Band - Keep It Live,6,6,7,1.0,6,Keep It Live,32.0,19,-1,0,0,1,down,1982-04-03
19503,Dazz Band,1982-08-21,Dazz Band - Keep It Live,6,6,7,1.0,7,Keep It Live,32.0,20,0,-1,0,0,stay,1982-04-03
19504,Dazz Band,1982-08-28,Dazz Band - Keep It Live,7,6,7,1.0,7,Keep It Live,32.0,21,0,0,-1,0,stay,1982-04-03
19505,Dazz Band,1982-09-04,Dazz Band - Keep It Live,7,7,13,1.0,7,Keep It Live,32.0,22,-6,0,0,1,down,1982-04-03
19506,Dazz Band,1982-09-11,Dazz Band - Keep It Live,7,7,15,1.0,13,Keep It Live,32.0,23,-2,-6,0,1,down,1982-04-03
19507,Dazz Band,1982-09-18,Dazz Band - Keep It Live,13,7,15,1.0,15,Keep It Live,32.0,24,0,-2,-6,0,stay,1982-04-03
19508,Dazz Band,1982-09-25,Dazz Band - Keep It Live,15,13,22,1.0,15,Keep It Live,32.0,25,-7,0,-2,1,down,1982-04-03
19509,Dazz Band,1982-10-02,Dazz Band - Keep It Live,15,15,27,1.0,22,Keep It Live,32.0,26,-5,-7,0,1,down,1982-04-03
19510,Dazz Band,1982-10-09,Dazz Band - Keep It Live,22,15,27,1.0,27,Keep It Live,32.0,27,0,-5,-7,0,stay,1982-04-03
19511,Dazz Band,1982-10-16,Dazz Band - Keep It Live,27,22,35,1.0,27,Keep It Live,32.0,28,-8,0,-5,1,down,1982-04-03
19512,Dazz Band,1982-10-23,Dazz Band - Keep It Live,27,27,35,1.0,35,Keep It Live,32.0,29,0,-8,0,0,stay,1982-04-03
19513,Dazz Band,1982-10-30,Dazz Band - Keep It Live,35,27,49,1.0,35,Keep It Live,32.0,30,-14,0,-8,1,down,1982-04-03
19514,Dazz Band,1982-11-06,Dazz Band - Keep It Live,35,35,50,1.0,49,Keep It Live,32.0,31,-1,-14,0,1,down,1982-04-03
19515,Dazz Band,1982-11-13,Dazz Band - Keep It Live,49,35,51,1.0,50,Keep It Live,32.0,32,-1,-1,-14,1,down,1982-04-03
19516,Roy Ayers,1982-04-03,Roy Ayers - Feeling Good,51,51,45,45.0,49,Feeling Good,2.0,0,4,2,0,1,up,1982-04-03
19517,Roy Ayers,1982-04-10,Roy Ayers - Feeling Good,49,51,45,45.0,45,Feeling Good,2.0,1,0,4,2,0,stay,1982-04-03
19518,Roy Ayers,1982-04-17,Roy Ayers - Feeling Good,45,49,51,45.0,45,Feeling Good,2.0,2,-6,0,4,1,down,1982-04-03
19519,Xavier,1982-04-10,Xavier - Point Of Pleasure,51,51,27,16.0,34,Point Of Pleasure,10.0,0,7,17,0,1,up,1982-04-10
19520,Xavier,1982-04-17,Xavier - Point Of Pleasure,34,51,21,16.0,27,Point Of Pleasure,10.0,1,6,7,17,1,up,1982-04-10
19521,Xavier,1982-04-24,Xavier - Point Of Pleasure,27,34,18,16.0,21,Point Of Pleasure,10.0,2,3,6,7,1,up,1982-04-10
19522,Xavier,1982-05-01,Xavier - Point Of Pleasure,21,27,16,16.0,18,Point Of Pleasure,10.0,3,2,3,6,1,up,1982-04-10
19523,Xavier,1982-05-08,Xavier - Point Of Pleasure,18,21,16,16.0,16,Point Of Pleasure,10.0,4,0,2,3,0,stay,1982-04-10
19524,Xavier,1982-05-15,Xavier - Point Of Pleasure,16,18,16,16.0,16,Point Of Pleasure,10.0,5,0,0,2,0,stay,1982-04-10
19525,Xavier,1982-05-22,Xavier - Point Of Pleasure,16,16,22,16.0,16,Point Of Pleasure,10.0,6,-6,0,0,1,down,1982-04-10
19526,Xavier,1982-05-29,Xavier - Point Of Pleasure,16,16,26,16.0,22,Point Of Pleasure,10.0,7,-4,-6,0,1,down,1982-04-10
19527,Xavier,1982-06-05,Xavier - Point Of Pleasure,22,16,30,16.0,26,Point Of Pleasure,10.0,8,-4,-4,-6,1,down,1982-04-10
19528,Xavier,1982-06-12,Xavier - Point Of Pleasure,26,22,41,16.0,30,Point Of Pleasure,10.0,9,-11,-4,-4,1,down,1982-04-10
19529,Xavier,1982-06-19,Xavier - Point Of Pleasure,30,26,51,16.0,41,Point Of Pleasure,10.0,10,-10,-11,-4,1,down,1982-04-10
19530,Jean Luc Ponty,1982-04-10,Jean Luc Ponty - Mystical Adventure,51,51,44,43.0,48,Mystical Adventure,2.0,0,4,3,0,1,up,1982-04-10
19531,Jean Luc Ponty,1982-04-17,Jean Luc Ponty - Mystical Adventure,48,51,43,43.0,44,Mystical Adventure,2.0,1,1,4,3,1,up,1982-04-10
19532,Jean Luc Ponty,1982-04-24,Jean Luc Ponty - Mystical Adventure,44,48,51,43.0,43,Mystical Adventure,2.0,2,-8,1,4,1,down,1982-04-10
19533,Deniece Williams,1982-04-17,Deniece Williams - Niecy,51,51,18,5.0,35,Niecy,26.0,0,17,16,0,1,up,1982-04-17
19534,Deniece Williams,1982-04-24,Deniece Williams - Niecy,35,51,10,5.0,18,Niecy,26.0,1,8,17,16,1,up,1982-04-17
19535,Deniece Williams,1982-05-01,Deniece Williams - Niecy,18,35,5,5.0,10,Niecy,26.0,2,5,8,17,1,up,1982-04-17
19536,Deniece Williams,1982-05-08,Deniece Williams - Niecy,10,18,5,5.0,5,Niecy,26.0,3,0,5,8,0,stay,1982-04-17
19537,Deniece Williams,1982-05-15,Deniece Williams - Niecy,5,10,5,5.0,5,Niecy,26.0,4,0,0,5,0,stay,1982-04-17
19538,Deniece Williams,1982-05-22,Deniece Williams - Niecy,5,5,5,5.0,5,Niecy,26.0,5,0,0,0,0,stay,1982-04-17
19539,Deniece Williams,1982-05-29,Deniece Williams - Niecy,5,5,5,5.0,5,Niecy,26.0,6,0,0,0,0,stay,1982-04-17
19540,Deniece Williams,1982-06-05,Deniece Williams - Niecy,5,5,5,5.0,5,Niecy,26.0,7,0,0,0,0,stay,1982-04-17
19541,Deniece Williams,1982-06-12,Deniece Williams - Niecy,5,5,13,5.0,5,Niecy,26.0,8,-8,0,0,1,down,1982-04-17
19542,Deniece Williams,1982-06-19,Deniece Williams - Niecy,5,5,13,5.0,13,Niecy,26.0,9,0,-8,0,0,stay,1982-04-17
19543,Deniece Williams,1982-06-26,Deniece Williams - Niecy,13,5,18,5.0,13,Niecy,26.0,10,-5,0,-8,1,down,1982-04-17
19544,Deniece Williams,1982-07-03,Deniece Williams - Niecy,13,13,22,5.0,18,Niecy,26.0,11,-4,-5,0,1,down,1982-04-17
19545,Deniece Williams,1982-07-10,Deniece Williams - Niecy,18,13,21,5.0,22,Niecy,26.0,12,1,-4,-5,1,up,1982-04-17
19546,Deniece Williams,1982-07-17,Deniece Williams - Niecy,22,18,21,5.0,21,Niecy,26.0,13,0,1,-4,0,stay,1982-04-17
19547,Deniece Williams,1982-07-24,Deniece Williams - Niecy,21,22,21,5.0,21,Niecy,26.0,14,0,0,1,0,stay,1982-04-17
19548,Deniece Williams,1982-07-31,Deniece Williams - Niecy,21,21,21,5.0,21,Niecy,26.0,15,0,0,0,0,stay,1982-04-17
19549,Deniece Williams,1982-08-07,Deniece Williams - Niecy,21,21,33,5.0,21,Niecy,26.0,16,-12,0,0,1,down,1982-04-17
19550,Deniece Williams,1982-08-14,Deniece Williams - Niecy,21,21,34,5.0,33,Niecy,26.0,17,-1,-12,0,1,down,1982-04-17
19551,Deniece Williams,1982-08-21,Deniece Williams - Niecy,33,21,32,5.0,34,Niecy,26.0,18,2,-1,-12,1,up,1982-04-17
19552,Deniece Williams,1982-08-28,Deniece Williams - Niecy,34,33,32,5.0,32,Niecy,26.0,19,0,2,-1,0,stay,1982-04-17
19553,Deniece Williams,1982-09-04,Deniece Williams - Niecy,32,34,35,5.0,32,Niecy,26.0,20,-3,0,2,1,down,1982-04-17
19554,Deniece Williams,1982-09-11,Deniece Williams - Niecy,32,32,40,5.0,35,Niecy,26.0,21,-5,-3,0,1,down,1982-04-17
19555,Deniece Williams,1982-09-18,Deniece Williams - Niecy,35,32,40,5.0,40,Niecy,26.0,22,0,-5,-3,0,stay,1982-04-17
19556,Deniece Williams,1982-09-25,Deniece Williams - Niecy,40,35,41,5.0,40,Niecy,26.0,23,-1,0,-5,1,down,1982-04-17
19557,Deniece Williams,1982-10-02,Deniece Williams - Niecy,40,40,50,5.0,41,Niecy,26.0,24,-9,-1,0,1,down,1982-04-17
19558,Deniece Williams,1982-10-09,Deniece Williams - Niecy,41,40,49,5.0,50,Niecy,26.0,25,1,-9,-1,1,up,1982-04-17
19559,Deniece Williams,1982-10-16,Deniece Williams - Niecy,50,41,51,5.0,49,Niecy,26.0,26,-2,1,-9,1,down,1982-04-17
19560,Richard Pryor,1982-04-17,Richard Pryor - Richard Pryor Live On The Sunset Strip,51,51,25,13.0,37,Richard Pryor Live On The Sunset Strip,12.0,0,12,14,0,1,up,1982-04-17
19561,Richard Pryor,1982-04-24,Richard Pryor - Richard Pryor Live On The Sunset Strip,37,51,21,13.0,25,Richard Pryor Live On The Sunset Strip,12.0,1,4,12,14,1,up,1982-04-17
19562,Richard Pryor,1982-05-01,Richard Pryor - Richard Pryor Live On The Sunset Strip,25,37,17,13.0,21,Richard Pryor Live On The Sunset Strip,12.0,2,4,4,12,1,up,1982-04-17
19563,Richard Pryor,1982-05-08,Richard Pryor - Richard Pryor Live On The Sunset Strip,21,25,14,13.0,17,Richard Pryor Live On The Sunset Strip,12.0,3,3,4,4,1,up,1982-04-17
19564,Richard Pryor,1982-05-15,Richard Pryor - Richard Pryor Live On The Sunset Strip,17,21,13,13.0,14,Richard Pryor Live On The Sunset Strip,12.0,4,1,3,4,1,up,1982-04-17
19565,Richard Pryor,1982-05-22,Richard Pryor - Richard Pryor Live On The Sunset Strip,14,17,13,13.0,13,Richard Pryor Live On The Sunset Strip,12.0,5,0,1,3,0,stay,1982-04-17
19566,Richard Pryor,1982-05-29,Richard Pryor - Richard Pryor Live On The Sunset Strip,13,14,22,13.0,13,Richard Pryor Live On The Sunset Strip,12.0,6,-9,0,1,1,down,1982-04-17
19567,Richard Pryor,1982-06-05,Richard Pryor - Richard Pryor Live On The Sunset Strip,13,13,20,13.0,22,Richard Pryor Live On The Sunset Strip,12.0,7,2,-9,0,1,up,1982-04-17
19568,Richard Pryor,1982-06-12,Richard Pryor - Richard Pryor Live On The Sunset Strip,22,13,20,13.0,20,Richard Pryor Live On The Sunset Strip,12.0,8,0,2,-9,0,stay,1982-04-17
19569,Richard Pryor,1982-06-19,Richard Pryor - Richard Pryor Live On The Sunset Strip,20,22,30,13.0,20,Richard Pryor Live On The Sunset Strip,12.0,9,-10,0,2,1,down,1982-04-17
19570,Richard Pryor,1982-06-26,Richard Pryor - Richard Pryor Live On The Sunset Strip,20,20,32,13.0,30,Richard Pryor Live On The Sunset Strip,12.0,10,-2,-10,0,1,down,1982-04-17
19571,Richard Pryor,1982-07-03,Richard Pryor - Richard Pryor Live On The Sunset Strip,30,20,34,13.0,32,Richard Pryor Live On The Sunset Strip,12.0,11,-2,-2,-10,1,down,1982-04-17
19572,Richard Pryor,1982-07-10,Richard Pryor - Richard Pryor Live On The Sunset Strip,32,30,51,13.0,34,Richard Pryor Live On The Sunset Strip,12.0,12,-17,-2,-2,1,down,1982-04-17
19573,Jeff Lorber,1982-04-17,Jeff Lorber - It's A Fact,51,51,44,44.0,47,It's A Fact,3.0,0,3,4,0,1,up,1982-04-17
19574,Jeff Lorber,1982-04-24,Jeff Lorber - It's A Fact,47,51,44,44.0,44,It's A Fact,3.0,1,0,3,4,0,stay,1982-04-17
19575,Jeff Lorber,1982-05-01,Jeff Lorber - It's A Fact,44,47,45,44.0,44,It's A Fact,3.0,2,-1,0,3,1,down,1982-04-17
19576,Jeff Lorber,1982-05-08,Jeff Lorber - It's A Fact,44,44,51,44.0,45,It's A Fact,3.0,3,-6,-1,0,1,down,1982-04-17
19577,Charles Earland,1982-04-17,Charles Earland - Earland's Jam,51,51,48,48.0,48,Earland's Jam,1.0,0,0,3,0,0,stay,1982-04-17
19578,Charles Earland,1982-04-24,Charles Earland - Earland's Jam,48,51,51,48.0,48,Earland's Jam,1.0,1,-3,0,3,1,down,1982-04-17
19579,Cameo,1982-04-24,Cameo - Alligator Woman,51,51,15,6.0,32,Alligator Woman,26.0,0,17,19,0,1,up,1982-04-24
19580,Cameo,1982-05-01,Cameo - Alligator Woman,32,51,6,6.0,15,Alligator Woman,26.0,1,9,17,19,1,up,1982-04-24
19581,Cameo,1982-05-08,Cameo - Alligator Woman,15,32,6,6.0,6,Alligator Woman,26.0,2,0,9,17,0,stay,1982-04-24
19582,Cameo,1982-05-15,Cameo - Alligator Woman,6,15,6,6.0,6,Alligator Woman,26.0,3,0,0,9,0,stay,1982-04-24
19583,Cameo,1982-05-22,Cameo - Alligator Woman,6,6,6,6.0,6,Alligator Woman,26.0,4,0,0,0,0,stay,1982-04-24
19584,Cameo,1982-05-29,Cameo - Alligator Woman,6,6,10,6.0,6,Alligator Woman,26.0,5,-4,0,0,1,down,1982-04-24
19585,Cameo,1982-06-05,Cameo - Alligator Woman,6,6,18,6.0,10,Alligator Woman,26.0,6,-8,-4,0,1,down,1982-04-24
19586,Cameo,1982-06-12,Cameo - Alligator Woman,10,6,18,6.0,18,Alligator Woman,26.0,7,0,-8,-4,0,stay,1982-04-24
19587,Cameo,1982-06-19,Cameo - Alligator Woman,18,10,18,6.0,18,Alligator Woman,26.0,8,0,0,-8,0,stay,1982-04-24
19588,Cameo,1982-06-26,Cameo - Alligator Woman,18,18,17,6.0,18,Alligator Woman,26.0,9,1,0,0,1,up,1982-04-24
19589,Cameo,1982-07-03,Cameo - Alligator Woman,18,18,16,6.0,17,Alligator Woman,26.0,10,1,1,0,1,up,1982-04-24
19590,Cameo,1982-07-10,Cameo - Alligator Woman,17,18,15,6.0,16,Alligator Woman,26.0,11,1,1,1,1,up,1982-04-24
19591,Cameo,1982-07-17,Cameo - Alligator Woman,16,17,13,6.0,15,Alligator Woman,26.0,12,2,1,1,1,up,1982-04-24
19592,Cameo,1982-07-24,Cameo - Alligator Woman,15,16,11,6.0,13,Alligator Woman,26.0,13,2,2,1,1,up,1982-04-24
19593,Cameo,1982-07-31,Cameo - Alligator Woman,13,15,11,6.0,11,Alligator Woman,26.0,14,0,2,2,0,stay,1982-04-24
19594,Cameo,1982-08-07,Cameo - Alligator Woman,11,13,11,6.0,11,Alligator Woman,26.0,15,0,0,2,0,stay,1982-04-24
19595,Cameo,1982-08-14,Cameo - Alligator Woman,11,11,26,6.0,11,Alligator Woman,26.0,16,-15,0,0,1,down,1982-04-24
19596,Cameo,1982-08-21,Cameo - Alligator Woman,11,11,29,6.0,26,Alligator Woman,26.0,17,-3,-15,0,1,down,1982-04-24
19597,Cameo,1982-08-28,Cameo - Alligator Woman,26,11,29,6.0,29,Alligator Woman,26.0,18,0,-3,-15,0,stay,1982-04-24
19598,Cameo,1982-09-04,Cameo - Alligator Woman,29,26,29,6.0,29,Alligator Woman,26.0,19,0,0,-3,0,stay,1982-04-24
19599,Cameo,1982-09-11,Cameo - Alligator Woman,29,29,39,6.0,29,Alligator Woman,26.0,20,-10,0,0,1,down,1982-04-24
19600,Cameo,1982-09-18,Cameo - Alligator Woman,29,29,39,6.0,39,Alligator Woman,26.0,21,0,-10,0,0,stay,1982-04-24
19601,Cameo,1982-09-25,Cameo - Alligator Woman,39,29,37,6.0,39,Alligator Woman,26.0,22,2,0,-10,1,up,1982-04-24
19602,Cameo,1982-10-02,Cameo - Alligator Woman,39,39,43,6.0,37,Alligator Woman,26.0,23,-6,2,0,1,down,1982-04-24
19603,Cameo,1982-10-09,Cameo - Alligator Woman,37,39,43,6.0,43,Alligator Woman,26.0,24,0,-6,2,0,stay,1982-04-24
19604,Cameo,1982-10-16,Cameo - Alligator Woman,43,37,48,6.0,43,Alligator Woman,26.0,25,-5,0,-6,1,down,1982-04-24
19605,Cameo,1982-10-23,Cameo - Alligator Woman,43,43,51,6.0,48,Alligator Woman,26.0,26,-3,-5,0,1,down,1982-04-24
19606,Patrice Rushen,1982-04-24,Patrice Rushen - Straight From The Heart,51,51,20,4.0,36,Straight From The Heart,24.0,0,16,15,0,1,up,1982-04-24
19607,Patrice Rushen,1982-05-01,Patrice Rushen - Straight From The Heart,36,51,13,4.0,20,Straight From The Heart,24.0,1,7,16,15,1,up,1982-04-24
19608,Patrice Rushen,1982-05-08,Patrice Rushen - Straight From The Heart,20,36,4,4.0,13,Straight From The Heart,24.0,2,9,7,16,1,up,1982-04-24
19609,Patrice Rushen,1982-05-15,Patrice Rushen - Straight From The Heart,13,20,4,4.0,4,Straight From The Heart,24.0,3,0,9,7,0,stay,1982-04-24
19610,Patrice Rushen,1982-05-22,Patrice Rushen - Straight From The Heart,4,13,4,4.0,4,Straight From The Heart,24.0,4,0,0,9,0,stay,1982-04-24
19611,Patrice Rushen,1982-05-29,Patrice Rushen - Straight From The Heart,4,4,4,4.0,4,Straight From The Heart,24.0,5,0,0,0,0,stay,1982-04-24
19612,Patrice Rushen,1982-06-05,Patrice Rushen - Straight From The Heart,4,4,4,4.0,4,Straight From The Heart,24.0,6,0,0,0,0,stay,1982-04-24
19613,Patrice Rushen,1982-06-12,Patrice Rushen - Straight From The Heart,4,4,4,4.0,4,Straight From The Heart,24.0,7,0,0,0,0,stay,1982-04-24
19614,Patrice Rushen,1982-06-19,Patrice Rushen - Straight From The Heart,4,4,5,4.0,4,Straight From The Heart,24.0,8,-1,0,0,1,down,1982-04-24
19615,Patrice Rushen,1982-06-26,Patrice Rushen - Straight From The Heart,4,4,5,4.0,5,Straight From The Heart,24.0,9,0,-1,0,0,stay,1982-04-24
19616,Patrice Rushen,1982-07-03,Patrice Rushen - Straight From The Heart,5,4,7,4.0,5,Straight From The Heart,24.0,10,-2,0,-1,1,down,1982-04-24
19617,Patrice Rushen,1982-07-10,Patrice Rushen - Straight From The Heart,5,5,10,4.0,7,Straight From The Heart,24.0,11,-3,-2,0,1,down,1982-04-24
19618,Patrice Rushen,1982-07-17,Patrice Rushen - Straight From The Heart,7,5,10,4.0,10,Straight From The Heart,24.0,12,0,-3,-2,0,stay,1982-04-24
19619,Patrice Rushen,1982-07-24,Patrice Rushen - Straight From The Heart,10,7,9,4.0,10,Straight From The Heart,24.0,13,1,0,-3,1,up,1982-04-24
19620,Patrice Rushen,1982-07-31,Patrice Rushen - Straight From The Heart,10,10,9,4.0,9,Straight From The Heart,24.0,14,0,1,0,0,stay,1982-04-24
19621,Patrice Rushen,1982-08-07,Patrice Rushen - Straight From The Heart,9,10,10,4.0,9,Straight From The Heart,24.0,15,-1,0,1,1,down,1982-04-24
19622,Patrice Rushen,1982-08-14,Patrice Rushen - Straight From The Heart,9,9,19,4.0,10,Straight From The Heart,24.0,16,-9,-1,0,1,down,1982-04-24
19623,Patrice Rushen,1982-08-21,Patrice Rushen - Straight From The Heart,10,9,30,4.0,19,Straight From The Heart,24.0,17,-11,-9,-1,1,down,1982-04-24
19624,Patrice Rushen,1982-08-28,Patrice Rushen - Straight From The Heart,19,10,30,4.0,30,Straight From The Heart,24.0,18,0,-11,-9,0,stay,1982-04-24
19625,Patrice Rushen,1982-09-04,Patrice Rushen - Straight From The Heart,30,19,33,4.0,30,Straight From The Heart,24.0,19,-3,0,-11,1,down,1982-04-24
19626,Patrice Rushen,1982-09-11,Patrice Rushen - Straight From The Heart,30,30,31,4.0,33,Straight From The Heart,24.0,20,2,-3,0,1,up,1982-04-24
19627,Patrice Rushen,1982-09-18,Patrice Rushen - Straight From The Heart,33,30,31,4.0,31,Straight From The Heart,24.0,21,0,2,-3,0,stay,1982-04-24
19628,Patrice Rushen,1982-09-25,Patrice Rushen - Straight From The Heart,31,33,31,4.0,31,Straight From The Heart,24.0,22,0,0,2,0,stay,1982-04-24
19629,Patrice Rushen,1982-10-02,Patrice Rushen - Straight From The Heart,31,31,41,4.0,31,Straight From The Heart,24.0,23,-10,0,0,1,down,1982-04-24
19630,Patrice Rushen,1982-10-09,Patrice Rushen - Straight From The Heart,31,31,51,4.0,41,Straight From The Heart,24.0,24,-10,-10,0,1,down,1982-04-24
19631,Instant Funk,1982-04-24,Instant Funk - Looks So Fine,51,51,43,43.0,47,Looks So Fine,2.0,0,4,4,0,1,up,1982-04-24
19632,Instant Funk,1982-05-01,Instant Funk - Looks So Fine,47,51,43,43.0,43,Looks So Fine,2.0,1,0,4,4,0,stay,1982-04-24
19633,Instant Funk,1982-05-08,Instant Funk - Looks So Fine,43,47,51,43.0,43,Looks So Fine,2.0,2,-8,0,4,1,down,1982-04-24
19634,Mass Production,1982-04-24,Mass Production - In A City Groove,51,51,46,46.0,49,In A City Groove,2.0,0,3,2,0,1,up,1982-04-24
19635,Mass Production,1982-05-01,Mass Production - In A City Groove,49,51,46,46.0,46,In A City Groove,2.0,1,0,3,2,0,stay,1982-04-24
19636,Mass Production,1982-05-08,Mass Production - In A City Groove,46,49,51,46.0,46,In A City Groove,2.0,2,-5,0,3,1,down,1982-04-24
19637,The Temptations,1982-05-01,The Temptations - Reunion,51,51,12,2.0,37,Reunion,21.0,0,25,14,0,1,up,1982-05-01
19638,The Temptations,1982-05-08,The Temptations - Reunion,37,51,2,2.0,12,Reunion,21.0,1,10,25,14,1,up,1982-05-01
19639,The Temptations,1982-05-15,The Temptations - Reunion,12,37,2,2.0,2,Reunion,21.0,2,0,10,25,0,stay,1982-05-01
19640,The Temptations,1982-05-22,The Temptations - Reunion,2,12,2,2.0,2,Reunion,21.0,3,0,0,10,0,stay,1982-05-01
19641,The Temptations,1982-05-29,The Temptations - Reunion,2,2,2,2.0,2,Reunion,21.0,4,0,0,0,0,stay,1982-05-01
19642,The Temptations,1982-06-05,The Temptations - Reunion,2,2,2,2.0,2,Reunion,21.0,5,0,0,0,0,stay,1982-05-01
19643,The Temptations,1982-06-12,The Temptations - Reunion,2,2,5,2.0,2,Reunion,21.0,6,-3,0,0,1,down,1982-05-01
19644,The Temptations,1982-06-19,The Temptations - Reunion,2,2,7,2.0,5,Reunion,21.0,7,-2,-3,0,1,down,1982-05-01
19645,The Temptations,1982-06-26,The Temptations - Reunion,5,2,8,2.0,7,Reunion,21.0,8,-1,-2,-3,1,down,1982-05-01
19646,The Temptations,1982-07-03,The Temptations - Reunion,7,5,10,2.0,8,Reunion,21.0,9,-2,-1,-2,1,down,1982-05-01
19647,The Temptations,1982-07-10,The Temptations - Reunion,8,7,11,2.0,10,Reunion,21.0,10,-1,-2,-1,1,down,1982-05-01
19648,The Temptations,1982-07-17,The Temptations - Reunion,10,8,12,2.0,11,Reunion,21.0,11,-1,-1,-2,1,down,1982-05-01
19649,The Temptations,1982-07-24,The Temptations - Reunion,11,10,14,2.0,12,Reunion,21.0,12,-2,-1,-1,1,down,1982-05-01
19650,The Temptations,1982-07-31,The Temptations - Reunion,12,11,19,2.0,14,Reunion,21.0,13,-5,-2,-1,1,down,1982-05-01
19651,The Temptations,1982-08-07,The Temptations - Reunion,14,12,20,2.0,19,Reunion,21.0,14,-1,-5,-2,1,down,1982-05-01
19652,The Temptations,1982-08-14,The Temptations - Reunion,19,14,27,2.0,20,Reunion,21.0,15,-7,-1,-5,1,down,1982-05-01
19653,The Temptations,1982-08-21,The Temptations - Reunion,20,19,28,2.0,27,Reunion,21.0,16,-1,-7,-1,1,down,1982-05-01
19654,The Temptations,1982-08-28,The Temptations - Reunion,27,20,33,2.0,28,Reunion,21.0,17,-5,-1,-7,1,down,1982-05-01
19655,The Temptations,1982-09-04,The Temptations - Reunion,28,27,43,2.0,33,Reunion,21.0,18,-10,-5,-1,1,down,1982-05-01
19656,The Temptations,1982-09-11,The Temptations - Reunion,33,28,44,2.0,43,Reunion,21.0,19,-1,-10,-5,1,down,1982-05-01
19657,The Temptations,1982-09-18,The Temptations - Reunion,43,33,44,2.0,44,Reunion,21.0,20,0,-1,-10,0,stay,1982-05-01
19658,The Temptations,1982-09-25,The Temptations - Reunion,44,43,51,2.0,44,Reunion,21.0,21,-7,0,-1,1,down,1982-05-01
19659,A Taste Of Honey,1982-05-01,A Taste Of Honey - Ladies Of The Eighties,51,51,27,14.0,42,Ladies Of The Eighties,10.0,0,15,9,0,1,up,1982-05-01
19660,A Taste Of Honey,1982-05-08,A Taste Of Honey - Ladies Of The Eighties,42,51,22,14.0,27,Ladies Of The Eighties,10.0,1,5,15,9,1,up,1982-05-01
19661,A Taste Of Honey,1982-05-15,A Taste Of Honey - Ladies Of The Eighties,27,42,18,14.0,22,Ladies Of The Eighties,10.0,2,4,5,15,1,up,1982-05-01
19662,A Taste Of Honey,1982-05-22,A Taste Of Honey - Ladies Of The Eighties,22,27,16,14.0,18,Ladies Of The Eighties,10.0,3,2,4,5,1,up,1982-05-01
19663,A Taste Of Honey,1982-05-29,A Taste Of Honey - Ladies Of The Eighties,18,22,14,14.0,16,Ladies Of The Eighties,10.0,4,2,2,4,1,up,1982-05-01
19664,A Taste Of Honey,1982-06-05,A Taste Of Honey - Ladies Of The Eighties,16,18,14,14.0,14,Ladies Of The Eighties,10.0,5,0,2,2,0,stay,1982-05-01
19665,A Taste Of Honey,1982-06-12,A Taste Of Honey - Ladies Of The Eighties,14,16,27,14.0,14,Ladies Of The Eighties,10.0,6,-13,0,2,1,down,1982-05-01
19666,A Taste Of Honey,1982-06-19,A Taste Of Honey - Ladies Of The Eighties,14,14,37,14.0,27,Ladies Of The Eighties,10.0,7,-10,-13,0,1,down,1982-05-01
19667,A Taste Of Honey,1982-06-26,A Taste Of Honey - Ladies Of The Eighties,27,14,48,14.0,37,Ladies Of The Eighties,10.0,8,-11,-10,-13,1,down,1982-05-01
19668,A Taste Of Honey,1982-07-03,A Taste Of Honey - Ladies Of The Eighties,37,27,48,14.0,48,Ladies Of The Eighties,10.0,9,0,-11,-10,0,stay,1982-05-01
19669,A Taste Of Honey,1982-07-10,A Taste Of Honey - Ladies Of The Eighties,48,37,51,14.0,48,Ladies Of The Eighties,10.0,10,-3,0,-11,1,down,1982-05-01
19670,Pleasure,1982-05-01,Pleasure - Give It Up,51,51,40,30.0,45,Give It Up,7.0,0,5,6,0,1,up,1982-05-01
19671,Pleasure,1982-05-08,Pleasure - Give It Up,45,51,36,30.0,40,Give It Up,7.0,1,4,5,6,1,up,1982-05-01
19672,Pleasure,1982-05-15,Pleasure - Give It Up,40,45,33,30.0,36,Give It Up,7.0,2,3,4,5,1,up,1982-05-01
19673,Pleasure,1982-05-22,Pleasure - Give It Up,36,40,30,30.0,33,Give It Up,7.0,3,3,3,4,1,up,1982-05-01
19674,Pleasure,1982-05-29,Pleasure - Give It Up,33,36,30,30.0,30,Give It Up,7.0,4,0,3,3,0,stay,1982-05-01
19675,Pleasure,1982-06-05,Pleasure - Give It Up,30,33,39,30.0,30,Give It Up,7.0,5,-9,0,3,1,down,1982-05-01
19676,Pleasure,1982-06-12,Pleasure - Give It Up,30,30,39,30.0,39,Give It Up,7.0,6,0,-9,0,0,stay,1982-05-01
19677,Pleasure,1982-06-19,Pleasure - Give It Up,39,30,51,30.0,39,Give It Up,7.0,7,-12,0,-9,1,down,1982-05-01
19678,D Train,1982-05-01,D Train - D Train,51,51,37,16.0,47,D Train,22.0,0,10,4,0,1,up,1982-05-01
19679,D Train,1982-05-08,D Train - D Train,47,51,33,16.0,37,D Train,22.0,1,4,10,4,1,up,1982-05-01
19680,D Train,1982-05-15,D Train - D Train,37,47,29,16.0,33,D Train,22.0,2,4,4,10,1,up,1982-05-01
19681,D Train,1982-05-22,D Train - D Train,33,37,27,16.0,29,D Train,22.0,3,2,4,4,1,up,1982-05-01
19682,D Train,1982-05-29,D Train - D Train,29,33,23,16.0,27,D Train,22.0,4,4,2,4,1,up,1982-05-01
19683,D Train,1982-06-05,D Train - D Train,27,29,23,16.0,23,D Train,22.0,5,0,4,2,0,stay,1982-05-01
19684,D Train,1982-06-12,D Train - D Train,23,27,23,16.0,23,D Train,22.0,6,0,0,4,0,stay,1982-05-01
19685,D Train,1982-06-19,D Train - D Train,23,23,28,16.0,23,D Train,22.0,7,-5,0,0,1,down,1982-05-01
19686,D Train,1982-06-26,D Train - D Train,23,23,25,16.0,28,D Train,22.0,8,3,-5,0,1,up,1982-05-01
19687,D Train,1982-07-03,D Train - D Train,28,23,21,16.0,25,D Train,22.0,9,4,3,-5,1,up,1982-05-01
19688,D Train,1982-07-10,D Train - D Train,25,28,18,16.0,21,D Train,22.0,10,3,4,3,1,up,1982-05-01
19689,D Train,1982-07-17,D Train - D Train,21,25,16,16.0,18,D Train,22.0,11,2,3,4,1,up,1982-05-01
19690,D Train,1982-07-24,D Train - D Train,18,21,16,16.0,16,D Train,22.0,12,0,2,3,0,stay,1982-05-01
19691,D Train,1982-07-31,D Train - D Train,16,18,16,16.0,16,D Train,22.0,13,0,0,2,0,stay,1982-05-01
19692,D Train,1982-08-07,D Train - D Train,16,16,17,16.0,16,D Train,22.0,14,-1,0,0,1,down,1982-05-01
19693,D Train,1982-08-14,D Train - D Train,16,16,30,16.0,17,D Train,22.0,15,-13,-1,0,1,down,1982-05-01
19694,D Train,1982-08-21,D Train - D Train,17,16,31,16.0,30,D Train,22.0,16,-1,-13,-1,1,down,1982-05-01
19695,D Train,1982-08-28,D Train - D Train,30,17,31,16.0,31,D Train,22.0,17,0,-1,-13,0,stay,1982-05-01
19696,D Train,1982-09-04,D Train - D Train,31,30,32,16.0,31,D Train,22.0,18,-1,0,-1,1,down,1982-05-01
19697,D Train,1982-09-11,D Train - D Train,31,31,41,16.0,32,D Train,22.0,19,-9,-1,0,1,down,1982-05-01
19698,D Train,1982-09-18,D Train - D Train,32,31,41,16.0,41,D Train,22.0,20,0,-9,-1,0,stay,1982-05-01
19699,D Train,1982-09-25,D Train - D Train,41,32,48,16.0,41,D Train,22.0,21,-7,0,-9,1,down,1982-05-01
19700,D Train,1982-10-02,D Train - D Train,41,41,51,16.0,48,D Train,22.0,22,-3,-7,0,1,down,1982-05-01
19701,Ray Parker Jr.,1982-05-08,Ray Parker Jr. - The Other Woman,51,51,12,1.0,23,The Other Woman,26.0,0,11,28,0,1,up,1982-05-08
19702,Ray Parker Jr.,1982-05-15,Ray Parker Jr. - The Other Woman,23,51,3,1.0,12,The Other Woman,26.0,1,9,11,28,1,up,1982-05-08
19703,Ray Parker Jr.,1982-05-22,Ray Parker Jr. - The Other Woman,12,23,1,1.0,3,The Other Woman,26.0,2,2,9,11,1,up,1982-05-08
19704,Ray Parker Jr.,1982-05-29,Ray Parker Jr. - The Other Woman,3,12,3,1.0,1,The Other Woman,26.0,3,-2,2,9,1,down,1982-05-08
19705,Ray Parker Jr.,1982-06-05,Ray Parker Jr. - The Other Woman,1,3,6,1.0,3,The Other Woman,26.0,4,-3,-2,2,1,down,1982-05-08
19706,Ray Parker Jr.,1982-06-12,Ray Parker Jr. - The Other Woman,3,1,9,1.0,6,The Other Woman,26.0,5,-3,-3,-2,1,down,1982-05-08
19707,Ray Parker Jr.,1982-06-19,Ray Parker Jr. - The Other Woman,6,3,12,1.0,9,The Other Woman,26.0,6,-3,-3,-3,1,down,1982-05-08
19708,Ray Parker Jr.,1982-06-26,Ray Parker Jr. - The Other Woman,9,6,13,1.0,12,The Other Woman,26.0,7,-1,-3,-3,1,down,1982-05-08
19709,Ray Parker Jr.,1982-07-03,Ray Parker Jr. - The Other Woman,12,9,13,1.0,13,The Other Woman,26.0,8,0,-1,-3,0,stay,1982-05-08
19710,Ray Parker Jr.,1982-07-10,Ray Parker Jr. - The Other Woman,13,12,12,1.0,13,The Other Woman,26.0,9,1,0,-1,1,up,1982-05-08
19711,Ray Parker Jr.,1982-07-17,Ray Parker Jr. - The Other Woman,13,13,11,1.0,12,The Other Woman,26.0,10,1,1,0,1,up,1982-05-08
19712,Ray Parker Jr.,1982-07-24,Ray Parker Jr. - The Other Woman,12,13,12,1.0,11,The Other Woman,26.0,11,-1,1,1,1,down,1982-05-08
19713,Ray Parker Jr.,1982-07-31,Ray Parker Jr. - The Other Woman,11,12,10,1.0,12,The Other Woman,26.0,12,2,-1,1,1,up,1982-05-08
19714,Ray Parker Jr.,1982-08-07,Ray Parker Jr. - The Other Woman,12,11,9,1.0,10,The Other Woman,26.0,13,1,2,-1,1,up,1982-05-08
19715,Ray Parker Jr.,1982-08-14,Ray Parker Jr. - The Other Woman,10,12,8,1.0,9,The Other Woman,26.0,14,1,1,2,1,up,1982-05-08
19716,Ray Parker Jr.,1982-08-21,Ray Parker Jr. - The Other Woman,9,10,8,1.0,8,The Other Woman,26.0,15,0,1,1,0,stay,1982-05-08
19717,Ray Parker Jr.,1982-08-28,Ray Parker Jr. - The Other Woman,8,9,8,1.0,8,The Other Woman,26.0,16,0,0,1,0,stay,1982-05-08
19718,Ray Parker Jr.,1982-09-04,Ray Parker Jr. - The Other Woman,8,8,8,1.0,8,The Other Woman,26.0,17,0,0,0,0,stay,1982-05-08
19719,Ray Parker Jr.,1982-09-11,Ray Parker Jr. - The Other Woman,8,8,13,1.0,8,The Other Woman,26.0,18,-5,0,0,1,down,1982-05-08
19720,Ray Parker Jr.,1982-09-18,Ray Parker Jr. - The Other Woman,8,8,17,1.0,13,The Other Woman,26.0,19,-4,-5,0,1,down,1982-05-08
19721,Ray Parker Jr.,1982-09-25,Ray Parker Jr. - The Other Woman,13,8,21,1.0,17,The Other Woman,26.0,20,-4,-4,-5,1,down,1982-05-08
19722,Ray Parker Jr.,1982-10-02,Ray Parker Jr. - The Other Woman,17,13,21,1.0,21,The Other Woman,26.0,21,0,-4,-4,0,stay,1982-05-08
19723,Ray Parker Jr.,1982-10-09,Ray Parker Jr. - The Other Woman,21,17,22,1.0,21,The Other Woman,26.0,22,-1,0,-4,1,down,1982-05-08
19724,Ray Parker Jr.,1982-10-16,Ray Parker Jr. - The Other Woman,21,21,23,1.0,22,The Other Woman,26.0,23,-1,-1,0,1,down,1982-05-08
19725,Ray Parker Jr.,1982-10-23,Ray Parker Jr. - The Other Woman,22,21,44,1.0,23,The Other Woman,26.0,24,-21,-1,-1,1,down,1982-05-08
19726,Ray Parker Jr.,1982-10-30,Ray Parker Jr. - The Other Woman,23,22,41,1.0,44,The Other Woman,26.0,25,3,-21,-1,1,up,1982-05-08
19727,Ray Parker Jr.,1982-11-06,Ray Parker Jr. - The Other Woman,44,23,51,1.0,41,The Other Woman,26.0,26,-10,3,-21,1,down,1982-05-08
19728,Junior,1982-05-08,Junior - Ji,51,51,29,15.0,39,Ji,19.0,0,10,12,0,1,up,1982-05-08
19729,Junior,1982-05-15,Junior - Ji,39,51,23,15.0,29,Ji,19.0,1,6,10,12,1,up,1982-05-08
19730,Junior,1982-05-22,Junior - Ji,29,39,20,15.0,23,Ji,19.0,2,3,6,10,1,up,1982-05-08
19731,Junior,1982-05-29,Junior - Ji,23,29,17,15.0,20,Ji,19.0,3,3,3,6,1,up,1982-05-08
19732,Junior,1982-06-05,Junior - Ji,20,23,16,15.0,17,Ji,19.0,4,1,3,3,1,up,1982-05-08
19733,Junior,1982-06-12,Junior - Ji,17,20,15,15.0,16,Ji,19.0,5,1,1,3,1,up,1982-05-08
19734,Junior,1982-06-19,Junior - Ji,16,17,15,15.0,15,Ji,19.0,6,0,1,1,0,stay,1982-05-08
19735,Junior,1982-06-26,Junior - Ji,15,16,15,15.0,15,Ji,19.0,7,0,0,1,0,stay,1982-05-08
19736,Junior,1982-07-03,Junior - Ji,15,15,15,15.0,15,Ji,19.0,8,0,0,0,0,stay,1982-05-08
19737,Junior,1982-07-10,Junior - Ji,15,15,16,15.0,15,Ji,19.0,9,-1,0,0,1,down,1982-05-08
19738,Junior,1982-07-17,Junior - Ji,15,15,15,15.0,16,Ji,19.0,10,1,-1,0,1,up,1982-05-08
19739,Junior,1982-07-24,Junior - Ji,16,15,15,15.0,15,Ji,19.0,11,0,1,-1,0,stay,1982-05-08
19740,Junior,1982-07-31,Junior - Ji,15,16,18,15.0,15,Ji,19.0,12,-3,0,1,1,down,1982-05-08
19741,Junior,1982-08-07,Junior - Ji,15,15,18,15.0,18,Ji,19.0,13,0,-3,0,0,stay,1982-05-08
19742,Junior,1982-08-14,Junior - Ji,18,15,38,15.0,18,Ji,19.0,14,-20,0,-3,1,down,1982-05-08
19743,Junior,1982-08-21,Junior - Ji,18,18,39,15.0,38,Ji,19.0,15,-1,-20,0,1,down,1982-05-08
19744,Junior,1982-08-28,Junior - Ji,38,18,39,15.0,39,Ji,19.0,16,0,-1,-20,0,stay,1982-05-08
19745,Junior,1982-09-04,Junior - Ji,39,38,49,15.0,39,Ji,19.0,17,-10,0,-1,1,down,1982-05-08
19746,Junior,1982-09-11,Junior - Ji,39,39,50,15.0,49,Ji,19.0,18,-1,-10,0,1,down,1982-05-08
19747,Junior,1982-09-18,Junior - Ji,49,39,51,15.0,50,Ji,19.0,19,-1,-1,-10,1,down,1982-05-08
19748,Brass Construction,1982-05-08,Brass Construction - Attitudes,51,51,34,21.0,41,Attitudes,14.0,0,7,10,0,1,up,1982-05-08
19749,Brass Construction,1982-05-15,Brass Construction - Attitudes,41,51,27,21.0,34,Attitudes,14.0,1,7,7,10,1,up,1982-05-08
19750,Brass Construction,1982-05-22,Brass Construction - Attitudes,34,41,24,21.0,27,Attitudes,14.0,2,3,7,7,1,up,1982-05-08
19751,Brass Construction,1982-05-29,Brass Construction - Attitudes,27,34,21,21.0,24,Attitudes,14.0,3,3,3,7,1,up,1982-05-08
19752,Brass Construction,1982-06-05,Brass Construction - Attitudes,24,27,21,21.0,21,Attitudes,14.0,4,0,3,3,0,stay,1982-05-08
19753,Brass Construction,1982-06-12,Brass Construction - Attitudes,21,24,21,21.0,21,Attitudes,14.0,5,0,0,3,0,stay,1982-05-08
19754,Brass Construction,1982-06-19,Brass Construction - Attitudes,21,21,26,21.0,21,Attitudes,14.0,6,-5,0,0,1,down,1982-05-08
19755,Brass Construction,1982-06-26,Brass Construction - Attitudes,21,21,26,21.0,26,Attitudes,14.0,7,0,-5,0,0,stay,1982-05-08
19756,Brass Construction,1982-07-03,Brass Construction - Attitudes,26,21,27,21.0,26,Attitudes,14.0,8,-1,0,-5,1,down,1982-05-08
19757,Brass Construction,1982-07-10,Brass Construction - Attitudes,26,26,34,21.0,27,Attitudes,14.0,9,-7,-1,0,1,down,1982-05-08
19758,Brass Construction,1982-07-17,Brass Construction - Attitudes,27,26,34,21.0,34,Attitudes,14.0,10,0,-7,-1,0,stay,1982-05-08
19759,Brass Construction,1982-07-24,Brass Construction - Attitudes,34,27,33,21.0,34,Attitudes,14.0,11,1,0,-7,1,up,1982-05-08
19760,Brass Construction,1982-07-31,Brass Construction - Attitudes,34,34,39,21.0,33,Attitudes,14.0,12,-6,1,0,1,down,1982-05-08
19761,Brass Construction,1982-08-07,Brass Construction - Attitudes,33,34,46,21.0,39,Attitudes,14.0,13,-7,-6,1,1,down,1982-05-08
19762,Brass Construction,1982-08-14,Brass Construction - Attitudes,39,33,51,21.0,46,Attitudes,14.0,14,-5,-7,-6,1,down,1982-05-08
19763,Change,1982-05-08,Change - Sharing Your Love,51,51,28,14.0,48,Sharing Your Love,13.0,0,20,3,0,1,up,1982-05-08
19764,Change,1982-05-15,Change - Sharing Your Love,48,51,22,14.0,28,Sharing Your Love,13.0,1,6,20,3,1,up,1982-05-08
19765,Change,1982-05-22,Change - Sharing Your Love,28,48,18,14.0,22,Sharing Your Love,13.0,2,4,6,20,1,up,1982-05-08
19766,Change,1982-05-29,Change - Sharing Your Love,22,28,15,14.0,18,Sharing Your Love,13.0,3,3,4,6,1,up,1982-05-08
19767,Change,1982-06-05,Change - Sharing Your Love,18,22,15,14.0,15,Sharing Your Love,13.0,4,0,3,4,0,stay,1982-05-08
19768,Change,1982-06-12,Change - Sharing Your Love,15,18,14,14.0,15,Sharing Your Love,13.0,5,1,0,3,1,up,1982-05-08
19769,Change,1982-06-19,Change - Sharing Your Love,15,15,14,14.0,14,Sharing Your Love,13.0,6,0,1,0,0,stay,1982-05-08
19770,Change,1982-06-26,Change - Sharing Your Love,14,15,14,14.0,14,Sharing Your Love,13.0,7,0,0,1,0,stay,1982-05-08
19771,Change,1982-07-03,Change - Sharing Your Love,14,14,25,14.0,14,Sharing Your Love,13.0,8,-11,0,0,1,down,1982-05-08
19772,Change,1982-07-10,Change - Sharing Your Love,14,14,29,14.0,25,Sharing Your Love,13.0,9,-4,-11,0,1,down,1982-05-08
19773,Change,1982-07-17,Change - Sharing Your Love,25,14,31,14.0,29,Sharing Your Love,13.0,10,-2,-4,-11,1,down,1982-05-08
19774,Change,1982-07-24,Change - Sharing Your Love,29,25,43,14.0,31,Sharing Your Love,13.0,11,-12,-2,-4,1,down,1982-05-08
19775,Change,1982-07-31,Change - Sharing Your Love,31,29,41,14.0,43,Sharing Your Love,13.0,12,2,-12,-2,1,up,1982-05-08
19776,Change,1982-08-07,Change - Sharing Your Love,43,31,51,14.0,41,Sharing Your Love,13.0,13,-10,2,-12,1,down,1982-05-08
19777,B.B. King,1982-05-08,B.B. King - Love Me Tender,51,51,45,45.0,49,Love Me Tender,4.0,0,4,2,0,1,up,1982-05-08
19778,B.B. King,1982-05-15,B.B. King - Love Me Tender,49,51,45,45.0,45,Love Me Tender,4.0,1,0,4,2,0,stay,1982-05-08
19779,B.B. King,1982-05-22,B.B. King - Love Me Tender,45,49,48,45.0,45,Love Me Tender,4.0,2,-3,0,4,1,down,1982-05-08
19780,B.B. King,1982-08-28,B.B. King - Love Me Tender,45,45,48,45.0,48,Love Me Tender,4.0,3,0,-3,0,0,stay,1982-05-08
19781,B.B. King,1982-09-04,B.B. King - Love Me Tender,48,45,51,45.0,48,Love Me Tender,4.0,4,-3,0,-3,1,down,1982-05-08
19782,Bobby Caldwell,1982-05-08,Bobby Caldwell - Carry On,51,51,46,41.0,50,Carry On,4.0,0,4,1,0,1,up,1982-05-08
19783,Bobby Caldwell,1982-05-15,Bobby Caldwell - Carry On,50,51,41,41.0,46,Carry On,4.0,1,5,4,1,1,up,1982-05-08
19784,Bobby Caldwell,1982-05-22,Bobby Caldwell - Carry On,46,50,41,41.0,41,Carry On,4.0,2,0,5,4,0,stay,1982-05-08
19785,Bobby Caldwell,1982-05-29,Bobby Caldwell - Carry On,41,46,50,41.0,41,Carry On,4.0,3,-9,0,5,1,down,1982-05-08
19786,Bobby Caldwell,1982-06-12,Bobby Caldwell - Carry On,41,41,51,41.0,50,Carry On,4.0,4,-1,-9,0,1,down,1982-05-08
19787,Paul McCartney,1982-05-15,Paul McCartney - Tug Of War,51,51,21,11.0,37,Tug Of War,14.0,0,16,14,0,1,up,1982-05-15
19788,Paul McCartney,1982-05-22,Paul McCartney - Tug Of War,37,51,17,11.0,21,Tug Of War,14.0,1,4,16,14,1,up,1982-05-15
19789,Paul McCartney,1982-05-29,Paul McCartney - Tug Of War,21,37,13,11.0,17,Tug Of War,14.0,2,4,4,16,1,up,1982-05-15
19790,Paul McCartney,1982-06-05,Paul McCartney - Tug Of War,17,21,11,11.0,13,Tug Of War,14.0,3,2,4,4,1,up,1982-05-15
19791,Paul McCartney,1982-06-12,Paul McCartney - Tug Of War,13,17,11,11.0,11,Tug Of War,14.0,4,0,2,4,0,stay,1982-05-15
19792,Paul McCartney,1982-06-19,Paul McCartney - Tug Of War,11,13,11,11.0,11,Tug Of War,14.0,5,0,0,2,0,stay,1982-05-15
19793,Paul McCartney,1982-06-26,Paul McCartney - Tug Of War,11,11,11,11.0,11,Tug Of War,14.0,6,0,0,0,0,stay,1982-05-15
19794,Paul McCartney,1982-07-03,Paul McCartney - Tug Of War,11,11,14,11.0,11,Tug Of War,14.0,7,-3,0,0,1,down,1982-05-15
19795,Paul McCartney,1982-07-10,Paul McCartney - Tug Of War,11,11,14,11.0,14,Tug Of War,14.0,8,0,-3,0,0,stay,1982-05-15
19796,Paul McCartney,1982-07-17,Paul McCartney - Tug Of War,14,11,25,11.0,14,Tug Of War,14.0,9,-11,0,-3,1,down,1982-05-15
19797,Paul McCartney,1982-07-24,Paul McCartney - Tug Of War,14,14,26,11.0,25,Tug Of War,14.0,10,-1,-11,0,1,down,1982-05-15
19798,Paul McCartney,1982-07-31,Paul McCartney - Tug Of War,25,14,37,11.0,26,Tug Of War,14.0,11,-11,-1,-11,1,down,1982-05-15
19799,Paul McCartney,1982-08-07,Paul McCartney - Tug Of War,26,25,47,11.0,37,Tug Of War,14.0,12,-10,-11,-1,1,down,1982-05-15
19800,Paul McCartney,1982-08-14,Paul McCartney - Tug Of War,37,26,47,11.0,47,Tug Of War,14.0,13,0,-10,-11,0,stay,1982-05-15
19801,Paul McCartney,1982-08-21,Paul McCartney - Tug Of War,47,37,51,11.0,47,Tug Of War,14.0,14,-4,0,-10,1,down,1982-05-15
19802,The O'Jays,1982-05-15,The O'Jays - My Favorite Person,51,51,24,7.0,43,My Favorite Person,26.0,0,19,8,0,1,up,1982-05-15
19803,The O'Jays,1982-05-22,The O'Jays - My Favorite Person,43,51,14,7.0,24,My Favorite Person,26.0,1,10,19,8,1,up,1982-05-15
19804,The O'Jays,1982-05-29,The O'Jays - My Favorite Person,24,43,11,7.0,14,My Favorite Person,26.0,2,3,10,19,1,up,1982-05-15
19805,The O'Jays,1982-06-05,The O'Jays - My Favorite Person,14,24,10,7.0,11,My Favorite Person,26.0,3,1,3,10,1,up,1982-05-15
19806,The O'Jays,1982-06-12,The O'Jays - My Favorite Person,11,14,10,7.0,10,My Favorite Person,26.0,4,0,1,3,0,stay,1982-05-15
19807,The O'Jays,1982-06-19,The O'Jays - My Favorite Person,10,11,10,7.0,10,My Favorite Person,26.0,5,0,0,1,0,stay,1982-05-15
19808,The O'Jays,1982-06-26,The O'Jays - My Favorite Person,10,10,9,7.0,10,My Favorite Person,26.0,6,1,0,0,1,up,1982-05-15
19809,The O'Jays,1982-07-03,The O'Jays - My Favorite Person,10,10,9,7.0,9,My Favorite Person,26.0,7,0,1,0,0,stay,1982-05-15
19810,The O'Jays,1982-07-10,The O'Jays - My Favorite Person,9,10,7,7.0,9,My Favorite Person,26.0,8,2,0,1,1,up,1982-05-15
19811,The O'Jays,1982-07-17,The O'Jays - My Favorite Person,9,9,7,7.0,7,My Favorite Person,26.0,9,0,2,0,0,stay,1982-05-15
19812,The O'Jays,1982-07-24,The O'Jays - My Favorite Person,7,9,7,7.0,7,My Favorite Person,26.0,10,0,0,2,0,stay,1982-05-15
19813,The O'Jays,1982-07-31,The O'Jays - My Favorite Person,7,7,13,7.0,7,My Favorite Person,26.0,11,-6,0,0,1,down,1982-05-15
19814,The O'Jays,1982-08-07,The O'Jays - My Favorite Person,7,7,14,7.0,13,My Favorite Person,26.0,12,-1,-6,0,1,down,1982-05-15
19815,The O'Jays,1982-08-14,The O'Jays - My Favorite Person,13,7,13,7.0,14,My Favorite Person,26.0,13,1,-1,-6,1,up,1982-05-15
19816,The O'Jays,1982-08-21,The O'Jays - My Favorite Person,14,13,12,7.0,13,My Favorite Person,26.0,14,1,1,-1,1,up,1982-05-15
19817,The O'Jays,1982-08-28,The O'Jays - My Favorite Person,13,14,19,7.0,12,My Favorite Person,26.0,15,-7,1,1,1,down,1982-05-15
19818,The O'Jays,1982-09-04,The O'Jays - My Favorite Person,12,13,19,7.0,19,My Favorite Person,26.0,16,0,-7,1,0,stay,1982-05-15
19819,The O'Jays,1982-09-11,The O'Jays - My Favorite Person,19,12,21,7.0,19,My Favorite Person,26.0,17,-2,0,-7,1,down,1982-05-15
19820,The O'Jays,1982-09-18,The O'Jays - My Favorite Person,19,19,20,7.0,21,My Favorite Person,26.0,18,1,-2,0,1,up,1982-05-15
19821,The O'Jays,1982-09-25,The O'Jays - My Favorite Person,21,19,20,7.0,20,My Favorite Person,26.0,19,0,1,-2,0,stay,1982-05-15
19822,The O'Jays,1982-10-02,The O'Jays - My Favorite Person,20,21,22,7.0,20,My Favorite Person,26.0,20,-2,0,1,1,down,1982-05-15
19823,The O'Jays,1982-10-09,The O'Jays - My Favorite Person,20,20,24,7.0,22,My Favorite Person,26.0,21,-2,-2,0,1,down,1982-05-15
19824,The O'Jays,1982-10-16,The O'Jays - My Favorite Person,22,20,24,7.0,24,My Favorite Person,26.0,22,0,-2,-2,0,stay,1982-05-15
19825,The O'Jays,1982-10-23,The O'Jays - My Favorite Person,24,22,27,7.0,24,My Favorite Person,26.0,23,-3,0,-2,1,down,1982-05-15
19826,The O'Jays,1982-10-30,The O'Jays - My Favorite Person,24,24,31,7.0,27,My Favorite Person,26.0,24,-4,-3,0,1,down,1982-05-15
19827,The O'Jays,1982-11-06,The O'Jays - My Favorite Person,27,24,35,7.0,31,My Favorite Person,26.0,25,-4,-4,-3,1,down,1982-05-15
19828,The O'Jays,1982-11-13,The O'Jays - My Favorite Person,31,27,51,7.0,35,My Favorite Person,26.0,26,-16,-4,-4,1,down,1982-05-15
19829,Trouble Funk,1982-05-15,Trouble Funk - Drop The Bomb,51,51,44,38.0,48,Drop The Bomb,3.0,0,4,3,0,1,up,1982-05-15
19830,Trouble Funk,1982-05-22,Trouble Funk - Drop The Bomb,48,51,39,38.0,44,Drop The Bomb,3.0,1,5,4,3,1,up,1982-05-15
19831,Trouble Funk,1982-05-29,Trouble Funk - Drop The Bomb,44,48,38,38.0,39,Drop The Bomb,3.0,2,1,5,4,1,up,1982-05-15
19832,Trouble Funk,1982-06-05,Trouble Funk - Drop The Bomb,39,44,51,38.0,38,Drop The Bomb,3.0,3,-13,1,5,1,down,1982-05-15
19833,Dionne Warwick,1982-05-15,Dionne Warwick - Friends In Love,51,51,46,33.0,49,Friends In Love,6.0,0,3,2,0,1,up,1982-05-15
19834,Dionne Warwick,1982-05-22,Dionne Warwick - Friends In Love,49,51,42,33.0,46,Friends In Love,6.0,1,4,3,2,1,up,1982-05-15
19835,Dionne Warwick,1982-05-29,Dionne Warwick - Friends In Love,46,49,37,33.0,42,Friends In Love,6.0,2,5,4,3,1,up,1982-05-15
19836,Dionne Warwick,1982-06-05,Dionne Warwick - Friends In Love,42,46,33,33.0,37,Friends In Love,6.0,3,4,5,4,1,up,1982-05-15
19837,Dionne Warwick,1982-06-12,Dionne Warwick - Friends In Love,37,42,33,33.0,33,Friends In Love,6.0,4,0,4,5,0,stay,1982-05-15
19838,Dionne Warwick,1982-06-19,Dionne Warwick - Friends In Love,33,37,39,33.0,33,Friends In Love,6.0,5,-6,0,4,1,down,1982-05-15
19839,Dionne Warwick,1982-06-26,Dionne Warwick - Friends In Love,33,33,51,33.0,39,Friends In Love,6.0,6,-12,-6,0,1,down,1982-05-15
19840,Vernon Burch,1982-05-15,Vernon Burch - Playing Hard To Get,51,51,50,50.0,50,Playing Hard To Get,1.0,0,0,1,0,0,stay,1982-05-15
19841,Vernon Burch,1982-05-22,Vernon Burch - Playing Hard To Get,50,51,51,50.0,50,Playing Hard To Get,1.0,1,-1,0,1,1,down,1982-05-15
19842,Dennis Brown,1982-05-22,Dennis Brown - Love Has Found It's Way,51,51,44,36.0,49,Love Has Found It's Way,5.0,0,5,2,0,1,up,1982-05-22
19843,Dennis Brown,1982-05-29,Dennis Brown - Love Has Found It's Way,49,51,40,36.0,44,Love Has Found It's Way,5.0,1,4,5,2,1,up,1982-05-22
19844,Dennis Brown,1982-06-05,Dennis Brown - Love Has Found It's Way,44,49,36,36.0,40,Love Has Found It's Way,5.0,2,4,4,5,1,up,1982-05-22
19845,Dennis Brown,1982-06-12,Dennis Brown - Love Has Found It's Way,40,44,36,36.0,36,Love Has Found It's Way,5.0,3,0,4,4,0,stay,1982-05-22
19846,Dennis Brown,1982-06-19,Dennis Brown - Love Has Found It's Way,36,40,48,36.0,36,Love Has Found It's Way,5.0,4,-12,0,4,1,down,1982-05-22
19847,Dennis Brown,1982-06-26,Dennis Brown - Love Has Found It's Way,36,36,51,36.0,48,Love Has Found It's Way,5.0,5,-3,-12,0,1,down,1982-05-22
19848,Stevie Wonder,1982-05-29,Stevie Wonder - Stevie Wonder's Original Musiquarium I,51,51,1,1.0,10,Stevie Wonder's Original Musiquarium I,25.0,0,9,41,0,1,up,1982-05-29
19849,Stevie Wonder,1982-06-05,Stevie Wonder - Stevie Wonder's Original Musiquarium I,10,51,1,1.0,1,Stevie Wonder's Original Musiquarium I,25.0,1,0,9,41,0,stay,1982-05-29
19850,Stevie Wonder,1982-06-12,Stevie Wonder - Stevie Wonder's Original Musiquarium I,1,10,2,1.0,1,Stevie Wonder's Original Musiquarium I,25.0,2,-1,0,9,1,down,1982-05-29
19851,Stevie Wonder,1982-06-19,Stevie Wonder - Stevie Wonder's Original Musiquarium I,1,1,1,1.0,2,Stevie Wonder's Original Musiquarium I,25.0,3,1,-1,0,1,up,1982-05-29
19852,Stevie Wonder,1982-06-26,Stevie Wonder - Stevie Wonder's Original Musiquarium I,2,1,2,1.0,1,Stevie Wonder's Original Musiquarium I,25.0,4,-1,1,-1,1,down,1982-05-29
19853,Stevie Wonder,1982-07-03,Stevie Wonder - Stevie Wonder's Original Musiquarium I,1,2,3,1.0,2,Stevie Wonder's Original Musiquarium I,25.0,5,-1,-1,1,1,down,1982-05-29
19854,Stevie Wonder,1982-07-10,Stevie Wonder - Stevie Wonder's Original Musiquarium I,2,1,4,1.0,3,Stevie Wonder's Original Musiquarium I,25.0,6,-1,-1,-1,1,down,1982-05-29
19855,Stevie Wonder,1982-07-17,Stevie Wonder - Stevie Wonder's Original Musiquarium I,3,2,4,1.0,4,Stevie Wonder's Original Musiquarium I,25.0,7,0,-1,-1,0,stay,1982-05-29
19856,Stevie Wonder,1982-07-24,Stevie Wonder - Stevie Wonder's Original Musiquarium I,4,3,8,1.0,4,Stevie Wonder's Original Musiquarium I,25.0,8,-4,0,-1,1,down,1982-05-29
19857,Stevie Wonder,1982-07-31,Stevie Wonder - Stevie Wonder's Original Musiquarium I,4,4,7,1.0,8,Stevie Wonder's Original Musiquarium I,25.0,9,1,-4,0,1,up,1982-05-29
19858,Stevie Wonder,1982-08-07,Stevie Wonder - Stevie Wonder's Original Musiquarium I,8,4,7,1.0,7,Stevie Wonder's Original Musiquarium I,25.0,10,0,1,-4,0,stay,1982-05-29
19859,Stevie Wonder,1982-08-14,Stevie Wonder - Stevie Wonder's Original Musiquarium I,7,8,17,1.0,7,Stevie Wonder's Original Musiquarium I,25.0,11,-10,0,1,1,down,1982-05-29
19860,Stevie Wonder,1982-08-21,Stevie Wonder - Stevie Wonder's Original Musiquarium I,7,7,16,1.0,17,Stevie Wonder's Original Musiquarium I,25.0,12,1,-10,0,1,up,1982-05-29
19861,Stevie Wonder,1982-08-28,Stevie Wonder - Stevie Wonder's Original Musiquarium I,17,7,16,1.0,16,Stevie Wonder's Original Musiquarium I,25.0,13,0,1,-10,0,stay,1982-05-29
19862,Stevie Wonder,1982-09-04,Stevie Wonder - Stevie Wonder's Original Musiquarium I,16,17,16,1.0,16,Stevie Wonder's Original Musiquarium I,25.0,14,0,0,1,0,stay,1982-05-29
19863,Stevie Wonder,1982-09-11,Stevie Wonder - Stevie Wonder's Original Musiquarium I,16,16,16,1.0,16,Stevie Wonder's Original Musiquarium I,25.0,15,0,0,0,0,stay,1982-05-29
19864,Stevie Wonder,1982-09-18,Stevie Wonder - Stevie Wonder's Original Musiquarium I,16,16,16,1.0,16,Stevie Wonder's Original Musiquarium I,25.0,16,0,0,0,0,stay,1982-05-29
19865,Stevie Wonder,1982-09-25,Stevie Wonder - Stevie Wonder's Original Musiquarium I,16,16,17,1.0,16,Stevie Wonder's Original Musiquarium I,25.0,17,-1,0,0,1,down,1982-05-29
19866,Stevie Wonder,1982-10-02,Stevie Wonder - Stevie Wonder's Original Musiquarium I,16,16,20,1.0,17,Stevie Wonder's Original Musiquarium I,25.0,18,-3,-1,0,1,down,1982-05-29
19867,Stevie Wonder,1982-10-09,Stevie Wonder - Stevie Wonder's Original Musiquarium I,17,16,21,1.0,20,Stevie Wonder's Original Musiquarium I,25.0,19,-1,-3,-1,1,down,1982-05-29
19868,Stevie Wonder,1982-10-16,Stevie Wonder - Stevie Wonder's Original Musiquarium I,20,17,34,1.0,21,Stevie Wonder's Original Musiquarium I,25.0,20,-13,-1,-3,1,down,1982-05-29
19869,Stevie Wonder,1982-10-23,Stevie Wonder - Stevie Wonder's Original Musiquarium I,21,20,41,1.0,34,Stevie Wonder's Original Musiquarium I,25.0,21,-7,-13,-1,1,down,1982-05-29
19870,Stevie Wonder,1982-10-30,Stevie Wonder - Stevie Wonder's Original Musiquarium I,34,21,39,1.0,41,Stevie Wonder's Original Musiquarium I,25.0,22,2,-7,-13,1,up,1982-05-29
19871,Stevie Wonder,1982-11-06,Stevie Wonder - Stevie Wonder's Original Musiquarium I,41,34,38,1.0,39,Stevie Wonder's Original Musiquarium I,25.0,23,1,2,-7,1,up,1982-05-29
19872,Stevie Wonder,1982-11-13,Stevie Wonder - Stevie Wonder's Original Musiquarium I,39,41,49,1.0,38,Stevie Wonder's Original Musiquarium I,25.0,24,-11,1,2,1,down,1982-05-29
19873,Stevie Wonder,1982-11-27,Stevie Wonder - Stevie Wonder's Original Musiquarium I,38,39,51,1.0,49,Stevie Wonder's Original Musiquarium I,25.0,25,-2,-11,1,1,down,1982-05-29
19874,William Bootsy Collins,1982-05-29,"William Bootsy Collins - The One Giveth, The Count Taketh Away",51,51,27,18.0,37,"The One Giveth, The Count Taketh Away",12.0,0,10,14,0,1,up,1982-05-29
19875,William Bootsy Collins,1982-06-05,"William Bootsy Collins - The One Giveth, The Count Taketh Away",37,51,25,18.0,27,"The One Giveth, The Count Taketh Away",12.0,1,2,10,14,1,up,1982-05-29
19876,William Bootsy Collins,1982-06-12,"William Bootsy Collins - The One Giveth, The Count Taketh Away",27,37,22,18.0,25,"The One Giveth, The Count Taketh Away",12.0,2,3,2,10,1,up,1982-05-29
19877,William Bootsy Collins,1982-06-19,"William Bootsy Collins - The One Giveth, The Count Taketh Away",25,27,19,18.0,22,"The One Giveth, The Count Taketh Away",12.0,3,3,3,2,1,up,1982-05-29
19878,William Bootsy Collins,1982-06-26,"William Bootsy Collins - The One Giveth, The Count Taketh Away",22,25,19,18.0,19,"The One Giveth, The Count Taketh Away",12.0,4,0,3,3,0,stay,1982-05-29
19879,William Bootsy Collins,1982-07-03,"William Bootsy Collins - The One Giveth, The Count Taketh Away",19,22,18,18.0,19,"The One Giveth, The Count Taketh Away",12.0,5,1,0,3,1,up,1982-05-29
19880,William Bootsy Collins,1982-07-10,"William Bootsy Collins - The One Giveth, The Count Taketh Away",19,19,24,18.0,18,"The One Giveth, The Count Taketh Away",12.0,6,-6,1,0,1,down,1982-05-29
19881,William Bootsy Collins,1982-07-17,"William Bootsy Collins - The One Giveth, The Count Taketh Away",18,19,27,18.0,24,"The One Giveth, The Count Taketh Away",12.0,7,-3,-6,1,1,down,1982-05-29
19882,William Bootsy Collins,1982-07-24,"William Bootsy Collins - The One Giveth, The Count Taketh Away",24,18,40,18.0,27,"The One Giveth, The Count Taketh Away",12.0,8,-13,-3,-6,1,down,1982-05-29
19883,William Bootsy Collins,1982-07-31,"William Bootsy Collins - The One Giveth, The Count Taketh Away",27,24,43,18.0,40,"The One Giveth, The Count Taketh Away",12.0,9,-3,-13,-3,1,down,1982-05-29
19884,William Bootsy Collins,1982-08-07,"William Bootsy Collins - The One Giveth, The Count Taketh Away",40,27,43,18.0,43,"The One Giveth, The Count Taketh Away",12.0,10,0,-3,-13,0,stay,1982-05-29
19885,William Bootsy Collins,1982-08-14,"William Bootsy Collins - The One Giveth, The Count Taketh Away",43,40,50,18.0,43,"The One Giveth, The Count Taketh Away",12.0,11,-7,0,-3,1,down,1982-05-29
19886,William Bootsy Collins,1982-08-21,"William Bootsy Collins - The One Giveth, The Count Taketh Away",43,43,51,18.0,50,"The One Giveth, The Count Taketh Away",12.0,12,-1,-7,0,1,down,1982-05-29
19887,Original Cast,1982-05-29,Original Cast - Dreamgirls,51,51,43,4.0,50,Dreamgirls,22.0,0,7,1,0,1,up,1982-05-29
19888,Original Cast,1982-06-05,Original Cast - Dreamgirls,50,51,34,4.0,43,Dreamgirls,22.0,1,9,7,1,1,up,1982-05-29
19889,Original Cast,1982-06-12,Original Cast - Dreamgirls,43,50,26,4.0,34,Dreamgirls,22.0,2,8,9,7,1,up,1982-05-29
19890,Original Cast,1982-06-19,Original Cast - Dreamgirls,34,43,20,4.0,26,Dreamgirls,22.0,3,6,8,9,1,up,1982-05-29
19891,Original Cast,1982-06-26,Original Cast - Dreamgirls,26,34,16,4.0,20,Dreamgirls,22.0,4,4,6,8,1,up,1982-05-29
19892,Original Cast,1982-07-03,Original Cast - Dreamgirls,20,26,11,4.0,16,Dreamgirls,22.0,5,5,4,6,1,up,1982-05-29
19893,Original Cast,1982-07-10,Original Cast - Dreamgirls,16,20,9,4.0,11,Dreamgirls,22.0,6,2,5,4,1,up,1982-05-29
19894,Original Cast,1982-07-17,Original Cast - Dreamgirls,11,16,8,4.0,9,Dreamgirls,22.0,7,1,2,5,1,up,1982-05-29
19895,Original Cast,1982-07-24,Original Cast - Dreamgirls,9,11,4,4.0,8,Dreamgirls,22.0,8,4,1,2,1,up,1982-05-29
19896,Original Cast,1982-07-31,Original Cast - Dreamgirls,8,9,4,4.0,4,Dreamgirls,22.0,9,0,4,1,0,stay,1982-05-29
19897,Original Cast,1982-08-07,Original Cast - Dreamgirls,4,8,4,4.0,4,Dreamgirls,22.0,10,0,0,4,0,stay,1982-05-29
19898,Original Cast,1982-08-14,Original Cast - Dreamgirls,4,4,4,4.0,4,Dreamgirls,22.0,11,0,0,0,0,stay,1982-05-29
19899,Original Cast,1982-08-21,Original Cast - Dreamgirls,4,4,4,4.0,4,Dreamgirls,22.0,12,0,0,0,0,stay,1982-05-29
19900,Original Cast,1982-08-28,Original Cast - Dreamgirls,4,4,11,4.0,4,Dreamgirls,22.0,13,-7,0,0,1,down,1982-05-29
19901,Original Cast,1982-09-04,Original Cast - Dreamgirls,4,4,14,4.0,11,Dreamgirls,22.0,14,-3,-7,0,1,down,1982-05-29
19902,Original Cast,1982-09-11,Original Cast - Dreamgirls,11,4,17,4.0,14,Dreamgirls,22.0,15,-3,-3,-7,1,down,1982-05-29
19903,Original Cast,1982-09-18,Original Cast - Dreamgirls,14,11,23,4.0,17,Dreamgirls,22.0,16,-6,-3,-3,1,down,1982-05-29
19904,Original Cast,1982-09-25,Original Cast - Dreamgirls,17,14,23,4.0,23,Dreamgirls,22.0,17,0,-6,-3,0,stay,1982-05-29
19905,Original Cast,1982-10-02,Original Cast - Dreamgirls,23,17,24,4.0,23,Dreamgirls,22.0,18,-1,0,-6,1,down,1982-05-29
19906,Original Cast,1982-10-09,Original Cast - Dreamgirls,23,23,26,4.0,24,Dreamgirls,22.0,19,-2,-1,0,1,down,1982-05-29
19907,Original Cast,1982-10-16,Original Cast - Dreamgirls,24,23,45,4.0,26,Dreamgirls,22.0,20,-19,-2,-1,1,down,1982-05-29
19908,Original Cast,1982-10-23,Original Cast - Dreamgirls,26,24,45,4.0,45,Dreamgirls,22.0,21,0,-19,-2,0,stay,1982-05-29
19909,Original Cast,1982-10-30,Original Cast - Dreamgirls,45,26,51,4.0,45,Dreamgirls,22.0,22,-6,0,-19,1,down,1982-05-29
19910,Rick James,1982-06-05,Rick James - Throwin' Down,51,51,9,2.0,20,Throwin' Down,26.0,0,11,31,0,1,up,1982-06-05
19911,Rick James,1982-06-12,Rick James - Throwin' Down,20,51,3,2.0,9,Throwin' Down,26.0,1,6,11,31,1,up,1982-06-05
19912,Rick James,1982-06-19,Rick James - Throwin' Down,9,20,3,2.0,3,Throwin' Down,26.0,2,0,6,11,0,stay,1982-06-05
19913,Rick James,1982-06-26,Rick James - Throwin' Down,3,9,3,2.0,3,Throwin' Down,26.0,3,0,0,6,0,stay,1982-06-05
19914,Rick James,1982-07-03,Rick James - Throwin' Down,3,3,2,2.0,3,Throwin' Down,26.0,4,1,0,0,1,up,1982-06-05
19915,Rick James,1982-07-10,Rick James - Throwin' Down,3,3,2,2.0,2,Throwin' Down,26.0,5,0,1,0,0,stay,1982-06-05
19916,Rick James,1982-07-17,Rick James - Throwin' Down,2,3,2,2.0,2,Throwin' Down,26.0,6,0,0,1,0,stay,1982-06-05
19917,Rick James,1982-07-24,Rick James - Throwin' Down,2,2,2,2.0,2,Throwin' Down,26.0,7,0,0,0,0,stay,1982-06-05
19918,Rick James,1982-07-31,Rick James - Throwin' Down,2,2,2,2.0,2,Throwin' Down,26.0,8,0,0,0,0,stay,1982-06-05
19919,Rick James,1982-08-07,Rick James - Throwin' Down,2,2,2,2.0,2,Throwin' Down,26.0,9,0,0,0,0,stay,1982-06-05
19920,Rick James,1982-08-14,Rick James - Throwin' Down,2,2,2,2.0,2,Throwin' Down,26.0,10,0,0,0,0,stay,1982-06-05
19921,Rick James,1982-08-21,Rick James - Throwin' Down,2,2,2,2.0,2,Throwin' Down,26.0,11,0,0,0,0,stay,1982-06-05
19922,Rick James,1982-08-28,Rick James - Throwin' Down,2,2,2,2.0,2,Throwin' Down,26.0,12,0,0,0,0,stay,1982-06-05
19923,Rick James,1982-09-04,Rick James - Throwin' Down,2,2,2,2.0,2,Throwin' Down,26.0,13,0,0,0,0,stay,1982-06-05
19924,Rick James,1982-09-11,Rick James - Throwin' Down,2,2,3,2.0,2,Throwin' Down,26.0,14,-1,0,0,1,down,1982-06-05
19925,Rick James,1982-09-18,Rick James - Throwin' Down,2,2,4,2.0,3,Throwin' Down,26.0,15,-1,-1,0,1,down,1982-06-05
19926,Rick James,1982-09-25,Rick James - Throwin' Down,3,2,5,2.0,4,Throwin' Down,26.0,16,-1,-1,-1,1,down,1982-06-05
19927,Rick James,1982-10-02,Rick James - Throwin' Down,4,3,8,2.0,5,Throwin' Down,26.0,17,-3,-1,-1,1,down,1982-06-05
19928,Rick James,1982-10-09,Rick James - Throwin' Down,5,4,13,2.0,8,Throwin' Down,26.0,18,-5,-3,-1,1,down,1982-06-05
19929,Rick James,1982-10-16,Rick James - Throwin' Down,8,5,16,2.0,13,Throwin' Down,26.0,19,-3,-5,-3,1,down,1982-06-05
19930,Rick James,1982-10-23,Rick James - Throwin' Down,13,8,17,2.0,16,Throwin' Down,26.0,20,-1,-3,-5,1,down,1982-06-05
19931,Rick James,1982-10-30,Rick James - Throwin' Down,16,13,19,2.0,17,Throwin' Down,26.0,21,-2,-1,-3,1,down,1982-06-05
19932,Rick James,1982-11-06,Rick James - Throwin' Down,17,16,19,2.0,19,Throwin' Down,26.0,22,0,-2,-1,0,stay,1982-06-05
19933,Rick James,1982-11-13,Rick James - Throwin' Down,19,17,24,2.0,19,Throwin' Down,26.0,23,-5,0,-2,1,down,1982-06-05
19934,Rick James,1982-11-20,Rick James - Throwin' Down,19,19,31,2.0,24,Throwin' Down,26.0,24,-7,-5,0,1,down,1982-06-05
19935,Rick James,1982-11-27,Rick James - Throwin' Down,24,19,49,2.0,31,Throwin' Down,26.0,25,-18,-7,-5,1,down,1982-06-05
19936,Rick James,1982-12-04,Rick James - Throwin' Down,31,24,51,2.0,49,Throwin' Down,26.0,26,-2,-18,-7,1,down,1982-06-05
19937,Ashford & Simpson,1982-06-05,Ashford & Simpson - Street Opera,51,51,12,5.0,35,Street Opera,22.0,0,23,16,0,1,up,1982-06-05
19938,Ashford & Simpson,1982-06-12,Ashford & Simpson - Street Opera,35,51,12,5.0,12,Street Opera,22.0,1,0,23,16,0,stay,1982-06-05
19939,Ashford & Simpson,1982-06-19,Ashford & Simpson - Street Opera,12,35,9,5.0,12,Street Opera,22.0,2,3,0,23,1,up,1982-06-05
19940,Ashford & Simpson,1982-06-26,Ashford & Simpson - Street Opera,12,12,7,5.0,9,Street Opera,22.0,3,2,3,0,1,up,1982-06-05
19941,Ashford & Simpson,1982-07-03,Ashford & Simpson - Street Opera,9,12,5,5.0,7,Street Opera,22.0,4,2,2,3,1,up,1982-06-05
19942,Ashford & Simpson,1982-07-10,Ashford & Simpson - Street Opera,7,9,5,5.0,5,Street Opera,22.0,5,0,2,2,0,stay,1982-06-05
19943,Ashford & Simpson,1982-07-17,Ashford & Simpson - Street Opera,5,7,5,5.0,5,Street Opera,22.0,6,0,0,2,0,stay,1982-06-05
19944,Ashford & Simpson,1982-07-24,Ashford & Simpson - Street Opera,5,5,5,5.0,5,Street Opera,22.0,7,0,0,0,0,stay,1982-06-05
19945,Ashford & Simpson,1982-07-31,Ashford & Simpson - Street Opera,5,5,5,5.0,5,Street Opera,22.0,8,0,0,0,0,stay,1982-06-05
19946,Ashford & Simpson,1982-08-07,Ashford & Simpson - Street Opera,5,5,5,5.0,5,Street Opera,22.0,9,0,0,0,0,stay,1982-06-05
19947,Ashford & Simpson,1982-08-14,Ashford & Simpson - Street Opera,5,5,6,5.0,5,Street Opera,22.0,10,-1,0,0,1,down,1982-06-05
19948,Ashford & Simpson,1982-08-21,Ashford & Simpson - Street Opera,5,5,14,5.0,6,Street Opera,22.0,11,-8,-1,0,1,down,1982-06-05
19949,Ashford & Simpson,1982-08-28,Ashford & Simpson - Street Opera,6,5,14,5.0,14,Street Opera,22.0,12,0,-8,-1,0,stay,1982-06-05
19950,Ashford & Simpson,1982-09-04,Ashford & Simpson - Street Opera,14,6,20,5.0,14,Street Opera,22.0,13,-6,0,-8,1,down,1982-06-05
19951,Ashford & Simpson,1982-09-11,Ashford & Simpson - Street Opera,14,14,20,5.0,20,Street Opera,22.0,14,0,-6,0,0,stay,1982-06-05
19952,Ashford & Simpson,1982-09-18,Ashford & Simpson - Street Opera,20,14,27,5.0,20,Street Opera,22.0,15,-7,0,-6,1,down,1982-06-05
19953,Ashford & Simpson,1982-09-25,Ashford & Simpson - Street Opera,20,20,27,5.0,27,Street Opera,22.0,16,0,-7,0,0,stay,1982-06-05
19954,Ashford & Simpson,1982-10-02,Ashford & Simpson - Street Opera,27,20,26,5.0,27,Street Opera,22.0,17,1,0,-7,1,up,1982-06-05
19955,Ashford & Simpson,1982-10-09,Ashford & Simpson - Street Opera,27,27,25,5.0,26,Street Opera,22.0,18,1,1,0,1,up,1982-06-05
19956,Ashford & Simpson,1982-10-16,Ashford & Simpson - Street Opera,26,27,25,5.0,25,Street Opera,22.0,19,0,1,1,0,stay,1982-06-05
19957,Ashford & Simpson,1982-10-23,Ashford & Simpson - Street Opera,25,26,34,5.0,25,Street Opera,22.0,20,-9,0,1,1,down,1982-06-05
19958,Ashford & Simpson,1982-10-30,Ashford & Simpson - Street Opera,25,25,48,5.0,34,Street Opera,22.0,21,-14,-9,0,1,down,1982-06-05
19959,Ashford & Simpson,1982-11-06,Ashford & Simpson - Street Opera,34,25,51,5.0,48,Street Opera,22.0,22,-3,-14,-9,1,down,1982-06-05
19960,The Reddings,1982-06-05,The Reddings - Steamin' Hot,51,51,27,19.0,39,Steamin' Hot,11.0,0,12,12,0,1,up,1982-06-05
19961,The Reddings,1982-06-12,The Reddings - Steamin' Hot,39,51,25,19.0,27,Steamin' Hot,11.0,1,2,12,12,1,up,1982-06-05
19962,The Reddings,1982-06-19,The Reddings - Steamin' Hot,27,39,22,19.0,25,Steamin' Hot,11.0,2,3,2,12,1,up,1982-06-05
19963,The Reddings,1982-06-26,The Reddings - Steamin' Hot,25,27,22,19.0,22,Steamin' Hot,11.0,3,0,3,2,0,stay,1982-06-05
19964,The Reddings,1982-07-03,The Reddings - Steamin' Hot,22,25,19,19.0,22,Steamin' Hot,11.0,4,3,0,3,1,up,1982-06-05
19965,The Reddings,1982-07-10,The Reddings - Steamin' Hot,22,22,19,19.0,19,Steamin' Hot,11.0,5,0,3,0,0,stay,1982-06-05
19966,The Reddings,1982-07-17,The Reddings - Steamin' Hot,19,22,19,19.0,19,Steamin' Hot,11.0,6,0,0,3,0,stay,1982-06-05
19967,The Reddings,1982-07-24,The Reddings - Steamin' Hot,19,19,22,19.0,19,Steamin' Hot,11.0,7,-3,0,0,1,down,1982-06-05
19968,The Reddings,1982-07-31,The Reddings - Steamin' Hot,19,19,34,19.0,22,Steamin' Hot,11.0,8,-12,-3,0,1,down,1982-06-05
19969,The Reddings,1982-08-07,The Reddings - Steamin' Hot,22,19,39,19.0,34,Steamin' Hot,11.0,9,-5,-12,-3,1,down,1982-06-05
19970,The Reddings,1982-08-14,The Reddings - Steamin' Hot,34,22,46,19.0,39,Steamin' Hot,11.0,10,-7,-5,-12,1,down,1982-06-05
19971,The Reddings,1982-08-21,The Reddings - Steamin' Hot,39,34,51,19.0,46,Steamin' Hot,11.0,11,-5,-7,-5,1,down,1982-06-05
19972,Herbie Hancock,1982-06-05,Herbie Hancock - Lite Me Up,51,51,41,31.0,46,Lite Me Up,12.0,0,5,5,0,1,up,1982-06-05
19973,Herbie Hancock,1982-06-12,Herbie Hancock - Lite Me Up,46,51,35,31.0,41,Lite Me Up,12.0,1,6,5,5,1,up,1982-06-05
19974,Herbie Hancock,1982-06-19,Herbie Hancock - Lite Me Up,41,46,35,31.0,35,Lite Me Up,12.0,2,0,6,5,0,stay,1982-06-05
19975,Herbie Hancock,1982-06-26,Herbie Hancock - Lite Me Up,35,41,37,31.0,35,Lite Me Up,12.0,3,-2,0,6,1,down,1982-06-05
19976,Herbie Hancock,1982-07-03,Herbie Hancock - Lite Me Up,35,35,39,31.0,37,Lite Me Up,12.0,4,-2,-2,0,1,down,1982-06-05
19977,Herbie Hancock,1982-07-10,Herbie Hancock - Lite Me Up,37,35,39,31.0,39,Lite Me Up,12.0,5,0,-2,-2,0,stay,1982-06-05
19978,Herbie Hancock,1982-07-17,Herbie Hancock - Lite Me Up,39,37,35,31.0,39,Lite Me Up,12.0,6,4,0,-2,1,up,1982-06-05
19979,Herbie Hancock,1982-07-24,Herbie Hancock - Lite Me Up,39,39,32,31.0,35,Lite Me Up,12.0,7,3,4,0,1,up,1982-06-05
19980,Herbie Hancock,1982-07-31,Herbie Hancock - Lite Me Up,35,39,31,31.0,32,Lite Me Up,12.0,8,1,3,4,1,up,1982-06-05
19981,Herbie Hancock,1982-08-07,Herbie Hancock - Lite Me Up,32,35,41,31.0,31,Lite Me Up,12.0,9,-10,1,3,1,down,1982-06-05
19982,Herbie Hancock,1982-08-14,Herbie Hancock - Lite Me Up,31,32,41,31.0,41,Lite Me Up,12.0,10,0,-10,1,0,stay,1982-06-05
19983,Herbie Hancock,1982-08-21,Herbie Hancock - Lite Me Up,41,31,46,31.0,41,Lite Me Up,12.0,11,-5,0,-10,1,down,1982-06-05
19984,Herbie Hancock,1982-08-28,Herbie Hancock - Lite Me Up,41,41,51,31.0,46,Lite Me Up,12.0,12,-5,-5,0,1,down,1982-06-05
19985,Narada,1982-06-12,Narada - Confidence,51,51,38,30.0,43,Confidence,7.0,0,5,8,0,1,up,1982-06-12
19986,Narada,1982-06-19,Narada - Confidence,43,51,34,30.0,38,Confidence,7.0,1,4,5,8,1,up,1982-06-12
19987,Narada,1982-06-26,Narada - Confidence,38,43,30,30.0,34,Confidence,7.0,2,4,4,5,1,up,1982-06-12
19988,Narada,1982-07-03,Narada - Confidence,34,38,30,30.0,30,Confidence,7.0,3,0,4,4,0,stay,1982-06-12
19989,Narada,1982-07-10,Narada - Confidence,30,34,30,30.0,30,Confidence,7.0,4,0,0,4,0,stay,1982-06-12
19990,Narada,1982-07-17,Narada - Confidence,30,30,48,30.0,30,Confidence,7.0,5,-18,0,0,1,down,1982-06-12
19991,Narada,1982-07-24,Narada - Confidence,30,30,49,30.0,48,Confidence,7.0,6,-1,-18,0,1,down,1982-06-12
19992,Narada,1982-07-31,Narada - Confidence,48,30,51,30.0,49,Confidence,7.0,7,-2,-1,-18,1,down,1982-06-12
19993,Pat Metheny Group,1982-06-12,Pat Metheny Group - Offramp,51,51,43,43.0,49,Offramp,3.0,0,6,2,0,1,up,1982-06-12
19994,Pat Metheny Group,1982-06-19,Pat Metheny Group - Offramp,49,51,43,43.0,43,Offramp,3.0,1,0,6,2,0,stay,1982-06-12
19995,Pat Metheny Group,1982-06-26,Pat Metheny Group - Offramp,43,49,49,43.0,43,Offramp,3.0,2,-6,0,6,1,down,1982-06-12
19996,Pat Metheny Group,1982-07-03,Pat Metheny Group - Offramp,43,43,51,43.0,49,Offramp,3.0,3,-2,-6,0,1,down,1982-06-12
19997,The Gap Band,1982-06-19,The Gap Band - Gap Band Iv,51,51,4,1.0,6,Gap Band Iv,51.0,0,2,45,0,1,up,1982-06-19
19998,The Gap Band,1982-06-26,The Gap Band - Gap Band Iv,6,51,1,1.0,4,Gap Band Iv,51.0,1,3,2,45,1,up,1982-06-19
19999,The Gap Band,1982-07-03,The Gap Band - Gap Band Iv,4,6,1,1.0,1,Gap Band Iv,51.0,2,0,3,2,0,stay,1982-06-19
20000,The Gap Band,1982-07-10,The Gap Band - Gap Band Iv,1,4,1,1.0,1,Gap Band Iv,51.0,3,0,0,3,0,stay,1982-06-19
20001,The Gap Band,1982-07-17,The Gap Band - Gap Band Iv,1,1,1,1.0,1,Gap Band Iv,51.0,4,0,0,0,0,stay,1982-06-19
20002,The Gap Band,1982-07-24,The Gap Band - Gap Band Iv,1,1,1,1.0,1,Gap Band Iv,51.0,5,0,0,0,0,stay,1982-06-19
20003,The Gap Band,1982-07-31,The Gap Band - Gap Band Iv,1,1,1,1.0,1,Gap Band Iv,51.0,6,0,0,0,0,stay,1982-06-19
20004,The Gap Band,1982-08-07,The Gap Band - Gap Band Iv,1,1,1,1.0,1,Gap Band Iv,51.0,7,0,0,0,0,stay,1982-06-19
20005,The Gap Band,1982-08-14,The Gap Band - Gap Band Iv,1,1,1,1.0,1,Gap Band Iv,51.0,8,0,0,0,0,stay,1982-06-19
20006,The Gap Band,1982-08-21,The Gap Band - Gap Band Iv,1,1,1,1.0,1,Gap Band Iv,51.0,9,0,0,0,0,stay,1982-06-19
20007,The Gap Band,1982-08-28,The Gap Band - Gap Band Iv,1,1,3,1.0,1,Gap Band Iv,51.0,10,-2,0,0,1,down,1982-06-19
20008,The Gap Band,1982-09-04,The Gap Band - Gap Band Iv,1,1,4,1.0,3,Gap Band Iv,51.0,11,-1,-2,0,1,down,1982-06-19
20009,The Gap Band,1982-09-11,The Gap Band - Gap Band Iv,3,1,4,1.0,4,Gap Band Iv,51.0,12,0,-1,-2,0,stay,1982-06-19
20010,The Gap Band,1982-09-18,The Gap Band - Gap Band Iv,4,3,3,1.0,4,Gap Band Iv,51.0,13,1,0,-1,1,up,1982-06-19
20011,The Gap Band,1982-09-25,The Gap Band - Gap Band Iv,4,4,3,1.0,3,Gap Band Iv,51.0,14,0,1,0,0,stay,1982-06-19
20012,The Gap Band,1982-10-02,The Gap Band - Gap Band Iv,3,4,5,1.0,3,Gap Band Iv,51.0,15,-2,0,1,1,down,1982-06-19
20013,The Gap Band,1982-10-09,The Gap Band - Gap Band Iv,3,3,5,1.0,5,Gap Band Iv,51.0,16,0,-2,0,0,stay,1982-06-19
20014,The Gap Band,1982-10-16,The Gap Band - Gap Band Iv,5,3,6,1.0,5,Gap Band Iv,51.0,17,-1,0,-2,1,down,1982-06-19
20015,The Gap Band,1982-10-23,The Gap Band - Gap Band Iv,5,5,7,1.0,6,Gap Band Iv,51.0,18,-1,-1,0,1,down,1982-06-19
20016,The Gap Band,1982-10-30,The Gap Band - Gap Band Iv,6,5,9,1.0,7,Gap Band Iv,51.0,19,-2,-1,-1,1,down,1982-06-19
20017,The Gap Band,1982-11-06,The Gap Band - Gap Band Iv,7,6,9,1.0,9,Gap Band Iv,51.0,20,0,-2,-1,0,stay,1982-06-19
20018,The Gap Band,1982-11-13,The Gap Band - Gap Band Iv,9,7,10,1.0,9,Gap Band Iv,51.0,21,-1,0,-2,1,down,1982-06-19
20019,The Gap Band,1982-11-20,The Gap Band - Gap Band Iv,9,9,15,1.0,10,Gap Band Iv,51.0,22,-5,-1,0,1,down,1982-06-19
20020,The Gap Band,1982-11-27,The Gap Band - Gap Band Iv,10,9,15,1.0,15,Gap Band Iv,51.0,23,0,-5,-1,0,stay,1982-06-19
20021,The Gap Band,1982-12-04,The Gap Band - Gap Band Iv,15,10,16,1.0,15,Gap Band Iv,51.0,24,-1,0,-5,1,down,1982-06-19
20022,The Gap Band,1982-12-11,The Gap Band - Gap Band Iv,15,15,18,1.0,16,Gap Band Iv,51.0,25,-2,-1,0,1,down,1982-06-19
20023,The Gap Band,1982-12-18,The Gap Band - Gap Band Iv,16,15,33,1.0,18,Gap Band Iv,51.0,26,-15,-2,-1,1,down,1982-06-19
20024,The Gap Band,1982-12-25,The Gap Band - Gap Band Iv,18,16,33,1.0,33,Gap Band Iv,51.0,27,0,-15,-2,0,stay,1982-06-19
20025,The Gap Band,1983-01-01,The Gap Band - Gap Band Iv,33,18,36,1.0,33,Gap Band Iv,51.0,28,-3,0,-15,1,down,1982-06-19
20026,The Gap Band,1983-01-08,The Gap Band - Gap Band Iv,33,33,34,1.0,36,Gap Band Iv,51.0,29,2,-3,0,1,up,1982-06-19
20027,The Gap Band,1983-01-15,The Gap Band - Gap Band Iv,36,33,34,1.0,34,Gap Band Iv,51.0,30,0,2,-3,0,stay,1982-06-19
20028,The Gap Band,1983-01-22,The Gap Band - Gap Band Iv,34,36,31,1.0,34,Gap Band Iv,51.0,31,3,0,2,1,up,1982-06-19
20029,The Gap Band,1983-01-29,The Gap Band - Gap Band Iv,34,34,26,1.0,31,Gap Band Iv,51.0,32,5,3,0,1,up,1982-06-19
20030,The Gap Band,1983-02-05,The Gap Band - Gap Band Iv,31,34,17,1.0,26,Gap Band Iv,51.0,33,9,5,3,1,up,1982-06-19
20031,The Gap Band,1983-02-12,The Gap Band - Gap Band Iv,26,31,14,1.0,17,Gap Band Iv,51.0,34,3,9,5,1,up,1982-06-19
20032,The Gap Band,1983-02-19,The Gap Band - Gap Band Iv,17,26,13,1.0,14,Gap Band Iv,51.0,35,1,3,9,1,up,1982-06-19
20033,The Gap Band,1983-02-26,The Gap Band - Gap Band Iv,14,17,12,1.0,13,Gap Band Iv,51.0,36,1,1,3,1,up,1982-06-19
20034,The Gap Band,1983-03-05,The Gap Band - Gap Band Iv,13,14,12,1.0,12,Gap Band Iv,51.0,37,0,1,1,0,stay,1982-06-19
20035,The Gap Band,1983-03-12,The Gap Band - Gap Band Iv,12,13,11,1.0,12,Gap Band Iv,51.0,38,1,0,1,1,up,1982-06-19
20036,The Gap Band,1983-03-19,The Gap Band - Gap Band Iv,12,12,11,1.0,11,Gap Band Iv,51.0,39,0,1,0,0,stay,1982-06-19
20037,The Gap Band,1983-03-26,The Gap Band - Gap Band Iv,11,12,10,1.0,11,Gap Band Iv,51.0,40,1,0,1,1,up,1982-06-19
20038,The Gap Band,1983-04-02,The Gap Band - Gap Band Iv,11,11,10,1.0,10,Gap Band Iv,51.0,41,0,1,0,0,stay,1982-06-19
20039,The Gap Band,1983-04-09,The Gap Band - Gap Band Iv,10,11,11,1.0,10,Gap Band Iv,51.0,42,-1,0,1,1,down,1982-06-19
20040,The Gap Band,1983-04-16,The Gap Band - Gap Band Iv,10,10,21,1.0,11,Gap Band Iv,51.0,43,-10,-1,0,1,down,1982-06-19
20041,The Gap Band,1983-04-23,The Gap Band - Gap Band Iv,11,10,22,1.0,21,Gap Band Iv,51.0,44,-1,-10,-1,1,down,1982-06-19
20042,The Gap Band,1983-04-30,The Gap Band - Gap Band Iv,21,11,22,1.0,22,Gap Band Iv,51.0,45,0,-1,-10,0,stay,1982-06-19
20043,The Gap Band,1983-05-07,The Gap Band - Gap Band Iv,22,21,22,1.0,22,Gap Band Iv,51.0,46,0,0,-1,0,stay,1982-06-19
20044,The Gap Band,1983-05-14,The Gap Band - Gap Band Iv,22,22,32,1.0,22,Gap Band Iv,51.0,47,-10,0,0,1,down,1982-06-19
20045,The Gap Band,1983-05-21,The Gap Band - Gap Band Iv,22,22,39,1.0,32,Gap Band Iv,51.0,48,-7,-10,0,1,down,1982-06-19
20046,The Gap Band,1983-05-28,The Gap Band - Gap Band Iv,32,22,42,1.0,39,Gap Band Iv,51.0,49,-3,-7,-10,1,down,1982-06-19
20047,The Gap Band,1983-06-04,The Gap Band - Gap Band Iv,39,32,49,1.0,42,Gap Band Iv,51.0,50,-7,-3,-7,1,down,1982-06-19
20048,The Gap Band,1983-06-11,The Gap Band - Gap Band Iv,42,39,51,1.0,49,Gap Band Iv,51.0,51,-2,-7,-3,1,down,1982-06-19
20049,Jeffrey Osborne,1982-06-19,Jeffrey Osborne - Jeffrey Osborne,51,51,21,3.0,42,Jeffrey Osborne,42.0,0,21,9,0,1,up,1982-06-19
20050,Jeffrey Osborne,1982-06-26,Jeffrey Osborne - Jeffrey Osborne,42,51,10,3.0,21,Jeffrey Osborne,42.0,1,11,21,9,1,up,1982-06-19
20051,Jeffrey Osborne,1982-07-03,Jeffrey Osborne - Jeffrey Osborne,21,42,8,3.0,10,Jeffrey Osborne,42.0,2,2,11,21,1,up,1982-06-19
20052,Jeffrey Osborne,1982-07-10,Jeffrey Osborne - Jeffrey Osborne,10,21,6,3.0,8,Jeffrey Osborne,42.0,3,2,2,11,1,up,1982-06-19
20053,Jeffrey Osborne,1982-07-17,Jeffrey Osborne - Jeffrey Osborne,8,10,3,3.0,6,Jeffrey Osborne,42.0,4,3,2,2,1,up,1982-06-19
20054,Jeffrey Osborne,1982-07-24,Jeffrey Osborne - Jeffrey Osborne,6,8,3,3.0,3,Jeffrey Osborne,42.0,5,0,3,2,0,stay,1982-06-19
20055,Jeffrey Osborne,1982-07-31,Jeffrey Osborne - Jeffrey Osborne,3,6,3,3.0,3,Jeffrey Osborne,42.0,6,0,0,3,0,stay,1982-06-19
20056,Jeffrey Osborne,1982-08-07,Jeffrey Osborne - Jeffrey Osborne,3,3,3,3.0,3,Jeffrey Osborne,42.0,7,0,0,0,0,stay,1982-06-19
20057,Jeffrey Osborne,1982-08-14,Jeffrey Osborne - Jeffrey Osborne,3,3,3,3.0,3,Jeffrey Osborne,42.0,8,0,0,0,0,stay,1982-06-19
20058,Jeffrey Osborne,1982-08-21,Jeffrey Osborne - Jeffrey Osborne,3,3,3,3.0,3,Jeffrey Osborne,42.0,9,0,0,0,0,stay,1982-06-19
20059,Jeffrey Osborne,1982-08-28,Jeffrey Osborne - Jeffrey Osborne,3,3,5,3.0,3,Jeffrey Osborne,42.0,10,-2,0,0,1,down,1982-06-19
20060,Jeffrey Osborne,1982-09-04,Jeffrey Osborne - Jeffrey Osborne,3,3,5,3.0,5,Jeffrey Osborne,42.0,11,0,-2,0,0,stay,1982-06-19
20061,Jeffrey Osborne,1982-09-11,Jeffrey Osborne - Jeffrey Osborne,5,3,5,3.0,5,Jeffrey Osborne,42.0,12,0,0,-2,0,stay,1982-06-19
20062,Jeffrey Osborne,1982-09-18,Jeffrey Osborne - Jeffrey Osborne,5,5,5,3.0,5,Jeffrey Osborne,42.0,13,0,0,0,0,stay,1982-06-19
20063,Jeffrey Osborne,1982-09-25,Jeffrey Osborne - Jeffrey Osborne,5,5,11,3.0,5,Jeffrey Osborne,42.0,14,-6,0,0,1,down,1982-06-19
20064,Jeffrey Osborne,1982-10-02,Jeffrey Osborne - Jeffrey Osborne,5,5,14,3.0,11,Jeffrey Osborne,42.0,15,-3,-6,0,1,down,1982-06-19
20065,Jeffrey Osborne,1982-10-09,Jeffrey Osborne - Jeffrey Osborne,11,5,14,3.0,14,Jeffrey Osborne,42.0,16,0,-3,-6,0,stay,1982-06-19
20066,Jeffrey Osborne,1982-10-16,Jeffrey Osborne - Jeffrey Osborne,14,11,14,3.0,14,Jeffrey Osborne,42.0,17,0,0,-3,0,stay,1982-06-19
20067,Jeffrey Osborne,1982-10-23,Jeffrey Osborne - Jeffrey Osborne,14,14,18,3.0,14,Jeffrey Osborne,42.0,18,-4,0,0,1,down,1982-06-19
20068,Jeffrey Osborne,1982-10-30,Jeffrey Osborne - Jeffrey Osborne,14,14,16,3.0,18,Jeffrey Osborne,42.0,19,2,-4,0,1,up,1982-06-19
20069,Jeffrey Osborne,1982-11-06,Jeffrey Osborne - Jeffrey Osborne,18,14,14,3.0,16,Jeffrey Osborne,42.0,20,2,2,-4,1,up,1982-06-19
20070,Jeffrey Osborne,1982-11-13,Jeffrey Osborne - Jeffrey Osborne,16,18,12,3.0,14,Jeffrey Osborne,42.0,21,2,2,2,1,up,1982-06-19
20071,Jeffrey Osborne,1982-11-20,Jeffrey Osborne - Jeffrey Osborne,14,16,12,3.0,12,Jeffrey Osborne,42.0,22,0,2,2,0,stay,1982-06-19
20072,Jeffrey Osborne,1982-11-27,Jeffrey Osborne - Jeffrey Osborne,12,14,13,3.0,12,Jeffrey Osborne,42.0,23,-1,0,2,1,down,1982-06-19
20073,Jeffrey Osborne,1982-12-04,Jeffrey Osborne - Jeffrey Osborne,12,12,15,3.0,13,Jeffrey Osborne,42.0,24,-2,-1,0,1,down,1982-06-19
20074,Jeffrey Osborne,1982-12-11,Jeffrey Osborne - Jeffrey Osborne,13,12,15,3.0,15,Jeffrey Osborne,42.0,25,0,-2,-1,0,stay,1982-06-19
20075,Jeffrey Osborne,1982-12-18,Jeffrey Osborne - Jeffrey Osborne,15,13,30,3.0,15,Jeffrey Osborne,42.0,26,-15,0,-2,1,down,1982-06-19
20076,Jeffrey Osborne,1982-12-25,Jeffrey Osborne - Jeffrey Osborne,15,15,30,3.0,30,Jeffrey Osborne,42.0,27,0,-15,0,0,stay,1982-06-19
20077,Jeffrey Osborne,1983-01-01,Jeffrey Osborne - Jeffrey Osborne,30,15,33,3.0,30,Jeffrey Osborne,42.0,28,-3,0,-15,1,down,1982-06-19
20078,Jeffrey Osborne,1983-01-08,Jeffrey Osborne - Jeffrey Osborne,30,30,32,3.0,33,Jeffrey Osborne,42.0,29,1,-3,0,1,up,1982-06-19
20079,Jeffrey Osborne,1983-01-15,Jeffrey Osborne - Jeffrey Osborne,33,30,32,3.0,32,Jeffrey Osborne,42.0,30,0,1,-3,0,stay,1982-06-19
20080,Jeffrey Osborne,1983-01-22,Jeffrey Osborne - Jeffrey Osborne,32,33,32,3.0,32,Jeffrey Osborne,42.0,31,0,0,1,0,stay,1982-06-19
20081,Jeffrey Osborne,1983-01-29,Jeffrey Osborne - Jeffrey Osborne,32,32,37,3.0,32,Jeffrey Osborne,42.0,32,-5,0,0,1,down,1982-06-19
20082,Jeffrey Osborne,1983-02-05,Jeffrey Osborne - Jeffrey Osborne,32,32,37,3.0,37,Jeffrey Osborne,42.0,33,0,-5,0,0,stay,1982-06-19
20083,Jeffrey Osborne,1983-02-12,Jeffrey Osborne - Jeffrey Osborne,37,32,35,3.0,37,Jeffrey Osborne,42.0,34,2,0,-5,1,up,1982-06-19
20084,Jeffrey Osborne,1983-02-19,Jeffrey Osborne - Jeffrey Osborne,37,37,34,3.0,35,Jeffrey Osborne,42.0,35,1,2,0,1,up,1982-06-19
20085,Jeffrey Osborne,1983-02-26,Jeffrey Osborne - Jeffrey Osborne,35,37,33,3.0,34,Jeffrey Osborne,42.0,36,1,1,2,1,up,1982-06-19
20086,Jeffrey Osborne,1983-03-05,Jeffrey Osborne - Jeffrey Osborne,34,35,33,3.0,33,Jeffrey Osborne,42.0,37,0,1,1,0,stay,1982-06-19
20087,Jeffrey Osborne,1983-03-12,Jeffrey Osborne - Jeffrey Osborne,33,34,32,3.0,33,Jeffrey Osborne,42.0,38,1,0,1,1,up,1982-06-19
20088,Jeffrey Osborne,1983-03-19,Jeffrey Osborne - Jeffrey Osborne,33,33,37,3.0,32,Jeffrey Osborne,42.0,39,-5,1,0,1,down,1982-06-19
20089,Jeffrey Osborne,1983-03-26,Jeffrey Osborne - Jeffrey Osborne,32,33,42,3.0,37,Jeffrey Osborne,42.0,40,-5,-5,1,1,down,1982-06-19
20090,Jeffrey Osborne,1983-04-02,Jeffrey Osborne - Jeffrey Osborne,37,32,50,3.0,42,Jeffrey Osborne,42.0,41,-8,-5,-5,1,down,1982-06-19
20091,Jeffrey Osborne,1983-04-09,Jeffrey Osborne - Jeffrey Osborne,42,37,51,3.0,50,Jeffrey Osborne,42.0,42,-1,-8,-5,1,down,1982-06-19
20092,The Dramatics,1982-06-19,The Dramatics - New Dimension,51,51,40,40.0,44,New Dimension,3.0,0,4,7,0,1,up,1982-06-19
20093,The Dramatics,1982-06-26,The Dramatics - New Dimension,44,51,40,40.0,40,New Dimension,3.0,1,0,4,7,0,stay,1982-06-19
20094,The Dramatics,1982-07-03,The Dramatics - New Dimension,40,44,50,40.0,40,New Dimension,3.0,2,-10,0,4,1,down,1982-06-19
20095,The Dramatics,1982-07-10,The Dramatics - New Dimension,40,40,51,40.0,50,New Dimension,3.0,3,-1,-10,0,1,down,1982-06-19
20096,Roberta Flack,1982-06-19,Roberta Flack - I'm The One,51,51,25,16.0,45,I'm The One,19.0,0,20,6,0,1,up,1982-06-19
20097,Roberta Flack,1982-06-26,Roberta Flack - I'm The One,45,51,20,16.0,25,I'm The One,19.0,1,5,20,6,1,up,1982-06-19
20098,Roberta Flack,1982-07-03,Roberta Flack - I'm The One,25,45,20,16.0,20,I'm The One,19.0,2,0,5,20,0,stay,1982-06-19
20099,Roberta Flack,1982-07-10,Roberta Flack - I'm The One,20,25,20,16.0,20,I'm The One,19.0,3,0,0,5,0,stay,1982-06-19
20100,Roberta Flack,1982-07-17,Roberta Flack - I'm The One,20,20,20,16.0,20,I'm The One,19.0,4,0,0,0,0,stay,1982-06-19
20101,Roberta Flack,1982-07-24,Roberta Flack - I'm The One,20,20,19,16.0,20,I'm The One,19.0,5,1,0,0,1,up,1982-06-19
20102,Roberta Flack,1982-07-31,Roberta Flack - I'm The One,20,20,17,16.0,19,I'm The One,19.0,6,2,1,0,1,up,1982-06-19
20103,Roberta Flack,1982-08-07,Roberta Flack - I'm The One,19,20,16,16.0,17,I'm The One,19.0,7,1,2,1,1,up,1982-06-19
20104,Roberta Flack,1982-08-14,Roberta Flack - I'm The One,17,19,16,16.0,16,I'm The One,19.0,8,0,1,2,0,stay,1982-06-19
20105,Roberta Flack,1982-08-21,Roberta Flack - I'm The One,16,17,17,16.0,16,I'm The One,19.0,9,-1,0,1,1,down,1982-06-19
20106,Roberta Flack,1982-08-28,Roberta Flack - I'm The One,16,16,20,16.0,17,I'm The One,19.0,10,-3,-1,0,1,down,1982-06-19
20107,Roberta Flack,1982-09-04,Roberta Flack - I'm The One,17,16,22,16.0,20,I'm The One,19.0,11,-2,-3,-1,1,down,1982-06-19
20108,Roberta Flack,1982-09-11,Roberta Flack - I'm The One,20,17,23,16.0,22,I'm The One,19.0,12,-1,-2,-3,1,down,1982-06-19
20109,Roberta Flack,1982-09-18,Roberta Flack - I'm The One,22,20,28,16.0,23,I'm The One,19.0,13,-5,-1,-2,1,down,1982-06-19
20110,Roberta Flack,1982-09-25,Roberta Flack - I'm The One,23,22,28,16.0,28,I'm The One,19.0,14,0,-5,-1,0,stay,1982-06-19
20111,Roberta Flack,1982-10-02,Roberta Flack - I'm The One,28,23,30,16.0,28,I'm The One,19.0,15,-2,0,-5,1,down,1982-06-19
20112,Roberta Flack,1982-10-09,Roberta Flack - I'm The One,28,28,30,16.0,30,I'm The One,19.0,16,0,-2,0,0,stay,1982-06-19
20113,Roberta Flack,1982-10-16,Roberta Flack - I'm The One,30,28,41,16.0,30,I'm The One,19.0,17,-11,0,-2,1,down,1982-06-19
20114,Roberta Flack,1982-10-23,Roberta Flack - I'm The One,30,30,42,16.0,41,I'm The One,19.0,18,-1,-11,0,1,down,1982-06-19
20115,Roberta Flack,1982-10-30,Roberta Flack - I'm The One,41,30,51,16.0,42,I'm The One,19.0,19,-9,-1,-11,1,down,1982-06-19
20116,B.T. Express,1982-06-19,B.T. Express - Keep It Up,51,51,49,49.0,49,Keep It Up,1.0,0,0,2,0,0,stay,1982-06-19
20117,B.T. Express,1982-06-26,B.T. Express - Keep It Up,49,51,51,49.0,49,Keep It Up,1.0,1,-2,0,2,1,down,1982-06-19
20118,The Ritchie Family,1982-06-19,The Ritchie Family - I'll Do My Best,51,51,45,36.0,50,I'll Do My Best,8.0,0,5,1,0,1,up,1982-06-19
20119,The Ritchie Family,1982-06-26,The Ritchie Family - I'll Do My Best,50,51,41,36.0,45,I'll Do My Best,8.0,1,4,5,1,1,up,1982-06-19
20120,The Ritchie Family,1982-07-03,The Ritchie Family - I'll Do My Best,45,50,37,36.0,41,I'll Do My Best,8.0,2,4,4,5,1,up,1982-06-19
20121,The Ritchie Family,1982-07-10,The Ritchie Family - I'll Do My Best,41,45,36,36.0,37,I'll Do My Best,8.0,3,1,4,4,1,up,1982-06-19
20122,The Ritchie Family,1982-07-17,The Ritchie Family - I'll Do My Best,37,41,36,36.0,36,I'll Do My Best,8.0,4,0,1,4,0,stay,1982-06-19
20123,The Ritchie Family,1982-07-24,The Ritchie Family - I'll Do My Best,36,37,41,36.0,36,I'll Do My Best,8.0,5,-5,0,1,1,down,1982-06-19
20124,The Ritchie Family,1982-07-31,The Ritchie Family - I'll Do My Best,36,36,42,36.0,41,I'll Do My Best,8.0,6,-1,-5,0,1,down,1982-06-19
20125,The Ritchie Family,1982-08-07,The Ritchie Family - I'll Do My Best,41,36,50,36.0,42,I'll Do My Best,8.0,7,-8,-1,-5,1,down,1982-06-19
20126,The Ritchie Family,1982-08-14,The Ritchie Family - I'll Do My Best,42,41,51,36.0,50,I'll Do My Best,8.0,8,-1,-8,-1,1,down,1982-06-19
20127,Larry Graham,1982-06-26,Larry Graham - Sooner Or Later,51,51,34,15.0,42,Sooner Or Later,17.0,0,8,9,0,1,up,1982-06-26
20128,Larry Graham,1982-07-03,Larry Graham - Sooner Or Later,42,51,29,15.0,34,Sooner Or Later,17.0,1,5,8,9,1,up,1982-06-26
20129,Larry Graham,1982-07-10,Larry Graham - Sooner Or Later,34,42,22,15.0,29,Sooner Or Later,17.0,2,7,5,8,1,up,1982-06-26
20130,Larry Graham,1982-07-17,Larry Graham - Sooner Or Later,29,34,18,15.0,22,Sooner Or Later,17.0,3,4,7,5,1,up,1982-06-26
20131,Larry Graham,1982-07-24,Larry Graham - Sooner Or Later,22,29,17,15.0,18,Sooner Or Later,17.0,4,1,4,7,1,up,1982-06-26
20132,Larry Graham,1982-07-31,Larry Graham - Sooner Or Later,18,22,15,15.0,17,Sooner Or Later,17.0,5,2,1,4,1,up,1982-06-26
20133,Larry Graham,1982-08-07,Larry Graham - Sooner Or Later,17,18,15,15.0,15,Sooner Or Later,17.0,6,0,2,1,0,stay,1982-06-26
20134,Larry Graham,1982-08-14,Larry Graham - Sooner Or Later,15,17,15,15.0,15,Sooner Or Later,17.0,7,0,0,2,0,stay,1982-06-26
20135,Larry Graham,1982-08-21,Larry Graham - Sooner Or Later,15,15,27,15.0,15,Sooner Or Later,17.0,8,-12,0,0,1,down,1982-06-26
20136,Larry Graham,1982-08-28,Larry Graham - Sooner Or Later,15,15,28,15.0,27,Sooner Or Later,17.0,9,-1,-12,0,1,down,1982-06-26
20137,Larry Graham,1982-09-04,Larry Graham - Sooner Or Later,27,15,28,15.0,28,Sooner Or Later,17.0,10,0,-1,-12,0,stay,1982-06-26
20138,Larry Graham,1982-09-11,Larry Graham - Sooner Or Later,28,27,33,15.0,28,Sooner Or Later,17.0,11,-5,0,-1,1,down,1982-06-26
20139,Larry Graham,1982-09-18,Larry Graham - Sooner Or Later,28,28,33,15.0,33,Sooner Or Later,17.0,12,0,-5,0,0,stay,1982-06-26
20140,Larry Graham,1982-09-25,Larry Graham - Sooner Or Later,33,28,36,15.0,33,Sooner Or Later,17.0,13,-3,0,-5,1,down,1982-06-26
20141,Larry Graham,1982-10-02,Larry Graham - Sooner Or Later,33,33,35,15.0,36,Sooner Or Later,17.0,14,1,-3,0,1,up,1982-06-26
20142,Larry Graham,1982-10-09,Larry Graham - Sooner Or Later,36,33,39,15.0,35,Sooner Or Later,17.0,15,-4,1,-3,1,down,1982-06-26
20143,Larry Graham,1982-10-16,Larry Graham - Sooner Or Later,35,36,39,15.0,39,Sooner Or Later,17.0,16,0,-4,1,0,stay,1982-06-26
20144,Larry Graham,1982-10-23,Larry Graham - Sooner Or Later,39,35,51,15.0,39,Sooner Or Later,17.0,17,-12,0,-4,1,down,1982-06-26
20145,Soundtrack,1982-06-26,Soundtrack - Soup For One,51,51,42,42.0,46,Soup For One,4.0,0,4,5,0,1,up,1982-06-26
20146,Soundtrack,1982-07-03,Soundtrack - Soup For One,46,51,42,42.0,42,Soup For One,4.0,1,0,4,5,0,stay,1982-06-26
20147,Soundtrack,1982-07-10,Soundtrack - Soup For One,42,46,42,42.0,42,Soup For One,4.0,2,0,0,4,0,stay,1982-06-26
20148,Soundtrack,1982-07-17,Soundtrack - Soup For One,42,42,50,42.0,42,Soup For One,4.0,3,-8,0,0,1,down,1982-06-26
20149,Soundtrack,1982-07-24,Soundtrack - Soup For One,42,42,51,42.0,50,Soup For One,4.0,4,-1,-8,0,1,down,1982-06-26
20150,Rose Royce,1982-06-26,Rose Royce - Stronger Than Ever,51,51,50,50.0,50,Stronger Than Ever,1.0,0,0,1,0,0,stay,1982-06-26
20151,Rose Royce,1982-07-03,Rose Royce - Stronger Than Ever,50,51,51,50.0,50,Stronger Than Ever,1.0,1,-1,0,1,1,down,1982-06-26
20152,Randy Crawford,1982-07-03,Randy Crawford - Windsong,51,51,31,24.0,39,Windsong,14.0,0,8,12,0,1,up,1982-07-03
20153,Randy Crawford,1982-07-10,Randy Crawford - Windsong,39,51,26,24.0,31,Windsong,14.0,1,5,8,12,1,up,1982-07-03
20154,Randy Crawford,1982-07-17,Randy Crawford - Windsong,31,39,24,24.0,26,Windsong,14.0,2,2,5,8,1,up,1982-07-03
20155,Randy Crawford,1982-07-24,Randy Crawford - Windsong,26,31,24,24.0,24,Windsong,14.0,3,0,2,5,0,stay,1982-07-03
20156,Randy Crawford,1982-07-31,Randy Crawford - Windsong,24,26,36,24.0,24,Windsong,14.0,4,-12,0,2,1,down,1982-07-03
20157,Randy Crawford,1982-08-07,Randy Crawford - Windsong,24,24,37,24.0,36,Windsong,14.0,5,-1,-12,0,1,down,1982-07-03
20158,Randy Crawford,1982-08-14,Randy Crawford - Windsong,36,24,39,24.0,37,Windsong,14.0,6,-2,-1,-12,1,down,1982-07-03
20159,Randy Crawford,1982-08-21,Randy Crawford - Windsong,37,36,42,24.0,39,Windsong,14.0,7,-3,-2,-1,1,down,1982-07-03
20160,Randy Crawford,1982-08-28,Randy Crawford - Windsong,39,37,42,24.0,42,Windsong,14.0,8,0,-3,-2,0,stay,1982-07-03
20161,Randy Crawford,1982-09-04,Randy Crawford - Windsong,42,39,41,24.0,42,Windsong,14.0,9,1,0,-3,1,up,1982-07-03
20162,Randy Crawford,1982-09-11,Randy Crawford - Windsong,42,42,42,24.0,41,Windsong,14.0,10,-1,1,0,1,down,1982-07-03
20163,Randy Crawford,1982-09-18,Randy Crawford - Windsong,41,42,43,24.0,42,Windsong,14.0,11,-1,-1,1,1,down,1982-07-03
20164,Randy Crawford,1982-09-25,Randy Crawford - Windsong,42,41,49,24.0,43,Windsong,14.0,12,-6,-1,-1,1,down,1982-07-03
20165,Randy Crawford,1982-10-02,Randy Crawford - Windsong,43,42,49,24.0,49,Windsong,14.0,13,0,-6,-1,0,stay,1982-07-03
20166,Randy Crawford,1982-10-09,Randy Crawford - Windsong,49,43,51,24.0,49,Windsong,14.0,14,-2,0,-6,1,down,1982-07-03
20167,Queen,1982-07-03,Queen - Hot Space,51,51,40,40.0,45,Hot Space,2.0,0,5,6,0,1,up,1982-07-03
20168,Queen,1982-07-10,Queen - Hot Space,45,51,40,40.0,40,Hot Space,2.0,1,0,5,6,0,stay,1982-07-03
20169,Queen,1982-07-17,Queen - Hot Space,40,45,51,40.0,40,Hot Space,2.0,2,-11,0,5,1,down,1982-07-03
20170,Jean Cairn,1982-07-03,Jean Cairn - Trust Me,51,51,41,37.0,46,Trust Me,6.0,0,5,5,0,1,up,1982-07-03
20171,Jean Cairn,1982-07-10,Jean Cairn - Trust Me,46,51,38,37.0,41,Trust Me,6.0,1,3,5,5,1,up,1982-07-03
20172,Jean Cairn,1982-07-17,Jean Cairn - Trust Me,41,46,37,37.0,38,Trust Me,6.0,2,1,3,5,1,up,1982-07-03
20173,Jean Cairn,1982-07-24,Jean Cairn - Trust Me,38,41,44,37.0,37,Trust Me,6.0,3,-7,1,3,1,down,1982-07-03
20174,Jean Cairn,1982-07-31,Jean Cairn - Trust Me,37,38,44,37.0,44,Trust Me,6.0,4,0,-7,1,0,stay,1982-07-03
20175,Jean Cairn,1982-08-07,Jean Cairn - Trust Me,44,37,49,37.0,44,Trust Me,6.0,5,-5,0,-7,1,down,1982-07-03
20176,Jean Cairn,1982-08-14,Jean Cairn - Trust Me,44,44,51,37.0,49,Trust Me,6.0,6,-2,-5,0,1,down,1982-07-03
20177,Bobby Bland,1982-07-10,Bobby Bland - Here We Go Again,51,51,37,22.0,44,Here We Go Again,21.0,0,7,7,0,1,up,1982-07-10
20178,Bobby Bland,1982-07-17,Bobby Bland - Here We Go Again,44,51,32,22.0,37,Here We Go Again,21.0,1,5,7,7,1,up,1982-07-10
20179,Bobby Bland,1982-07-24,Bobby Bland - Here We Go Again,37,44,29,22.0,32,Here We Go Again,21.0,2,3,5,7,1,up,1982-07-10
20180,Bobby Bland,1982-07-31,Bobby Bland - Here We Go Again,32,37,26,22.0,29,Here We Go Again,21.0,3,3,3,5,1,up,1982-07-10
20181,Bobby Bland,1982-08-07,Bobby Bland - Here We Go Again,29,32,24,22.0,26,Here We Go Again,21.0,4,2,3,3,1,up,1982-07-10
20182,Bobby Bland,1982-08-14,Bobby Bland - Here We Go Again,26,29,22,22.0,24,Here We Go Again,21.0,5,2,2,3,1,up,1982-07-10
20183,Bobby Bland,1982-08-21,Bobby Bland - Here We Go Again,24,26,22,22.0,22,Here We Go Again,21.0,6,0,2,2,0,stay,1982-07-10
20184,Bobby Bland,1982-08-28,Bobby Bland - Here We Go Again,22,24,26,22.0,22,Here We Go Again,21.0,7,-4,0,2,1,down,1982-07-10
20185,Bobby Bland,1982-09-04,Bobby Bland - Here We Go Again,22,22,26,22.0,26,Here We Go Again,21.0,8,0,-4,0,0,stay,1982-07-10
20186,Bobby Bland,1982-09-11,Bobby Bland - Here We Go Again,26,22,29,22.0,26,Here We Go Again,21.0,9,-3,0,-4,1,down,1982-07-10
20187,Bobby Bland,1982-09-18,Bobby Bland - Here We Go Again,26,26,29,22.0,29,Here We Go Again,21.0,10,0,-3,0,0,stay,1982-07-10
20188,Bobby Bland,1982-09-25,Bobby Bland - Here We Go Again,29,26,29,22.0,29,Here We Go Again,21.0,11,0,0,-3,0,stay,1982-07-10
20189,Bobby Bland,1982-10-02,Bobby Bland - Here We Go Again,29,29,29,22.0,29,Here We Go Again,21.0,12,0,0,0,0,stay,1982-07-10
20190,Bobby Bland,1982-10-09,Bobby Bland - Here We Go Again,29,29,29,22.0,29,Here We Go Again,21.0,13,0,0,0,0,stay,1982-07-10
20191,Bobby Bland,1982-10-16,Bobby Bland - Here We Go Again,29,29,26,22.0,29,Here We Go Again,21.0,14,3,0,0,1,up,1982-07-10
20192,Bobby Bland,1982-10-23,Bobby Bland - Here We Go Again,29,29,26,22.0,26,Here We Go Again,21.0,15,0,3,0,0,stay,1982-07-10
20193,Bobby Bland,1982-10-30,Bobby Bland - Here We Go Again,26,29,27,22.0,26,Here We Go Again,21.0,16,-1,0,3,1,down,1982-07-10
20194,Bobby Bland,1982-11-06,Bobby Bland - Here We Go Again,26,26,33,22.0,27,Here We Go Again,21.0,17,-6,-1,0,1,down,1982-07-10
20195,Bobby Bland,1982-11-13,Bobby Bland - Here We Go Again,27,26,39,22.0,33,Here We Go Again,21.0,18,-6,-6,-1,1,down,1982-07-10
20196,Bobby Bland,1982-11-20,Bobby Bland - Here We Go Again,33,27,41,22.0,39,Here We Go Again,21.0,19,-2,-6,-6,1,down,1982-07-10
20197,Bobby Bland,1982-11-27,Bobby Bland - Here We Go Again,39,33,46,22.0,41,Here We Go Again,21.0,20,-5,-2,-6,1,down,1982-07-10
20198,Bobby Bland,1982-12-04,Bobby Bland - Here We Go Again,41,39,51,22.0,46,Here We Go Again,21.0,21,-5,-5,-2,1,down,1982-07-10
20199,The Crusaders With B.B.King And The Royal Philharmonic Orchestra,1982-07-10,The Crusaders With B.B.King And The Royal Philharmonic Orchestra - Royal Jam,51,51,41,30.0,46,Royal Jam,8.0,0,5,5,0,1,up,1982-07-10
20200,The Crusaders With B.B.King And The Royal Philharmonic Orchestra,1982-07-17,The Crusaders With B.B.King And The Royal Philharmonic Orchestra - Royal Jam,46,51,33,30.0,41,Royal Jam,8.0,1,8,5,5,1,up,1982-07-10
20201,The Crusaders With B.B.King And The Royal Philharmonic Orchestra,1982-07-24,The Crusaders With B.B.King And The Royal Philharmonic Orchestra - Royal Jam,41,46,30,30.0,33,Royal Jam,8.0,2,3,8,5,1,up,1982-07-10
20202,The Crusaders With B.B.King And The Royal Philharmonic Orchestra,1982-07-31,The Crusaders With B.B.King And The Royal Philharmonic Orchestra - Royal Jam,33,41,30,30.0,30,Royal Jam,8.0,3,0,3,8,0,stay,1982-07-10
20203,The Crusaders With B.B.King And The Royal Philharmonic Orchestra,1982-08-07,The Crusaders With B.B.King And The Royal Philharmonic Orchestra - Royal Jam,30,33,38,30.0,30,Royal Jam,8.0,4,-8,0,3,1,down,1982-07-10
20204,The Crusaders With B.B.King And The Royal Philharmonic Orchestra,1982-08-14,The Crusaders With B.B.King And The Royal Philharmonic Orchestra - Royal Jam,30,30,43,30.0,38,Royal Jam,8.0,5,-5,-8,0,1,down,1982-07-10
20205,The Crusaders With B.B.King And The Royal Philharmonic Orchestra,1982-08-21,The Crusaders With B.B.King And The Royal Philharmonic Orchestra - Royal Jam,38,30,41,30.0,43,Royal Jam,8.0,6,2,-5,-8,1,up,1982-07-10
20206,The Crusaders With B.B.King And The Royal Philharmonic Orchestra,1982-08-28,The Crusaders With B.B.King And The Royal Philharmonic Orchestra - Royal Jam,43,38,41,30.0,41,Royal Jam,8.0,7,0,2,-5,0,stay,1982-07-10
20207,The Crusaders With B.B.King And The Royal Philharmonic Orchestra,1982-09-04,The Crusaders With B.B.King And The Royal Philharmonic Orchestra - Royal Jam,41,43,51,30.0,41,Royal Jam,8.0,8,-10,0,2,1,down,1982-07-10
20208,Odyssey,1982-07-10,Odyssey - Happy Together,51,51,46,23.0,47,Happy Together,13.0,0,1,4,0,1,up,1982-07-10
20209,Odyssey,1982-07-17,Odyssey - Happy Together,47,51,41,23.0,46,Happy Together,13.0,1,5,1,4,1,up,1982-07-10
20210,Odyssey,1982-07-24,Odyssey - Happy Together,46,47,35,23.0,41,Happy Together,13.0,2,6,5,1,1,up,1982-07-10
20211,Odyssey,1982-07-31,Odyssey - Happy Together,41,46,27,23.0,35,Happy Together,13.0,3,8,6,5,1,up,1982-07-10
20212,Odyssey,1982-08-07,Odyssey - Happy Together,35,41,25,23.0,27,Happy Together,13.0,4,2,8,6,1,up,1982-07-10
20213,Odyssey,1982-08-14,Odyssey - Happy Together,27,35,23,23.0,25,Happy Together,13.0,5,2,2,8,1,up,1982-07-10
20214,Odyssey,1982-08-21,Odyssey - Happy Together,25,27,23,23.0,23,Happy Together,13.0,6,0,2,2,0,stay,1982-07-10
20215,Odyssey,1982-08-28,Odyssey - Happy Together,23,25,24,23.0,23,Happy Together,13.0,7,-1,0,2,1,down,1982-07-10
20216,Odyssey,1982-09-04,Odyssey - Happy Together,23,23,24,23.0,24,Happy Together,13.0,8,0,-1,0,0,stay,1982-07-10
20217,Odyssey,1982-09-11,Odyssey - Happy Together,24,23,34,23.0,24,Happy Together,13.0,9,-10,0,-1,1,down,1982-07-10
20218,Odyssey,1982-09-18,Odyssey - Happy Together,24,24,38,23.0,34,Happy Together,13.0,10,-4,-10,0,1,down,1982-07-10
20219,Odyssey,1982-09-25,Odyssey - Happy Together,34,24,39,23.0,38,Happy Together,13.0,11,-1,-4,-10,1,down,1982-07-10
20220,Odyssey,1982-10-02,Odyssey - Happy Together,38,34,39,23.0,39,Happy Together,13.0,12,0,-1,-4,0,stay,1982-07-10
20221,Odyssey,1982-10-09,Odyssey - Happy Together,39,38,51,23.0,39,Happy Together,13.0,13,-12,0,-1,1,down,1982-07-10
20222,Kid Creole & The Coconuts,1982-07-10,Kid Creole & The Coconuts - Wise Guy,51,51,44,43.0,49,Wise Guy,3.0,0,5,2,0,1,up,1982-07-10
20223,Kid Creole & The Coconuts,1982-07-17,Kid Creole & The Coconuts - Wise Guy,49,51,43,43.0,44,Wise Guy,3.0,1,1,5,2,1,up,1982-07-10
20224,Kid Creole & The Coconuts,1982-07-24,Kid Creole & The Coconuts - Wise Guy,44,49,47,43.0,43,Wise Guy,3.0,2,-4,1,5,1,down,1982-07-10
20225,Kid Creole & The Coconuts,1982-07-31,Kid Creole & The Coconuts - Wise Guy,43,44,51,43.0,47,Wise Guy,3.0,3,-4,-4,1,1,down,1982-07-10
20226,Bloodstone,1982-07-17,Bloodstone - We Go A Long Way Back,51,51,17,11.0,25,We Go A Long Way Back,19.0,0,8,26,0,1,up,1982-07-17
20227,Bloodstone,1982-07-24,Bloodstone - We Go A Long Way Back,25,51,13,11.0,17,We Go A Long Way Back,19.0,1,4,8,26,1,up,1982-07-17
20228,Bloodstone,1982-07-31,Bloodstone - We Go A Long Way Back,17,25,12,11.0,13,We Go A Long Way Back,19.0,2,1,4,8,1,up,1982-07-17
20229,Bloodstone,1982-08-07,Bloodstone - We Go A Long Way Back,13,17,12,11.0,12,We Go A Long Way Back,19.0,3,0,1,4,0,stay,1982-07-17
20230,Bloodstone,1982-08-14,Bloodstone - We Go A Long Way Back,12,13,11,11.0,12,We Go A Long Way Back,19.0,4,1,0,1,1,up,1982-07-17
20231,Bloodstone,1982-08-21,Bloodstone - We Go A Long Way Back,12,12,11,11.0,11,We Go A Long Way Back,19.0,5,0,1,0,0,stay,1982-07-17
20232,Bloodstone,1982-08-28,Bloodstone - We Go A Long Way Back,11,12,18,11.0,11,We Go A Long Way Back,19.0,6,-7,0,1,1,down,1982-07-17
20233,Bloodstone,1982-09-04,Bloodstone - We Go A Long Way Back,11,11,18,11.0,18,We Go A Long Way Back,19.0,7,0,-7,0,0,stay,1982-07-17
20234,Bloodstone,1982-09-11,Bloodstone - We Go A Long Way Back,18,11,18,11.0,18,We Go A Long Way Back,19.0,8,0,0,-7,0,stay,1982-07-17
20235,Bloodstone,1982-09-18,Bloodstone - We Go A Long Way Back,18,18,18,11.0,18,We Go A Long Way Back,19.0,9,0,0,0,0,stay,1982-07-17
20236,Bloodstone,1982-09-25,Bloodstone - We Go A Long Way Back,18,18,18,11.0,18,We Go A Long Way Back,19.0,10,0,0,0,0,stay,1982-07-17
20237,Bloodstone,1982-10-02,Bloodstone - We Go A Long Way Back,18,18,17,11.0,18,We Go A Long Way Back,19.0,11,1,0,0,1,up,1982-07-17
20238,Bloodstone,1982-10-09,Bloodstone - We Go A Long Way Back,18,18,20,11.0,17,We Go A Long Way Back,19.0,12,-3,1,0,1,down,1982-07-17
20239,Bloodstone,1982-10-16,Bloodstone - We Go A Long Way Back,17,18,21,11.0,20,We Go A Long Way Back,19.0,13,-1,-3,1,1,down,1982-07-17
20240,Bloodstone,1982-10-23,Bloodstone - We Go A Long Way Back,20,17,23,11.0,21,We Go A Long Way Back,19.0,14,-2,-1,-3,1,down,1982-07-17
20241,Bloodstone,1982-10-30,Bloodstone - We Go A Long Way Back,21,20,23,11.0,23,We Go A Long Way Back,19.0,15,0,-2,-1,0,stay,1982-07-17
20242,Bloodstone,1982-11-06,Bloodstone - We Go A Long Way Back,23,21,24,11.0,23,We Go A Long Way Back,19.0,16,-1,0,-2,1,down,1982-07-17
20243,Bloodstone,1982-11-13,Bloodstone - We Go A Long Way Back,23,23,37,11.0,24,We Go A Long Way Back,19.0,17,-13,-1,0,1,down,1982-07-17
20244,Bloodstone,1982-11-20,Bloodstone - We Go A Long Way Back,24,23,50,11.0,37,We Go A Long Way Back,19.0,18,-13,-13,-1,1,down,1982-07-17
20245,Bloodstone,1982-11-27,Bloodstone - We Go A Long Way Back,37,24,51,11.0,50,We Go A Long Way Back,19.0,19,-1,-13,-13,1,down,1982-07-17
20246,Cheryl Lynn,1982-07-17,Cheryl Lynn - Instant Love,51,51,22,7.0,31,Instant Love,24.0,0,9,20,0,1,up,1982-07-17
20247,Cheryl Lynn,1982-07-24,Cheryl Lynn - Instant Love,31,51,18,7.0,22,Instant Love,24.0,1,4,9,20,1,up,1982-07-17
20248,Cheryl Lynn,1982-07-31,Cheryl Lynn - Instant Love,22,31,14,7.0,18,Instant Love,24.0,2,4,4,9,1,up,1982-07-17
20249,Cheryl Lynn,1982-08-07,Cheryl Lynn - Instant Love,18,22,13,7.0,14,Instant Love,24.0,3,1,4,4,1,up,1982-07-17
20250,Cheryl Lynn,1982-08-14,Cheryl Lynn - Instant Love,14,18,9,7.0,13,Instant Love,24.0,4,4,1,4,1,up,1982-07-17
20251,Cheryl Lynn,1982-08-21,Cheryl Lynn - Instant Love,13,14,9,7.0,9,Instant Love,24.0,5,0,4,1,0,stay,1982-07-17
20252,Cheryl Lynn,1982-08-28,Cheryl Lynn - Instant Love,9,13,9,7.0,9,Instant Love,24.0,6,0,0,4,0,stay,1982-07-17
20253,Cheryl Lynn,1982-09-04,Cheryl Lynn - Instant Love,9,9,7,7.0,9,Instant Love,24.0,7,2,0,0,1,up,1982-07-17
20254,Cheryl Lynn,1982-09-11,Cheryl Lynn - Instant Love,9,9,7,7.0,7,Instant Love,24.0,8,0,2,0,0,stay,1982-07-17
20255,Cheryl Lynn,1982-09-18,Cheryl Lynn - Instant Love,7,9,7,7.0,7,Instant Love,24.0,9,0,0,2,0,stay,1982-07-17
20256,Cheryl Lynn,1982-09-25,Cheryl Lynn - Instant Love,7,7,7,7.0,7,Instant Love,24.0,10,0,0,0,0,stay,1982-07-17
20257,Cheryl Lynn,1982-10-02,Cheryl Lynn - Instant Love,7,7,7,7.0,7,Instant Love,24.0,11,0,0,0,0,stay,1982-07-17
20258,Cheryl Lynn,1982-10-09,Cheryl Lynn - Instant Love,7,7,7,7.0,7,Instant Love,24.0,12,0,0,0,0,stay,1982-07-17
20259,Cheryl Lynn,1982-10-16,Cheryl Lynn - Instant Love,7,7,7,7.0,7,Instant Love,24.0,13,0,0,0,0,stay,1982-07-17
20260,Cheryl Lynn,1982-10-23,Cheryl Lynn - Instant Love,7,7,14,7.0,7,Instant Love,24.0,14,-7,0,0,1,down,1982-07-17
20261,Cheryl Lynn,1982-10-30,Cheryl Lynn - Instant Love,7,7,14,7.0,14,Instant Love,24.0,15,0,-7,0,0,stay,1982-07-17
20262,Cheryl Lynn,1982-11-06,Cheryl Lynn - Instant Love,14,7,15,7.0,14,Instant Love,24.0,16,-1,0,-7,1,down,1982-07-17
20263,Cheryl Lynn,1982-11-13,Cheryl Lynn - Instant Love,14,14,19,7.0,15,Instant Love,24.0,17,-4,-1,0,1,down,1982-07-17
20264,Cheryl Lynn,1982-11-20,Cheryl Lynn - Instant Love,15,14,29,7.0,19,Instant Love,24.0,18,-10,-4,-1,1,down,1982-07-17
20265,Cheryl Lynn,1982-11-27,Cheryl Lynn - Instant Love,19,15,30,7.0,29,Instant Love,24.0,19,-1,-10,-4,1,down,1982-07-17
20266,Cheryl Lynn,1982-12-04,Cheryl Lynn - Instant Love,29,19,35,7.0,30,Instant Love,24.0,20,-5,-1,-10,1,down,1982-07-17
20267,Cheryl Lynn,1982-12-11,Cheryl Lynn - Instant Love,30,29,35,7.0,35,Instant Love,24.0,21,0,-5,-1,0,stay,1982-07-17
20268,Cheryl Lynn,1982-12-18,Cheryl Lynn - Instant Love,35,30,41,7.0,35,Instant Love,24.0,22,-6,0,-5,1,down,1982-07-17
20269,Cheryl Lynn,1982-12-25,Cheryl Lynn - Instant Love,35,35,41,7.0,41,Instant Love,24.0,23,0,-6,0,0,stay,1982-07-17
20270,Cheryl Lynn,1983-01-01,Cheryl Lynn - Instant Love,41,35,51,7.0,41,Instant Love,24.0,24,-10,0,-6,1,down,1982-07-17
20271,Heatwave,1982-07-17,Heatwave - Current,51,51,30,21.0,35,Current,6.0,0,5,16,0,1,up,1982-07-17
20272,Heatwave,1982-07-24,Heatwave - Current,35,51,27,21.0,30,Current,6.0,1,3,5,16,1,up,1982-07-17
20273,Heatwave,1982-07-31,Heatwave - Current,30,35,24,21.0,27,Current,6.0,2,3,3,5,1,up,1982-07-17
20274,Heatwave,1982-08-07,Heatwave - Current,27,30,21,21.0,24,Current,6.0,3,3,3,3,1,up,1982-07-17
20275,Heatwave,1982-08-14,Heatwave - Current,24,27,21,21.0,21,Current,6.0,4,0,3,3,0,stay,1982-07-17
20276,Heatwave,1982-08-21,Heatwave - Current,21,24,35,21.0,21,Current,6.0,5,-14,0,3,1,down,1982-07-17
20277,Heatwave,1982-08-28,Heatwave - Current,21,21,51,21.0,35,Current,6.0,6,-16,-14,0,1,down,1982-07-17
20278,The Fatback Band,1982-07-17,The Fatback Band - On The Floor,51,51,42,28.0,48,On The Floor,8.0,0,6,3,0,1,up,1982-07-17
20279,The Fatback Band,1982-07-24,The Fatback Band - On The Floor,48,51,31,28.0,42,On The Floor,8.0,1,11,6,3,1,up,1982-07-17
20280,The Fatback Band,1982-07-31,The Fatback Band - On The Floor,42,48,28,28.0,31,On The Floor,8.0,2,3,11,6,1,up,1982-07-17
20281,The Fatback Band,1982-08-07,The Fatback Band - On The Floor,31,42,28,28.0,28,On The Floor,8.0,3,0,3,11,0,stay,1982-07-17
20282,The Fatback Band,1982-08-14,The Fatback Band - On The Floor,28,31,31,28.0,28,On The Floor,8.0,4,-3,0,3,1,down,1982-07-17
20283,The Fatback Band,1982-08-21,The Fatback Band - On The Floor,28,28,44,28.0,31,On The Floor,8.0,5,-13,-3,0,1,down,1982-07-17
20284,The Fatback Band,1982-08-28,The Fatback Band - On The Floor,31,28,44,28.0,44,On The Floor,8.0,6,0,-13,-3,0,stay,1982-07-17
20285,The Fatback Band,1982-09-04,The Fatback Band - On The Floor,44,31,50,28.0,44,On The Floor,8.0,7,-6,0,-13,1,down,1982-07-17
20286,The Fatback Band,1982-09-11,The Fatback Band - On The Floor,44,44,51,28.0,50,On The Floor,8.0,8,-1,-6,0,1,down,1982-07-17
20287,David Sanborn,1982-07-17,David Sanborn - As We Speak,51,51,44,32.0,49,As We Speak,14.0,0,5,2,0,1,up,1982-07-17
20288,David Sanborn,1982-07-24,David Sanborn - As We Speak,49,51,36,32.0,44,As We Speak,14.0,1,8,5,2,1,up,1982-07-17
20289,David Sanborn,1982-07-31,David Sanborn - As We Speak,44,49,32,32.0,36,As We Speak,14.0,2,4,8,5,1,up,1982-07-17
20290,David Sanborn,1982-08-07,David Sanborn - As We Speak,36,44,32,32.0,32,As We Speak,14.0,3,0,4,8,0,stay,1982-07-17
20291,David Sanborn,1982-08-14,David Sanborn - As We Speak,32,36,32,32.0,32,As We Speak,14.0,4,0,0,4,0,stay,1982-07-17
20292,David Sanborn,1982-08-21,David Sanborn - As We Speak,32,32,38,32.0,32,As We Speak,14.0,5,-6,0,0,1,down,1982-07-17
20293,David Sanborn,1982-08-28,David Sanborn - As We Speak,32,32,38,32.0,38,As We Speak,14.0,6,0,-6,0,0,stay,1982-07-17
20294,David Sanborn,1982-09-04,David Sanborn - As We Speak,38,32,37,32.0,38,As We Speak,14.0,7,1,0,-6,1,up,1982-07-17
20295,David Sanborn,1982-09-11,David Sanborn - As We Speak,38,38,37,32.0,37,As We Speak,14.0,8,0,1,0,0,stay,1982-07-17
20296,David Sanborn,1982-09-18,David Sanborn - As We Speak,37,38,37,32.0,37,As We Speak,14.0,9,0,0,1,0,stay,1982-07-17
20297,David Sanborn,1982-09-25,David Sanborn - As We Speak,37,37,38,32.0,37,As We Speak,14.0,10,-1,0,0,1,down,1982-07-17
20298,David Sanborn,1982-10-02,David Sanborn - As We Speak,37,37,42,32.0,38,As We Speak,14.0,11,-4,-1,0,1,down,1982-07-17
20299,David Sanborn,1982-10-09,David Sanborn - As We Speak,38,37,42,32.0,42,As We Speak,14.0,12,0,-4,-1,0,stay,1982-07-17
20300,David Sanborn,1982-10-16,David Sanborn - As We Speak,42,38,50,32.0,42,As We Speak,14.0,13,-8,0,-4,1,down,1982-07-17
20301,David Sanborn,1982-10-23,David Sanborn - As We Speak,42,42,51,32.0,50,As We Speak,14.0,14,-1,-8,0,1,down,1982-07-17
20302,The Pointer Sisters,1982-07-24,The Pointer Sisters - So Excited,51,51,34,24.0,40,So Excited,12.0,0,6,11,0,1,up,1982-07-24
20303,The Pointer Sisters,1982-07-31,The Pointer Sisters - So Excited,40,51,29,24.0,34,So Excited,12.0,1,5,6,11,1,up,1982-07-24
20304,The Pointer Sisters,1982-08-07,The Pointer Sisters - So Excited,34,40,27,24.0,29,So Excited,12.0,2,2,5,6,1,up,1982-07-24
20305,The Pointer Sisters,1982-08-14,The Pointer Sisters - So Excited,29,34,24,24.0,27,So Excited,12.0,3,3,2,5,1,up,1982-07-24
20306,The Pointer Sisters,1982-08-21,The Pointer Sisters - So Excited,27,29,24,24.0,24,So Excited,12.0,4,0,3,2,0,stay,1982-07-24
20307,The Pointer Sisters,1982-08-28,The Pointer Sisters - So Excited,24,27,27,24.0,24,So Excited,12.0,5,-3,0,3,1,down,1982-07-24
20308,The Pointer Sisters,1982-09-04,The Pointer Sisters - So Excited,24,24,27,24.0,27,So Excited,12.0,6,0,-3,0,0,stay,1982-07-24
20309,The Pointer Sisters,1982-09-11,The Pointer Sisters - So Excited,27,24,35,24.0,27,So Excited,12.0,7,-8,0,-3,1,down,1982-07-24
20310,The Pointer Sisters,1982-09-18,The Pointer Sisters - So Excited,27,27,42,24.0,35,So Excited,12.0,8,-7,-8,0,1,down,1982-07-24
20311,The Pointer Sisters,1982-09-25,The Pointer Sisters - So Excited,35,27,40,24.0,42,So Excited,12.0,9,2,-7,-8,1,up,1982-07-24
20312,The Pointer Sisters,1982-10-02,The Pointer Sisters - So Excited,42,35,40,24.0,40,So Excited,12.0,10,0,2,-7,0,stay,1982-07-24
20313,The Pointer Sisters,1982-10-09,The Pointer Sisters - So Excited,40,42,48,24.0,40,So Excited,12.0,11,-8,0,2,1,down,1982-07-24
20314,The Pointer Sisters,1982-10-16,The Pointer Sisters - So Excited,40,40,51,24.0,48,So Excited,12.0,12,-3,-8,0,1,down,1982-07-24
20315,Pieces Of A Dream,1982-07-24,Pieces Of A Dream - We Are One,51,51,39,22.0,45,We Are One,19.0,0,6,6,0,1,up,1982-07-24
20316,Pieces Of A Dream,1982-07-31,Pieces Of A Dream - We Are One,45,51,33,22.0,39,We Are One,19.0,1,6,6,6,1,up,1982-07-24
20317,Pieces Of A Dream,1982-08-07,Pieces Of A Dream - We Are One,39,45,31,22.0,33,We Are One,19.0,2,2,6,6,1,up,1982-07-24
20318,Pieces Of A Dream,1982-08-14,Pieces Of A Dream - We Are One,33,39,28,22.0,31,We Are One,19.0,3,3,2,6,1,up,1982-07-24
20319,Pieces Of A Dream,1982-08-21,Pieces Of A Dream - We Are One,31,33,26,22.0,28,We Are One,19.0,4,2,3,2,1,up,1982-07-24
20320,Pieces Of A Dream,1982-08-28,Pieces Of A Dream - We Are One,28,31,25,22.0,26,We Are One,19.0,5,1,2,3,1,up,1982-07-24
20321,Pieces Of A Dream,1982-09-04,Pieces Of A Dream - We Are One,26,28,25,22.0,25,We Are One,19.0,6,0,1,2,0,stay,1982-07-24
20322,Pieces Of A Dream,1982-09-11,Pieces Of A Dream - We Are One,25,26,25,22.0,25,We Are One,19.0,7,0,0,1,0,stay,1982-07-24
20323,Pieces Of A Dream,1982-09-18,Pieces Of A Dream - We Are One,25,25,24,22.0,25,We Are One,19.0,8,1,0,0,1,up,1982-07-24
20324,Pieces Of A Dream,1982-09-25,Pieces Of A Dream - We Are One,25,25,24,22.0,24,We Are One,19.0,9,0,1,0,0,stay,1982-07-24
20325,Pieces Of A Dream,1982-10-02,Pieces Of A Dream - We Are One,24,25,23,22.0,24,We Are One,19.0,10,1,0,1,1,up,1982-07-24
20326,Pieces Of A Dream,1982-10-09,Pieces Of A Dream - We Are One,24,24,23,22.0,23,We Are One,19.0,11,0,1,0,0,stay,1982-07-24
20327,Pieces Of A Dream,1982-10-16,Pieces Of A Dream - We Are One,23,24,22,22.0,23,We Are One,19.0,12,1,0,1,1,up,1982-07-24
20328,Pieces Of A Dream,1982-10-23,Pieces Of A Dream - We Are One,23,23,25,22.0,22,We Are One,19.0,13,-3,1,0,1,down,1982-07-24
20329,Pieces Of A Dream,1982-10-30,Pieces Of A Dream - We Are One,22,23,26,22.0,25,We Are One,19.0,14,-1,-3,1,1,down,1982-07-24
20330,Pieces Of A Dream,1982-11-06,Pieces Of A Dream - We Are One,25,22,26,22.0,26,We Are One,19.0,15,0,-1,-3,0,stay,1982-07-24
20331,Pieces Of A Dream,1982-11-13,Pieces Of A Dream - We Are One,26,25,29,22.0,26,We Are One,19.0,16,-3,0,-1,1,down,1982-07-24
20332,Pieces Of A Dream,1982-11-20,Pieces Of A Dream - We Are One,26,26,36,22.0,29,We Are One,19.0,17,-7,-3,0,1,down,1982-07-24
20333,Pieces Of A Dream,1982-11-27,Pieces Of A Dream - We Are One,29,26,50,22.0,36,We Are One,19.0,18,-14,-7,-3,1,down,1982-07-24
20334,Pieces Of A Dream,1982-12-04,Pieces Of A Dream - We Are One,36,29,51,22.0,50,We Are One,19.0,19,-1,-14,-7,1,down,1982-07-24
20335,Quincy Jones,1982-07-24,Quincy Jones - The Best,51,51,45,45.0,46,The Best,2.0,0,1,5,0,1,up,1982-07-24
20336,Quincy Jones,1982-07-31,Quincy Jones - The Best,46,51,47,45.0,45,The Best,2.0,1,-2,1,5,1,down,1982-07-24
20337,Quincy Jones,1982-08-07,Quincy Jones - The Best,45,46,51,45.0,47,The Best,2.0,2,-4,-2,1,1,down,1982-07-24
20338,Howard Johnson,1982-07-31,Howard Johnson - Keepin' Love New,51,51,23,10.0,38,Keepin' Love New,15.0,0,15,13,0,1,up,1982-07-31
20339,Howard Johnson,1982-08-07,Howard Johnson - Keepin' Love New,38,51,19,10.0,23,Keepin' Love New,15.0,1,4,15,13,1,up,1982-07-31
20340,Howard Johnson,1982-08-14,Howard Johnson - Keepin' Love New,23,38,14,10.0,19,Keepin' Love New,15.0,2,5,4,15,1,up,1982-07-31
20341,Howard Johnson,1982-08-21,Howard Johnson - Keepin' Love New,19,23,13,10.0,14,Keepin' Love New,15.0,3,1,5,4,1,up,1982-07-31
20342,Howard Johnson,1982-08-28,Howard Johnson - Keepin' Love New,14,19,10,10.0,13,Keepin' Love New,15.0,4,3,1,5,1,up,1982-07-31
20343,Howard Johnson,1982-09-04,Howard Johnson - Keepin' Love New,13,14,10,10.0,10,Keepin' Love New,15.0,5,0,3,1,0,stay,1982-07-31
20344,Howard Johnson,1982-09-11,Howard Johnson - Keepin' Love New,10,13,10,10.0,10,Keepin' Love New,15.0,6,0,0,3,0,stay,1982-07-31
20345,Howard Johnson,1982-09-18,Howard Johnson - Keepin' Love New,10,10,14,10.0,10,Keepin' Love New,15.0,7,-4,0,0,1,down,1982-07-31
20346,Howard Johnson,1982-09-25,Howard Johnson - Keepin' Love New,10,10,15,10.0,14,Keepin' Love New,15.0,8,-1,-4,0,1,down,1982-07-31
20347,Howard Johnson,1982-10-02,Howard Johnson - Keepin' Love New,14,10,16,10.0,15,Keepin' Love New,15.0,9,-1,-1,-4,1,down,1982-07-31
20348,Howard Johnson,1982-10-09,Howard Johnson - Keepin' Love New,15,14,18,10.0,16,Keepin' Love New,15.0,10,-2,-1,-1,1,down,1982-07-31
20349,Howard Johnson,1982-10-16,Howard Johnson - Keepin' Love New,16,15,20,10.0,18,Keepin' Love New,15.0,11,-2,-2,-1,1,down,1982-07-31
20350,Howard Johnson,1982-10-23,Howard Johnson - Keepin' Love New,18,16,36,10.0,20,Keepin' Love New,15.0,12,-16,-2,-2,1,down,1982-07-31
20351,Howard Johnson,1982-10-30,Howard Johnson - Keepin' Love New,20,18,36,10.0,36,Keepin' Love New,15.0,13,0,-16,-2,0,stay,1982-07-31
20352,Howard Johnson,1982-11-06,Howard Johnson - Keepin' Love New,36,20,40,10.0,36,Keepin' Love New,15.0,14,-4,0,-16,1,down,1982-07-31
20353,Howard Johnson,1982-11-13,Howard Johnson - Keepin' Love New,36,36,51,10.0,40,Keepin' Love New,15.0,15,-11,-4,0,1,down,1982-07-31
20354,Carrie Lucas,1982-07-31,Carrie Lucas - Still In Love,51,51,40,33.0,50,Still In Love,4.0,0,10,1,0,1,up,1982-07-31
20355,Carrie Lucas,1982-08-07,Carrie Lucas - Still In Love,50,51,36,33.0,40,Still In Love,4.0,1,4,10,1,1,up,1982-07-31
20356,Carrie Lucas,1982-08-14,Carrie Lucas - Still In Love,40,50,33,33.0,36,Still In Love,4.0,2,3,4,10,1,up,1982-07-31
20357,Carrie Lucas,1982-08-21,Carrie Lucas - Still In Love,36,40,33,33.0,33,Still In Love,4.0,3,0,3,4,0,stay,1982-07-31
20358,Carrie Lucas,1982-08-28,Carrie Lucas - Still In Love,33,36,51,33.0,33,Still In Love,4.0,4,-18,0,3,1,down,1982-07-31
20359,Zapp,1982-08-07,Zapp - Zapp Ii,51,51,26,2.0,48,Zapp Ii,30.0,0,22,3,0,1,up,1982-08-07
20360,Zapp,1982-08-14,Zapp - Zapp Ii,48,51,5,2.0,26,Zapp Ii,30.0,1,21,22,3,1,up,1982-08-07
20361,Zapp,1982-08-21,Zapp - Zapp Ii,26,48,5,2.0,5,Zapp Ii,30.0,2,0,21,22,0,stay,1982-08-07
20362,Zapp,1982-08-28,Zapp - Zapp Ii,5,26,4,2.0,5,Zapp Ii,30.0,3,1,0,21,1,up,1982-08-07
20363,Zapp,1982-09-04,Zapp - Zapp Ii,5,5,3,2.0,4,Zapp Ii,30.0,4,1,1,0,1,up,1982-08-07
20364,Zapp,1982-09-11,Zapp - Zapp Ii,4,5,2,2.0,3,Zapp Ii,30.0,5,1,1,1,1,up,1982-08-07
20365,Zapp,1982-09-18,Zapp - Zapp Ii,3,4,2,2.0,2,Zapp Ii,30.0,6,0,1,1,0,stay,1982-08-07
20366,Zapp,1982-09-25,Zapp - Zapp Ii,2,3,2,2.0,2,Zapp Ii,30.0,7,0,0,1,0,stay,1982-08-07
20367,Zapp,1982-10-02,Zapp - Zapp Ii,2,2,2,2.0,2,Zapp Ii,30.0,8,0,0,0,0,stay,1982-08-07
20368,Zapp,1982-10-09,Zapp - Zapp Ii,2,2,4,2.0,2,Zapp Ii,30.0,9,-2,0,0,1,down,1982-08-07
20369,Zapp,1982-10-16,Zapp - Zapp Ii,2,2,4,2.0,4,Zapp Ii,30.0,10,0,-2,0,0,stay,1982-08-07
20370,Zapp,1982-10-23,Zapp - Zapp Ii,4,2,6,2.0,4,Zapp Ii,30.0,11,-2,0,-2,1,down,1982-08-07
20371,Zapp,1982-10-30,Zapp - Zapp Ii,4,4,12,2.0,6,Zapp Ii,30.0,12,-6,-2,0,1,down,1982-08-07
20372,Zapp,1982-11-06,Zapp - Zapp Ii,6,4,12,2.0,12,Zapp Ii,30.0,13,0,-6,-2,0,stay,1982-08-07
20373,Zapp,1982-11-13,Zapp - Zapp Ii,12,6,13,2.0,12,Zapp Ii,30.0,14,-1,0,-6,1,down,1982-08-07
20374,Zapp,1982-11-20,Zapp - Zapp Ii,12,12,16,2.0,13,Zapp Ii,30.0,15,-3,-1,0,1,down,1982-08-07
20375,Zapp,1982-11-27,Zapp - Zapp Ii,13,12,17,2.0,16,Zapp Ii,30.0,16,-1,-3,-1,1,down,1982-08-07
20376,Zapp,1982-12-04,Zapp - Zapp Ii,16,13,17,2.0,17,Zapp Ii,30.0,17,0,-1,-3,0,stay,1982-08-07
20377,Zapp,1982-12-11,Zapp - Zapp Ii,17,16,23,2.0,17,Zapp Ii,30.0,18,-6,0,-1,1,down,1982-08-07
20378,Zapp,1982-12-18,Zapp - Zapp Ii,17,17,34,2.0,23,Zapp Ii,30.0,19,-11,-6,0,1,down,1982-08-07
20379,Zapp,1982-12-25,Zapp - Zapp Ii,23,17,34,2.0,34,Zapp Ii,30.0,20,0,-11,-6,0,stay,1982-08-07
20380,Zapp,1983-01-01,Zapp - Zapp Ii,34,23,37,2.0,34,Zapp Ii,30.0,21,-3,0,-11,1,down,1982-08-07
20381,Zapp,1983-01-08,Zapp - Zapp Ii,34,34,37,2.0,37,Zapp Ii,30.0,22,0,-3,0,0,stay,1982-08-07
20382,Zapp,1983-01-15,Zapp - Zapp Ii,37,34,37,2.0,37,Zapp Ii,30.0,23,0,0,-3,0,stay,1982-08-07
20383,Zapp,1983-01-22,Zapp - Zapp Ii,37,37,37,2.0,37,Zapp Ii,30.0,24,0,0,0,0,stay,1982-08-07
20384,Zapp,1983-01-29,Zapp - Zapp Ii,37,37,44,2.0,37,Zapp Ii,30.0,25,-7,0,0,1,down,1982-08-07
20385,Zapp,1983-02-05,Zapp - Zapp Ii,37,37,45,2.0,44,Zapp Ii,30.0,26,-1,-7,0,1,down,1982-08-07
20386,Zapp,1983-02-12,Zapp - Zapp Ii,44,37,46,2.0,45,Zapp Ii,30.0,27,-1,-1,-7,1,down,1982-08-07
20387,Zapp,1983-02-19,Zapp - Zapp Ii,45,44,46,2.0,46,Zapp Ii,30.0,28,0,-1,-1,0,stay,1982-08-07
20388,Zapp,1983-02-26,Zapp - Zapp Ii,46,45,46,2.0,46,Zapp Ii,30.0,29,0,0,-1,0,stay,1982-08-07
20389,Zapp,1983-03-05,Zapp - Zapp Ii,46,46,51,2.0,46,Zapp Ii,30.0,30,-5,0,0,1,down,1982-08-07
20390,Gino Soccio,1982-08-07,Gino Soccio - Face To Face,51,51,45,45.0,49,Face To Face,2.0,0,4,2,0,1,up,1982-08-07
20391,Gino Soccio,1982-08-14,Gino Soccio - Face To Face,49,51,45,45.0,45,Face To Face,2.0,1,0,4,2,0,stay,1982-08-07
20392,Gino Soccio,1982-08-21,Gino Soccio - Face To Face,45,49,51,45.0,45,Face To Face,2.0,2,-6,0,4,1,down,1982-08-07
20393,Aretha Franklin,1982-08-14,Aretha Franklin - Jump To It,51,51,10,1.0,29,Jump To It,29.0,0,19,22,0,1,up,1982-08-14
20394,Aretha Franklin,1982-08-21,Aretha Franklin - Jump To It,29,51,6,1.0,10,Jump To It,29.0,1,4,19,22,1,up,1982-08-14
20395,Aretha Franklin,1982-08-28,Aretha Franklin - Jump To It,10,29,1,1.0,6,Jump To It,29.0,2,5,4,19,1,up,1982-08-14
20396,Aretha Franklin,1982-09-04,Aretha Franklin - Jump To It,6,10,1,1.0,1,Jump To It,29.0,3,0,5,4,0,stay,1982-08-14
20397,Aretha Franklin,1982-09-11,Aretha Franklin - Jump To It,1,6,1,1.0,1,Jump To It,29.0,4,0,0,5,0,stay,1982-08-14
20398,Aretha Franklin,1982-09-18,Aretha Franklin - Jump To It,1,1,1,1.0,1,Jump To It,29.0,5,0,0,0,0,stay,1982-08-14
20399,Aretha Franklin,1982-09-25,Aretha Franklin - Jump To It,1,1,1,1.0,1,Jump To It,29.0,6,0,0,0,0,stay,1982-08-14
20400,Aretha Franklin,1982-10-02,Aretha Franklin - Jump To It,1,1,1,1.0,1,Jump To It,29.0,7,0,0,0,0,stay,1982-08-14
20401,Aretha Franklin,1982-10-09,Aretha Franklin - Jump To It,1,1,1,1.0,1,Jump To It,29.0,8,0,0,0,0,stay,1982-08-14
20402,Aretha Franklin,1982-10-16,Aretha Franklin - Jump To It,1,1,3,1.0,1,Jump To It,29.0,9,-2,0,0,1,down,1982-08-14
20403,Aretha Franklin,1982-10-23,Aretha Franklin - Jump To It,1,1,3,1.0,3,Jump To It,29.0,10,0,-2,0,0,stay,1982-08-14
20404,Aretha Franklin,1982-10-30,Aretha Franklin - Jump To It,3,1,6,1.0,3,Jump To It,29.0,11,-3,0,-2,1,down,1982-08-14
20405,Aretha Franklin,1982-11-06,Aretha Franklin - Jump To It,3,3,6,1.0,6,Jump To It,29.0,12,0,-3,0,0,stay,1982-08-14
20406,Aretha Franklin,1982-11-13,Aretha Franklin - Jump To It,6,3,7,1.0,6,Jump To It,29.0,13,-1,0,-3,1,down,1982-08-14
20407,Aretha Franklin,1982-11-20,Aretha Franklin - Jump To It,6,6,11,1.0,7,Jump To It,29.0,14,-4,-1,0,1,down,1982-08-14
20408,Aretha Franklin,1982-11-27,Aretha Franklin - Jump To It,7,6,12,1.0,11,Jump To It,29.0,15,-1,-4,-1,1,down,1982-08-14
20409,Aretha Franklin,1982-12-04,Aretha Franklin - Jump To It,11,7,14,1.0,12,Jump To It,29.0,16,-2,-1,-4,1,down,1982-08-14
20410,Aretha Franklin,1982-12-11,Aretha Franklin - Jump To It,12,11,14,1.0,14,Jump To It,29.0,17,0,-2,-1,0,stay,1982-08-14
20411,Aretha Franklin,1982-12-18,Aretha Franklin - Jump To It,14,12,26,1.0,14,Jump To It,29.0,18,-12,0,-2,1,down,1982-08-14
20412,Aretha Franklin,1982-12-25,Aretha Franklin - Jump To It,14,14,26,1.0,26,Jump To It,29.0,19,0,-12,0,0,stay,1982-08-14
20413,Aretha Franklin,1983-01-01,Aretha Franklin - Jump To It,26,14,30,1.0,26,Jump To It,29.0,20,-4,0,-12,1,down,1982-08-14
20414,Aretha Franklin,1983-01-08,Aretha Franklin - Jump To It,26,26,30,1.0,30,Jump To It,29.0,21,0,-4,0,0,stay,1982-08-14
20415,Aretha Franklin,1983-01-15,Aretha Franklin - Jump To It,30,26,41,1.0,30,Jump To It,29.0,22,-11,0,-4,1,down,1982-08-14
20416,Aretha Franklin,1983-01-22,Aretha Franklin - Jump To It,30,30,41,1.0,41,Jump To It,29.0,23,0,-11,0,0,stay,1982-08-14
20417,Aretha Franklin,1983-01-29,Aretha Franklin - Jump To It,41,30,43,1.0,41,Jump To It,29.0,24,-2,0,-11,1,down,1982-08-14
20418,Aretha Franklin,1983-02-05,Aretha Franklin - Jump To It,41,41,43,1.0,43,Jump To It,29.0,25,0,-2,0,0,stay,1982-08-14
20419,Aretha Franklin,1983-02-12,Aretha Franklin - Jump To It,43,41,43,1.0,43,Jump To It,29.0,26,0,0,-2,0,stay,1982-08-14
20420,Aretha Franklin,1983-02-19,Aretha Franklin - Jump To It,43,43,43,1.0,43,Jump To It,29.0,27,0,0,0,0,stay,1982-08-14
20421,Aretha Franklin,1983-02-26,Aretha Franklin - Jump To It,43,43,44,1.0,43,Jump To It,29.0,28,-1,0,0,1,down,1982-08-14
20422,Aretha Franklin,1983-03-05,Aretha Franklin - Jump To It,43,43,51,1.0,44,Jump To It,29.0,29,-7,-1,0,1,down,1982-08-14
20423,Donna Summer,1982-08-14,Donna Summer - Donna Summer,51,51,12,6.0,30,Donna Summer,17.0,0,18,21,0,1,up,1982-08-14
20424,Donna Summer,1982-08-21,Donna Summer - Donna Summer,30,51,10,6.0,12,Donna Summer,17.0,1,2,18,21,1,up,1982-08-14
20425,Donna Summer,1982-08-28,Donna Summer - Donna Summer,12,30,6,6.0,10,Donna Summer,17.0,2,4,2,18,1,up,1982-08-14
20426,Donna Summer,1982-09-04,Donna Summer - Donna Summer,10,12,6,6.0,6,Donna Summer,17.0,3,0,4,2,0,stay,1982-08-14
20427,Donna Summer,1982-09-11,Donna Summer - Donna Summer,6,10,6,6.0,6,Donna Summer,17.0,4,0,0,4,0,stay,1982-08-14
20428,Donna Summer,1982-09-18,Donna Summer - Donna Summer,6,6,13,6.0,6,Donna Summer,17.0,5,-7,0,0,1,down,1982-08-14
20429,Donna Summer,1982-09-25,Donna Summer - Donna Summer,6,6,14,6.0,13,Donna Summer,17.0,6,-1,-7,0,1,down,1982-08-14
20430,Donna Summer,1982-10-02,Donna Summer - Donna Summer,13,6,15,6.0,14,Donna Summer,17.0,7,-1,-1,-7,1,down,1982-08-14
20431,Donna Summer,1982-10-09,Donna Summer - Donna Summer,14,13,15,6.0,15,Donna Summer,17.0,8,0,-1,-1,0,stay,1982-08-14
20432,Donna Summer,1982-10-16,Donna Summer - Donna Summer,15,14,17,6.0,15,Donna Summer,17.0,9,-2,0,-1,1,down,1982-08-14
20433,Donna Summer,1982-10-23,Donna Summer - Donna Summer,15,15,19,6.0,17,Donna Summer,17.0,10,-2,-2,0,1,down,1982-08-14
20434,Donna Summer,1982-10-30,Donna Summer - Donna Summer,17,15,21,6.0,19,Donna Summer,17.0,11,-2,-2,-2,1,down,1982-08-14
20435,Donna Summer,1982-11-06,Donna Summer - Donna Summer,19,17,20,6.0,21,Donna Summer,17.0,12,1,-2,-2,1,up,1982-08-14
20436,Donna Summer,1982-11-13,Donna Summer - Donna Summer,21,19,30,6.0,20,Donna Summer,17.0,13,-10,1,-2,1,down,1982-08-14
20437,Donna Summer,1982-11-20,Donna Summer - Donna Summer,20,21,45,6.0,30,Donna Summer,17.0,14,-15,-10,1,1,down,1982-08-14
20438,Donna Summer,1982-11-27,Donna Summer - Donna Summer,30,20,45,6.0,45,Donna Summer,17.0,15,0,-15,-10,0,stay,1982-08-14
20439,Donna Summer,1982-12-04,Donna Summer - Donna Summer,45,30,45,6.0,45,Donna Summer,17.0,16,0,0,-15,0,stay,1982-08-14
20440,Donna Summer,1982-12-11,Donna Summer - Donna Summer,45,45,51,6.0,45,Donna Summer,17.0,17,-6,0,0,1,down,1982-08-14
20441,Jermaine Jackson,1982-08-14,Jermaine Jackson - Let Me Tickle Your Fancy,51,51,29,9.0,40,Let Me Tickle Your Fancy,18.0,0,11,11,0,1,up,1982-08-14
20442,Jermaine Jackson,1982-08-21,Jermaine Jackson - Let Me Tickle Your Fancy,40,51,15,9.0,29,Let Me Tickle Your Fancy,18.0,1,14,11,11,1,up,1982-08-14
20443,Jermaine Jackson,1982-08-28,Jermaine Jackson - Let Me Tickle Your Fancy,29,40,13,9.0,15,Let Me Tickle Your Fancy,18.0,2,2,14,11,1,up,1982-08-14
20444,Jermaine Jackson,1982-09-04,Jermaine Jackson - Let Me Tickle Your Fancy,15,29,11,9.0,13,Let Me Tickle Your Fancy,18.0,3,2,2,14,1,up,1982-08-14
20445,Jermaine Jackson,1982-09-11,Jermaine Jackson - Let Me Tickle Your Fancy,13,15,11,9.0,11,Let Me Tickle Your Fancy,18.0,4,0,2,2,0,stay,1982-08-14
20446,Jermaine Jackson,1982-09-18,Jermaine Jackson - Let Me Tickle Your Fancy,11,13,10,9.0,11,Let Me Tickle Your Fancy,18.0,5,1,0,2,1,up,1982-08-14
20447,Jermaine Jackson,1982-09-25,Jermaine Jackson - Let Me Tickle Your Fancy,11,11,9,9.0,10,Let Me Tickle Your Fancy,18.0,6,1,1,0,1,up,1982-08-14
20448,Jermaine Jackson,1982-10-02,Jermaine Jackson - Let Me Tickle Your Fancy,10,11,9,9.0,9,Let Me Tickle Your Fancy,18.0,7,0,1,1,0,stay,1982-08-14
20449,Jermaine Jackson,1982-10-09,Jermaine Jackson - Let Me Tickle Your Fancy,9,10,9,9.0,9,Let Me Tickle Your Fancy,18.0,8,0,0,1,0,stay,1982-08-14
20450,Jermaine Jackson,1982-10-16,Jermaine Jackson - Let Me Tickle Your Fancy,9,9,9,9.0,9,Let Me Tickle Your Fancy,18.0,9,0,0,0,0,stay,1982-08-14
20451,Jermaine Jackson,1982-10-23,Jermaine Jackson - Let Me Tickle Your Fancy,9,9,16,9.0,9,Let Me Tickle Your Fancy,18.0,10,-7,0,0,1,down,1982-08-14
20452,Jermaine Jackson,1982-10-30,Jermaine Jackson - Let Me Tickle Your Fancy,9,9,20,9.0,16,Let Me Tickle Your Fancy,18.0,11,-4,-7,0,1,down,1982-08-14
20453,Jermaine Jackson,1982-11-06,Jermaine Jackson - Let Me Tickle Your Fancy,16,9,22,9.0,20,Let Me Tickle Your Fancy,18.0,12,-2,-4,-7,1,down,1982-08-14
20454,Jermaine Jackson,1982-11-13,Jermaine Jackson - Let Me Tickle Your Fancy,20,16,26,9.0,22,Let Me Tickle Your Fancy,18.0,13,-4,-2,-4,1,down,1982-08-14
20455,Jermaine Jackson,1982-11-20,Jermaine Jackson - Let Me Tickle Your Fancy,22,20,30,9.0,26,Let Me Tickle Your Fancy,18.0,14,-4,-4,-2,1,down,1982-08-14
20456,Jermaine Jackson,1982-11-27,Jermaine Jackson - Let Me Tickle Your Fancy,26,22,38,9.0,30,Let Me Tickle Your Fancy,18.0,15,-8,-4,-4,1,down,1982-08-14
20457,Jermaine Jackson,1982-12-04,Jermaine Jackson - Let Me Tickle Your Fancy,30,26,43,9.0,38,Let Me Tickle Your Fancy,18.0,16,-5,-8,-4,1,down,1982-08-14
20458,Jermaine Jackson,1982-12-11,Jermaine Jackson - Let Me Tickle Your Fancy,38,30,43,9.0,43,Let Me Tickle Your Fancy,18.0,17,0,-5,-8,0,stay,1982-08-14
20459,Jermaine Jackson,1982-12-18,Jermaine Jackson - Let Me Tickle Your Fancy,43,38,51,9.0,43,Let Me Tickle Your Fancy,18.0,18,-8,0,-5,1,down,1982-08-14
20460,Stephanie Mills,1982-08-14,Stephanie Mills - Tantalizingly Hot,51,51,25,10.0,44,Tantalizingly Hot,26.0,0,19,7,0,1,up,1982-08-14
20461,Stephanie Mills,1982-08-21,Stephanie Mills - Tantalizingly Hot,44,51,19,10.0,25,Tantalizingly Hot,26.0,1,6,19,7,1,up,1982-08-14
20462,Stephanie Mills,1982-08-28,Stephanie Mills - Tantalizingly Hot,25,44,17,10.0,19,Tantalizingly Hot,26.0,2,2,6,19,1,up,1982-08-14
20463,Stephanie Mills,1982-09-04,Stephanie Mills - Tantalizingly Hot,19,25,15,10.0,17,Tantalizingly Hot,26.0,3,2,2,6,1,up,1982-08-14
20464,Stephanie Mills,1982-09-11,Stephanie Mills - Tantalizingly Hot,17,19,12,10.0,15,Tantalizingly Hot,26.0,4,3,2,2,1,up,1982-08-14
20465,Stephanie Mills,1982-09-18,Stephanie Mills - Tantalizingly Hot,15,17,11,10.0,12,Tantalizingly Hot,26.0,5,1,3,2,1,up,1982-08-14
20466,Stephanie Mills,1982-09-25,Stephanie Mills - Tantalizingly Hot,12,15,10,10.0,11,Tantalizingly Hot,26.0,6,1,1,3,1,up,1982-08-14
20467,Stephanie Mills,1982-10-02,Stephanie Mills - Tantalizingly Hot,11,12,10,10.0,10,Tantalizingly Hot,26.0,7,0,1,1,0,stay,1982-08-14
20468,Stephanie Mills,1982-10-09,Stephanie Mills - Tantalizingly Hot,10,11,10,10.0,10,Tantalizingly Hot,26.0,8,0,0,1,0,stay,1982-08-14
20469,Stephanie Mills,1982-10-16,Stephanie Mills - Tantalizingly Hot,10,10,10,10.0,10,Tantalizingly Hot,26.0,9,0,0,0,0,stay,1982-08-14
20470,Stephanie Mills,1982-10-23,Stephanie Mills - Tantalizingly Hot,10,10,10,10.0,10,Tantalizingly Hot,26.0,10,0,0,0,0,stay,1982-08-14
20471,Stephanie Mills,1982-10-30,Stephanie Mills - Tantalizingly Hot,10,10,13,10.0,10,Tantalizingly Hot,26.0,11,-3,0,0,1,down,1982-08-14
20472,Stephanie Mills,1982-11-06,Stephanie Mills - Tantalizingly Hot,10,10,13,10.0,13,Tantalizingly Hot,26.0,12,0,-3,0,0,stay,1982-08-14
20473,Stephanie Mills,1982-11-13,Stephanie Mills - Tantalizingly Hot,13,10,16,10.0,13,Tantalizingly Hot,26.0,13,-3,0,-3,1,down,1982-08-14
20474,Stephanie Mills,1982-11-20,Stephanie Mills - Tantalizingly Hot,13,13,17,10.0,16,Tantalizingly Hot,26.0,14,-1,-3,0,1,down,1982-08-14
20475,Stephanie Mills,1982-11-27,Stephanie Mills - Tantalizingly Hot,16,13,19,10.0,17,Tantalizingly Hot,26.0,15,-2,-1,-3,1,down,1982-08-14
20476,Stephanie Mills,1982-12-04,Stephanie Mills - Tantalizingly Hot,17,16,19,10.0,19,Tantalizingly Hot,26.0,16,0,-2,-1,0,stay,1982-08-14
20477,Stephanie Mills,1982-12-11,Stephanie Mills - Tantalizingly Hot,19,17,21,10.0,19,Tantalizingly Hot,26.0,17,-2,0,-2,1,down,1982-08-14
20478,Stephanie Mills,1982-12-18,Stephanie Mills - Tantalizingly Hot,19,19,35,10.0,21,Tantalizingly Hot,26.0,18,-14,-2,0,1,down,1982-08-14
20479,Stephanie Mills,1982-12-25,Stephanie Mills - Tantalizingly Hot,21,19,35,10.0,35,Tantalizingly Hot,26.0,19,0,-14,-2,0,stay,1982-08-14
20480,Stephanie Mills,1983-01-01,Stephanie Mills - Tantalizingly Hot,35,21,40,10.0,35,Tantalizingly Hot,26.0,20,-5,0,-14,1,down,1982-08-14
20481,Stephanie Mills,1983-01-08,Stephanie Mills - Tantalizingly Hot,35,35,40,10.0,40,Tantalizingly Hot,26.0,21,0,-5,0,0,stay,1982-08-14
20482,Stephanie Mills,1983-01-15,Stephanie Mills - Tantalizingly Hot,40,35,40,10.0,40,Tantalizingly Hot,26.0,22,0,0,-5,0,stay,1982-08-14
20483,Stephanie Mills,1983-01-22,Stephanie Mills - Tantalizingly Hot,40,40,42,10.0,40,Tantalizingly Hot,26.0,23,-2,0,0,1,down,1982-08-14
20484,Stephanie Mills,1983-01-29,Stephanie Mills - Tantalizingly Hot,40,40,47,10.0,42,Tantalizingly Hot,26.0,24,-5,-2,0,1,down,1982-08-14
20485,Stephanie Mills,1983-02-05,Stephanie Mills - Tantalizingly Hot,42,40,49,10.0,47,Tantalizingly Hot,26.0,25,-2,-5,-2,1,down,1982-08-14
20486,Stephanie Mills,1983-02-12,Stephanie Mills - Tantalizingly Hot,47,42,51,10.0,49,Tantalizingly Hot,26.0,26,-2,-2,-5,1,down,1982-08-14
20487,Shalamar,1982-08-14,Shalamar - Greatest Hits,51,51,48,48.0,48,Greatest Hits,1.0,0,0,3,0,0,stay,1982-08-14
20488,Shalamar,1982-08-21,Shalamar - Greatest Hits,48,51,51,48.0,48,Greatest Hits,1.0,1,-3,0,3,1,down,1982-08-14
20489,The Isley Brothers,1982-08-21,The Isley Brothers - The Real Deal,51,51,21,9.0,40,The Real Deal,13.0,0,19,11,0,1,up,1982-08-21
20490,The Isley Brothers,1982-08-28,The Isley Brothers - The Real Deal,40,51,12,9.0,21,The Real Deal,13.0,1,9,19,11,1,up,1982-08-21
20491,The Isley Brothers,1982-09-04,The Isley Brothers - The Real Deal,21,40,9,9.0,12,The Real Deal,13.0,2,3,9,19,1,up,1982-08-21
20492,The Isley Brothers,1982-09-11,The Isley Brothers - The Real Deal,12,21,9,9.0,9,The Real Deal,13.0,3,0,3,9,0,stay,1982-08-21
20493,The Isley Brothers,1982-09-18,The Isley Brothers - The Real Deal,9,12,9,9.0,9,The Real Deal,13.0,4,0,0,3,0,stay,1982-08-21
20494,The Isley Brothers,1982-09-25,The Isley Brothers - The Real Deal,9,9,13,9.0,9,The Real Deal,13.0,5,-4,0,0,1,down,1982-08-21
20495,The Isley Brothers,1982-10-02,The Isley Brothers - The Real Deal,9,9,13,9.0,13,The Real Deal,13.0,6,0,-4,0,0,stay,1982-08-21
20496,The Isley Brothers,1982-10-09,The Isley Brothers - The Real Deal,13,9,17,9.0,13,The Real Deal,13.0,7,-4,0,-4,1,down,1982-08-21
20497,The Isley Brothers,1982-10-16,The Isley Brothers - The Real Deal,13,13,18,9.0,17,The Real Deal,13.0,8,-1,-4,0,1,down,1982-08-21
20498,The Isley Brothers,1982-10-23,The Isley Brothers - The Real Deal,17,13,20,9.0,18,The Real Deal,13.0,9,-2,-1,-4,1,down,1982-08-21
20499,The Isley Brothers,1982-10-30,The Isley Brothers - The Real Deal,18,17,22,9.0,20,The Real Deal,13.0,10,-2,-2,-1,1,down,1982-08-21
20500,The Isley Brothers,1982-11-06,The Isley Brothers - The Real Deal,20,18,25,9.0,22,The Real Deal,13.0,11,-3,-2,-2,1,down,1982-08-21
20501,The Isley Brothers,1982-11-13,The Isley Brothers - The Real Deal,22,20,40,9.0,25,The Real Deal,13.0,12,-15,-3,-2,1,down,1982-08-21
20502,The Isley Brothers,1982-11-20,The Isley Brothers - The Real Deal,25,22,51,9.0,40,The Real Deal,13.0,13,-11,-15,-3,1,down,1982-08-21
20503,Teddy Pendergrass,1982-08-21,Teddy Pendergrass - This One's For You,51,51,25,6.0,42,This One's For You,17.0,0,17,9,0,1,up,1982-08-21
20504,Teddy Pendergrass,1982-08-28,Teddy Pendergrass - This One's For You,42,51,15,6.0,25,This One's For You,17.0,1,10,17,9,1,up,1982-08-21
20505,Teddy Pendergrass,1982-09-04,Teddy Pendergrass - This One's For You,25,42,12,6.0,15,This One's For You,17.0,2,3,10,17,1,up,1982-08-21
20506,Teddy Pendergrass,1982-09-11,Teddy Pendergrass - This One's For You,15,25,8,6.0,12,This One's For You,17.0,3,4,3,10,1,up,1982-08-21
20507,Teddy Pendergrass,1982-09-18,Teddy Pendergrass - This One's For You,12,15,8,6.0,8,This One's For You,17.0,4,0,4,3,0,stay,1982-08-21
20508,Teddy Pendergrass,1982-09-25,Teddy Pendergrass - This One's For You,8,12,8,6.0,8,This One's For You,17.0,5,0,0,4,0,stay,1982-08-21
20509,Teddy Pendergrass,1982-10-02,Teddy Pendergrass - This One's For You,8,8,6,6.0,8,This One's For You,17.0,6,2,0,0,1,up,1982-08-21
20510,Teddy Pendergrass,1982-10-09,Teddy Pendergrass - This One's For You,8,8,6,6.0,6,This One's For You,17.0,7,0,2,0,0,stay,1982-08-21
20511,Teddy Pendergrass,1982-10-16,Teddy Pendergrass - This One's For You,6,8,8,6.0,6,This One's For You,17.0,8,-2,0,2,1,down,1982-08-21
20512,Teddy Pendergrass,1982-10-23,Teddy Pendergrass - This One's For You,6,6,15,6.0,8,This One's For You,17.0,9,-7,-2,0,1,down,1982-08-21
20513,Teddy Pendergrass,1982-10-30,Teddy Pendergrass - This One's For You,8,6,18,6.0,15,This One's For You,17.0,10,-3,-7,-2,1,down,1982-08-21
20514,Teddy Pendergrass,1982-11-06,Teddy Pendergrass - This One's For You,15,8,18,6.0,18,This One's For You,17.0,11,0,-3,-7,0,stay,1982-08-21
20515,Teddy Pendergrass,1982-11-13,Teddy Pendergrass - This One's For You,18,15,20,6.0,18,This One's For You,17.0,12,-2,0,-3,1,down,1982-08-21
20516,Teddy Pendergrass,1982-11-20,Teddy Pendergrass - This One's For You,18,18,24,6.0,20,This One's For You,17.0,13,-4,-2,0,1,down,1982-08-21
20517,Teddy Pendergrass,1982-11-27,Teddy Pendergrass - This One's For You,20,18,27,6.0,24,This One's For You,17.0,14,-3,-4,-2,1,down,1982-08-21
20518,Teddy Pendergrass,1982-12-04,Teddy Pendergrass - This One's For You,24,20,37,6.0,27,This One's For You,17.0,15,-10,-3,-4,1,down,1982-08-21
20519,Teddy Pendergrass,1982-12-11,Teddy Pendergrass - This One's For You,27,24,49,6.0,37,This One's For You,17.0,16,-12,-10,-3,1,down,1982-08-21
20520,Teddy Pendergrass,1982-12-18,Teddy Pendergrass - This One's For You,37,27,51,6.0,49,This One's For You,17.0,17,-2,-12,-10,1,down,1982-08-21
20521,Dayton,1982-08-21,Dayton - Hot Fun,51,51,43,36.0,49,Hot Fun,5.0,0,6,2,0,1,up,1982-08-21
20522,Dayton,1982-08-28,Dayton - Hot Fun,49,51,40,36.0,43,Hot Fun,5.0,1,3,6,2,1,up,1982-08-21
20523,Dayton,1982-09-04,Dayton - Hot Fun,43,49,36,36.0,40,Hot Fun,5.0,2,4,3,6,1,up,1982-08-21
20524,Dayton,1982-09-11,Dayton - Hot Fun,40,43,36,36.0,36,Hot Fun,5.0,3,0,4,3,0,stay,1982-08-21
20525,Dayton,1982-09-18,Dayton - Hot Fun,36,40,50,36.0,36,Hot Fun,5.0,4,-14,0,4,1,down,1982-08-21
20526,Dayton,1982-09-25,Dayton - Hot Fun,36,36,51,36.0,50,Hot Fun,5.0,5,-1,-14,0,1,down,1982-08-21
20527,Stacy Lattisaw,1982-08-28,Stacy Lattisaw - Sneakin' Out,51,51,23,11.0,40,Sneakin' Out,16.0,0,17,11,0,1,up,1982-08-28
20528,Stacy Lattisaw,1982-09-04,Stacy Lattisaw - Sneakin' Out,40,51,17,11.0,23,Sneakin' Out,16.0,1,6,17,11,1,up,1982-08-28
20529,Stacy Lattisaw,1982-09-11,Stacy Lattisaw - Sneakin' Out,23,40,14,11.0,17,Sneakin' Out,16.0,2,3,6,17,1,up,1982-08-28
20530,Stacy Lattisaw,1982-09-18,Stacy Lattisaw - Sneakin' Out,17,23,12,11.0,14,Sneakin' Out,16.0,3,2,3,6,1,up,1982-08-28
20531,Stacy Lattisaw,1982-09-25,Stacy Lattisaw - Sneakin' Out,14,17,12,11.0,12,Sneakin' Out,16.0,4,0,2,3,0,stay,1982-08-28
20532,Stacy Lattisaw,1982-10-02,Stacy Lattisaw - Sneakin' Out,12,14,11,11.0,12,Sneakin' Out,16.0,5,1,0,2,1,up,1982-08-28
20533,Stacy Lattisaw,1982-10-09,Stacy Lattisaw - Sneakin' Out,12,12,11,11.0,11,Sneakin' Out,16.0,6,0,1,0,0,stay,1982-08-28
20534,Stacy Lattisaw,1982-10-16,Stacy Lattisaw - Sneakin' Out,11,12,11,11.0,11,Sneakin' Out,16.0,7,0,0,1,0,stay,1982-08-28
20535,Stacy Lattisaw,1982-10-23,Stacy Lattisaw - Sneakin' Out,11,11,11,11.0,11,Sneakin' Out,16.0,8,0,0,0,0,stay,1982-08-28
20536,Stacy Lattisaw,1982-10-30,Stacy Lattisaw - Sneakin' Out,11,11,11,11.0,11,Sneakin' Out,16.0,9,0,0,0,0,stay,1982-08-28
20537,Stacy Lattisaw,1982-11-06,Stacy Lattisaw - Sneakin' Out,11,11,17,11.0,11,Sneakin' Out,16.0,10,-6,0,0,1,down,1982-08-28
20538,Stacy Lattisaw,1982-11-13,Stacy Lattisaw - Sneakin' Out,11,11,17,11.0,17,Sneakin' Out,16.0,11,0,-6,0,0,stay,1982-08-28
20539,Stacy Lattisaw,1982-11-20,Stacy Lattisaw - Sneakin' Out,17,11,22,11.0,17,Sneakin' Out,16.0,12,-5,0,-6,1,down,1982-08-28
20540,Stacy Lattisaw,1982-11-27,Stacy Lattisaw - Sneakin' Out,17,17,23,11.0,22,Sneakin' Out,16.0,13,-1,-5,0,1,down,1982-08-28
20541,Stacy Lattisaw,1982-12-04,Stacy Lattisaw - Sneakin' Out,22,17,33,11.0,23,Sneakin' Out,16.0,14,-10,-1,-5,1,down,1982-08-28
20542,Stacy Lattisaw,1982-12-11,Stacy Lattisaw - Sneakin' Out,23,22,39,11.0,33,Sneakin' Out,16.0,15,-6,-10,-1,1,down,1982-08-28
20543,Stacy Lattisaw,1982-12-18,Stacy Lattisaw - Sneakin' Out,33,23,51,11.0,39,Sneakin' Out,16.0,16,-12,-6,-10,1,down,1982-08-28
20544,Stanley Clarke,1982-08-28,Stanley Clarke - Let Me Know You,51,51,35,25.0,45,Let Me Know You,6.0,0,10,6,0,1,up,1982-08-28
20545,Stanley Clarke,1982-09-04,Stanley Clarke - Let Me Know You,45,51,31,25.0,35,Let Me Know You,6.0,1,4,10,6,1,up,1982-08-28
20546,Stanley Clarke,1982-09-11,Stanley Clarke - Let Me Know You,35,45,27,25.0,31,Let Me Know You,6.0,2,4,4,10,1,up,1982-08-28
20547,Stanley Clarke,1982-09-18,Stanley Clarke - Let Me Know You,31,35,25,25.0,27,Let Me Know You,6.0,3,2,4,4,1,up,1982-08-28
20548,Stanley Clarke,1982-09-25,Stanley Clarke - Let Me Know You,27,31,25,25.0,25,Let Me Know You,6.0,4,0,2,4,0,stay,1982-08-28
20549,Stanley Clarke,1982-10-02,Stanley Clarke - Let Me Know You,25,27,46,25.0,25,Let Me Know You,6.0,5,-21,0,2,1,down,1982-08-28
20550,Stanley Clarke,1982-10-09,Stanley Clarke - Let Me Know You,25,25,51,25.0,46,Let Me Know You,6.0,6,-5,-21,0,1,down,1982-08-28
20551,The Valentine Brothers,1982-08-28,The Valentine Brothers - First Take,51,51,46,46.0,49,First Take,4.0,0,3,2,0,1,up,1982-08-28
20552,The Valentine Brothers,1982-09-04,The Valentine Brothers - First Take,49,51,46,46.0,46,First Take,4.0,1,0,3,2,0,stay,1982-08-28
20553,The Valentine Brothers,1982-09-11,The Valentine Brothers - First Take,46,49,47,46.0,46,First Take,4.0,2,-1,0,3,1,down,1982-08-28
20554,The Valentine Brothers,1982-10-09,The Valentine Brothers - First Take,46,46,47,46.0,47,First Take,4.0,3,0,-1,0,0,stay,1982-08-28
20555,The Valentine Brothers,1982-10-16,The Valentine Brothers - First Take,47,46,51,46.0,47,First Take,4.0,4,-4,0,-1,1,down,1982-08-28
20556,Average White Band,1982-08-28,Average White Band - Cupid's In Fashion,51,51,49,49.0,50,Cupid's In Fashion,1.0,0,1,1,0,1,up,1982-08-28
20557,Average White Band,1982-09-04,Average White Band - Cupid's In Fashion,50,51,51,49.0,49,Cupid's In Fashion,1.0,1,-2,1,1,1,down,1982-08-28
20558,Michael McDonald,1982-09-04,Michael McDonald - If That's What It Takes,51,51,30,10.0,43,If That's What It Takes,18.0,0,13,8,0,1,up,1982-09-04
20559,Michael McDonald,1982-09-11,Michael McDonald - If That's What It Takes,43,51,24,10.0,30,If That's What It Takes,18.0,1,6,13,8,1,up,1982-09-04
20560,Michael McDonald,1982-09-18,Michael McDonald - If That's What It Takes,30,43,21,10.0,24,If That's What It Takes,18.0,2,3,6,13,1,up,1982-09-04
20561,Michael McDonald,1982-09-25,Michael McDonald - If That's What It Takes,24,30,16,10.0,21,If That's What It Takes,18.0,3,5,3,6,1,up,1982-09-04
20562,Michael McDonald,1982-10-02,Michael McDonald - If That's What It Takes,21,24,12,10.0,16,If That's What It Takes,18.0,4,4,5,3,1,up,1982-09-04
20563,Michael McDonald,1982-10-09,Michael McDonald - If That's What It Takes,16,21,12,10.0,12,If That's What It Takes,18.0,5,0,4,5,0,stay,1982-09-04
20564,Michael McDonald,1982-10-16,Michael McDonald - If That's What It Takes,12,16,12,10.0,12,If That's What It Takes,18.0,6,0,0,4,0,stay,1982-09-04
20565,Michael McDonald,1982-10-23,Michael McDonald - If That's What It Takes,12,12,12,10.0,12,If That's What It Takes,18.0,7,0,0,0,0,stay,1982-09-04
20566,Michael McDonald,1982-10-30,Michael McDonald - If That's What It Takes,12,12,10,10.0,12,If That's What It Takes,18.0,8,2,0,0,1,up,1982-09-04
20567,Michael McDonald,1982-11-06,Michael McDonald - If That's What It Takes,12,12,10,10.0,10,If That's What It Takes,18.0,9,0,2,0,0,stay,1982-09-04
20568,Michael McDonald,1982-11-13,Michael McDonald - If That's What It Takes,10,12,11,10.0,10,If That's What It Takes,18.0,10,-1,0,2,1,down,1982-09-04
20569,Michael McDonald,1982-11-20,Michael McDonald - If That's What It Takes,10,10,20,10.0,11,If That's What It Takes,18.0,11,-9,-1,0,1,down,1982-09-04
20570,Michael McDonald,1982-11-27,Michael McDonald - If That's What It Takes,11,10,20,10.0,20,If That's What It Takes,18.0,12,0,-9,-1,0,stay,1982-09-04
20571,Michael McDonald,1982-12-04,Michael McDonald - If That's What It Takes,20,11,23,10.0,20,If That's What It Takes,18.0,13,-3,0,-9,1,down,1982-09-04
20572,Michael McDonald,1982-12-11,Michael McDonald - If That's What It Takes,20,20,37,10.0,23,If That's What It Takes,18.0,14,-14,-3,0,1,down,1982-09-04
20573,Michael McDonald,1982-12-18,Michael McDonald - If That's What It Takes,23,20,40,10.0,37,If That's What It Takes,18.0,15,-3,-14,-3,1,down,1982-09-04
20574,Michael McDonald,1982-12-25,Michael McDonald - If That's What It Takes,37,23,40,10.0,40,If That's What It Takes,18.0,16,0,-3,-14,0,stay,1982-09-04
20575,Michael McDonald,1983-01-01,Michael McDonald - If That's What It Takes,40,37,44,10.0,40,If That's What It Takes,18.0,17,-4,0,-3,1,down,1982-09-04
20576,Michael McDonald,1983-01-08,Michael McDonald - If That's What It Takes,40,40,51,10.0,44,If That's What It Takes,18.0,18,-7,-4,0,1,down,1982-09-04
20577,Lou Rawls,1982-09-04,Lou Rawls - Now Is The Time,51,51,45,45.0,45,Now Is The Time,3.0,0,0,6,0,0,stay,1982-09-04
20578,Lou Rawls,1982-09-11,Lou Rawls - Now Is The Time,45,51,46,45.0,45,Now Is The Time,3.0,1,-1,0,6,1,down,1982-09-04
20579,Lou Rawls,1982-09-18,Lou Rawls - Now Is The Time,45,45,48,45.0,46,Now Is The Time,3.0,2,-2,-1,0,1,down,1982-09-04
20580,Lou Rawls,1982-09-25,Lou Rawls - Now Is The Time,46,45,51,45.0,48,Now Is The Time,3.0,3,-3,-2,-1,1,down,1982-09-04
20581,"Brooklyn, Bronx & Queens Band",1982-09-04,"Brooklyn, Bronx & Queens Band - All Night Long",51,51,42,32.0,47,All Night Long,6.0,0,5,4,0,1,up,1982-09-04
20582,"Brooklyn, Bronx & Queens Band",1982-09-11,"Brooklyn, Bronx & Queens Band - All Night Long",47,51,38,32.0,42,All Night Long,6.0,1,4,5,4,1,up,1982-09-04
20583,"Brooklyn, Bronx & Queens Band",1982-09-18,"Brooklyn, Bronx & Queens Band - All Night Long",42,47,35,32.0,38,All Night Long,6.0,2,3,4,5,1,up,1982-09-04
20584,"Brooklyn, Bronx & Queens Band",1982-09-25,"Brooklyn, Bronx & Queens Band - All Night Long",38,42,32,32.0,35,All Night Long,6.0,3,3,3,4,1,up,1982-09-04
20585,"Brooklyn, Bronx & Queens Band",1982-10-02,"Brooklyn, Bronx & Queens Band - All Night Long",35,38,32,32.0,32,All Night Long,6.0,4,0,3,3,0,stay,1982-09-04
20586,"Brooklyn, Bronx & Queens Band",1982-10-09,"Brooklyn, Bronx & Queens Band - All Night Long",32,35,38,32.0,32,All Night Long,6.0,5,-6,0,3,1,down,1982-09-04
20587,"Brooklyn, Bronx & Queens Band",1982-10-16,"Brooklyn, Bronx & Queens Band - All Night Long",32,32,51,32.0,38,All Night Long,6.0,6,-13,-6,0,1,down,1982-09-04
20588,Rafael Cameron,1982-09-04,Rafael Cameron - Cameron All The Way,51,51,44,43.0,50,Cameron All The Way,3.0,0,6,1,0,1,up,1982-09-04
20589,Rafael Cameron,1982-09-11,Rafael Cameron - Cameron All The Way,50,51,43,43.0,44,Cameron All The Way,3.0,1,1,6,1,1,up,1982-09-04
20590,Rafael Cameron,1982-09-18,Rafael Cameron - Cameron All The Way,44,50,46,43.0,43,Cameron All The Way,3.0,2,-3,1,6,1,down,1982-09-04
20591,Rafael Cameron,1982-09-25,Rafael Cameron - Cameron All The Way,43,44,51,43.0,46,Cameron All The Way,3.0,3,-5,-3,1,1,down,1982-09-04
20592,Barry White,1982-09-11,Barry White - Change,51,51,26,19.0,38,Change,11.0,0,12,13,0,1,up,1982-09-11
20593,Barry White,1982-09-18,Barry White - Change,38,51,22,19.0,26,Change,11.0,1,4,12,13,1,up,1982-09-11
20594,Barry White,1982-09-25,Barry White - Change,26,38,19,19.0,22,Change,11.0,2,3,4,12,1,up,1982-09-11
20595,Barry White,1982-10-02,Barry White - Change,22,26,19,19.0,19,Change,11.0,3,0,3,4,0,stay,1982-09-11
20596,Barry White,1982-10-09,Barry White - Change,19,22,19,19.0,19,Change,11.0,4,0,0,3,0,stay,1982-09-11
20597,Barry White,1982-10-16,Barry White - Change,19,19,19,19.0,19,Change,11.0,5,0,0,0,0,stay,1982-09-11
20598,Barry White,1982-10-23,Barry White - Change,19,19,24,19.0,19,Change,11.0,6,-5,0,0,1,down,1982-09-11
20599,Barry White,1982-10-30,Barry White - Change,19,19,24,19.0,24,Change,11.0,7,0,-5,0,0,stay,1982-09-11
20600,Barry White,1982-11-06,Barry White - Change,24,19,27,19.0,24,Change,11.0,8,-3,0,-5,1,down,1982-09-11
20601,Barry White,1982-11-13,Barry White - Change,24,24,31,19.0,27,Change,11.0,9,-4,-3,0,1,down,1982-09-11
20602,Barry White,1982-11-20,Barry White - Change,27,24,46,19.0,31,Change,11.0,10,-15,-4,-3,1,down,1982-09-11
20603,Barry White,1982-11-27,Barry White - Change,31,27,51,19.0,46,Change,11.0,11,-5,-15,-4,1,down,1982-09-11
20604,"Evelyn ""Champagne"" King",1982-09-11,"Evelyn ""Champagne"" King - Get Loose",51,51,19,1.0,39,Get Loose,33.0,0,20,12,0,1,up,1982-09-11
20605,"Evelyn ""Champagne"" King",1982-09-18,"Evelyn ""Champagne"" King - Get Loose",39,51,6,1.0,19,Get Loose,33.0,1,13,20,12,1,up,1982-09-11
20606,"Evelyn ""Champagne"" King",1982-09-25,"Evelyn ""Champagne"" King - Get Loose",19,39,4,1.0,6,Get Loose,33.0,2,2,13,20,1,up,1982-09-11
20607,"Evelyn ""Champagne"" King",1982-10-02,"Evelyn ""Champagne"" King - Get Loose",6,19,3,1.0,4,Get Loose,33.0,3,1,2,13,1,up,1982-09-11
20608,"Evelyn ""Champagne"" King",1982-10-09,"Evelyn ""Champagne"" King - Get Loose",4,6,2,1.0,3,Get Loose,33.0,4,1,1,2,1,up,1982-09-11
20609,"Evelyn ""Champagne"" King",1982-10-16,"Evelyn ""Champagne"" King - Get Loose",3,4,1,1.0,2,Get Loose,33.0,5,1,1,1,1,up,1982-09-11
20610,"Evelyn ""Champagne"" King",1982-10-23,"Evelyn ""Champagne"" King - Get Loose",2,3,1,1.0,1,Get Loose,33.0,6,0,1,1,0,stay,1982-09-11
20611,"Evelyn ""Champagne"" King",1982-10-30,"Evelyn ""Champagne"" King - Get Loose",1,2,3,1.0,1,Get Loose,33.0,7,-2,0,1,1,down,1982-09-11
20612,"Evelyn ""Champagne"" King",1982-11-06,"Evelyn ""Champagne"" King - Get Loose",1,1,3,1.0,3,Get Loose,33.0,8,0,-2,0,0,stay,1982-09-11
20613,"Evelyn ""Champagne"" King",1982-11-13,"Evelyn ""Champagne"" King - Get Loose",3,1,3,1.0,3,Get Loose,33.0,9,0,0,-2,0,stay,1982-09-11
20614,"Evelyn ""Champagne"" King",1982-11-20,"Evelyn ""Champagne"" King - Get Loose",3,3,4,1.0,3,Get Loose,33.0,10,-1,0,0,1,down,1982-09-11
20615,"Evelyn ""Champagne"" King",1982-11-27,"Evelyn ""Champagne"" King - Get Loose",3,3,9,1.0,4,Get Loose,33.0,11,-5,-1,0,1,down,1982-09-11
20616,"Evelyn ""Champagne"" King",1982-12-04,"Evelyn ""Champagne"" King - Get Loose",4,3,9,1.0,9,Get Loose,33.0,12,0,-5,-1,0,stay,1982-09-11
20617,"Evelyn ""Champagne"" King",1982-12-11,"Evelyn ""Champagne"" King - Get Loose",9,4,8,1.0,9,Get Loose,33.0,13,1,0,-5,1,up,1982-09-11
20618,"Evelyn ""Champagne"" King",1982-12-18,"Evelyn ""Champagne"" King - Get Loose",9,9,8,1.0,8,Get Loose,33.0,14,0,1,0,0,stay,1982-09-11
20619,"Evelyn ""Champagne"" King",1982-12-25,"Evelyn ""Champagne"" King - Get Loose",8,9,8,1.0,8,Get Loose,33.0,15,0,0,1,0,stay,1982-09-11
20620,"Evelyn ""Champagne"" King",1983-01-01,"Evelyn ""Champagne"" King - Get Loose",8,8,7,1.0,8,Get Loose,33.0,16,1,0,0,1,up,1982-09-11
20621,"Evelyn ""Champagne"" King",1983-01-08,"Evelyn ""Champagne"" King - Get Loose",8,8,7,1.0,7,Get Loose,33.0,17,0,1,0,0,stay,1982-09-11
20622,"Evelyn ""Champagne"" King",1983-01-15,"Evelyn ""Champagne"" King - Get Loose",7,8,13,1.0,7,Get Loose,33.0,18,-6,0,1,1,down,1982-09-11
20623,"Evelyn ""Champagne"" King",1983-01-22,"Evelyn ""Champagne"" King - Get Loose",7,7,15,1.0,13,Get Loose,33.0,19,-2,-6,0,1,down,1982-09-11
20624,"Evelyn ""Champagne"" King",1983-01-29,"Evelyn ""Champagne"" King - Get Loose",13,7,15,1.0,15,Get Loose,33.0,20,0,-2,-6,0,stay,1982-09-11
20625,"Evelyn ""Champagne"" King",1983-02-05,"Evelyn ""Champagne"" King - Get Loose",15,13,18,1.0,15,Get Loose,33.0,21,-3,0,-2,1,down,1982-09-11
20626,"Evelyn ""Champagne"" King",1983-02-12,"Evelyn ""Champagne"" King - Get Loose",15,15,17,1.0,18,Get Loose,33.0,22,1,-3,0,1,up,1982-09-11
20627,"Evelyn ""Champagne"" King",1983-02-19,"Evelyn ""Champagne"" King - Get Loose",18,15,18,1.0,17,Get Loose,33.0,23,-1,1,-3,1,down,1982-09-11
20628,"Evelyn ""Champagne"" King",1983-02-26,"Evelyn ""Champagne"" King - Get Loose",17,18,18,1.0,18,Get Loose,33.0,24,0,-1,1,0,stay,1982-09-11
20629,"Evelyn ""Champagne"" King",1983-03-05,"Evelyn ""Champagne"" King - Get Loose",18,17,25,1.0,18,Get Loose,33.0,25,-7,0,-1,1,down,1982-09-11
20630,"Evelyn ""Champagne"" King",1983-03-12,"Evelyn ""Champagne"" King - Get Loose",18,18,24,1.0,25,Get Loose,33.0,26,1,-7,0,1,up,1982-09-11
20631,"Evelyn ""Champagne"" King",1983-03-19,"Evelyn ""Champagne"" King - Get Loose",25,18,23,1.0,24,Get Loose,33.0,27,1,1,-7,1,up,1982-09-11
20632,"Evelyn ""Champagne"" King",1983-03-26,"Evelyn ""Champagne"" King - Get Loose",24,25,29,1.0,23,Get Loose,33.0,28,-6,1,1,1,down,1982-09-11
20633,"Evelyn ""Champagne"" King",1983-04-02,"Evelyn ""Champagne"" King - Get Loose",23,24,28,1.0,29,Get Loose,33.0,29,1,-6,1,1,up,1982-09-11
20634,"Evelyn ""Champagne"" King",1983-04-09,"Evelyn ""Champagne"" King - Get Loose",29,23,33,1.0,28,Get Loose,33.0,30,-5,1,-6,1,down,1982-09-11
20635,"Evelyn ""Champagne"" King",1983-04-16,"Evelyn ""Champagne"" King - Get Loose",28,29,42,1.0,33,Get Loose,33.0,31,-9,-5,1,1,down,1982-09-11
20636,"Evelyn ""Champagne"" King",1983-04-23,"Evelyn ""Champagne"" King - Get Loose",33,28,42,1.0,42,Get Loose,33.0,32,0,-9,-5,0,stay,1982-09-11
20637,"Evelyn ""Champagne"" King",1983-04-30,"Evelyn ""Champagne"" King - Get Loose",42,33,51,1.0,42,Get Loose,33.0,33,-9,0,-9,1,down,1982-09-11
20638,Eddie Murphy,1982-09-11,Eddie Murphy - Eddie Murphy,51,51,28,26.0,40,Eddie Murphy,8.0,0,12,11,0,1,up,1982-09-11
20639,Eddie Murphy,1982-09-18,Eddie Murphy - Eddie Murphy,40,51,26,26.0,28,Eddie Murphy,8.0,1,2,12,11,1,up,1982-09-11
20640,Eddie Murphy,1982-09-25,Eddie Murphy - Eddie Murphy,28,40,26,26.0,26,Eddie Murphy,8.0,2,0,2,12,0,stay,1982-09-11
20641,Eddie Murphy,1982-10-02,Eddie Murphy - Eddie Murphy,26,28,28,26.0,26,Eddie Murphy,8.0,3,-2,0,2,1,down,1982-09-11
20642,Eddie Murphy,1982-10-09,Eddie Murphy - Eddie Murphy,26,26,28,26.0,28,Eddie Murphy,8.0,4,0,-2,0,0,stay,1982-09-11
20643,Eddie Murphy,1982-10-16,Eddie Murphy - Eddie Murphy,28,26,36,26.0,28,Eddie Murphy,8.0,5,-8,0,-2,1,down,1982-09-11
20644,Eddie Murphy,1982-10-23,Eddie Murphy - Eddie Murphy,28,28,39,26.0,36,Eddie Murphy,8.0,6,-3,-8,0,1,down,1982-09-11
20645,Eddie Murphy,1982-10-30,Eddie Murphy - Eddie Murphy,36,28,45,26.0,39,Eddie Murphy,8.0,7,-6,-3,-8,1,down,1982-09-11
20646,Eddie Murphy,1982-11-06,Eddie Murphy - Eddie Murphy,39,36,51,26.0,45,Eddie Murphy,8.0,8,-6,-6,-3,1,down,1982-09-11
20647,Robert Goodie Whitfield,1982-09-18,Robert Goodie Whitfield - Call Me Goodie,51,51,36,31.0,45,Call Me Goodie,5.0,0,9,6,0,1,up,1982-09-18
20648,Robert Goodie Whitfield,1982-09-25,Robert Goodie Whitfield - Call Me Goodie,45,51,33,31.0,36,Call Me Goodie,5.0,1,3,9,6,1,up,1982-09-18
20649,Robert Goodie Whitfield,1982-10-02,Robert Goodie Whitfield - Call Me Goodie,36,45,31,31.0,33,Call Me Goodie,5.0,2,2,3,9,1,up,1982-09-18
20650,Robert Goodie Whitfield,1982-10-09,Robert Goodie Whitfield - Call Me Goodie,33,36,31,31.0,31,Call Me Goodie,5.0,3,0,2,3,0,stay,1982-09-18
20651,Robert Goodie Whitfield,1982-10-16,Robert Goodie Whitfield - Call Me Goodie,31,33,43,31.0,31,Call Me Goodie,5.0,4,-12,0,2,1,down,1982-09-18
20652,Robert Goodie Whitfield,1982-10-23,Robert Goodie Whitfield - Call Me Goodie,31,31,51,31.0,43,Call Me Goodie,5.0,5,-8,-12,0,1,down,1982-09-18
20653,Ozone,1982-09-18,Ozone - Li'l Suzy,51,51,45,45.0,49,Li'l Suzy,2.0,0,4,2,0,1,up,1982-09-18
20654,Ozone,1982-09-25,Ozone - Li'l Suzy,49,51,45,45.0,45,Li'l Suzy,2.0,1,0,4,2,0,stay,1982-09-18
20655,Ozone,1982-10-02,Ozone - Li'l Suzy,45,49,51,45.0,45,Li'l Suzy,2.0,2,-6,0,4,1,down,1982-09-18
20656,The Time,1982-09-25,The Time - What Time Is It?,51,51,6,2.0,19,What Time Is It?,33.0,0,13,32,0,1,up,1982-09-25
20657,The Time,1982-10-02,The Time - What Time Is It?,19,51,4,2.0,6,What Time Is It?,33.0,1,2,13,32,1,up,1982-09-25
20658,The Time,1982-10-09,The Time - What Time Is It?,6,19,3,2.0,4,What Time Is It?,33.0,2,1,2,13,1,up,1982-09-25
20659,The Time,1982-10-16,The Time - What Time Is It?,4,6,2,2.0,3,What Time Is It?,33.0,3,1,1,2,1,up,1982-09-25
20660,The Time,1982-10-23,The Time - What Time Is It?,3,4,2,2.0,2,What Time Is It?,33.0,4,0,1,1,0,stay,1982-09-25
20661,The Time,1982-10-30,The Time - What Time Is It?,2,3,2,2.0,2,What Time Is It?,33.0,5,0,0,1,0,stay,1982-09-25
20662,The Time,1982-11-06,The Time - What Time Is It?,2,2,4,2.0,2,What Time Is It?,33.0,6,-2,0,0,1,down,1982-09-25
20663,The Time,1982-11-13,The Time - What Time Is It?,2,2,4,2.0,4,What Time Is It?,33.0,7,0,-2,0,0,stay,1982-09-25
20664,The Time,1982-11-20,The Time - What Time Is It?,4,2,7,2.0,4,What Time Is It?,33.0,8,-3,0,-2,1,down,1982-09-25
20665,The Time,1982-11-27,The Time - What Time Is It?,4,4,7,2.0,7,What Time Is It?,33.0,9,0,-3,0,0,stay,1982-09-25
20666,The Time,1982-12-04,The Time - What Time Is It?,7,4,7,2.0,7,What Time Is It?,33.0,10,0,0,-3,0,stay,1982-09-25
20667,The Time,1982-12-11,The Time - What Time Is It?,7,7,7,2.0,7,What Time Is It?,33.0,11,0,0,0,0,stay,1982-09-25
20668,The Time,1982-12-18,The Time - What Time Is It?,7,7,10,2.0,7,What Time Is It?,33.0,12,-3,0,0,1,down,1982-09-25
20669,The Time,1982-12-25,The Time - What Time Is It?,7,7,10,2.0,10,What Time Is It?,33.0,13,0,-3,0,0,stay,1982-09-25
20670,The Time,1983-01-01,The Time - What Time Is It?,10,7,11,2.0,10,What Time Is It?,33.0,14,-1,0,-3,1,down,1982-09-25
20671,The Time,1983-01-08,The Time - What Time Is It?,10,10,13,2.0,11,What Time Is It?,33.0,15,-2,-1,0,1,down,1982-09-25
20672,The Time,1983-01-15,The Time - What Time Is It?,11,10,16,2.0,13,What Time Is It?,33.0,16,-3,-2,-1,1,down,1982-09-25
20673,The Time,1983-01-22,The Time - What Time Is It?,13,11,16,2.0,16,What Time Is It?,33.0,17,0,-3,-2,0,stay,1982-09-25
20674,The Time,1983-01-29,The Time - What Time Is It?,16,13,20,2.0,16,What Time Is It?,33.0,18,-4,0,-3,1,down,1982-09-25
20675,The Time,1983-02-05,The Time - What Time Is It?,16,16,21,2.0,20,What Time Is It?,33.0,19,-1,-4,0,1,down,1982-09-25
20676,The Time,1983-02-12,The Time - What Time Is It?,20,16,21,2.0,21,What Time Is It?,33.0,20,0,-1,-4,0,stay,1982-09-25
20677,The Time,1983-02-19,The Time - What Time Is It?,21,20,24,2.0,21,What Time Is It?,33.0,21,-3,0,-1,1,down,1982-09-25
20678,The Time,1983-02-26,The Time - What Time Is It?,21,21,23,2.0,24,What Time Is It?,33.0,22,1,-3,0,1,up,1982-09-25
20679,The Time,1983-03-05,The Time - What Time Is It?,24,21,24,2.0,23,What Time Is It?,33.0,23,-1,1,-3,1,down,1982-09-25
20680,The Time,1983-03-12,The Time - What Time Is It?,23,24,26,2.0,24,What Time Is It?,33.0,24,-2,-1,1,1,down,1982-09-25
20681,The Time,1983-03-19,The Time - What Time Is It?,24,23,32,2.0,26,What Time Is It?,33.0,25,-6,-2,-1,1,down,1982-09-25
20682,The Time,1983-03-26,The Time - What Time Is It?,26,24,34,2.0,32,What Time Is It?,33.0,26,-2,-6,-2,1,down,1982-09-25
20683,The Time,1983-04-02,The Time - What Time Is It?,32,26,41,2.0,34,What Time Is It?,33.0,27,-7,-2,-6,1,down,1982-09-25
20684,The Time,1983-04-09,The Time - What Time Is It?,34,32,39,2.0,41,What Time Is It?,33.0,28,2,-7,-2,1,up,1982-09-25
20685,The Time,1983-04-16,The Time - What Time Is It?,41,34,38,2.0,39,What Time Is It?,33.0,29,1,2,-7,1,up,1982-09-25
20686,The Time,1983-04-23,The Time - What Time Is It?,39,41,38,2.0,38,What Time Is It?,33.0,30,0,1,2,0,stay,1982-09-25
20687,The Time,1983-04-30,The Time - What Time Is It?,38,39,46,2.0,38,What Time Is It?,33.0,31,-8,0,1,1,down,1982-09-25
20688,The Time,1983-05-07,The Time - What Time Is It?,38,38,48,2.0,46,What Time Is It?,33.0,32,-2,-8,0,1,down,1982-09-25
20689,The Time,1983-05-14,The Time - What Time Is It?,46,38,51,2.0,48,What Time Is It?,33.0,33,-3,-2,-8,1,down,1982-09-25
20690,Four Tops,1982-09-25,Four Tops - One More Mountain,51,51,46,45.0,49,One More Mountain,2.0,0,3,2,0,1,up,1982-09-25
20691,Four Tops,1982-10-02,Four Tops - One More Mountain,49,51,45,45.0,46,One More Mountain,2.0,1,1,3,2,1,up,1982-09-25
20692,Four Tops,1982-10-09,Four Tops - One More Mountain,46,49,51,45.0,45,One More Mountain,2.0,2,-6,1,3,1,down,1982-09-25
20693,Gil Scott-Heron,1982-10-02,Gil Scott-Heron - Moving Target,51,51,38,33.0,42,Moving Target,6.0,0,4,9,0,1,up,1982-10-02
20694,Gil Scott-Heron,1982-10-09,Gil Scott-Heron - Moving Target,42,51,36,33.0,38,Moving Target,6.0,1,2,4,9,1,up,1982-10-02
20695,Gil Scott-Heron,1982-10-16,Gil Scott-Heron - Moving Target,38,42,33,33.0,36,Moving Target,6.0,2,3,2,4,1,up,1982-10-02
20696,Gil Scott-Heron,1982-10-23,Gil Scott-Heron - Moving Target,36,38,33,33.0,33,Moving Target,6.0,3,0,3,2,0,stay,1982-10-02
20697,Gil Scott-Heron,1982-10-30,Gil Scott-Heron - Moving Target,33,36,34,33.0,33,Moving Target,6.0,4,-1,0,3,1,down,1982-10-02
20698,Gil Scott-Heron,1982-11-06,Gil Scott-Heron - Moving Target,33,33,42,33.0,34,Moving Target,6.0,5,-8,-1,0,1,down,1982-10-02
20699,Gil Scott-Heron,1982-11-13,Gil Scott-Heron - Moving Target,34,33,51,33.0,42,Moving Target,6.0,6,-9,-8,-1,1,down,1982-10-02
20700,Tavares,1982-10-02,Tavares - New Directions,51,51,37,30.0,43,New Directions,13.0,0,6,8,0,1,up,1982-10-02
20701,Tavares,1982-10-09,Tavares - New Directions,43,51,35,30.0,37,New Directions,13.0,1,2,6,8,1,up,1982-10-02
20702,Tavares,1982-10-16,Tavares - New Directions,37,43,30,30.0,35,New Directions,13.0,2,5,2,6,1,up,1982-10-02
20703,Tavares,1982-10-23,Tavares - New Directions,35,37,30,30.0,30,New Directions,13.0,3,0,5,2,0,stay,1982-10-02
20704,Tavares,1982-10-30,Tavares - New Directions,30,35,30,30.0,30,New Directions,13.0,4,0,0,5,0,stay,1982-10-02
20705,Tavares,1982-11-06,Tavares - New Directions,30,30,34,30.0,30,New Directions,13.0,5,-4,0,0,1,down,1982-10-02
20706,Tavares,1982-11-13,Tavares - New Directions,30,30,35,30.0,34,New Directions,13.0,6,-1,-4,0,1,down,1982-10-02
20707,Tavares,1982-11-20,Tavares - New Directions,34,30,47,30.0,35,New Directions,13.0,7,-12,-1,-4,1,down,1982-10-02
20708,Tavares,1982-11-27,Tavares - New Directions,35,34,47,30.0,47,New Directions,13.0,8,0,-12,-1,0,stay,1982-10-02
20709,Tavares,1982-12-04,Tavares - New Directions,47,35,46,30.0,47,New Directions,13.0,9,1,0,-12,1,up,1982-10-02
20710,Tavares,1982-12-11,Tavares - New Directions,47,47,44,30.0,46,New Directions,13.0,10,2,1,0,1,up,1982-10-02
20711,Tavares,1982-12-18,Tavares - New Directions,46,47,44,30.0,44,New Directions,13.0,11,0,2,1,0,stay,1982-10-02
20712,Tavares,1982-12-25,Tavares - New Directions,44,46,44,30.0,44,New Directions,13.0,12,0,0,2,0,stay,1982-10-02
20713,Tavares,1983-01-01,Tavares - New Directions,44,44,51,30.0,44,New Directions,13.0,13,-7,0,0,1,down,1982-10-02
20714,Gwen Guthrie,1982-10-02,Gwen Guthrie - Gwen Guthrie,51,51,36,28.0,44,Gwen Guthrie,7.0,0,8,7,0,1,up,1982-10-02
20715,Gwen Guthrie,1982-10-09,Gwen Guthrie - Gwen Guthrie,44,51,34,28.0,36,Gwen Guthrie,7.0,1,2,8,7,1,up,1982-10-02
20716,Gwen Guthrie,1982-10-16,Gwen Guthrie - Gwen Guthrie,36,44,31,28.0,34,Gwen Guthrie,7.0,2,3,2,8,1,up,1982-10-02
20717,Gwen Guthrie,1982-10-23,Gwen Guthrie - Gwen Guthrie,34,36,28,28.0,31,Gwen Guthrie,7.0,3,3,3,2,1,up,1982-10-02
20718,Gwen Guthrie,1982-10-30,Gwen Guthrie - Gwen Guthrie,31,34,28,28.0,28,Gwen Guthrie,7.0,4,0,3,3,0,stay,1982-10-02
20719,Gwen Guthrie,1982-11-06,Gwen Guthrie - Gwen Guthrie,28,31,28,28.0,28,Gwen Guthrie,7.0,5,0,0,3,0,stay,1982-10-02
20720,Gwen Guthrie,1982-11-13,Gwen Guthrie - Gwen Guthrie,28,28,44,28.0,28,Gwen Guthrie,7.0,6,-16,0,0,1,down,1982-10-02
20721,Gwen Guthrie,1982-11-20,Gwen Guthrie - Gwen Guthrie,28,28,51,28.0,44,Gwen Guthrie,7.0,7,-7,-16,0,1,down,1982-10-02
20722,Vanity 6,1982-10-02,Vanity 6 - Vanity 6,51,51,25,6.0,50,Vanity 6,31.0,0,25,1,0,1,up,1982-10-02
20723,Vanity 6,1982-10-09,Vanity 6 - Vanity 6,50,51,16,6.0,25,Vanity 6,31.0,1,9,25,1,1,up,1982-10-02
20724,Vanity 6,1982-10-16,Vanity 6 - Vanity 6,25,50,13,6.0,16,Vanity 6,31.0,2,3,9,25,1,up,1982-10-02
20725,Vanity 6,1982-10-23,Vanity 6 - Vanity 6,16,25,9,6.0,13,Vanity 6,31.0,3,4,3,9,1,up,1982-10-02
20726,Vanity 6,1982-10-30,Vanity 6 - Vanity 6,13,16,8,6.0,9,Vanity 6,31.0,4,1,4,3,1,up,1982-10-02
20727,Vanity 6,1982-11-06,Vanity 6 - Vanity 6,9,13,8,6.0,8,Vanity 6,31.0,5,0,1,4,0,stay,1982-10-02
20728,Vanity 6,1982-11-13,Vanity 6 - Vanity 6,8,9,6,6.0,8,Vanity 6,31.0,6,2,0,1,1,up,1982-10-02
20729,Vanity 6,1982-11-20,Vanity 6 - Vanity 6,8,8,6,6.0,6,Vanity 6,31.0,7,0,2,0,0,stay,1982-10-02
20730,Vanity 6,1982-11-27,Vanity 6 - Vanity 6,6,8,6,6.0,6,Vanity 6,31.0,8,0,0,2,0,stay,1982-10-02
20731,Vanity 6,1982-12-04,Vanity 6 - Vanity 6,6,6,6,6.0,6,Vanity 6,31.0,9,0,0,0,0,stay,1982-10-02
20732,Vanity 6,1982-12-11,Vanity 6 - Vanity 6,6,6,6,6.0,6,Vanity 6,31.0,10,0,0,0,0,stay,1982-10-02
20733,Vanity 6,1982-12-18,Vanity 6 - Vanity 6,6,6,6,6.0,6,Vanity 6,31.0,11,0,0,0,0,stay,1982-10-02
20734,Vanity 6,1982-12-25,Vanity 6 - Vanity 6,6,6,6,6.0,6,Vanity 6,31.0,12,0,0,0,0,stay,1982-10-02
20735,Vanity 6,1983-01-01,Vanity 6 - Vanity 6,6,6,8,6.0,6,Vanity 6,31.0,13,-2,0,0,1,down,1982-10-02
20736,Vanity 6,1983-01-08,Vanity 6 - Vanity 6,6,6,15,6.0,8,Vanity 6,31.0,14,-7,-2,0,1,down,1982-10-02
20737,Vanity 6,1983-01-15,Vanity 6 - Vanity 6,8,6,17,6.0,15,Vanity 6,31.0,15,-2,-7,-2,1,down,1982-10-02
20738,Vanity 6,1983-01-22,Vanity 6 - Vanity 6,15,8,20,6.0,17,Vanity 6,31.0,16,-3,-2,-7,1,down,1982-10-02
20739,Vanity 6,1983-01-29,Vanity 6 - Vanity 6,17,15,31,6.0,20,Vanity 6,31.0,17,-11,-3,-2,1,down,1982-10-02
20740,Vanity 6,1983-02-05,Vanity 6 - Vanity 6,20,17,32,6.0,31,Vanity 6,31.0,18,-1,-11,-3,1,down,1982-10-02
20741,Vanity 6,1983-02-12,Vanity 6 - Vanity 6,31,20,32,6.0,32,Vanity 6,31.0,19,0,-1,-11,0,stay,1982-10-02
20742,Vanity 6,1983-02-19,Vanity 6 - Vanity 6,32,31,32,6.0,32,Vanity 6,31.0,20,0,0,-1,0,stay,1982-10-02
20743,Vanity 6,1983-02-26,Vanity 6 - Vanity 6,32,32,31,6.0,32,Vanity 6,31.0,21,1,0,0,1,up,1982-10-02
20744,Vanity 6,1983-03-05,Vanity 6 - Vanity 6,32,32,30,6.0,31,Vanity 6,31.0,22,1,1,0,1,up,1982-10-02
20745,Vanity 6,1983-03-12,Vanity 6 - Vanity 6,31,32,31,6.0,30,Vanity 6,31.0,23,-1,1,1,1,down,1982-10-02
20746,Vanity 6,1983-03-19,Vanity 6 - Vanity 6,30,31,35,6.0,31,Vanity 6,31.0,24,-4,-1,1,1,down,1982-10-02
20747,Vanity 6,1983-03-26,Vanity 6 - Vanity 6,31,30,37,6.0,35,Vanity 6,31.0,25,-2,-4,-1,1,down,1982-10-02
20748,Vanity 6,1983-04-02,Vanity 6 - Vanity 6,35,31,37,6.0,37,Vanity 6,31.0,26,0,-2,-4,0,stay,1982-10-02
20749,Vanity 6,1983-04-09,Vanity 6 - Vanity 6,37,35,43,6.0,37,Vanity 6,31.0,27,-6,0,-2,1,down,1982-10-02
20750,Vanity 6,1983-04-16,Vanity 6 - Vanity 6,37,37,43,6.0,43,Vanity 6,31.0,28,0,-6,0,0,stay,1982-10-02
20751,Vanity 6,1983-04-23,Vanity 6 - Vanity 6,43,37,43,6.0,43,Vanity 6,31.0,29,0,0,-6,0,stay,1982-10-02
20752,Vanity 6,1983-04-30,Vanity 6 - Vanity 6,43,43,47,6.0,43,Vanity 6,31.0,30,-4,0,0,1,down,1982-10-02
20753,Vanity 6,1983-05-07,Vanity 6 - Vanity 6,43,43,51,6.0,47,Vanity 6,31.0,31,-4,-4,0,1,down,1982-10-02
20754,Kool & The Gang,1982-10-09,Kool & The Gang - As One,51,51,8,5.0,18,As One,24.0,0,10,33,0,1,up,1982-10-09
20755,Kool & The Gang,1982-10-16,Kool & The Gang - As One,18,51,5,5.0,8,As One,24.0,1,3,10,33,1,up,1982-10-09
20756,Kool & The Gang,1982-10-23,Kool & The Gang - As One,8,18,5,5.0,5,As One,24.0,2,0,3,10,0,stay,1982-10-09
20757,Kool & The Gang,1982-10-30,Kool & The Gang - As One,5,8,5,5.0,5,As One,24.0,3,0,0,3,0,stay,1982-10-09
20758,Kool & The Gang,1982-11-06,Kool & The Gang - As One,5,5,7,5.0,5,As One,24.0,4,-2,0,0,1,down,1982-10-09
20759,Kool & The Gang,1982-11-13,Kool & The Gang - As One,5,5,8,5.0,7,As One,24.0,5,-1,-2,0,1,down,1982-10-09
20760,Kool & The Gang,1982-11-20,Kool & The Gang - As One,7,5,8,5.0,8,As One,24.0,6,0,-1,-2,0,stay,1982-10-09
20761,Kool & The Gang,1982-11-27,Kool & The Gang - As One,8,7,10,5.0,8,As One,24.0,7,-2,0,-1,1,down,1982-10-09
20762,Kool & The Gang,1982-12-04,Kool & The Gang - As One,8,8,10,5.0,10,As One,24.0,8,0,-2,0,0,stay,1982-10-09
20763,Kool & The Gang,1982-12-11,Kool & The Gang - As One,10,8,12,5.0,10,As One,24.0,9,-2,0,-2,1,down,1982-10-09
20764,Kool & The Gang,1982-12-18,Kool & The Gang - As One,10,10,12,5.0,12,As One,24.0,10,0,-2,0,0,stay,1982-10-09
20765,Kool & The Gang,1982-12-25,Kool & The Gang - As One,12,10,12,5.0,12,As One,24.0,11,0,0,-2,0,stay,1982-10-09
20766,Kool & The Gang,1983-01-01,Kool & The Gang - As One,12,12,25,5.0,12,As One,24.0,12,-13,0,0,1,down,1982-10-09
20767,Kool & The Gang,1983-01-08,Kool & The Gang - As One,12,12,25,5.0,25,As One,24.0,13,0,-13,0,0,stay,1982-10-09
20768,Kool & The Gang,1983-01-15,Kool & The Gang - As One,25,12,30,5.0,25,As One,24.0,14,-5,0,-13,1,down,1982-10-09
20769,Kool & The Gang,1983-01-22,Kool & The Gang - As One,25,25,30,5.0,30,As One,24.0,15,0,-5,0,0,stay,1982-10-09
20770,Kool & The Gang,1983-01-29,Kool & The Gang - As One,30,25,30,5.0,30,As One,24.0,16,0,0,-5,0,stay,1982-10-09
20771,Kool & The Gang,1983-02-05,Kool & The Gang - As One,30,30,31,5.0,30,As One,24.0,17,-1,0,0,1,down,1982-10-09
20772,Kool & The Gang,1983-02-12,Kool & The Gang - As One,30,30,33,5.0,31,As One,24.0,18,-2,-1,0,1,down,1982-10-09
20773,Kool & The Gang,1983-02-19,Kool & The Gang - As One,31,30,33,5.0,33,As One,24.0,19,0,-2,-1,0,stay,1982-10-09
20774,Kool & The Gang,1983-02-26,Kool & The Gang - As One,33,31,34,5.0,33,As One,24.0,20,-1,0,-2,1,down,1982-10-09
20775,Kool & The Gang,1983-03-05,Kool & The Gang - As One,33,33,38,5.0,34,As One,24.0,21,-4,-1,0,1,down,1982-10-09
20776,Kool & The Gang,1983-03-12,Kool & The Gang - As One,34,33,45,5.0,38,As One,24.0,22,-7,-4,-1,1,down,1982-10-09
20777,Kool & The Gang,1983-03-19,Kool & The Gang - As One,38,34,47,5.0,45,As One,24.0,23,-2,-7,-4,1,down,1982-10-09
20778,Kool & The Gang,1983-03-26,Kool & The Gang - As One,45,38,51,5.0,47,As One,24.0,24,-4,-2,-7,1,down,1982-10-09
20779,Sunrize,1982-10-09,Sunrize - Sunrize,51,51,32,29.0,44,Sunrize,6.0,0,12,7,0,1,up,1982-10-09
20780,Sunrize,1982-10-16,Sunrize - Sunrize,44,51,29,29.0,32,Sunrize,6.0,1,3,12,7,1,up,1982-10-09
20781,Sunrize,1982-10-23,Sunrize - Sunrize,32,44,29,29.0,29,Sunrize,6.0,2,0,3,12,0,stay,1982-10-09
20782,Sunrize,1982-10-30,Sunrize - Sunrize,29,32,32,29.0,29,Sunrize,6.0,3,-3,0,3,1,down,1982-10-09
20783,Sunrize,1982-11-06,Sunrize - Sunrize,29,29,48,29.0,32,Sunrize,6.0,4,-16,-3,0,1,down,1982-10-09
20784,Sunrize,1982-11-13,Sunrize - Sunrize,32,29,48,29.0,48,Sunrize,6.0,5,0,-16,-3,0,stay,1982-10-09
20785,Sunrize,1982-11-20,Sunrize - Sunrize,48,32,51,29.0,48,Sunrize,6.0,6,-3,0,-16,1,down,1982-10-09
20786,Yaz,1982-10-09,Yaz - Upstairs At Eric's,51,51,44,37.0,48,Upstairs At Eric's,4.0,0,4,3,0,1,up,1982-10-09
20787,Yaz,1982-10-16,Yaz - Upstairs At Eric's,48,51,40,37.0,44,Upstairs At Eric's,4.0,1,4,4,3,1,up,1982-10-09
20788,Yaz,1982-10-23,Yaz - Upstairs At Eric's,44,48,37,37.0,40,Upstairs At Eric's,4.0,2,3,4,4,1,up,1982-10-09
20789,Yaz,1982-10-30,Yaz - Upstairs At Eric's,40,44,37,37.0,37,Upstairs At Eric's,4.0,3,0,3,4,0,stay,1982-10-09
20790,Yaz,1982-11-06,Yaz - Upstairs At Eric's,37,40,51,37.0,37,Upstairs At Eric's,4.0,4,-14,0,3,1,down,1982-10-09
20791,Bobby Nunn,1982-10-16,Bobby Nunn - Second To Nunn,51,51,27,14.0,40,Second To Nunn,19.0,0,13,11,0,1,up,1982-10-16
20792,Bobby Nunn,1982-10-23,Bobby Nunn - Second To Nunn,40,51,21,14.0,27,Second To Nunn,19.0,1,6,13,11,1,up,1982-10-16
20793,Bobby Nunn,1982-10-30,Bobby Nunn - Second To Nunn,27,40,17,14.0,21,Second To Nunn,19.0,2,4,6,13,1,up,1982-10-16
20794,Bobby Nunn,1982-11-06,Bobby Nunn - Second To Nunn,21,27,16,14.0,17,Second To Nunn,19.0,3,1,4,6,1,up,1982-10-16
20795,Bobby Nunn,1982-11-13,Bobby Nunn - Second To Nunn,17,21,14,14.0,16,Second To Nunn,19.0,4,2,1,4,1,up,1982-10-16
20796,Bobby Nunn,1982-11-20,Bobby Nunn - Second To Nunn,16,17,14,14.0,14,Second To Nunn,19.0,5,0,2,1,0,stay,1982-10-16
20797,Bobby Nunn,1982-11-27,Bobby Nunn - Second To Nunn,14,16,22,14.0,14,Second To Nunn,19.0,6,-8,0,2,1,down,1982-10-16
20798,Bobby Nunn,1982-12-04,Bobby Nunn - Second To Nunn,14,14,26,14.0,22,Second To Nunn,19.0,7,-4,-8,0,1,down,1982-10-16
20799,Bobby Nunn,1982-12-11,Bobby Nunn - Second To Nunn,22,14,38,14.0,26,Second To Nunn,19.0,8,-12,-4,-8,1,down,1982-10-16
20800,Bobby Nunn,1982-12-18,Bobby Nunn - Second To Nunn,26,22,38,14.0,38,Second To Nunn,19.0,9,0,-12,-4,0,stay,1982-10-16
20801,Bobby Nunn,1982-12-25,Bobby Nunn - Second To Nunn,38,26,38,14.0,38,Second To Nunn,19.0,10,0,0,-12,0,stay,1982-10-16
20802,Bobby Nunn,1983-01-01,Bobby Nunn - Second To Nunn,38,38,38,14.0,38,Second To Nunn,19.0,11,0,0,0,0,stay,1982-10-16
20803,Bobby Nunn,1983-01-08,Bobby Nunn - Second To Nunn,38,38,38,14.0,38,Second To Nunn,19.0,12,0,0,0,0,stay,1982-10-16
20804,Bobby Nunn,1983-01-15,Bobby Nunn - Second To Nunn,38,38,44,14.0,38,Second To Nunn,19.0,13,-6,0,0,1,down,1982-10-16
20805,Bobby Nunn,1983-01-22,Bobby Nunn - Second To Nunn,38,38,44,14.0,44,Second To Nunn,19.0,14,0,-6,0,0,stay,1982-10-16
20806,Bobby Nunn,1983-01-29,Bobby Nunn - Second To Nunn,44,38,39,14.0,44,Second To Nunn,19.0,15,5,0,-6,1,up,1982-10-16
20807,Bobby Nunn,1983-02-05,Bobby Nunn - Second To Nunn,44,44,39,14.0,39,Second To Nunn,19.0,16,0,5,0,0,stay,1982-10-16
20808,Bobby Nunn,1983-02-12,Bobby Nunn - Second To Nunn,39,44,40,14.0,39,Second To Nunn,19.0,17,-1,0,5,1,down,1982-10-16
20809,Bobby Nunn,1983-02-19,Bobby Nunn - Second To Nunn,39,39,44,14.0,40,Second To Nunn,19.0,18,-4,-1,0,1,down,1982-10-16
20810,Bobby Nunn,1983-02-26,Bobby Nunn - Second To Nunn,40,39,51,14.0,44,Second To Nunn,19.0,19,-7,-4,-1,1,down,1982-10-16
20811,Kurtis Blow,1982-10-16,Kurtis Blow - Tough,51,51,38,38.0,41,Tough,4.0,0,3,10,0,1,up,1982-10-16
20812,Kurtis Blow,1982-10-23,Kurtis Blow - Tough,41,51,38,38.0,38,Tough,4.0,1,0,3,10,0,stay,1982-10-16
20813,Kurtis Blow,1982-10-30,Kurtis Blow - Tough,38,41,38,38.0,38,Tough,4.0,2,0,0,3,0,stay,1982-10-16
20814,Kurtis Blow,1982-11-06,Kurtis Blow - Tough,38,38,47,38.0,38,Tough,4.0,3,-9,0,0,1,down,1982-10-16
20815,Kurtis Blow,1982-11-13,Kurtis Blow - Tough,38,38,51,38.0,47,Tough,4.0,4,-4,-9,0,1,down,1982-10-16
20816,Luther Vandross,1982-10-16,"Luther Vandross - Forever, For Always, For Love",51,51,15,1.0,45,"Forever, For Always, For Love",35.0,0,30,6,0,1,up,1982-10-16
20817,Luther Vandross,1982-10-23,"Luther Vandross - Forever, For Always, For Love",45,51,4,1.0,15,"Forever, For Always, For Love",35.0,1,11,30,6,1,up,1982-10-16
20818,Luther Vandross,1982-10-30,"Luther Vandross - Forever, For Always, For Love",15,45,1,1.0,4,"Forever, For Always, For Love",35.0,2,3,11,30,1,up,1982-10-16
20819,Luther Vandross,1982-11-06,"Luther Vandross - Forever, For Always, For Love",4,15,1,1.0,1,"Forever, For Always, For Love",35.0,3,0,3,11,0,stay,1982-10-16
20820,Luther Vandross,1982-11-13,"Luther Vandross - Forever, For Always, For Love",1,4,1,1.0,1,"Forever, For Always, For Love",35.0,4,0,0,3,0,stay,1982-10-16
20821,Luther Vandross,1982-11-20,"Luther Vandross - Forever, For Always, For Love",1,1,2,1.0,1,"Forever, For Always, For Love",35.0,5,-1,0,0,1,down,1982-10-16
20822,Luther Vandross,1982-11-27,"Luther Vandross - Forever, For Always, For Love",1,1,2,1.0,2,"Forever, For Always, For Love",35.0,6,0,-1,0,0,stay,1982-10-16
20823,Luther Vandross,1982-12-04,"Luther Vandross - Forever, For Always, For Love",2,1,2,1.0,2,"Forever, For Always, For Love",35.0,7,0,0,-1,0,stay,1982-10-16
20824,Luther Vandross,1982-12-11,"Luther Vandross - Forever, For Always, For Love",2,2,2,1.0,2,"Forever, For Always, For Love",35.0,8,0,0,0,0,stay,1982-10-16
20825,Luther Vandross,1982-12-18,"Luther Vandross - Forever, For Always, For Love",2,2,2,1.0,2,"Forever, For Always, For Love",35.0,9,0,0,0,0,stay,1982-10-16
20826,Luther Vandross,1982-12-25,"Luther Vandross - Forever, For Always, For Love",2,2,2,1.0,2,"Forever, For Always, For Love",35.0,10,0,0,0,0,stay,1982-10-16
20827,Luther Vandross,1983-01-01,"Luther Vandross - Forever, For Always, For Love",2,2,3,1.0,2,"Forever, For Always, For Love",35.0,11,-1,0,0,1,down,1982-10-16
20828,Luther Vandross,1983-01-08,"Luther Vandross - Forever, For Always, For Love",2,2,3,1.0,3,"Forever, For Always, For Love",35.0,12,0,-1,0,0,stay,1982-10-16
20829,Luther Vandross,1983-01-15,"Luther Vandross - Forever, For Always, For Love",3,2,5,1.0,3,"Forever, For Always, For Love",35.0,13,-2,0,-1,1,down,1982-10-16
20830,Luther Vandross,1983-01-22,"Luther Vandross - Forever, For Always, For Love",3,3,7,1.0,5,"Forever, For Always, For Love",35.0,14,-2,-2,0,1,down,1982-10-16
20831,Luther Vandross,1983-01-29,"Luther Vandross - Forever, For Always, For Love",5,3,7,1.0,7,"Forever, For Always, For Love",35.0,15,0,-2,-2,0,stay,1982-10-16
20832,Luther Vandross,1983-02-05,"Luther Vandross - Forever, For Always, For Love",7,5,6,1.0,7,"Forever, For Always, For Love",35.0,16,1,0,-2,1,up,1982-10-16
20833,Luther Vandross,1983-02-12,"Luther Vandross - Forever, For Always, For Love",7,7,4,1.0,6,"Forever, For Always, For Love",35.0,17,2,1,0,1,up,1982-10-16
20834,Luther Vandross,1983-02-19,"Luther Vandross - Forever, For Always, For Love",6,7,3,1.0,4,"Forever, For Always, For Love",35.0,18,1,2,1,1,up,1982-10-16
20835,Luther Vandross,1983-02-26,"Luther Vandross - Forever, For Always, For Love",4,6,3,1.0,3,"Forever, For Always, For Love",35.0,19,0,1,2,0,stay,1982-10-16
20836,Luther Vandross,1983-03-05,"Luther Vandross - Forever, For Always, For Love",3,4,4,1.0,3,"Forever, For Always, For Love",35.0,20,-1,0,1,1,down,1982-10-16
20837,Luther Vandross,1983-03-12,"Luther Vandross - Forever, For Always, For Love",3,3,5,1.0,4,"Forever, For Always, For Love",35.0,21,-1,-1,0,1,down,1982-10-16
20838,Luther Vandross,1983-03-19,"Luther Vandross - Forever, For Always, For Love",4,3,7,1.0,5,"Forever, For Always, For Love",35.0,22,-2,-1,-1,1,down,1982-10-16
20839,Luther Vandross,1983-03-26,"Luther Vandross - Forever, For Always, For Love",5,4,7,1.0,7,"Forever, For Always, For Love",35.0,23,0,-2,-1,0,stay,1982-10-16
20840,Luther Vandross,1983-04-02,"Luther Vandross - Forever, For Always, For Love",7,5,14,1.0,7,"Forever, For Always, For Love",35.0,24,-7,0,-2,1,down,1982-10-16
20841,Luther Vandross,1983-04-09,"Luther Vandross - Forever, For Always, For Love",7,7,13,1.0,14,"Forever, For Always, For Love",35.0,25,1,-7,0,1,up,1982-10-16
20842,Luther Vandross,1983-04-16,"Luther Vandross - Forever, For Always, For Love",14,7,13,1.0,13,"Forever, For Always, For Love",35.0,26,0,1,-7,0,stay,1982-10-16
20843,Luther Vandross,1983-04-23,"Luther Vandross - Forever, For Always, For Love",13,14,21,1.0,13,"Forever, For Always, For Love",35.0,27,-8,0,1,1,down,1982-10-16
20844,Luther Vandross,1983-04-30,"Luther Vandross - Forever, For Always, For Love",13,13,20,1.0,21,"Forever, For Always, For Love",35.0,28,1,-8,0,1,up,1982-10-16
20845,Luther Vandross,1983-05-07,"Luther Vandross - Forever, For Always, For Love",21,13,21,1.0,20,"Forever, For Always, For Love",35.0,29,-1,1,-8,1,down,1982-10-16
20846,Luther Vandross,1983-05-14,"Luther Vandross - Forever, For Always, For Love",20,21,22,1.0,21,"Forever, For Always, For Love",35.0,30,-1,-1,1,1,down,1982-10-16
20847,Luther Vandross,1983-05-21,"Luther Vandross - Forever, For Always, For Love",21,20,23,1.0,22,"Forever, For Always, For Love",35.0,31,-1,-1,-1,1,down,1982-10-16
20848,Luther Vandross,1983-05-28,"Luther Vandross - Forever, For Always, For Love",22,21,29,1.0,23,"Forever, For Always, For Love",35.0,32,-6,-1,-1,1,down,1982-10-16
20849,Luther Vandross,1983-06-04,"Luther Vandross - Forever, For Always, For Love",23,22,29,1.0,29,"Forever, For Always, For Love",35.0,33,0,-6,-1,0,stay,1982-10-16
20850,Luther Vandross,1983-06-11,"Luther Vandross - Forever, For Always, For Love",29,23,41,1.0,29,"Forever, For Always, For Love",35.0,34,-12,0,-6,1,down,1982-10-16
20851,Luther Vandross,1983-06-18,"Luther Vandross - Forever, For Always, For Love",29,29,51,1.0,41,"Forever, For Always, For Love",35.0,35,-10,-12,0,1,down,1982-10-16
20852,Alicia Myers,1982-10-16,Alicia Myers - I Fooled You This Time,51,51,37,27.0,46,I Fooled You This Time,11.0,0,9,5,0,1,up,1982-10-16
20853,Alicia Myers,1982-10-23,Alicia Myers - I Fooled You This Time,46,51,32,27.0,37,I Fooled You This Time,11.0,1,5,9,5,1,up,1982-10-16
20854,Alicia Myers,1982-10-30,Alicia Myers - I Fooled You This Time,37,46,29,27.0,32,I Fooled You This Time,11.0,2,3,5,9,1,up,1982-10-16
20855,Alicia Myers,1982-11-06,Alicia Myers - I Fooled You This Time,32,37,29,27.0,29,I Fooled You This Time,11.0,3,0,3,5,0,stay,1982-10-16
20856,Alicia Myers,1982-11-13,Alicia Myers - I Fooled You This Time,29,32,27,27.0,29,I Fooled You This Time,11.0,4,2,0,3,1,up,1982-10-16
20857,Alicia Myers,1982-11-20,Alicia Myers - I Fooled You This Time,29,29,27,27.0,27,I Fooled You This Time,11.0,5,0,2,0,0,stay,1982-10-16
20858,Alicia Myers,1982-11-27,Alicia Myers - I Fooled You This Time,27,29,28,27.0,27,I Fooled You This Time,11.0,6,-1,0,2,1,down,1982-10-16
20859,Alicia Myers,1982-12-04,Alicia Myers - I Fooled You This Time,27,27,36,27.0,28,I Fooled You This Time,11.0,7,-8,-1,0,1,down,1982-10-16
20860,Alicia Myers,1982-12-11,Alicia Myers - I Fooled You This Time,28,27,42,27.0,36,I Fooled You This Time,11.0,8,-6,-8,-1,1,down,1982-10-16
20861,Alicia Myers,1982-12-18,Alicia Myers - I Fooled You This Time,36,28,49,27.0,42,I Fooled You This Time,11.0,9,-7,-6,-8,1,down,1982-10-16
20862,Alicia Myers,1982-12-25,Alicia Myers - I Fooled You This Time,42,36,49,27.0,49,I Fooled You This Time,11.0,10,0,-7,-6,0,stay,1982-10-16
20863,Alicia Myers,1983-01-01,Alicia Myers - I Fooled You This Time,49,42,51,27.0,49,I Fooled You This Time,11.0,11,-2,0,-7,1,down,1982-10-16
20864,The Steve Miller Band,1982-10-16,The Steve Miller Band - Abracadabra,51,51,44,40.0,50,Abracadabra,3.0,0,6,1,0,1,up,1982-10-16
20865,The Steve Miller Band,1982-10-23,The Steve Miller Band - Abracadabra,50,51,40,40.0,44,Abracadabra,3.0,1,4,6,1,1,up,1982-10-16
20866,The Steve Miller Band,1982-10-30,The Steve Miller Band - Abracadabra,44,50,40,40.0,40,Abracadabra,3.0,2,0,4,6,0,stay,1982-10-16
20867,The Steve Miller Band,1982-11-06,The Steve Miller Band - Abracadabra,40,44,51,40.0,40,Abracadabra,3.0,3,-11,0,4,1,down,1982-10-16
20868,Diana Ross,1982-10-23,Diana Ross - Silk Electric,51,51,13,5.0,28,Silk Electric,22.0,0,15,23,0,1,up,1982-10-23
20869,Diana Ross,1982-10-30,Diana Ross - Silk Electric,28,51,7,5.0,13,Silk Electric,22.0,1,6,15,23,1,up,1982-10-23
20870,Diana Ross,1982-11-06,Diana Ross - Silk Electric,13,28,5,5.0,7,Silk Electric,22.0,2,2,6,15,1,up,1982-10-23
20871,Diana Ross,1982-11-13,Diana Ross - Silk Electric,7,13,5,5.0,5,Silk Electric,22.0,3,0,2,6,0,stay,1982-10-23
20872,Diana Ross,1982-11-20,Diana Ross - Silk Electric,5,7,5,5.0,5,Silk Electric,22.0,4,0,0,2,0,stay,1982-10-23
20873,Diana Ross,1982-11-27,Diana Ross - Silk Electric,5,5,5,5.0,5,Silk Electric,22.0,5,0,0,0,0,stay,1982-10-23
20874,Diana Ross,1982-12-04,Diana Ross - Silk Electric,5,5,5,5.0,5,Silk Electric,22.0,6,0,0,0,0,stay,1982-10-23
20875,Diana Ross,1982-12-11,Diana Ross - Silk Electric,5,5,5,5.0,5,Silk Electric,22.0,7,0,0,0,0,stay,1982-10-23
20876,Diana Ross,1982-12-18,Diana Ross - Silk Electric,5,5,5,5.0,5,Silk Electric,22.0,8,0,0,0,0,stay,1982-10-23
20877,Diana Ross,1982-12-25,Diana Ross - Silk Electric,5,5,5,5.0,5,Silk Electric,22.0,9,0,0,0,0,stay,1982-10-23
20878,Diana Ross,1983-01-01,Diana Ross - Silk Electric,5,5,19,5.0,5,Silk Electric,22.0,10,-14,0,0,1,down,1982-10-23
20879,Diana Ross,1983-01-08,Diana Ross - Silk Electric,5,5,20,5.0,19,Silk Electric,22.0,11,-1,-14,0,1,down,1982-10-23
20880,Diana Ross,1983-01-15,Diana Ross - Silk Electric,19,5,22,5.0,20,Silk Electric,22.0,12,-2,-1,-14,1,down,1982-10-23
20881,Diana Ross,1983-01-22,Diana Ross - Silk Electric,20,19,34,5.0,22,Silk Electric,22.0,13,-12,-2,-1,1,down,1982-10-23
20882,Diana Ross,1983-01-29,Diana Ross - Silk Electric,22,20,32,5.0,34,Silk Electric,22.0,14,2,-12,-2,1,up,1982-10-23
20883,Diana Ross,1983-02-05,Diana Ross - Silk Electric,34,22,34,5.0,32,Silk Electric,22.0,15,-2,2,-12,1,down,1982-10-23
20884,Diana Ross,1983-02-12,Diana Ross - Silk Electric,32,34,36,5.0,34,Silk Electric,22.0,16,-2,-2,2,1,down,1982-10-23
20885,Diana Ross,1983-02-19,Diana Ross - Silk Electric,34,32,41,5.0,36,Silk Electric,22.0,17,-5,-2,-2,1,down,1982-10-23
20886,Diana Ross,1983-02-26,Diana Ross - Silk Electric,36,34,41,5.0,41,Silk Electric,22.0,18,0,-5,-2,0,stay,1982-10-23
20887,Diana Ross,1983-03-05,Diana Ross - Silk Electric,41,36,44,5.0,41,Silk Electric,22.0,19,-3,0,-5,1,down,1982-10-23
20888,Diana Ross,1983-03-12,Diana Ross - Silk Electric,41,41,42,5.0,44,Silk Electric,22.0,20,2,-3,0,1,up,1982-10-23
20889,Diana Ross,1983-03-19,Diana Ross - Silk Electric,44,41,45,5.0,42,Silk Electric,22.0,21,-3,2,-3,1,down,1982-10-23
20890,Diana Ross,1983-03-26,Diana Ross - Silk Electric,42,44,51,5.0,45,Silk Electric,22.0,22,-6,-3,2,1,down,1982-10-23
20891,Grandmaster Flash & The Furious Five,1982-10-23,Grandmaster Flash & The Furious Five - The Message,51,51,22,8.0,32,The Message,23.0,0,10,19,0,1,up,1982-10-23
20892,Grandmaster Flash & The Furious Five,1982-10-30,Grandmaster Flash & The Furious Five - The Message,32,51,15,8.0,22,The Message,23.0,1,7,10,19,1,up,1982-10-23
20893,Grandmaster Flash & The Furious Five,1982-11-06,Grandmaster Flash & The Furious Five - The Message,22,32,11,8.0,15,The Message,23.0,2,4,7,10,1,up,1982-10-23
20894,Grandmaster Flash & The Furious Five,1982-11-13,Grandmaster Flash & The Furious Five - The Message,15,22,9,8.0,11,The Message,23.0,3,2,4,7,1,up,1982-10-23
20895,Grandmaster Flash & The Furious Five,1982-11-20,Grandmaster Flash & The Furious Five - The Message,11,15,9,8.0,9,The Message,23.0,4,0,2,4,0,stay,1982-10-23
20896,Grandmaster Flash & The Furious Five,1982-11-27,Grandmaster Flash & The Furious Five - The Message,9,11,8,8.0,9,The Message,23.0,5,1,0,2,1,up,1982-10-23
20897,Grandmaster Flash & The Furious Five,1982-12-04,Grandmaster Flash & The Furious Five - The Message,9,9,8,8.0,8,The Message,23.0,6,0,1,0,0,stay,1982-10-23
20898,Grandmaster Flash & The Furious Five,1982-12-11,Grandmaster Flash & The Furious Five - The Message,8,9,11,8.0,8,The Message,23.0,7,-3,0,1,1,down,1982-10-23
20899,Grandmaster Flash & The Furious Five,1982-12-18,Grandmaster Flash & The Furious Five - The Message,8,8,11,8.0,11,The Message,23.0,8,0,-3,0,0,stay,1982-10-23
20900,Grandmaster Flash & The Furious Five,1982-12-25,Grandmaster Flash & The Furious Five - The Message,11,8,11,8.0,11,The Message,23.0,9,0,0,-3,0,stay,1982-10-23
20901,Grandmaster Flash & The Furious Five,1983-01-01,Grandmaster Flash & The Furious Five - The Message,11,11,24,8.0,11,The Message,23.0,10,-13,0,0,1,down,1982-10-23
20902,Grandmaster Flash & The Furious Five,1983-01-08,Grandmaster Flash & The Furious Five - The Message,11,11,24,8.0,24,The Message,23.0,11,0,-13,0,0,stay,1982-10-23
20903,Grandmaster Flash & The Furious Five,1983-01-15,Grandmaster Flash & The Furious Five - The Message,24,11,26,8.0,24,The Message,23.0,12,-2,0,-13,1,down,1982-10-23
20904,Grandmaster Flash & The Furious Five,1983-01-22,Grandmaster Flash & The Furious Five - The Message,24,24,27,8.0,26,The Message,23.0,13,-1,-2,0,1,down,1982-10-23
20905,Grandmaster Flash & The Furious Five,1983-01-29,Grandmaster Flash & The Furious Five - The Message,26,24,27,8.0,27,The Message,23.0,14,0,-1,-2,0,stay,1982-10-23
20906,Grandmaster Flash & The Furious Five,1983-02-05,Grandmaster Flash & The Furious Five - The Message,27,26,29,8.0,27,The Message,23.0,15,-2,0,-1,1,down,1982-10-23
20907,Grandmaster Flash & The Furious Five,1983-02-12,Grandmaster Flash & The Furious Five - The Message,27,27,29,8.0,29,The Message,23.0,16,0,-2,0,0,stay,1982-10-23
20908,Grandmaster Flash & The Furious Five,1983-02-19,Grandmaster Flash & The Furious Five - The Message,29,27,29,8.0,29,The Message,23.0,17,0,0,-2,0,stay,1982-10-23
20909,Grandmaster Flash & The Furious Five,1983-02-26,Grandmaster Flash & The Furious Five - The Message,29,29,29,8.0,29,The Message,23.0,18,0,0,0,0,stay,1982-10-23
20910,Grandmaster Flash & The Furious Five,1983-03-05,Grandmaster Flash & The Furious Five - The Message,29,29,32,8.0,29,The Message,23.0,19,-3,0,0,1,down,1982-10-23
20911,Grandmaster Flash & The Furious Five,1983-03-12,Grandmaster Flash & The Furious Five - The Message,29,29,35,8.0,32,The Message,23.0,20,-3,-3,0,1,down,1982-10-23
20912,Grandmaster Flash & The Furious Five,1983-03-19,Grandmaster Flash & The Furious Five - The Message,32,29,36,8.0,35,The Message,23.0,21,-1,-3,-3,1,down,1982-10-23
20913,Grandmaster Flash & The Furious Five,1983-03-26,Grandmaster Flash & The Furious Five - The Message,35,32,46,8.0,36,The Message,23.0,22,-10,-1,-3,1,down,1982-10-23
20914,Grandmaster Flash & The Furious Five,1983-04-02,Grandmaster Flash & The Furious Five - The Message,36,35,51,8.0,46,The Message,23.0,23,-5,-10,-1,1,down,1982-10-23
20915,Carl Carlton,1982-10-23,Carl Carlton - The Bad C.c.,51,51,31,21.0,42,The Bad C.c.,7.0,0,11,9,0,1,up,1982-10-23
20916,Carl Carlton,1982-10-30,Carl Carlton - The Bad C.c.,42,51,25,21.0,31,The Bad C.c.,7.0,1,6,11,9,1,up,1982-10-23
20917,Carl Carlton,1982-11-06,Carl Carlton - The Bad C.c.,31,42,23,21.0,25,The Bad C.c.,7.0,2,2,6,11,1,up,1982-10-23
20918,Carl Carlton,1982-11-13,Carl Carlton - The Bad C.c.,25,31,21,21.0,23,The Bad C.c.,7.0,3,2,2,6,1,up,1982-10-23
20919,Carl Carlton,1982-11-20,Carl Carlton - The Bad C.c.,23,25,21,21.0,21,The Bad C.c.,7.0,4,0,2,2,0,stay,1982-10-23
20920,Carl Carlton,1982-11-27,Carl Carlton - The Bad C.c.,21,23,37,21.0,21,The Bad C.c.,7.0,5,-16,0,2,1,down,1982-10-23
20921,Carl Carlton,1982-12-04,Carl Carlton - The Bad C.c.,21,21,42,21.0,37,The Bad C.c.,7.0,6,-5,-16,0,1,down,1982-10-23
20922,Carl Carlton,1982-12-11,Carl Carlton - The Bad C.c.,37,21,51,21.0,42,The Bad C.c.,7.0,7,-9,-5,-16,1,down,1982-10-23
20923,Curtis Mayfield,1982-10-23,Curtis Mayfield - Honesty,51,51,49,49.0,49,Honesty,1.0,0,0,2,0,0,stay,1982-10-23
20924,Curtis Mayfield,1982-10-30,Curtis Mayfield - Honesty,49,51,51,49.0,49,Honesty,1.0,1,-2,0,2,1,down,1982-10-23
20925,Lionel Richie,1982-10-30,Lionel Richie - Lionel Richie,51,51,4,1.0,8,Lionel Richie,62.0,0,4,43,0,1,up,1982-10-30
20926,Lionel Richie,1982-11-06,Lionel Richie - Lionel Richie,8,51,2,1.0,4,Lionel Richie,62.0,1,2,4,43,1,up,1982-10-30
20927,Lionel Richie,1982-11-13,Lionel Richie - Lionel Richie,4,8,2,1.0,2,Lionel Richie,62.0,2,0,2,4,0,stay,1982-10-30
20928,Lionel Richie,1982-11-20,Lionel Richie - Lionel Richie,2,4,1,1.0,2,Lionel Richie,62.0,3,1,0,2,1,up,1982-10-30
20929,Lionel Richie,1982-11-27,Lionel Richie - Lionel Richie,2,2,3,1.0,1,Lionel Richie,62.0,4,-2,1,0,1,down,1982-10-30
20930,Lionel Richie,1982-12-04,Lionel Richie - Lionel Richie,1,2,3,1.0,3,Lionel Richie,62.0,5,0,-2,1,0,stay,1982-10-30
20931,Lionel Richie,1982-12-11,Lionel Richie - Lionel Richie,3,1,3,1.0,3,Lionel Richie,62.0,6,0,0,-2,0,stay,1982-10-30
20932,Lionel Richie,1982-12-18,Lionel Richie - Lionel Richie,3,3,3,1.0,3,Lionel Richie,62.0,7,0,0,0,0,stay,1982-10-30
20933,Lionel Richie,1982-12-25,Lionel Richie - Lionel Richie,3,3,3,1.0,3,Lionel Richie,62.0,8,0,0,0,0,stay,1982-10-30
20934,Lionel Richie,1983-01-01,Lionel Richie - Lionel Richie,3,3,2,1.0,3,Lionel Richie,62.0,9,1,0,0,1,up,1982-10-30
20935,Lionel Richie,1983-01-08,Lionel Richie - Lionel Richie,3,3,2,1.0,2,Lionel Richie,62.0,10,0,1,0,0,stay,1982-10-30
20936,Lionel Richie,1983-01-15,Lionel Richie - Lionel Richie,2,3,2,1.0,2,Lionel Richie,62.0,11,0,0,1,0,stay,1982-10-30
20937,Lionel Richie,1983-01-22,Lionel Richie - Lionel Richie,2,2,3,1.0,2,Lionel Richie,62.0,12,-1,0,0,1,down,1982-10-30
20938,Lionel Richie,1983-01-29,Lionel Richie - Lionel Richie,2,2,3,1.0,3,Lionel Richie,62.0,13,0,-1,0,0,stay,1982-10-30
20939,Lionel Richie,1983-02-05,Lionel Richie - Lionel Richie,3,2,2,1.0,3,Lionel Richie,62.0,14,1,0,-1,1,up,1982-10-30
20940,Lionel Richie,1983-02-12,Lionel Richie - Lionel Richie,3,3,2,1.0,2,Lionel Richie,62.0,15,0,1,0,0,stay,1982-10-30
20941,Lionel Richie,1983-02-19,Lionel Richie - Lionel Richie,2,3,2,1.0,2,Lionel Richie,62.0,16,0,0,1,0,stay,1982-10-30
20942,Lionel Richie,1983-02-26,Lionel Richie - Lionel Richie,2,2,2,1.0,2,Lionel Richie,62.0,17,0,0,0,0,stay,1982-10-30
20943,Lionel Richie,1983-03-05,Lionel Richie - Lionel Richie,2,2,2,1.0,2,Lionel Richie,62.0,18,0,0,0,0,stay,1982-10-30
20944,Lionel Richie,1983-03-12,Lionel Richie - Lionel Richie,2,2,2,1.0,2,Lionel Richie,62.0,19,0,0,0,0,stay,1982-10-30
20945,Lionel Richie,1983-03-19,Lionel Richie - Lionel Richie,2,2,2,1.0,2,Lionel Richie,62.0,20,0,0,0,0,stay,1982-10-30
20946,Lionel Richie,1983-03-26,Lionel Richie - Lionel Richie,2,2,2,1.0,2,Lionel Richie,62.0,21,0,0,0,0,stay,1982-10-30
20947,Lionel Richie,1983-04-02,Lionel Richie - Lionel Richie,2,2,2,1.0,2,Lionel Richie,62.0,22,0,0,0,0,stay,1982-10-30
20948,Lionel Richie,1983-04-09,Lionel Richie - Lionel Richie,2,2,2,1.0,2,Lionel Richie,62.0,23,0,0,0,0,stay,1982-10-30
20949,Lionel Richie,1983-04-16,Lionel Richie - Lionel Richie,2,2,2,1.0,2,Lionel Richie,62.0,24,0,0,0,0,stay,1982-10-30
20950,Lionel Richie,1983-04-23,Lionel Richie - Lionel Richie,2,2,2,1.0,2,Lionel Richie,62.0,25,0,0,0,0,stay,1982-10-30
20951,Lionel Richie,1983-04-30,Lionel Richie - Lionel Richie,2,2,2,1.0,2,Lionel Richie,62.0,26,0,0,0,0,stay,1982-10-30
20952,Lionel Richie,1983-05-07,Lionel Richie - Lionel Richie,2,2,2,1.0,2,Lionel Richie,62.0,27,0,0,0,0,stay,1982-10-30
20953,Lionel Richie,1983-05-14,Lionel Richie - Lionel Richie,2,2,4,1.0,2,Lionel Richie,62.0,28,-2,0,0,1,down,1982-10-30
20954,Lionel Richie,1983-05-21,Lionel Richie - Lionel Richie,2,2,3,1.0,4,Lionel Richie,62.0,29,1,-2,0,1,up,1982-10-30
20955,Lionel Richie,1983-05-28,Lionel Richie - Lionel Richie,4,2,3,1.0,3,Lionel Richie,62.0,30,0,1,-2,0,stay,1982-10-30
20956,Lionel Richie,1983-06-04,Lionel Richie - Lionel Richie,3,4,11,1.0,3,Lionel Richie,62.0,31,-8,0,1,1,down,1982-10-30
20957,Lionel Richie,1983-06-11,Lionel Richie - Lionel Richie,3,3,11,1.0,11,Lionel Richie,62.0,32,0,-8,0,0,stay,1982-10-30
20958,Lionel Richie,1983-06-18,Lionel Richie - Lionel Richie,11,3,9,1.0,11,Lionel Richie,62.0,33,2,0,-8,1,up,1982-10-30
20959,Lionel Richie,1983-06-25,Lionel Richie - Lionel Richie,11,11,9,1.0,9,Lionel Richie,62.0,34,0,2,0,0,stay,1982-10-30
20960,Lionel Richie,1983-07-02,Lionel Richie - Lionel Richie,9,11,13,1.0,9,Lionel Richie,62.0,35,-4,0,2,1,down,1982-10-30
20961,Lionel Richie,1983-07-09,Lionel Richie - Lionel Richie,9,9,14,1.0,13,Lionel Richie,62.0,36,-1,-4,0,1,down,1982-10-30
20962,Lionel Richie,1983-07-16,Lionel Richie - Lionel Richie,13,9,18,1.0,14,Lionel Richie,62.0,37,-4,-1,-4,1,down,1982-10-30
20963,Lionel Richie,1983-07-23,Lionel Richie - Lionel Richie,14,13,23,1.0,18,Lionel Richie,62.0,38,-5,-4,-1,1,down,1982-10-30
20964,Lionel Richie,1983-07-30,Lionel Richie - Lionel Richie,18,14,23,1.0,23,Lionel Richie,62.0,39,0,-5,-4,0,stay,1982-10-30
20965,Lionel Richie,1983-08-06,Lionel Richie - Lionel Richie,23,18,31,1.0,23,Lionel Richie,62.0,40,-8,0,-5,1,down,1982-10-30
20966,Lionel Richie,1983-08-13,Lionel Richie - Lionel Richie,23,23,39,1.0,31,Lionel Richie,62.0,41,-8,-8,0,1,down,1982-10-30
20967,Lionel Richie,1983-08-20,Lionel Richie - Lionel Richie,31,23,41,1.0,39,Lionel Richie,62.0,42,-2,-8,-8,1,down,1982-10-30
20968,Lionel Richie,1983-08-27,Lionel Richie - Lionel Richie,39,31,40,1.0,41,Lionel Richie,62.0,43,1,-2,-8,1,up,1982-10-30
20969,Lionel Richie,1983-09-03,Lionel Richie - Lionel Richie,41,39,48,1.0,40,Lionel Richie,62.0,44,-8,1,-2,1,down,1982-10-30
20970,Lionel Richie,1983-09-10,Lionel Richie - Lionel Richie,40,41,50,1.0,48,Lionel Richie,62.0,45,-2,-8,1,1,down,1982-10-30
20971,Lionel Richie,1983-09-17,Lionel Richie - Lionel Richie,48,40,50,1.0,50,Lionel Richie,62.0,46,0,-2,-8,0,stay,1982-10-30
20972,Lionel Richie,1983-09-24,Lionel Richie - Lionel Richie,50,48,49,1.0,50,Lionel Richie,62.0,47,1,0,-2,1,up,1982-10-30
20973,Lionel Richie,1983-10-01,Lionel Richie - Lionel Richie,50,50,46,1.0,49,Lionel Richie,62.0,48,3,1,0,1,up,1982-10-30
20974,Lionel Richie,1983-10-29,Lionel Richie - Lionel Richie,49,50,39,1.0,46,Lionel Richie,62.0,49,7,3,1,1,up,1982-10-30
20975,Lionel Richie,1983-11-05,Lionel Richie - Lionel Richie,46,49,26,1.0,39,Lionel Richie,62.0,50,13,7,3,1,up,1982-10-30
20976,Lionel Richie,1983-11-12,Lionel Richie - Lionel Richie,39,46,26,1.0,26,Lionel Richie,62.0,51,0,13,7,0,stay,1982-10-30
20977,Lionel Richie,1983-11-19,Lionel Richie - Lionel Richie,26,39,33,1.0,26,Lionel Richie,62.0,52,-7,0,13,1,down,1982-10-30
20978,Lionel Richie,1983-11-26,Lionel Richie - Lionel Richie,26,26,43,1.0,33,Lionel Richie,62.0,53,-10,-7,0,1,down,1982-10-30
20979,Lionel Richie,1983-12-03,Lionel Richie - Lionel Richie,33,26,43,1.0,43,Lionel Richie,62.0,54,0,-10,-7,0,stay,1982-10-30
20980,Lionel Richie,1983-12-10,Lionel Richie - Lionel Richie,43,33,42,1.0,43,Lionel Richie,62.0,55,1,0,-10,1,up,1982-10-30
20981,Lionel Richie,1983-12-17,Lionel Richie - Lionel Richie,43,43,49,1.0,42,Lionel Richie,62.0,56,-7,1,0,1,down,1982-10-30
20982,Lionel Richie,1984-01-07,Lionel Richie - Lionel Richie,42,43,47,1.0,49,Lionel Richie,62.0,57,2,-7,1,1,up,1982-10-30
20983,Lionel Richie,1984-01-14,Lionel Richie - Lionel Richie,49,42,46,1.0,47,Lionel Richie,62.0,58,1,2,-7,1,up,1982-10-30
20984,Lionel Richie,1984-01-21,Lionel Richie - Lionel Richie,47,49,46,1.0,46,Lionel Richie,62.0,59,0,1,2,0,stay,1982-10-30
20985,Lionel Richie,1984-01-28,Lionel Richie - Lionel Richie,46,47,44,1.0,46,Lionel Richie,62.0,60,2,0,1,1,up,1982-10-30
20986,Lionel Richie,1984-02-04,Lionel Richie - Lionel Richie,46,46,44,1.0,44,Lionel Richie,62.0,61,0,2,0,0,stay,1982-10-30
20987,Lionel Richie,1984-02-11,Lionel Richie - Lionel Richie,44,46,51,1.0,44,Lionel Richie,62.0,62,-7,0,2,1,down,1982-10-30
20988,Dionne Warwick,1982-10-30,Dionne Warwick - Heartbreaker,51,51,35,13.0,43,Heartbreaker,18.0,0,8,8,0,1,up,1982-10-30
20989,Dionne Warwick,1982-11-06,Dionne Warwick - Heartbreaker,43,51,30,13.0,35,Heartbreaker,18.0,1,5,8,8,1,up,1982-10-30
20990,Dionne Warwick,1982-11-13,Dionne Warwick - Heartbreaker,35,43,22,13.0,30,Heartbreaker,18.0,2,8,5,8,1,up,1982-10-30
20991,Dionne Warwick,1982-11-20,Dionne Warwick - Heartbreaker,30,35,19,13.0,22,Heartbreaker,18.0,3,3,8,5,1,up,1982-10-30
20992,Dionne Warwick,1982-11-27,Dionne Warwick - Heartbreaker,22,30,16,13.0,19,Heartbreaker,18.0,4,3,3,8,1,up,1982-10-30
20993,Dionne Warwick,1982-12-04,Dionne Warwick - Heartbreaker,19,22,13,13.0,16,Heartbreaker,18.0,5,3,3,3,1,up,1982-10-30
20994,Dionne Warwick,1982-12-11,Dionne Warwick - Heartbreaker,16,19,13,13.0,13,Heartbreaker,18.0,6,0,3,3,0,stay,1982-10-30
20995,Dionne Warwick,1982-12-18,Dionne Warwick - Heartbreaker,13,16,13,13.0,13,Heartbreaker,18.0,7,0,0,3,0,stay,1982-10-30
20996,Dionne Warwick,1982-12-25,Dionne Warwick - Heartbreaker,13,13,13,13.0,13,Heartbreaker,18.0,8,0,0,0,0,stay,1982-10-30
20997,Dionne Warwick,1983-01-01,Dionne Warwick - Heartbreaker,13,13,13,13.0,13,Heartbreaker,18.0,9,0,0,0,0,stay,1982-10-30
20998,Dionne Warwick,1983-01-08,Dionne Warwick - Heartbreaker,13,13,17,13.0,13,Heartbreaker,18.0,10,-4,0,0,1,down,1982-10-30
20999,Dionne Warwick,1983-01-15,Dionne Warwick - Heartbreaker,13,13,21,13.0,17,Heartbreaker,18.0,11,-4,-4,0,1,down,1982-10-30
21000,Dionne Warwick,1983-01-22,Dionne Warwick - Heartbreaker,17,13,28,13.0,21,Heartbreaker,18.0,12,-7,-4,-4,1,down,1982-10-30
21001,Dionne Warwick,1983-01-29,Dionne Warwick - Heartbreaker,21,17,38,13.0,28,Heartbreaker,18.0,13,-10,-7,-4,1,down,1982-10-30
21002,Dionne Warwick,1983-02-05,Dionne Warwick - Heartbreaker,28,21,38,13.0,38,Heartbreaker,18.0,14,0,-10,-7,0,stay,1982-10-30
21003,Dionne Warwick,1983-02-12,Dionne Warwick - Heartbreaker,38,28,39,13.0,38,Heartbreaker,18.0,15,-1,0,-10,1,down,1982-10-30
21004,Dionne Warwick,1983-02-19,Dionne Warwick - Heartbreaker,38,38,39,13.0,39,Heartbreaker,18.0,16,0,-1,0,0,stay,1982-10-30
21005,Dionne Warwick,1983-02-26,Dionne Warwick - Heartbreaker,39,38,50,13.0,39,Heartbreaker,18.0,17,-11,0,-1,1,down,1982-10-30
21006,Dionne Warwick,1983-03-05,Dionne Warwick - Heartbreaker,39,39,51,13.0,50,Heartbreaker,18.0,18,-1,-11,0,1,down,1982-10-30
21007,Janet Jackson,1982-11-06,Janet Jackson - Janet Jackson,51,51,21,6.0,33,Janet Jackson,39.0,0,12,18,0,1,up,1982-11-06
21008,Janet Jackson,1982-11-13,Janet Jackson - Janet Jackson,33,51,18,6.0,21,Janet Jackson,39.0,1,3,12,18,1,up,1982-11-06
21009,Janet Jackson,1982-11-20,Janet Jackson - Janet Jackson,21,33,13,6.0,18,Janet Jackson,39.0,2,5,3,12,1,up,1982-11-06
21010,Janet Jackson,1982-11-27,Janet Jackson - Janet Jackson,18,21,11,6.0,13,Janet Jackson,39.0,3,2,5,3,1,up,1982-11-06
21011,Janet Jackson,1982-12-04,Janet Jackson - Janet Jackson,13,18,11,6.0,11,Janet Jackson,39.0,4,0,2,5,0,stay,1982-11-06
21012,Janet Jackson,1982-12-11,Janet Jackson - Janet Jackson,11,13,10,6.0,11,Janet Jackson,39.0,5,1,0,2,1,up,1982-11-06
21013,Janet Jackson,1982-12-18,Janet Jackson - Janet Jackson,11,11,7,6.0,10,Janet Jackson,39.0,6,3,1,0,1,up,1982-11-06
21014,Janet Jackson,1982-12-25,Janet Jackson - Janet Jackson,10,11,7,6.0,7,Janet Jackson,39.0,7,0,3,1,0,stay,1982-11-06
21015,Janet Jackson,1983-01-01,Janet Jackson - Janet Jackson,7,10,6,6.0,7,Janet Jackson,39.0,8,1,0,3,1,up,1982-11-06
21016,Janet Jackson,1983-01-08,Janet Jackson - Janet Jackson,7,7,6,6.0,6,Janet Jackson,39.0,9,0,1,0,0,stay,1982-11-06
21017,Janet Jackson,1983-01-15,Janet Jackson - Janet Jackson,6,7,6,6.0,6,Janet Jackson,39.0,10,0,0,1,0,stay,1982-11-06
21018,Janet Jackson,1983-01-22,Janet Jackson - Janet Jackson,6,6,6,6.0,6,Janet Jackson,39.0,11,0,0,0,0,stay,1982-11-06
21019,Janet Jackson,1983-01-29,Janet Jackson - Janet Jackson,6,6,6,6.0,6,Janet Jackson,39.0,12,0,0,0,0,stay,1982-11-06
21020,Janet Jackson,1983-02-05,Janet Jackson - Janet Jackson,6,6,12,6.0,6,Janet Jackson,39.0,13,-6,0,0,1,down,1982-11-06
21021,Janet Jackson,1983-02-12,Janet Jackson - Janet Jackson,6,6,16,6.0,12,Janet Jackson,39.0,14,-4,-6,0,1,down,1982-11-06
21022,Janet Jackson,1983-02-19,Janet Jackson - Janet Jackson,12,6,19,6.0,16,Janet Jackson,39.0,15,-3,-4,-6,1,down,1982-11-06
21023,Janet Jackson,1983-02-26,Janet Jackson - Janet Jackson,16,12,19,6.0,19,Janet Jackson,39.0,16,0,-3,-4,0,stay,1982-11-06
21024,Janet Jackson,1983-03-05,Janet Jackson - Janet Jackson,19,16,21,6.0,19,Janet Jackson,39.0,17,-2,0,-3,1,down,1982-11-06
21025,Janet Jackson,1983-03-12,Janet Jackson - Janet Jackson,19,19,21,6.0,21,Janet Jackson,39.0,18,0,-2,0,0,stay,1982-11-06
21026,Janet Jackson,1983-03-19,Janet Jackson - Janet Jackson,21,19,21,6.0,21,Janet Jackson,39.0,19,0,0,-2,0,stay,1982-11-06
21027,Janet Jackson,1983-03-26,Janet Jackson - Janet Jackson,21,21,26,6.0,21,Janet Jackson,39.0,20,-5,0,0,1,down,1982-11-06
21028,Janet Jackson,1983-04-02,Janet Jackson - Janet Jackson,21,21,29,6.0,26,Janet Jackson,39.0,21,-3,-5,0,1,down,1982-11-06
21029,Janet Jackson,1983-04-09,Janet Jackson - Janet Jackson,26,21,32,6.0,29,Janet Jackson,39.0,22,-3,-3,-5,1,down,1982-11-06
21030,Janet Jackson,1983-04-16,Janet Jackson - Janet Jackson,29,26,32,6.0,32,Janet Jackson,39.0,23,0,-3,-3,0,stay,1982-11-06
21031,Janet Jackson,1983-04-23,Janet Jackson - Janet Jackson,32,29,32,6.0,32,Janet Jackson,39.0,24,0,0,-3,0,stay,1982-11-06
21032,Janet Jackson,1983-04-30,Janet Jackson - Janet Jackson,32,32,33,6.0,32,Janet Jackson,39.0,25,-1,0,0,1,down,1982-11-06
21033,Janet Jackson,1983-05-07,Janet Jackson - Janet Jackson,32,32,33,6.0,33,Janet Jackson,39.0,26,0,-1,0,0,stay,1982-11-06
21034,Janet Jackson,1983-05-14,Janet Jackson - Janet Jackson,33,32,38,6.0,33,Janet Jackson,39.0,27,-5,0,-1,1,down,1982-11-06
21035,Janet Jackson,1983-05-21,Janet Jackson - Janet Jackson,33,33,38,6.0,38,Janet Jackson,39.0,28,0,-5,0,0,stay,1982-11-06
21036,Janet Jackson,1983-05-28,Janet Jackson - Janet Jackson,38,33,39,6.0,38,Janet Jackson,39.0,29,-1,0,-5,1,down,1982-11-06
21037,Janet Jackson,1983-06-04,Janet Jackson - Janet Jackson,38,38,35,6.0,39,Janet Jackson,39.0,30,4,-1,0,1,up,1982-11-06
21038,Janet Jackson,1983-06-11,Janet Jackson - Janet Jackson,39,38,34,6.0,35,Janet Jackson,39.0,31,1,4,-1,1,up,1982-11-06
21039,Janet Jackson,1983-06-18,Janet Jackson - Janet Jackson,35,39,48,6.0,34,Janet Jackson,39.0,32,-14,1,4,1,down,1982-11-06
21040,Janet Jackson,1983-06-25,Janet Jackson - Janet Jackson,34,35,46,6.0,48,Janet Jackson,39.0,33,2,-14,1,1,up,1982-11-06
21041,Janet Jackson,1983-07-02,Janet Jackson - Janet Jackson,48,34,35,6.0,46,Janet Jackson,39.0,34,11,2,-14,1,up,1982-11-06
21042,Janet Jackson,1983-07-09,Janet Jackson - Janet Jackson,46,48,35,6.0,35,Janet Jackson,39.0,35,0,11,2,0,stay,1982-11-06
21043,Janet Jackson,1983-07-16,Janet Jackson - Janet Jackson,35,46,34,6.0,35,Janet Jackson,39.0,36,1,0,11,1,up,1982-11-06
21044,Janet Jackson,1983-07-23,Janet Jackson - Janet Jackson,35,35,34,6.0,34,Janet Jackson,39.0,37,0,1,0,0,stay,1982-11-06
21045,Janet Jackson,1983-07-30,Janet Jackson - Janet Jackson,34,35,42,6.0,34,Janet Jackson,39.0,38,-8,0,1,1,down,1982-11-06
21046,Janet Jackson,1983-08-06,Janet Jackson - Janet Jackson,34,34,51,6.0,42,Janet Jackson,39.0,39,-9,-8,0,1,down,1982-11-06
21047,One Way,1982-11-06,One Way - Wild Night,51,51,31,16.0,42,Wild Night,18.0,0,11,9,0,1,up,1982-11-06
21048,One Way,1982-11-13,One Way - Wild Night,42,51,28,16.0,31,Wild Night,18.0,1,3,11,9,1,up,1982-11-06
21049,One Way,1982-11-20,One Way - Wild Night,31,42,26,16.0,28,Wild Night,18.0,2,2,3,11,1,up,1982-11-06
21050,One Way,1982-11-27,One Way - Wild Night,28,31,24,16.0,26,Wild Night,18.0,3,2,2,3,1,up,1982-11-06
21051,One Way,1982-12-04,One Way - Wild Night,26,28,22,16.0,24,Wild Night,18.0,4,2,2,2,1,up,1982-11-06
21052,One Way,1982-12-11,One Way - Wild Night,24,26,16,16.0,22,Wild Night,18.0,5,6,2,2,1,up,1982-11-06
21053,One Way,1982-12-18,One Way - Wild Night,22,24,16,16.0,16,Wild Night,18.0,6,0,6,2,0,stay,1982-11-06
21054,One Way,1982-12-25,One Way - Wild Night,16,22,16,16.0,16,Wild Night,18.0,7,0,0,6,0,stay,1982-11-06
21055,One Way,1983-01-01,One Way - Wild Night,16,16,16,16.0,16,Wild Night,18.0,8,0,0,0,0,stay,1982-11-06
21056,One Way,1983-01-08,One Way - Wild Night,16,16,33,16.0,16,Wild Night,18.0,9,-17,0,0,1,down,1982-11-06
21057,One Way,1983-01-15,One Way - Wild Night,16,16,42,16.0,33,Wild Night,18.0,10,-9,-17,0,1,down,1982-11-06
21058,One Way,1983-01-22,One Way - Wild Night,33,16,43,16.0,42,Wild Night,18.0,11,-1,-9,-17,1,down,1982-11-06
21059,One Way,1983-01-29,One Way - Wild Night,42,33,50,16.0,43,Wild Night,18.0,12,-7,-1,-9,1,down,1982-11-06
21060,One Way,1983-02-05,One Way - Wild Night,43,42,48,16.0,50,Wild Night,18.0,13,2,-7,-1,1,up,1982-11-06
21061,One Way,1983-02-12,One Way - Wild Night,50,43,47,16.0,48,Wild Night,18.0,14,1,2,-7,1,up,1982-11-06
21062,One Way,1983-02-19,One Way - Wild Night,48,50,47,16.0,47,Wild Night,18.0,15,0,1,2,0,stay,1982-11-06
21063,One Way,1983-02-26,One Way - Wild Night,47,48,47,16.0,47,Wild Night,18.0,16,0,0,1,0,stay,1982-11-06
21064,One Way,1983-03-05,One Way - Wild Night,47,47,47,16.0,47,Wild Night,18.0,17,0,0,0,0,stay,1982-11-06
21065,One Way,1983-03-12,One Way - Wild Night,47,47,51,16.0,47,Wild Night,18.0,18,-4,0,0,1,down,1982-11-06
21066,Johnnie Taylor,1982-11-06,Johnnie Taylor - Just Ain't Good Enough,51,51,36,19.0,50,Just Ain't Good Enough,22.0,0,14,1,0,1,up,1982-11-06
21067,Johnnie Taylor,1982-11-13,Johnnie Taylor - Just Ain't Good Enough,50,51,25,19.0,36,Just Ain't Good Enough,22.0,1,11,14,1,1,up,1982-11-06
21068,Johnnie Taylor,1982-11-20,Johnnie Taylor - Just Ain't Good Enough,36,50,23,19.0,25,Just Ain't Good Enough,22.0,2,2,11,14,1,up,1982-11-06
21069,Johnnie Taylor,1982-11-27,Johnnie Taylor - Just Ain't Good Enough,25,36,21,19.0,23,Just Ain't Good Enough,22.0,3,2,2,11,1,up,1982-11-06
21070,Johnnie Taylor,1982-12-04,Johnnie Taylor - Just Ain't Good Enough,23,25,21,19.0,21,Just Ain't Good Enough,22.0,4,0,2,2,0,stay,1982-11-06
21071,Johnnie Taylor,1982-12-11,Johnnie Taylor - Just Ain't Good Enough,21,23,19,19.0,21,Just Ain't Good Enough,22.0,5,2,0,2,1,up,1982-11-06
21072,Johnnie Taylor,1982-12-18,Johnnie Taylor - Just Ain't Good Enough,21,21,19,19.0,19,Just Ain't Good Enough,22.0,6,0,2,0,0,stay,1982-11-06
21073,Johnnie Taylor,1982-12-25,Johnnie Taylor - Just Ain't Good Enough,19,21,19,19.0,19,Just Ain't Good Enough,22.0,7,0,0,2,0,stay,1982-11-06
21074,Johnnie Taylor,1983-01-01,Johnnie Taylor - Just Ain't Good Enough,19,19,29,19.0,19,Just Ain't Good Enough,22.0,8,-10,0,0,1,down,1982-11-06
21075,Johnnie Taylor,1983-01-08,Johnnie Taylor - Just Ain't Good Enough,19,19,29,19.0,29,Just Ain't Good Enough,22.0,9,0,-10,0,0,stay,1982-11-06
21076,Johnnie Taylor,1983-01-15,Johnnie Taylor - Just Ain't Good Enough,29,19,38,19.0,29,Just Ain't Good Enough,22.0,10,-9,0,-10,1,down,1982-11-06
21077,Johnnie Taylor,1983-01-22,Johnnie Taylor - Just Ain't Good Enough,29,29,39,19.0,38,Just Ain't Good Enough,22.0,11,-1,-9,0,1,down,1982-11-06
21078,Johnnie Taylor,1983-01-29,Johnnie Taylor - Just Ain't Good Enough,38,29,48,19.0,39,Just Ain't Good Enough,22.0,12,-9,-1,-9,1,down,1982-11-06
21079,Johnnie Taylor,1983-02-05,Johnnie Taylor - Just Ain't Good Enough,39,38,47,19.0,48,Just Ain't Good Enough,22.0,13,1,-9,-1,1,up,1982-11-06
21080,Johnnie Taylor,1983-02-12,Johnnie Taylor - Just Ain't Good Enough,48,39,44,19.0,47,Just Ain't Good Enough,22.0,14,3,1,-9,1,up,1982-11-06
21081,Johnnie Taylor,1983-02-19,Johnnie Taylor - Just Ain't Good Enough,47,48,40,19.0,44,Just Ain't Good Enough,22.0,15,4,3,1,1,up,1982-11-06
21082,Johnnie Taylor,1983-02-26,Johnnie Taylor - Just Ain't Good Enough,44,47,40,19.0,40,Just Ain't Good Enough,22.0,16,0,4,3,0,stay,1982-11-06
21083,Johnnie Taylor,1983-03-05,Johnnie Taylor - Just Ain't Good Enough,40,44,39,19.0,40,Just Ain't Good Enough,22.0,17,1,0,4,1,up,1982-11-06
21084,Johnnie Taylor,1983-03-12,Johnnie Taylor - Just Ain't Good Enough,40,40,38,19.0,39,Just Ain't Good Enough,22.0,18,1,1,0,1,up,1982-11-06
21085,Johnnie Taylor,1983-03-19,Johnnie Taylor - Just Ain't Good Enough,39,40,38,19.0,38,Just Ain't Good Enough,22.0,19,0,1,1,0,stay,1982-11-06
21086,Johnnie Taylor,1983-03-26,Johnnie Taylor - Just Ain't Good Enough,38,39,41,19.0,38,Just Ain't Good Enough,22.0,20,-3,0,1,1,down,1982-11-06
21087,Johnnie Taylor,1983-04-02,Johnnie Taylor - Just Ain't Good Enough,38,38,40,19.0,41,Just Ain't Good Enough,22.0,21,1,-3,0,1,up,1982-11-06
21088,Johnnie Taylor,1983-04-09,Johnnie Taylor - Just Ain't Good Enough,41,38,51,19.0,40,Just Ain't Good Enough,22.0,22,-11,1,-3,1,down,1982-11-06
21089,Melba Moore,1982-11-13,Melba Moore - The Other Side Of The Rainbow,51,51,23,18.0,32,The Other Side Of The Rainbow,26.0,0,9,19,0,1,up,1982-11-13
21090,Melba Moore,1982-11-20,Melba Moore - The Other Side Of The Rainbow,32,51,18,18.0,23,The Other Side Of The Rainbow,26.0,1,5,9,19,1,up,1982-11-13
21091,Melba Moore,1982-11-27,Melba Moore - The Other Side Of The Rainbow,23,32,18,18.0,18,The Other Side Of The Rainbow,26.0,2,0,5,9,0,stay,1982-11-13
21092,Melba Moore,1982-12-04,Melba Moore - The Other Side Of The Rainbow,18,23,18,18.0,18,The Other Side Of The Rainbow,26.0,3,0,0,5,0,stay,1982-11-13
21093,Melba Moore,1982-12-11,Melba Moore - The Other Side Of The Rainbow,18,18,26,18.0,18,The Other Side Of The Rainbow,26.0,4,-8,0,0,1,down,1982-11-13
21094,Melba Moore,1982-12-18,Melba Moore - The Other Side Of The Rainbow,18,18,37,18.0,26,The Other Side Of The Rainbow,26.0,5,-11,-8,0,1,down,1982-11-13
21095,Melba Moore,1982-12-25,Melba Moore - The Other Side Of The Rainbow,26,18,37,18.0,37,The Other Side Of The Rainbow,26.0,6,0,-11,-8,0,stay,1982-11-13
21096,Melba Moore,1983-01-01,Melba Moore - The Other Side Of The Rainbow,37,26,35,18.0,37,The Other Side Of The Rainbow,26.0,7,2,0,-11,1,up,1982-11-13
21097,Melba Moore,1983-01-08,Melba Moore - The Other Side Of The Rainbow,37,37,28,18.0,35,The Other Side Of The Rainbow,26.0,8,7,2,0,1,up,1982-11-13
21098,Melba Moore,1983-01-15,Melba Moore - The Other Side Of The Rainbow,35,37,28,18.0,28,The Other Side Of The Rainbow,26.0,9,0,7,2,0,stay,1982-11-13
21099,Melba Moore,1983-01-22,Melba Moore - The Other Side Of The Rainbow,28,35,26,18.0,28,The Other Side Of The Rainbow,26.0,10,2,0,7,1,up,1982-11-13
21100,Melba Moore,1983-01-29,Melba Moore - The Other Side Of The Rainbow,28,28,25,18.0,26,The Other Side Of The Rainbow,26.0,11,1,2,0,1,up,1982-11-13
21101,Melba Moore,1983-02-05,Melba Moore - The Other Side Of The Rainbow,26,28,22,18.0,25,The Other Side Of The Rainbow,26.0,12,3,1,2,1,up,1982-11-13
21102,Melba Moore,1983-02-12,Melba Moore - The Other Side Of The Rainbow,25,26,22,18.0,22,The Other Side Of The Rainbow,26.0,13,0,3,1,0,stay,1982-11-13
21103,Melba Moore,1983-02-19,Melba Moore - The Other Side Of The Rainbow,22,25,23,18.0,22,The Other Side Of The Rainbow,26.0,14,-1,0,3,1,down,1982-11-13
21104,Melba Moore,1983-02-26,Melba Moore - The Other Side Of The Rainbow,22,22,24,18.0,23,The Other Side Of The Rainbow,26.0,15,-1,-1,0,1,down,1982-11-13
21105,Melba Moore,1983-03-05,Melba Moore - The Other Side Of The Rainbow,23,22,26,18.0,24,The Other Side Of The Rainbow,26.0,16,-2,-1,-1,1,down,1982-11-13
21106,Melba Moore,1983-03-12,Melba Moore - The Other Side Of The Rainbow,24,23,25,18.0,26,The Other Side Of The Rainbow,26.0,17,1,-2,-1,1,up,1982-11-13
21107,Melba Moore,1983-03-19,Melba Moore - The Other Side Of The Rainbow,26,24,26,18.0,25,The Other Side Of The Rainbow,26.0,18,-1,1,-2,1,down,1982-11-13
21108,Melba Moore,1983-03-26,Melba Moore - The Other Side Of The Rainbow,25,26,31,18.0,26,The Other Side Of The Rainbow,26.0,19,-5,-1,1,1,down,1982-11-13
21109,Melba Moore,1983-04-02,Melba Moore - The Other Side Of The Rainbow,26,25,31,18.0,31,The Other Side Of The Rainbow,26.0,20,0,-5,-1,0,stay,1982-11-13
21110,Melba Moore,1983-04-09,Melba Moore - The Other Side Of The Rainbow,31,26,35,18.0,31,The Other Side Of The Rainbow,26.0,21,-4,0,-5,1,down,1982-11-13
21111,Melba Moore,1983-04-16,Melba Moore - The Other Side Of The Rainbow,31,31,35,18.0,35,The Other Side Of The Rainbow,26.0,22,0,-4,0,0,stay,1982-11-13
21112,Melba Moore,1983-04-23,Melba Moore - The Other Side Of The Rainbow,35,31,40,18.0,35,The Other Side Of The Rainbow,26.0,23,-5,0,-4,1,down,1982-11-13
21113,Melba Moore,1983-04-30,Melba Moore - The Other Side Of The Rainbow,35,35,39,18.0,40,The Other Side Of The Rainbow,26.0,24,1,-5,0,1,up,1982-11-13
21114,Melba Moore,1983-05-07,Melba Moore - The Other Side Of The Rainbow,40,35,50,18.0,39,The Other Side Of The Rainbow,26.0,25,-11,1,-5,1,down,1982-11-13
21115,Melba Moore,1983-05-14,Melba Moore - The Other Side Of The Rainbow,39,40,51,18.0,50,The Other Side Of The Rainbow,26.0,26,-1,-11,1,1,down,1982-11-13
21116,Donald Fagen,1982-11-13,Donald Fagen - The Nightfly,51,51,34,24.0,41,The Nightfly,10.0,0,7,10,0,1,up,1982-11-13
21117,Donald Fagen,1982-11-20,Donald Fagen - The Nightfly,41,51,28,24.0,34,The Nightfly,10.0,1,6,7,10,1,up,1982-11-13
21118,Donald Fagen,1982-11-27,Donald Fagen - The Nightfly,34,41,26,24.0,28,The Nightfly,10.0,2,2,6,7,1,up,1982-11-13
21119,Donald Fagen,1982-12-04,Donald Fagen - The Nightfly,28,34,24,24.0,26,The Nightfly,10.0,3,2,2,6,1,up,1982-11-13
21120,Donald Fagen,1982-12-11,Donald Fagen - The Nightfly,26,28,24,24.0,24,The Nightfly,10.0,4,0,2,2,0,stay,1982-11-13
21121,Donald Fagen,1982-12-18,Donald Fagen - The Nightfly,24,26,36,24.0,24,The Nightfly,10.0,5,-12,0,2,1,down,1982-11-13
21122,Donald Fagen,1982-12-25,Donald Fagen - The Nightfly,24,24,36,24.0,36,The Nightfly,10.0,6,0,-12,0,0,stay,1982-11-13
21123,Donald Fagen,1983-01-01,Donald Fagen - The Nightfly,36,24,39,24.0,36,The Nightfly,10.0,7,-3,0,-12,1,down,1982-11-13
21124,Donald Fagen,1983-01-08,Donald Fagen - The Nightfly,36,36,50,24.0,39,The Nightfly,10.0,8,-11,-3,0,1,down,1982-11-13
21125,Donald Fagen,1983-01-15,Donald Fagen - The Nightfly,39,36,50,24.0,50,The Nightfly,10.0,9,0,-11,-3,0,stay,1982-11-13
21126,Donald Fagen,1983-01-22,Donald Fagen - The Nightfly,50,39,51,24.0,50,The Nightfly,10.0,10,-1,0,-11,1,down,1982-11-13
21127,Bill Summers & Summers Heat,1982-11-13,Bill Summers & Summers Heat - Seventeen,51,51,38,31.0,43,Seventeen,5.0,0,5,8,0,1,up,1982-11-13
21128,Bill Summers & Summers Heat,1982-11-20,Bill Summers & Summers Heat - Seventeen,43,51,32,31.0,38,Seventeen,5.0,1,6,5,8,1,up,1982-11-13
21129,Bill Summers & Summers Heat,1982-11-27,Bill Summers & Summers Heat - Seventeen,38,43,32,31.0,32,Seventeen,5.0,2,0,6,5,0,stay,1982-11-13
21130,Bill Summers & Summers Heat,1982-12-04,Bill Summers & Summers Heat - Seventeen,32,38,31,31.0,32,Seventeen,5.0,3,1,0,6,1,up,1982-11-13
21131,Bill Summers & Summers Heat,1982-12-11,Bill Summers & Summers Heat - Seventeen,32,32,47,31.0,31,Seventeen,5.0,4,-16,1,0,1,down,1982-11-13
21132,Bill Summers & Summers Heat,1982-12-18,Bill Summers & Summers Heat - Seventeen,31,32,51,31.0,47,Seventeen,5.0,5,-4,-16,1,1,down,1982-11-13
21133,Various Artists,1982-11-13,Various Artists - Casino Lights,51,51,41,32.0,45,Casino Lights,12.0,0,4,6,0,1,up,1982-11-13
21134,Various Artists,1982-11-20,Various Artists - Casino Lights,45,51,38,32.0,41,Casino Lights,12.0,1,3,4,6,1,up,1982-11-13
21135,Various Artists,1982-11-27,Various Artists - Casino Lights,41,45,35,32.0,38,Casino Lights,12.0,2,3,3,4,1,up,1982-11-13
21136,Various Artists,1982-12-04,Various Artists - Casino Lights,38,41,32,32.0,35,Casino Lights,12.0,3,3,3,3,1,up,1982-11-13
21137,Various Artists,1982-12-11,Various Artists - Casino Lights,35,38,32,32.0,32,Casino Lights,12.0,4,0,3,3,0,stay,1982-11-13
21138,Various Artists,1982-12-18,Various Artists - Casino Lights,32,35,39,32.0,32,Casino Lights,12.0,5,-7,0,3,1,down,1982-11-13
21139,Various Artists,1982-12-25,Various Artists - Casino Lights,32,32,39,32.0,39,Casino Lights,12.0,6,0,-7,0,0,stay,1982-11-13
21140,Various Artists,1983-01-01,Various Artists - Casino Lights,39,32,43,32.0,39,Casino Lights,12.0,7,-4,0,-7,1,down,1982-11-13
21141,Various Artists,1983-01-08,Various Artists - Casino Lights,39,39,44,32.0,43,Casino Lights,12.0,8,-1,-4,0,1,down,1982-11-13
21142,Various Artists,1983-01-15,Various Artists - Casino Lights,43,39,48,32.0,44,Casino Lights,12.0,9,-4,-1,-4,1,down,1982-11-13
21143,Various Artists,1983-01-22,Various Artists - Casino Lights,44,43,48,32.0,48,Casino Lights,12.0,10,0,-4,-1,0,stay,1982-11-13
21144,Various Artists,1983-01-29,Various Artists - Casino Lights,48,44,49,32.0,48,Casino Lights,12.0,11,-1,0,-4,1,down,1982-11-13
21145,Various Artists,1983-02-05,Various Artists - Casino Lights,48,48,51,32.0,49,Casino Lights,12.0,12,-2,-1,0,1,down,1982-11-13
21146,Debarge,1982-11-13,Debarge - All This Love,51,51,46,3.0,49,All This Love,45.0,0,3,2,0,1,up,1982-11-13
21147,Debarge,1982-11-20,Debarge - All This Love,49,51,42,3.0,46,All This Love,45.0,1,4,3,2,1,up,1982-11-13
21148,Debarge,1982-11-27,Debarge - All This Love,46,49,41,3.0,42,All This Love,45.0,2,1,4,3,1,up,1982-11-13
21149,Debarge,1982-12-04,Debarge - All This Love,42,46,40,3.0,41,All This Love,45.0,3,1,1,4,1,up,1982-11-13
21150,Debarge,1982-12-11,Debarge - All This Love,41,42,40,3.0,40,All This Love,45.0,4,0,1,1,0,stay,1982-11-13
21151,Debarge,1982-12-18,Debarge - All This Love,40,41,48,3.0,40,All This Love,45.0,5,-8,0,1,1,down,1982-11-13
21152,Debarge,1982-12-25,Debarge - All This Love,40,40,48,3.0,48,All This Love,45.0,6,0,-8,0,0,stay,1982-11-13
21153,Debarge,1983-01-01,Debarge - All This Love,48,40,46,3.0,48,All This Love,45.0,7,2,0,-8,1,up,1982-11-13
21154,Debarge,1983-01-08,Debarge - All This Love,48,48,42,3.0,46,All This Love,45.0,8,4,2,0,1,up,1982-11-13
21155,Debarge,1983-01-15,Debarge - All This Love,46,48,36,3.0,42,All This Love,45.0,9,6,4,2,1,up,1982-11-13
21156,Debarge,1983-01-22,Debarge - All This Love,42,46,25,3.0,36,All This Love,45.0,10,11,6,4,1,up,1982-11-13
21157,Debarge,1983-01-29,Debarge - All This Love,36,42,18,3.0,25,All This Love,45.0,11,7,11,6,1,up,1982-11-13
21158,Debarge,1983-02-05,Debarge - All This Love,25,36,7,3.0,18,All This Love,45.0,12,11,7,11,1,up,1982-11-13
21159,Debarge,1983-02-12,Debarge - All This Love,18,25,6,3.0,7,All This Love,45.0,13,1,11,7,1,up,1982-11-13
21160,Debarge,1983-02-19,Debarge - All This Love,7,18,4,3.0,6,All This Love,45.0,14,2,1,11,1,up,1982-11-13
21161,Debarge,1983-02-26,Debarge - All This Love,6,7,4,3.0,4,All This Love,45.0,15,0,2,1,0,stay,1982-11-13
21162,Debarge,1983-03-05,Debarge - All This Love,4,6,3,3.0,4,All This Love,45.0,16,1,0,2,1,up,1982-11-13
21163,Debarge,1983-03-12,Debarge - All This Love,4,4,3,3.0,3,All This Love,45.0,17,0,1,0,0,stay,1982-11-13
21164,Debarge,1983-03-19,Debarge - All This Love,3,4,3,3.0,3,All This Love,45.0,18,0,0,1,0,stay,1982-11-13
21165,Debarge,1983-03-26,Debarge - All This Love,3,3,3,3.0,3,All This Love,45.0,19,0,0,0,0,stay,1982-11-13
21166,Debarge,1983-04-02,Debarge - All This Love,3,3,5,3.0,3,All This Love,45.0,20,-2,0,0,1,down,1982-11-13
21167,Debarge,1983-04-09,Debarge - All This Love,3,3,5,3.0,5,All This Love,45.0,21,0,-2,0,0,stay,1982-11-13
21168,Debarge,1983-04-16,Debarge - All This Love,5,3,5,3.0,5,All This Love,45.0,22,0,0,-2,0,stay,1982-11-13
21169,Debarge,1983-04-23,Debarge - All This Love,5,5,6,3.0,5,All This Love,45.0,23,-1,0,0,1,down,1982-11-13
21170,Debarge,1983-04-30,Debarge - All This Love,5,5,6,3.0,6,All This Love,45.0,24,0,-1,0,0,stay,1982-11-13
21171,Debarge,1983-05-07,Debarge - All This Love,6,5,7,3.0,6,All This Love,45.0,25,-1,0,-1,1,down,1982-11-13
21172,Debarge,1983-05-14,Debarge - All This Love,6,6,6,3.0,7,All This Love,45.0,26,1,-1,0,1,up,1982-11-13
21173,Debarge,1983-05-21,Debarge - All This Love,7,6,6,3.0,6,All This Love,45.0,27,0,1,-1,0,stay,1982-11-13
21174,Debarge,1983-05-28,Debarge - All This Love,6,7,5,3.0,6,All This Love,45.0,28,1,0,1,1,up,1982-11-13
21175,Debarge,1983-06-04,Debarge - All This Love,6,6,5,3.0,5,All This Love,45.0,29,0,1,0,0,stay,1982-11-13
21176,Debarge,1983-06-11,Debarge - All This Love,5,6,7,3.0,5,All This Love,45.0,30,-2,0,1,1,down,1982-11-13
21177,Debarge,1983-06-18,Debarge - All This Love,5,5,11,3.0,7,All This Love,45.0,31,-4,-2,0,1,down,1982-11-13
21178,Debarge,1983-06-25,Debarge - All This Love,7,5,10,3.0,11,All This Love,45.0,32,1,-4,-2,1,up,1982-11-13
21179,Debarge,1983-07-02,Debarge - All This Love,11,7,11,3.0,10,All This Love,45.0,33,-1,1,-4,1,down,1982-11-13
21180,Debarge,1983-07-09,Debarge - All This Love,10,11,11,3.0,11,All This Love,45.0,34,0,-1,1,0,stay,1982-11-13
21181,Debarge,1983-07-16,Debarge - All This Love,11,10,15,3.0,11,All This Love,45.0,35,-4,0,-1,1,down,1982-11-13
21182,Debarge,1983-07-23,Debarge - All This Love,11,11,18,3.0,15,All This Love,45.0,36,-3,-4,0,1,down,1982-11-13
21183,Debarge,1983-07-30,Debarge - All This Love,15,11,20,3.0,18,All This Love,45.0,37,-2,-3,-4,1,down,1982-11-13
21184,Debarge,1983-08-06,Debarge - All This Love,18,15,22,3.0,20,All This Love,45.0,38,-2,-2,-3,1,down,1982-11-13
21185,Debarge,1983-08-13,Debarge - All This Love,20,18,24,3.0,22,All This Love,45.0,39,-2,-2,-2,1,down,1982-11-13
21186,Debarge,1983-08-20,Debarge - All This Love,22,20,25,3.0,24,All This Love,45.0,40,-1,-2,-2,1,down,1982-11-13
21187,Debarge,1983-08-27,Debarge - All This Love,24,22,25,3.0,25,All This Love,45.0,41,0,-1,-2,0,stay,1982-11-13
21188,Debarge,1983-09-03,Debarge - All This Love,25,24,28,3.0,25,All This Love,45.0,42,-3,0,-1,1,down,1982-11-13
21189,Debarge,1983-09-10,Debarge - All This Love,25,25,39,3.0,28,All This Love,45.0,43,-11,-3,0,1,down,1982-11-13
21190,Debarge,1983-09-17,Debarge - All This Love,28,25,40,3.0,39,All This Love,45.0,44,-1,-11,-3,1,down,1982-11-13
21191,Debarge,1983-09-24,Debarge - All This Love,39,28,51,3.0,40,All This Love,45.0,45,-11,-1,-11,1,down,1982-11-13
21192,Marvin Gaye,1982-11-20,Marvin Gaye - Midnight Love,51,51,3,1.0,15,Midnight Love,30.0,0,12,36,0,1,up,1982-11-20
21193,Marvin Gaye,1982-11-27,Marvin Gaye - Midnight Love,15,51,1,1.0,3,Midnight Love,30.0,1,2,12,36,1,up,1982-11-20
21194,Marvin Gaye,1982-12-04,Marvin Gaye - Midnight Love,3,15,1,1.0,1,Midnight Love,30.0,2,0,2,12,0,stay,1982-11-20
21195,Marvin Gaye,1982-12-11,Marvin Gaye - Midnight Love,1,3,1,1.0,1,Midnight Love,30.0,3,0,0,2,0,stay,1982-11-20
21196,Marvin Gaye,1982-12-18,Marvin Gaye - Midnight Love,1,1,1,1.0,1,Midnight Love,30.0,4,0,0,0,0,stay,1982-11-20
21197,Marvin Gaye,1982-12-25,Marvin Gaye - Midnight Love,1,1,1,1.0,1,Midnight Love,30.0,5,0,0,0,0,stay,1982-11-20
21198,Marvin Gaye,1983-01-01,Marvin Gaye - Midnight Love,1,1,1,1.0,1,Midnight Love,30.0,6,0,0,0,0,stay,1982-11-20
21199,Marvin Gaye,1983-01-08,Marvin Gaye - Midnight Love,1,1,1,1.0,1,Midnight Love,30.0,7,0,0,0,0,stay,1982-11-20
21200,Marvin Gaye,1983-01-15,Marvin Gaye - Midnight Love,1,1,1,1.0,1,Midnight Love,30.0,8,0,0,0,0,stay,1982-11-20
21201,Marvin Gaye,1983-01-22,Marvin Gaye - Midnight Love,1,1,2,1.0,1,Midnight Love,30.0,9,-1,0,0,1,down,1982-11-20
21202,Marvin Gaye,1983-01-29,Marvin Gaye - Midnight Love,1,1,2,1.0,2,Midnight Love,30.0,10,0,-1,0,0,stay,1982-11-20
21203,Marvin Gaye,1983-02-05,Marvin Gaye - Midnight Love,2,1,3,1.0,2,Midnight Love,30.0,11,-1,0,-1,1,down,1982-11-20
21204,Marvin Gaye,1983-02-12,Marvin Gaye - Midnight Love,2,2,3,1.0,3,Midnight Love,30.0,12,0,-1,0,0,stay,1982-11-20
21205,Marvin Gaye,1983-02-19,Marvin Gaye - Midnight Love,3,2,5,1.0,3,Midnight Love,30.0,13,-2,0,-1,1,down,1982-11-20
21206,Marvin Gaye,1983-02-26,Marvin Gaye - Midnight Love,3,3,5,1.0,5,Midnight Love,30.0,14,0,-2,0,0,stay,1982-11-20
21207,Marvin Gaye,1983-03-05,Marvin Gaye - Midnight Love,5,3,10,1.0,5,Midnight Love,30.0,15,-5,0,-2,1,down,1982-11-20
21208,Marvin Gaye,1983-03-12,Marvin Gaye - Midnight Love,5,5,13,1.0,10,Midnight Love,30.0,16,-3,-5,0,1,down,1982-11-20
21209,Marvin Gaye,1983-03-19,Marvin Gaye - Midnight Love,10,5,10,1.0,13,Midnight Love,30.0,17,3,-3,-5,1,up,1982-11-20
21210,Marvin Gaye,1983-03-26,Marvin Gaye - Midnight Love,13,10,9,1.0,10,Midnight Love,30.0,18,1,3,-3,1,up,1982-11-20
21211,Marvin Gaye,1983-04-02,Marvin Gaye - Midnight Love,10,13,9,1.0,9,Midnight Love,30.0,19,0,1,3,0,stay,1982-11-20
21212,Marvin Gaye,1983-04-09,Marvin Gaye - Midnight Love,9,10,10,1.0,9,Midnight Love,30.0,20,-1,0,1,1,down,1982-11-20
21213,Marvin Gaye,1983-04-16,Marvin Gaye - Midnight Love,9,9,10,1.0,10,Midnight Love,30.0,21,0,-1,0,0,stay,1982-11-20
21214,Marvin Gaye,1983-04-23,Marvin Gaye - Midnight Love,10,9,20,1.0,10,Midnight Love,30.0,22,-10,0,-1,1,down,1982-11-20
21215,Marvin Gaye,1983-04-30,Marvin Gaye - Midnight Love,10,10,21,1.0,20,Midnight Love,30.0,23,-1,-10,0,1,down,1982-11-20
21216,Marvin Gaye,1983-05-07,Marvin Gaye - Midnight Love,20,10,23,1.0,21,Midnight Love,30.0,24,-2,-1,-10,1,down,1982-11-20
21217,Marvin Gaye,1983-05-14,Marvin Gaye - Midnight Love,21,20,34,1.0,23,Midnight Love,30.0,25,-11,-2,-1,1,down,1982-11-20
21218,Marvin Gaye,1983-05-21,Marvin Gaye - Midnight Love,23,21,36,1.0,34,Midnight Love,30.0,26,-2,-11,-2,1,down,1982-11-20
21219,Marvin Gaye,1983-05-28,Marvin Gaye - Midnight Love,34,23,38,1.0,36,Midnight Love,30.0,27,-2,-2,-11,1,down,1982-11-20
21220,Marvin Gaye,1983-06-04,Marvin Gaye - Midnight Love,36,34,42,1.0,38,Midnight Love,30.0,28,-4,-2,-2,1,down,1982-11-20
21221,Marvin Gaye,1983-06-11,Marvin Gaye - Midnight Love,38,36,48,1.0,42,Midnight Love,30.0,29,-6,-4,-2,1,down,1982-11-20
21222,Marvin Gaye,1983-06-18,Marvin Gaye - Midnight Love,42,38,51,1.0,48,Midnight Love,30.0,30,-3,-6,-4,1,down,1982-11-20
21223,Prince,1982-11-20,Prince - 1999,51,51,10,4.0,32,1999,73.0,0,22,19,0,1,up,1982-11-20
21224,Prince,1982-11-27,Prince - 1999,32,51,4,4.0,10,1999,73.0,1,6,22,19,1,up,1982-11-20
21225,Prince,1982-12-04,Prince - 1999,10,32,4,4.0,4,1999,73.0,2,0,6,22,0,stay,1982-11-20
21226,Prince,1982-12-11,Prince - 1999,4,10,4,4.0,4,1999,73.0,3,0,0,6,0,stay,1982-11-20
21227,Prince,1982-12-18,Prince - 1999,4,4,4,4.0,4,1999,73.0,4,0,0,0,0,stay,1982-11-20
21228,Prince,1982-12-25,Prince - 1999,4,4,4,4.0,4,1999,73.0,5,0,0,0,0,stay,1982-11-20
21229,Prince,1983-01-01,Prince - 1999,4,4,4,4.0,4,1999,73.0,6,0,0,0,0,stay,1982-11-20
21230,Prince,1983-01-08,Prince - 1999,4,4,4,4.0,4,1999,73.0,7,0,0,0,0,stay,1982-11-20
21231,Prince,1983-01-15,Prince - 1999,4,4,4,4.0,4,1999,73.0,8,0,0,0,0,stay,1982-11-20
21232,Prince,1983-01-22,Prince - 1999,4,4,4,4.0,4,1999,73.0,9,0,0,0,0,stay,1982-11-20
21233,Prince,1983-01-29,Prince - 1999,4,4,4,4.0,4,1999,73.0,10,0,0,0,0,stay,1982-11-20
21234,Prince,1983-02-05,Prince - 1999,4,4,4,4.0,4,1999,73.0,11,0,0,0,0,stay,1982-11-20
21235,Prince,1983-02-12,Prince - 1999,4,4,7,4.0,4,1999,73.0,12,-3,0,0,1,down,1982-11-20
21236,Prince,1983-02-19,Prince - 1999,4,4,7,4.0,7,1999,73.0,13,0,-3,0,0,stay,1982-11-20
21237,Prince,1983-02-26,Prince - 1999,7,4,6,4.0,7,1999,73.0,14,1,0,-3,1,up,1982-11-20
21238,Prince,1983-03-05,Prince - 1999,7,7,6,4.0,6,1999,73.0,15,0,1,0,0,stay,1982-11-20
21239,Prince,1983-03-12,Prince - 1999,6,7,10,4.0,6,1999,73.0,16,-4,0,1,1,down,1982-11-20
21240,Prince,1983-03-19,Prince - 1999,6,6,9,4.0,10,1999,73.0,17,1,-4,0,1,up,1982-11-20
21241,Prince,1983-03-26,Prince - 1999,10,6,8,4.0,9,1999,73.0,18,1,1,-4,1,up,1982-11-20
21242,Prince,1983-04-02,Prince - 1999,9,10,7,4.0,8,1999,73.0,19,1,1,1,1,up,1982-11-20
21243,Prince,1983-04-09,Prince - 1999,8,9,7,4.0,7,1999,73.0,20,0,1,1,0,stay,1982-11-20
21244,Prince,1983-04-16,Prince - 1999,7,8,9,4.0,7,1999,73.0,21,-2,0,1,1,down,1982-11-20
21245,Prince,1983-04-23,Prince - 1999,7,7,9,4.0,9,1999,73.0,22,0,-2,0,0,stay,1982-11-20
21246,Prince,1983-04-30,Prince - 1999,9,7,8,4.0,9,1999,73.0,23,1,0,-2,1,up,1982-11-20
21247,Prince,1983-05-07,Prince - 1999,9,9,8,4.0,8,1999,73.0,24,0,1,0,0,stay,1982-11-20
21248,Prince,1983-05-14,Prince - 1999,8,9,7,4.0,8,1999,73.0,25,1,0,1,1,up,1982-11-20
21249,Prince,1983-05-21,Prince - 1999,8,8,7,4.0,7,1999,73.0,26,0,1,0,0,stay,1982-11-20
21250,Prince,1983-05-28,Prince - 1999,7,8,12,4.0,7,1999,73.0,27,-5,0,1,1,down,1982-11-20
21251,Prince,1983-06-04,Prince - 1999,7,7,12,4.0,12,1999,73.0,28,0,-5,0,0,stay,1982-11-20
21252,Prince,1983-06-11,Prince - 1999,12,7,13,4.0,12,1999,73.0,29,-1,0,-5,1,down,1982-11-20
21253,Prince,1983-06-18,Prince - 1999,12,12,17,4.0,13,1999,73.0,30,-4,-1,0,1,down,1982-11-20
21254,Prince,1983-06-25,Prince - 1999,13,12,17,4.0,17,1999,73.0,31,0,-4,-1,0,stay,1982-11-20
21255,Prince,1983-07-02,Prince - 1999,17,13,20,4.0,17,1999,73.0,32,-3,0,-4,1,down,1982-11-20
21256,Prince,1983-07-09,Prince - 1999,17,17,18,4.0,20,1999,73.0,33,2,-3,0,1,up,1982-11-20
21257,Prince,1983-07-16,Prince - 1999,20,17,16,4.0,18,1999,73.0,34,2,2,-3,1,up,1982-11-20
21258,Prince,1983-07-23,Prince - 1999,18,20,14,4.0,16,1999,73.0,35,2,2,2,1,up,1982-11-20
21259,Prince,1983-07-30,Prince - 1999,16,18,14,4.0,14,1999,73.0,36,0,2,2,0,stay,1982-11-20
21260,Prince,1983-08-06,Prince - 1999,14,16,17,4.0,14,1999,73.0,37,-3,0,2,1,down,1982-11-20
21261,Prince,1983-08-13,Prince - 1999,14,14,15,4.0,17,1999,73.0,38,2,-3,0,1,up,1982-11-20
21262,Prince,1983-08-20,Prince - 1999,17,14,15,4.0,15,1999,73.0,39,0,2,-3,0,stay,1982-11-20
21263,Prince,1983-08-27,Prince - 1999,15,17,22,4.0,15,1999,73.0,40,-7,0,2,1,down,1982-11-20
21264,Prince,1983-09-03,Prince - 1999,15,15,22,4.0,22,1999,73.0,41,0,-7,0,0,stay,1982-11-20
21265,Prince,1983-09-10,Prince - 1999,22,15,21,4.0,22,1999,73.0,42,1,0,-7,1,up,1982-11-20
21266,Prince,1983-09-17,Prince - 1999,22,22,21,4.0,21,1999,73.0,43,0,1,0,0,stay,1982-11-20
21267,Prince,1983-09-24,Prince - 1999,21,22,26,4.0,21,1999,73.0,44,-5,0,1,1,down,1982-11-20
21268,Prince,1983-10-01,Prince - 1999,21,21,26,4.0,26,1999,73.0,45,0,-5,0,0,stay,1982-11-20
21269,Prince,1983-10-08,Prince - 1999,26,21,26,4.0,26,1999,73.0,46,0,0,-5,0,stay,1982-11-20
21270,Prince,1983-10-15,Prince - 1999,26,26,27,4.0,26,1999,73.0,47,-1,0,0,1,down,1982-11-20
21271,Prince,1983-10-22,Prince - 1999,26,26,25,4.0,27,1999,73.0,48,2,-1,0,1,up,1982-11-20
21272,Prince,1983-10-29,Prince - 1999,27,26,24,4.0,25,1999,73.0,49,1,2,-1,1,up,1982-11-20
21273,Prince,1983-11-05,Prince - 1999,25,27,24,4.0,24,1999,73.0,50,0,1,2,0,stay,1982-11-20
21274,Prince,1983-11-12,Prince - 1999,24,25,24,4.0,24,1999,73.0,51,0,0,1,0,stay,1982-11-20
21275,Prince,1983-11-19,Prince - 1999,24,24,28,4.0,24,1999,73.0,52,-4,0,0,1,down,1982-11-20
21276,Prince,1983-11-26,Prince - 1999,24,24,28,4.0,28,1999,73.0,53,0,-4,0,0,stay,1982-11-20
21277,Prince,1983-12-03,Prince - 1999,28,24,37,4.0,28,1999,73.0,54,-9,0,-4,1,down,1982-11-20
21278,Prince,1983-12-10,Prince - 1999,28,28,37,4.0,37,1999,73.0,55,0,-9,0,0,stay,1982-11-20
21279,Prince,1983-12-17,Prince - 1999,37,28,35,4.0,37,1999,73.0,56,2,0,-9,1,up,1982-11-20
21280,Prince,1983-12-24,Prince - 1999,37,37,35,4.0,35,1999,73.0,57,0,2,0,0,stay,1982-11-20
21281,Prince,1983-12-31,Prince - 1999,35,37,50,4.0,35,1999,73.0,58,-15,0,2,1,down,1982-11-20
21282,Prince,1984-01-07,Prince - 1999,35,35,43,4.0,50,1999,73.0,59,7,-15,0,1,up,1982-11-20
21283,Prince,1984-01-14,Prince - 1999,50,35,42,4.0,43,1999,73.0,60,1,7,-15,1,up,1982-11-20
21284,Prince,1984-01-21,Prince - 1999,43,50,40,4.0,42,1999,73.0,61,2,1,7,1,up,1982-11-20
21285,Prince,1984-01-28,Prince - 1999,42,43,39,4.0,40,1999,73.0,62,1,2,1,1,up,1982-11-20
21286,Prince,1984-02-04,Prince - 1999,40,42,39,4.0,39,1999,73.0,63,0,1,2,0,stay,1982-11-20
21287,Prince,1984-02-11,Prince - 1999,39,40,37,4.0,39,1999,73.0,64,2,0,1,1,up,1982-11-20
21288,Prince,1984-02-18,Prince - 1999,39,39,46,4.0,37,1999,73.0,65,-9,2,0,1,down,1982-11-20
21289,Prince,1984-02-25,Prince - 1999,37,39,45,4.0,46,1999,73.0,66,1,-9,2,1,up,1982-11-20
21290,Prince,1984-03-03,Prince - 1999,46,37,47,4.0,45,1999,73.0,67,-2,1,-9,1,down,1982-11-20
21291,Prince,1984-03-10,Prince - 1999,45,46,48,4.0,47,1999,73.0,68,-1,-2,1,1,down,1982-11-20
21292,Prince,1984-03-17,Prince - 1999,47,45,49,4.0,48,1999,73.0,69,-1,-1,-2,1,down,1982-11-20
21293,Prince,1984-03-24,Prince - 1999,48,47,48,4.0,49,1999,73.0,70,1,-1,-1,1,up,1982-11-20
21294,Prince,1984-03-31,Prince - 1999,49,48,49,4.0,48,1999,73.0,71,-1,1,-1,1,down,1982-11-20
21295,Prince,1984-11-24,Prince - 1999,48,49,49,4.0,49,1999,73.0,72,0,-1,1,0,stay,1982-11-20
21296,Prince,1984-12-01,Prince - 1999,49,48,51,4.0,49,1999,73.0,73,-2,0,-1,1,down,1982-11-20
21297,Spyro Gyra,1982-11-20,Spyro Gyra - Incognito,51,51,39,39.0,42,Incognito,3.0,0,3,9,0,1,up,1982-11-20
21298,Spyro Gyra,1982-11-27,Spyro Gyra - Incognito,42,51,39,39.0,39,Incognito,3.0,1,0,3,9,0,stay,1982-11-20
21299,Spyro Gyra,1982-12-04,Spyro Gyra - Incognito,39,42,41,39.0,39,Incognito,3.0,2,-2,0,3,1,down,1982-11-20
21300,Spyro Gyra,1982-12-11,Spyro Gyra - Incognito,39,39,51,39.0,41,Incognito,3.0,3,-10,-2,0,1,down,1982-11-20
21301,Barkays,1982-11-20,Barkays - Propositions,51,51,25,9.0,43,Propositions,32.0,0,18,8,0,1,up,1982-11-20
21302,Barkays,1982-11-27,Barkays - Propositions,43,51,14,9.0,25,Propositions,32.0,1,11,18,8,1,up,1982-11-20
21303,Barkays,1982-12-04,Barkays - Propositions,25,43,12,9.0,14,Propositions,32.0,2,2,11,18,1,up,1982-11-20
21304,Barkays,1982-12-11,Barkays - Propositions,14,25,9,9.0,12,Propositions,32.0,3,3,2,11,1,up,1982-11-20
21305,Barkays,1982-12-18,Barkays - Propositions,12,14,9,9.0,9,Propositions,32.0,4,0,3,2,0,stay,1982-11-20
21306,Barkays,1982-12-25,Barkays - Propositions,9,12,9,9.0,9,Propositions,32.0,5,0,0,3,0,stay,1982-11-20
21307,Barkays,1983-01-01,Barkays - Propositions,9,9,9,9.0,9,Propositions,32.0,6,0,0,0,0,stay,1982-11-20
21308,Barkays,1983-01-08,Barkays - Propositions,9,9,9,9.0,9,Propositions,32.0,7,0,0,0,0,stay,1982-11-20
21309,Barkays,1983-01-15,Barkays - Propositions,9,9,9,9.0,9,Propositions,32.0,8,0,0,0,0,stay,1982-11-20
21310,Barkays,1983-01-22,Barkays - Propositions,9,9,9,9.0,9,Propositions,32.0,9,0,0,0,0,stay,1982-11-20
21311,Barkays,1983-01-29,Barkays - Propositions,9,9,9,9.0,9,Propositions,32.0,10,0,0,0,0,stay,1982-11-20
21312,Barkays,1983-02-05,Barkays - Propositions,9,9,9,9.0,9,Propositions,32.0,11,0,0,0,0,stay,1982-11-20
21313,Barkays,1983-02-12,Barkays - Propositions,9,9,9,9.0,9,Propositions,32.0,12,0,0,0,0,stay,1982-11-20
21314,Barkays,1983-02-19,Barkays - Propositions,9,9,9,9.0,9,Propositions,32.0,13,0,0,0,0,stay,1982-11-20
21315,Barkays,1983-02-26,Barkays - Propositions,9,9,9,9.0,9,Propositions,32.0,14,0,0,0,0,stay,1982-11-20
21316,Barkays,1983-03-05,Barkays - Propositions,9,9,9,9.0,9,Propositions,32.0,15,0,0,0,0,stay,1982-11-20
21317,Barkays,1983-03-12,Barkays - Propositions,9,9,9,9.0,9,Propositions,32.0,16,0,0,0,0,stay,1982-11-20
21318,Barkays,1983-03-19,Barkays - Propositions,9,9,15,9.0,9,Propositions,32.0,17,-6,0,0,1,down,1982-11-20
21319,Barkays,1983-03-26,Barkays - Propositions,9,9,15,9.0,15,Propositions,32.0,18,0,-6,0,0,stay,1982-11-20
21320,Barkays,1983-04-02,Barkays - Propositions,15,9,18,9.0,15,Propositions,32.0,19,-3,0,-6,1,down,1982-11-20
21321,Barkays,1983-04-09,Barkays - Propositions,15,15,17,9.0,18,Propositions,32.0,20,1,-3,0,1,up,1982-11-20
21322,Barkays,1983-04-16,Barkays - Propositions,18,15,17,9.0,17,Propositions,32.0,21,0,1,-3,0,stay,1982-11-20
21323,Barkays,1983-04-23,Barkays - Propositions,17,18,17,9.0,17,Propositions,32.0,22,0,0,1,0,stay,1982-11-20
21324,Barkays,1983-04-30,Barkays - Propositions,17,17,16,9.0,17,Propositions,32.0,23,1,0,0,1,up,1982-11-20
21325,Barkays,1983-05-07,Barkays - Propositions,17,17,15,9.0,16,Propositions,32.0,24,1,1,0,1,up,1982-11-20
21326,Barkays,1983-05-14,Barkays - Propositions,16,17,19,9.0,15,Propositions,32.0,25,-4,1,1,1,down,1982-11-20
21327,Barkays,1983-05-21,Barkays - Propositions,15,16,29,9.0,19,Propositions,32.0,26,-10,-4,1,1,down,1982-11-20
21328,Barkays,1983-05-28,Barkays - Propositions,19,15,27,9.0,29,Propositions,32.0,27,2,-10,-4,1,up,1982-11-20
21329,Barkays,1983-06-04,Barkays - Propositions,29,19,38,9.0,27,Propositions,32.0,28,-11,2,-10,1,down,1982-11-20
21330,Barkays,1983-06-11,Barkays - Propositions,27,29,35,9.0,38,Propositions,32.0,29,3,-11,2,1,up,1982-11-20
21331,Barkays,1983-06-18,Barkays - Propositions,38,27,35,9.0,35,Propositions,32.0,30,0,3,-11,0,stay,1982-11-20
21332,Barkays,1983-06-25,Barkays - Propositions,35,38,49,9.0,35,Propositions,32.0,31,-14,0,3,1,down,1982-11-20
21333,Barkays,1983-07-02,Barkays - Propositions,35,35,51,9.0,49,Propositions,32.0,32,-2,-14,0,1,down,1982-11-20
21334,Millie Jackson,1982-11-20,Millie Jackson - Hard Times,51,51,37,29.0,45,Hard Times,10.0,0,8,6,0,1,up,1982-11-20
21335,Millie Jackson,1982-11-27,Millie Jackson - Hard Times,45,51,33,29.0,37,Hard Times,10.0,1,4,8,6,1,up,1982-11-20
21336,Millie Jackson,1982-12-04,Millie Jackson - Hard Times,37,45,29,29.0,33,Hard Times,10.0,2,4,4,8,1,up,1982-11-20
21337,Millie Jackson,1982-12-11,Millie Jackson - Hard Times,33,37,29,29.0,29,Hard Times,10.0,3,0,4,4,0,stay,1982-11-20
21338,Millie Jackson,1982-12-18,Millie Jackson - Hard Times,29,33,29,29.0,29,Hard Times,10.0,4,0,0,4,0,stay,1982-11-20
21339,Millie Jackson,1982-12-25,Millie Jackson - Hard Times,29,29,29,29.0,29,Hard Times,10.0,5,0,0,0,0,stay,1982-11-20
21340,Millie Jackson,1983-01-01,Millie Jackson - Hard Times,29,29,42,29.0,29,Hard Times,10.0,6,-13,0,0,1,down,1982-11-20
21341,Millie Jackson,1983-01-08,Millie Jackson - Hard Times,29,29,49,29.0,42,Hard Times,10.0,7,-7,-13,0,1,down,1982-11-20
21342,Millie Jackson,1983-01-15,Millie Jackson - Hard Times,42,29,49,29.0,49,Hard Times,10.0,8,0,-7,-13,0,stay,1982-11-20
21343,Millie Jackson,1983-01-22,Millie Jackson - Hard Times,49,42,49,29.0,49,Hard Times,10.0,9,0,0,-7,0,stay,1982-11-20
21344,Millie Jackson,1983-01-29,Millie Jackson - Hard Times,49,49,51,29.0,49,Hard Times,10.0,10,-2,0,0,1,down,1982-11-20
21345,The Spinners,1982-11-20,The Spinners - Grand Slam,51,51,43,43.0,47,Grand Slam,3.0,0,4,4,0,1,up,1982-11-20
21346,The Spinners,1982-11-27,The Spinners - Grand Slam,47,51,43,43.0,43,Grand Slam,3.0,1,0,4,4,0,stay,1982-11-20
21347,The Spinners,1982-12-04,The Spinners - Grand Slam,43,47,44,43.0,43,Grand Slam,3.0,2,-1,0,4,1,down,1982-11-20
21348,The Spinners,1982-12-11,The Spinners - Grand Slam,43,43,51,43.0,44,Grand Slam,3.0,3,-7,-1,0,1,down,1982-11-20
21349,ConFunkShun,1982-11-20,ConFunkShun - To The Max,51,51,35,9.0,49,To The Max,35.0,0,14,2,0,1,up,1982-11-20
21350,ConFunkShun,1982-11-27,ConFunkShun - To The Max,49,51,25,9.0,35,To The Max,35.0,1,10,14,2,1,up,1982-11-20
21351,ConFunkShun,1982-12-04,ConFunkShun - To The Max,35,49,20,9.0,25,To The Max,35.0,2,5,10,14,1,up,1982-11-20
21352,ConFunkShun,1982-12-11,ConFunkShun - To The Max,25,35,17,9.0,20,To The Max,35.0,3,3,5,10,1,up,1982-11-20
21353,ConFunkShun,1982-12-18,ConFunkShun - To The Max,20,25,17,9.0,17,To The Max,35.0,4,0,3,5,0,stay,1982-11-20
21354,ConFunkShun,1982-12-25,ConFunkShun - To The Max,17,20,17,9.0,17,To The Max,35.0,5,0,0,3,0,stay,1982-11-20
21355,ConFunkShun,1983-01-01,ConFunkShun - To The Max,17,17,17,9.0,17,To The Max,35.0,6,0,0,0,0,stay,1982-11-20
21356,ConFunkShun,1983-01-08,ConFunkShun - To The Max,17,17,39,9.0,17,To The Max,35.0,7,-22,0,0,1,down,1982-11-20
21357,ConFunkShun,1983-01-15,ConFunkShun - To The Max,17,17,39,9.0,39,To The Max,35.0,8,0,-22,0,0,stay,1982-11-20
21358,ConFunkShun,1983-01-22,ConFunkShun - To The Max,39,17,38,9.0,39,To The Max,35.0,9,1,0,-22,1,up,1982-11-20
21359,ConFunkShun,1983-01-29,ConFunkShun - To The Max,39,39,34,9.0,38,To The Max,35.0,10,4,1,0,1,up,1982-11-20
21360,ConFunkShun,1983-02-05,ConFunkShun - To The Max,38,39,26,9.0,34,To The Max,35.0,11,8,4,1,1,up,1982-11-20
21361,ConFunkShun,1983-02-12,ConFunkShun - To The Max,34,38,20,9.0,26,To The Max,35.0,12,6,8,4,1,up,1982-11-20
21362,ConFunkShun,1983-02-19,ConFunkShun - To The Max,26,34,17,9.0,20,To The Max,35.0,13,3,6,8,1,up,1982-11-20
21363,ConFunkShun,1983-02-26,ConFunkShun - To The Max,20,26,17,9.0,17,To The Max,35.0,14,0,3,6,0,stay,1982-11-20
21364,ConFunkShun,1983-03-05,ConFunkShun - To The Max,17,20,16,9.0,17,To The Max,35.0,15,1,0,3,1,up,1982-11-20
21365,ConFunkShun,1983-03-12,ConFunkShun - To The Max,17,17,15,9.0,16,To The Max,35.0,16,1,1,0,1,up,1982-11-20
21366,ConFunkShun,1983-03-19,ConFunkShun - To The Max,16,17,14,9.0,15,To The Max,35.0,17,1,1,1,1,up,1982-11-20
21367,ConFunkShun,1983-03-26,ConFunkShun - To The Max,15,16,13,9.0,14,To The Max,35.0,18,1,1,1,1,up,1982-11-20
21368,ConFunkShun,1983-04-02,ConFunkShun - To The Max,14,15,13,9.0,13,To The Max,35.0,19,0,1,1,0,stay,1982-11-20
21369,ConFunkShun,1983-04-09,ConFunkShun - To The Max,13,14,12,9.0,13,To The Max,35.0,20,1,0,1,1,up,1982-11-20
21370,ConFunkShun,1983-04-16,ConFunkShun - To The Max,13,13,11,9.0,12,To The Max,35.0,21,1,1,0,1,up,1982-11-20
21371,ConFunkShun,1983-04-23,ConFunkShun - To The Max,12,13,10,9.0,11,To The Max,35.0,22,1,1,1,1,up,1982-11-20
21372,ConFunkShun,1983-04-30,ConFunkShun - To The Max,11,12,9,9.0,10,To The Max,35.0,23,1,1,1,1,up,1982-11-20
21373,ConFunkShun,1983-05-07,ConFunkShun - To The Max,10,11,9,9.0,9,To The Max,35.0,24,0,1,1,0,stay,1982-11-20
21374,ConFunkShun,1983-05-14,ConFunkShun - To The Max,9,10,9,9.0,9,To The Max,35.0,25,0,0,1,0,stay,1982-11-20
21375,ConFunkShun,1983-05-21,ConFunkShun - To The Max,9,9,22,9.0,9,To The Max,35.0,26,-13,0,0,1,down,1982-11-20
21376,ConFunkShun,1983-05-28,ConFunkShun - To The Max,9,9,22,9.0,22,To The Max,35.0,27,0,-13,0,0,stay,1982-11-20
21377,ConFunkShun,1983-06-04,ConFunkShun - To The Max,22,9,28,9.0,22,To The Max,35.0,28,-6,0,-13,1,down,1982-11-20
21378,ConFunkShun,1983-06-11,ConFunkShun - To The Max,22,22,29,9.0,28,To The Max,35.0,29,-1,-6,0,1,down,1982-11-20
21379,ConFunkShun,1983-06-18,ConFunkShun - To The Max,28,22,39,9.0,29,To The Max,35.0,30,-10,-1,-6,1,down,1982-11-20
21380,ConFunkShun,1983-06-25,ConFunkShun - To The Max,29,28,38,9.0,39,To The Max,35.0,31,1,-10,-1,1,up,1982-11-20
21381,ConFunkShun,1983-07-02,ConFunkShun - To The Max,39,29,37,9.0,38,To The Max,35.0,32,1,1,-10,1,up,1982-11-20
21382,ConFunkShun,1983-07-09,ConFunkShun - To The Max,38,39,40,9.0,37,To The Max,35.0,33,-3,1,1,1,down,1982-11-20
21383,ConFunkShun,1983-07-16,ConFunkShun - To The Max,37,38,48,9.0,40,To The Max,35.0,34,-8,-3,1,1,down,1982-11-20
21384,ConFunkShun,1983-07-23,ConFunkShun - To The Max,40,37,51,9.0,48,To The Max,35.0,35,-3,-8,-3,1,down,1982-11-20
21385,Alphonse Mouzon,1982-11-20,Alphonse Mouzon - Distant Lover,51,51,44,24.0,50,Distant Lover,14.0,0,6,1,0,1,up,1982-11-20
21386,Alphonse Mouzon,1982-11-27,Alphonse Mouzon - Distant Lover,50,51,42,24.0,44,Distant Lover,14.0,1,2,6,1,1,up,1982-11-20
21387,Alphonse Mouzon,1982-12-04,Alphonse Mouzon - Distant Lover,44,50,38,24.0,42,Distant Lover,14.0,2,4,2,6,1,up,1982-11-20
21388,Alphonse Mouzon,1982-12-11,Alphonse Mouzon - Distant Lover,42,44,36,24.0,38,Distant Lover,14.0,3,2,4,2,1,up,1982-11-20
21389,Alphonse Mouzon,1982-12-18,Alphonse Mouzon - Distant Lover,38,42,32,24.0,36,Distant Lover,14.0,4,4,2,4,1,up,1982-11-20
21390,Alphonse Mouzon,1982-12-25,Alphonse Mouzon - Distant Lover,36,38,32,24.0,32,Distant Lover,14.0,5,0,4,2,0,stay,1982-11-20
21391,Alphonse Mouzon,1983-01-01,Alphonse Mouzon - Distant Lover,32,36,28,24.0,32,Distant Lover,14.0,6,4,0,4,1,up,1982-11-20
21392,Alphonse Mouzon,1983-01-08,Alphonse Mouzon - Distant Lover,32,32,26,24.0,28,Distant Lover,14.0,7,2,4,0,1,up,1982-11-20
21393,Alphonse Mouzon,1983-01-15,Alphonse Mouzon - Distant Lover,28,32,24,24.0,26,Distant Lover,14.0,8,2,2,4,1,up,1982-11-20
21394,Alphonse Mouzon,1983-01-22,Alphonse Mouzon - Distant Lover,26,28,24,24.0,24,Distant Lover,14.0,9,0,2,2,0,stay,1982-11-20
21395,Alphonse Mouzon,1983-01-29,Alphonse Mouzon - Distant Lover,24,26,24,24.0,24,Distant Lover,14.0,10,0,0,2,0,stay,1982-11-20
21396,Alphonse Mouzon,1983-02-05,Alphonse Mouzon - Distant Lover,24,24,41,24.0,24,Distant Lover,14.0,11,-17,0,0,1,down,1982-11-20
21397,Alphonse Mouzon,1983-02-12,Alphonse Mouzon - Distant Lover,24,24,48,24.0,41,Distant Lover,14.0,12,-7,-17,0,1,down,1982-11-20
21398,Alphonse Mouzon,1983-02-19,Alphonse Mouzon - Distant Lover,41,24,49,24.0,48,Distant Lover,14.0,13,-1,-7,-17,1,down,1982-11-20
21399,Alphonse Mouzon,1983-02-26,Alphonse Mouzon - Distant Lover,48,41,51,24.0,49,Distant Lover,14.0,14,-2,-1,-7,1,down,1982-11-20
21400,Skyy,1982-11-27,Skyy - Skyyjammer,51,51,29,22.0,40,Skyyjammer,16.0,0,11,11,0,1,up,1982-11-27
21401,Skyy,1982-12-04,Skyy - Skyyjammer,40,51,25,22.0,29,Skyyjammer,16.0,1,4,11,11,1,up,1982-11-27
21402,Skyy,1982-12-11,Skyy - Skyyjammer,29,40,25,22.0,25,Skyyjammer,16.0,2,0,4,11,0,stay,1982-11-27
21403,Skyy,1982-12-18,Skyy - Skyyjammer,25,29,22,22.0,25,Skyyjammer,16.0,3,3,0,4,1,up,1982-11-27
21404,Skyy,1982-12-25,Skyy - Skyyjammer,25,25,22,22.0,22,Skyyjammer,16.0,4,0,3,0,0,stay,1982-11-27
21405,Skyy,1983-01-01,Skyy - Skyyjammer,22,25,22,22.0,22,Skyyjammer,16.0,5,0,0,3,0,stay,1982-11-27
21406,Skyy,1983-01-08,Skyy - Skyyjammer,22,22,47,22.0,22,Skyyjammer,16.0,6,-25,0,0,1,down,1982-11-27
21407,Skyy,1983-01-15,Skyy - Skyyjammer,22,22,47,22.0,47,Skyyjammer,16.0,7,0,-25,0,0,stay,1982-11-27
21408,Skyy,1983-01-22,Skyy - Skyyjammer,47,22,47,22.0,47,Skyyjammer,16.0,8,0,0,-25,0,stay,1982-11-27
21409,Skyy,1983-01-29,Skyy - Skyyjammer,47,47,46,22.0,47,Skyyjammer,16.0,9,1,0,0,1,up,1982-11-27
21410,Skyy,1983-02-05,Skyy - Skyyjammer,47,47,46,22.0,46,Skyyjammer,16.0,10,0,1,0,0,stay,1982-11-27
21411,Skyy,1983-02-12,Skyy - Skyyjammer,46,47,41,22.0,46,Skyyjammer,16.0,11,5,0,1,1,up,1982-11-27
21412,Skyy,1983-02-19,Skyy - Skyyjammer,46,46,38,22.0,41,Skyyjammer,16.0,12,3,5,0,1,up,1982-11-27
21413,Skyy,1983-02-26,Skyy - Skyyjammer,41,46,38,22.0,38,Skyyjammer,16.0,13,0,3,5,0,stay,1982-11-27
21414,Skyy,1983-03-05,Skyy - Skyyjammer,38,41,46,22.0,38,Skyyjammer,16.0,14,-8,0,3,1,down,1982-11-27
21415,Skyy,1983-03-12,Skyy - Skyyjammer,38,38,44,22.0,46,Skyyjammer,16.0,15,2,-8,0,1,up,1982-11-27
21416,Skyy,1983-03-19,Skyy - Skyyjammer,46,38,51,22.0,44,Skyyjammer,16.0,16,-7,2,-8,1,down,1982-11-27
21417,Earl Klugh,1982-11-27,Earl Klugh - Two Of A Kind,51,51,44,23.0,48,Two Of A Kind,14.0,0,4,3,0,1,up,1982-11-27
21418,Earl Klugh,1982-12-04,Earl Klugh - Two Of A Kind,48,51,34,23.0,44,Two Of A Kind,14.0,1,10,4,3,1,up,1982-11-27
21419,Earl Klugh,1982-12-11,Earl Klugh - Two Of A Kind,44,48,31,23.0,34,Two Of A Kind,14.0,2,3,10,4,1,up,1982-11-27
21420,Earl Klugh,1982-12-18,Earl Klugh - Two Of A Kind,34,44,28,23.0,31,Two Of A Kind,14.0,3,3,3,10,1,up,1982-11-27
21421,Earl Klugh,1982-12-25,Earl Klugh - Two Of A Kind,31,34,28,23.0,28,Two Of A Kind,14.0,4,0,3,3,0,stay,1982-11-27
21422,Earl Klugh,1983-01-01,Earl Klugh - Two Of A Kind,28,31,26,23.0,28,Two Of A Kind,14.0,5,2,0,3,1,up,1982-11-27
21423,Earl Klugh,1983-01-08,Earl Klugh - Two Of A Kind,28,28,23,23.0,26,Two Of A Kind,14.0,6,3,2,0,1,up,1982-11-27
21424,Earl Klugh,1983-01-15,Earl Klugh - Two Of A Kind,26,28,23,23.0,23,Two Of A Kind,14.0,7,0,3,2,0,stay,1982-11-27
21425,Earl Klugh,1983-01-22,Earl Klugh - Two Of A Kind,23,26,36,23.0,23,Two Of A Kind,14.0,8,-13,0,3,1,down,1982-11-27
21426,Earl Klugh,1983-01-29,Earl Klugh - Two Of A Kind,23,23,36,23.0,36,Two Of A Kind,14.0,9,0,-13,0,0,stay,1982-11-27
21427,Earl Klugh,1983-02-05,Earl Klugh - Two Of A Kind,36,23,36,23.0,36,Two Of A Kind,14.0,10,0,0,-13,0,stay,1982-11-27
21428,Earl Klugh,1983-02-12,Earl Klugh - Two Of A Kind,36,36,37,23.0,36,Two Of A Kind,14.0,11,-1,0,0,1,down,1982-11-27
21429,Earl Klugh,1983-02-19,Earl Klugh - Two Of A Kind,36,36,36,23.0,37,Two Of A Kind,14.0,12,1,-1,0,1,up,1982-11-27
21430,Earl Klugh,1983-02-26,Earl Klugh - Two Of A Kind,37,36,36,23.0,36,Two Of A Kind,14.0,13,0,1,-1,0,stay,1982-11-27
21431,Earl Klugh,1983-03-05,Earl Klugh - Two Of A Kind,36,37,51,23.0,36,Two Of A Kind,14.0,14,-15,0,1,1,down,1982-11-27
21432,Commodores,1982-12-04,Commodores - All The Greatest Hits,51,51,27,12.0,36,All The Greatest Hits,18.0,0,9,15,0,1,up,1982-12-04
21433,Commodores,1982-12-11,Commodores - All The Greatest Hits,36,51,20,12.0,27,All The Greatest Hits,18.0,1,7,9,15,1,up,1982-12-04
21434,Commodores,1982-12-18,Commodores - All The Greatest Hits,27,36,18,12.0,20,All The Greatest Hits,18.0,2,2,7,9,1,up,1982-12-04
21435,Commodores,1982-12-25,Commodores - All The Greatest Hits,20,27,18,12.0,18,All The Greatest Hits,18.0,3,0,2,7,0,stay,1982-12-04
21436,Commodores,1983-01-01,Commodores - All The Greatest Hits,18,20,14,12.0,18,All The Greatest Hits,18.0,4,4,0,2,1,up,1982-12-04
21437,Commodores,1983-01-08,Commodores - All The Greatest Hits,18,18,12,12.0,14,All The Greatest Hits,18.0,5,2,4,0,1,up,1982-12-04
21438,Commodores,1983-01-15,Commodores - All The Greatest Hits,14,18,12,12.0,12,All The Greatest Hits,18.0,6,0,2,4,0,stay,1982-12-04
21439,Commodores,1983-01-22,Commodores - All The Greatest Hits,12,14,12,12.0,12,All The Greatest Hits,18.0,7,0,0,2,0,stay,1982-12-04
21440,Commodores,1983-01-29,Commodores - All The Greatest Hits,12,12,12,12.0,12,All The Greatest Hits,18.0,8,0,0,0,0,stay,1982-12-04
21441,Commodores,1983-02-05,Commodores - All The Greatest Hits,12,12,13,12.0,12,All The Greatest Hits,18.0,9,-1,0,0,1,down,1982-12-04
21442,Commodores,1983-02-12,Commodores - All The Greatest Hits,12,12,23,12.0,13,All The Greatest Hits,18.0,10,-10,-1,0,1,down,1982-12-04
21443,Commodores,1983-02-19,Commodores - All The Greatest Hits,13,12,25,12.0,23,All The Greatest Hits,18.0,11,-2,-10,-1,1,down,1982-12-04
21444,Commodores,1983-02-26,Commodores - All The Greatest Hits,23,13,25,12.0,25,All The Greatest Hits,18.0,12,0,-2,-10,0,stay,1982-12-04
21445,Commodores,1983-03-05,Commodores - All The Greatest Hits,25,23,28,12.0,25,All The Greatest Hits,18.0,13,-3,0,-2,1,down,1982-12-04
21446,Commodores,1983-03-12,Commodores - All The Greatest Hits,25,25,29,12.0,28,All The Greatest Hits,18.0,14,-1,-3,0,1,down,1982-12-04
21447,Commodores,1983-03-19,Commodores - All The Greatest Hits,28,25,31,12.0,29,All The Greatest Hits,18.0,15,-2,-1,-3,1,down,1982-12-04
21448,Commodores,1983-03-26,Commodores - All The Greatest Hits,29,28,35,12.0,31,All The Greatest Hits,18.0,16,-4,-2,-1,1,down,1982-12-04
21449,Commodores,1983-04-02,Commodores - All The Greatest Hits,31,29,42,12.0,35,All The Greatest Hits,18.0,17,-7,-4,-2,1,down,1982-12-04
21450,Commodores,1983-04-09,Commodores - All The Greatest Hits,35,31,51,12.0,42,All The Greatest Hits,18.0,18,-9,-7,-4,1,down,1982-12-04
21451,The S.O.S. Band,1982-12-04,The S.O.S. Band - S.o.s. Iii,51,51,30,27.0,40,S.o.s. Iii,14.0,0,10,11,0,1,up,1982-12-04
21452,The S.O.S. Band,1982-12-11,The S.O.S. Band - S.o.s. Iii,40,51,27,27.0,30,S.o.s. Iii,14.0,1,3,10,11,1,up,1982-12-04
21453,The S.O.S. Band,1982-12-18,The S.O.S. Band - S.o.s. Iii,30,40,27,27.0,27,S.o.s. Iii,14.0,2,0,3,10,0,stay,1982-12-04
21454,The S.O.S. Band,1982-12-25,The S.O.S. Band - S.o.s. Iii,27,30,27,27.0,27,S.o.s. Iii,14.0,3,0,0,3,0,stay,1982-12-04
21455,The S.O.S. Band,1983-01-01,The S.O.S. Band - S.o.s. Iii,27,27,31,27.0,27,S.o.s. Iii,14.0,4,-4,0,0,1,down,1982-12-04
21456,The S.O.S. Band,1983-01-08,The S.O.S. Band - S.o.s. Iii,27,27,31,27.0,31,S.o.s. Iii,14.0,5,0,-4,0,0,stay,1982-12-04
21457,The S.O.S. Band,1983-01-15,The S.O.S. Band - S.o.s. Iii,31,27,29,27.0,31,S.o.s. Iii,14.0,6,2,0,-4,1,up,1982-12-04
21458,The S.O.S. Band,1983-01-22,The S.O.S. Band - S.o.s. Iii,31,31,29,27.0,29,S.o.s. Iii,14.0,7,0,2,0,0,stay,1982-12-04
21459,The S.O.S. Band,1983-01-29,The S.O.S. Band - S.o.s. Iii,29,31,29,27.0,29,S.o.s. Iii,14.0,8,0,0,2,0,stay,1982-12-04
21460,The S.O.S. Band,1983-02-05,The S.O.S. Band - S.o.s. Iii,29,29,30,27.0,29,S.o.s. Iii,14.0,9,-1,0,0,1,down,1982-12-04
21461,The S.O.S. Band,1983-02-12,The S.O.S. Band - S.o.s. Iii,29,29,30,27.0,30,S.o.s. Iii,14.0,10,0,-1,0,0,stay,1982-12-04
21462,The S.O.S. Band,1983-02-19,The S.O.S. Band - S.o.s. Iii,30,29,30,27.0,30,S.o.s. Iii,14.0,11,0,0,-1,0,stay,1982-12-04
21463,The S.O.S. Band,1983-02-26,The S.O.S. Band - S.o.s. Iii,30,30,42,27.0,30,S.o.s. Iii,14.0,12,-12,0,0,1,down,1982-12-04
21464,The S.O.S. Band,1983-03-05,The S.O.S. Band - S.o.s. Iii,30,30,42,27.0,42,S.o.s. Iii,14.0,13,0,-12,0,0,stay,1982-12-04
21465,The S.O.S. Band,1983-03-12,The S.O.S. Band - S.o.s. Iii,42,30,51,27.0,42,S.o.s. Iii,14.0,14,-9,0,-12,1,down,1982-12-04
21466,Imagination,1982-12-04,Imagination - In The Heat Of The Night,51,51,48,45.0,48,In The Heat Of The Night,4.0,0,0,3,0,0,stay,1982-12-04
21467,Imagination,1982-12-11,Imagination - In The Heat Of The Night,48,51,45,45.0,48,In The Heat Of The Night,4.0,1,3,0,3,1,up,1982-12-04
21468,Imagination,1982-12-18,Imagination - In The Heat Of The Night,48,48,45,45.0,45,In The Heat Of The Night,4.0,2,0,3,0,0,stay,1982-12-04
21469,Imagination,1982-12-25,Imagination - In The Heat Of The Night,45,48,45,45.0,45,In The Heat Of The Night,4.0,3,0,0,3,0,stay,1982-12-04
21470,Imagination,1983-01-01,Imagination - In The Heat Of The Night,45,45,51,45.0,45,In The Heat Of The Night,4.0,4,-6,0,0,1,down,1982-12-04
21471,"Richard ""Dimples"" Fields",1982-12-11,"Richard ""Dimples"" Fields - Give Everybody Some!",51,51,46,40.0,47,Give Everybody Some!,5.0,0,1,4,0,1,up,1982-12-11
21472,"Richard ""Dimples"" Fields",1982-12-18,"Richard ""Dimples"" Fields - Give Everybody Some!",47,51,48,40.0,46,Give Everybody Some!,5.0,1,-2,1,4,1,down,1982-12-11
21473,"Richard ""Dimples"" Fields",1983-01-15,"Richard ""Dimples"" Fields - Give Everybody Some!",46,47,43,40.0,48,Give Everybody Some!,5.0,2,5,-2,1,1,up,1982-12-11
21474,"Richard ""Dimples"" Fields",1983-01-22,"Richard ""Dimples"" Fields - Give Everybody Some!",48,46,40,40.0,43,Give Everybody Some!,5.0,3,3,5,-2,1,up,1982-12-11
21475,"Richard ""Dimples"" Fields",1983-01-29,"Richard ""Dimples"" Fields - Give Everybody Some!",43,48,40,40.0,40,Give Everybody Some!,5.0,4,0,3,5,0,stay,1982-12-11
21476,"Richard ""Dimples"" Fields",1983-02-05,"Richard ""Dimples"" Fields - Give Everybody Some!",40,43,51,40.0,40,Give Everybody Some!,5.0,5,-11,0,3,1,down,1982-12-11
21477,Charlene,1982-12-11,Charlene - Used To Be,51,51,48,48.0,49,Used To Be,1.0,0,1,2,0,1,up,1982-12-11
21478,Charlene,1982-12-18,Charlene - Used To Be,49,51,51,48.0,48,Used To Be,1.0,1,-3,1,2,1,down,1982-12-11
21479,Peabo Bryson,1982-12-11,Peabo Bryson - Don't Play With Fire,51,51,22,8.0,50,Don't Play With Fire,24.0,0,28,1,0,1,up,1982-12-11
21480,Peabo Bryson,1982-12-18,Peabo Bryson - Don't Play With Fire,50,51,15,8.0,22,Don't Play With Fire,24.0,1,7,28,1,1,up,1982-12-11
21481,Peabo Bryson,1982-12-25,Peabo Bryson - Don't Play With Fire,22,50,15,8.0,15,Don't Play With Fire,24.0,2,0,7,28,0,stay,1982-12-11
21482,Peabo Bryson,1983-01-01,Peabo Bryson - Don't Play With Fire,15,22,10,8.0,15,Don't Play With Fire,24.0,3,5,0,7,1,up,1982-12-11
21483,Peabo Bryson,1983-01-08,Peabo Bryson - Don't Play With Fire,15,15,8,8.0,10,Don't Play With Fire,24.0,4,2,5,0,1,up,1982-12-11
21484,Peabo Bryson,1983-01-15,Peabo Bryson - Don't Play With Fire,10,15,8,8.0,8,Don't Play With Fire,24.0,5,0,2,5,0,stay,1982-12-11
21485,Peabo Bryson,1983-01-22,Peabo Bryson - Don't Play With Fire,8,10,8,8.0,8,Don't Play With Fire,24.0,6,0,0,2,0,stay,1982-12-11
21486,Peabo Bryson,1983-01-29,Peabo Bryson - Don't Play With Fire,8,8,8,8.0,8,Don't Play With Fire,24.0,7,0,0,0,0,stay,1982-12-11
21487,Peabo Bryson,1983-02-05,Peabo Bryson - Don't Play With Fire,8,8,8,8.0,8,Don't Play With Fire,24.0,8,0,0,0,0,stay,1982-12-11
21488,Peabo Bryson,1983-02-12,Peabo Bryson - Don't Play With Fire,8,8,13,8.0,8,Don't Play With Fire,24.0,9,-5,0,0,1,down,1982-12-11
21489,Peabo Bryson,1983-02-19,Peabo Bryson - Don't Play With Fire,8,8,15,8.0,13,Don't Play With Fire,24.0,10,-2,-5,0,1,down,1982-12-11
21490,Peabo Bryson,1983-02-26,Peabo Bryson - Don't Play With Fire,13,8,16,8.0,15,Don't Play With Fire,24.0,11,-1,-2,-5,1,down,1982-12-11
21491,Peabo Bryson,1983-03-05,Peabo Bryson - Don't Play With Fire,15,13,17,8.0,16,Don't Play With Fire,24.0,12,-1,-1,-2,1,down,1982-12-11
21492,Peabo Bryson,1983-03-12,Peabo Bryson - Don't Play With Fire,16,15,17,8.0,17,Don't Play With Fire,24.0,13,0,-1,-1,0,stay,1982-12-11
21493,Peabo Bryson,1983-03-19,Peabo Bryson - Don't Play With Fire,17,16,17,8.0,17,Don't Play With Fire,24.0,14,0,0,-1,0,stay,1982-12-11
21494,Peabo Bryson,1983-03-26,Peabo Bryson - Don't Play With Fire,17,17,21,8.0,17,Don't Play With Fire,24.0,15,-4,0,0,1,down,1982-12-11
21495,Peabo Bryson,1983-04-02,Peabo Bryson - Don't Play With Fire,17,17,23,8.0,21,Don't Play With Fire,24.0,16,-2,-4,0,1,down,1982-12-11
21496,Peabo Bryson,1983-04-09,Peabo Bryson - Don't Play With Fire,21,17,26,8.0,23,Don't Play With Fire,24.0,17,-3,-2,-4,1,down,1982-12-11
21497,Peabo Bryson,1983-04-16,Peabo Bryson - Don't Play With Fire,23,21,27,8.0,26,Don't Play With Fire,24.0,18,-1,-3,-2,1,down,1982-12-11
21498,Peabo Bryson,1983-04-23,Peabo Bryson - Don't Play With Fire,26,23,31,8.0,27,Don't Play With Fire,24.0,19,-4,-1,-3,1,down,1982-12-11
21499,Peabo Bryson,1983-04-30,Peabo Bryson - Don't Play With Fire,27,26,31,8.0,31,Don't Play With Fire,24.0,20,0,-4,-1,0,stay,1982-12-11
21500,Peabo Bryson,1983-05-07,Peabo Bryson - Don't Play With Fire,31,27,40,8.0,31,Don't Play With Fire,24.0,21,-9,0,-4,1,down,1982-12-11
21501,Peabo Bryson,1983-05-14,Peabo Bryson - Don't Play With Fire,31,31,43,8.0,40,Don't Play With Fire,24.0,22,-3,-9,0,1,down,1982-12-11
21502,Peabo Bryson,1983-05-21,Peabo Bryson - Don't Play With Fire,40,31,43,8.0,43,Don't Play With Fire,24.0,23,0,-3,-9,0,stay,1982-12-11
21503,Peabo Bryson,1983-05-28,Peabo Bryson - Don't Play With Fire,43,40,51,8.0,43,Don't Play With Fire,24.0,24,-8,0,-3,1,down,1982-12-11
21504,Grace Jones,1982-12-18,Grace Jones - Living My Life,51,51,24,19.0,30,Living My Life,19.0,0,6,21,0,1,up,1982-12-18
21505,Grace Jones,1982-12-25,Grace Jones - Living My Life,30,51,24,19.0,24,Living My Life,19.0,1,0,6,21,0,stay,1982-12-18
21506,Grace Jones,1983-01-01,Grace Jones - Living My Life,24,30,21,19.0,24,Living My Life,19.0,2,3,0,6,1,up,1982-12-18
21507,Grace Jones,1983-01-08,Grace Jones - Living My Life,24,24,19,19.0,21,Living My Life,19.0,3,2,3,0,1,up,1982-12-18
21508,Grace Jones,1983-01-15,Grace Jones - Living My Life,21,24,19,19.0,19,Living My Life,19.0,4,0,2,3,0,stay,1982-12-18
21509,Grace Jones,1983-01-22,Grace Jones - Living My Life,19,21,19,19.0,19,Living My Life,19.0,5,0,0,2,0,stay,1982-12-18
21510,Grace Jones,1983-01-29,Grace Jones - Living My Life,19,19,28,19.0,19,Living My Life,19.0,6,-9,0,0,1,down,1982-12-18
21511,Grace Jones,1983-02-05,Grace Jones - Living My Life,19,19,28,19.0,28,Living My Life,19.0,7,0,-9,0,0,stay,1982-12-18
21512,Grace Jones,1983-02-12,Grace Jones - Living My Life,28,19,28,19.0,28,Living My Life,19.0,8,0,0,-9,0,stay,1982-12-18
21513,Grace Jones,1983-02-19,Grace Jones - Living My Life,28,28,28,19.0,28,Living My Life,19.0,9,0,0,0,0,stay,1982-12-18
21514,Grace Jones,1983-02-26,Grace Jones - Living My Life,28,28,28,19.0,28,Living My Life,19.0,10,0,0,0,0,stay,1982-12-18
21515,Grace Jones,1983-03-05,Grace Jones - Living My Life,28,28,29,19.0,28,Living My Life,19.0,11,-1,0,0,1,down,1982-12-18
21516,Grace Jones,1983-03-12,Grace Jones - Living My Life,28,28,39,19.0,29,Living My Life,19.0,12,-10,-1,0,1,down,1982-12-18
21517,Grace Jones,1983-03-19,Grace Jones - Living My Life,29,28,39,19.0,39,Living My Life,19.0,13,0,-10,-1,0,stay,1982-12-18
21518,Grace Jones,1983-03-26,Grace Jones - Living My Life,39,29,45,19.0,39,Living My Life,19.0,14,-6,0,-10,1,down,1982-12-18
21519,Grace Jones,1983-04-02,Grace Jones - Living My Life,39,39,45,19.0,45,Living My Life,19.0,15,0,-6,0,0,stay,1982-12-18
21520,Grace Jones,1983-04-09,Grace Jones - Living My Life,45,39,49,19.0,45,Living My Life,19.0,16,-4,0,-6,1,down,1982-12-18
21521,Grace Jones,1983-04-16,Grace Jones - Living My Life,45,45,48,19.0,49,Living My Life,19.0,17,1,-4,0,1,up,1982-12-18
21522,Grace Jones,1983-04-23,Grace Jones - Living My Life,49,45,48,19.0,48,Living My Life,19.0,18,0,1,-4,0,stay,1982-12-18
21523,Grace Jones,1983-04-30,Grace Jones - Living My Life,48,49,51,19.0,48,Living My Life,19.0,19,-3,0,1,1,down,1982-12-18
21524,"Grover Washington, Jr.",1982-12-18,"Grover Washington, Jr. - The Best Is Yet To Come",51,51,20,8.0,33,The Best Is Yet To Come,24.0,0,13,18,0,1,up,1982-12-18
21525,"Grover Washington, Jr.",1982-12-25,"Grover Washington, Jr. - The Best Is Yet To Come",33,51,20,8.0,20,The Best Is Yet To Come,24.0,1,0,13,18,0,stay,1982-12-18
21526,"Grover Washington, Jr.",1983-01-01,"Grover Washington, Jr. - The Best Is Yet To Come",20,33,15,8.0,20,The Best Is Yet To Come,24.0,2,5,0,13,1,up,1982-12-18
21527,"Grover Washington, Jr.",1983-01-08,"Grover Washington, Jr. - The Best Is Yet To Come",20,20,11,8.0,15,The Best Is Yet To Come,24.0,3,4,5,0,1,up,1982-12-18
21528,"Grover Washington, Jr.",1983-01-15,"Grover Washington, Jr. - The Best Is Yet To Come",15,20,11,8.0,11,The Best Is Yet To Come,24.0,4,0,4,5,0,stay,1982-12-18
21529,"Grover Washington, Jr.",1983-01-22,"Grover Washington, Jr. - The Best Is Yet To Come",11,15,11,8.0,11,The Best Is Yet To Come,24.0,5,0,0,4,0,stay,1982-12-18
21530,"Grover Washington, Jr.",1983-01-29,"Grover Washington, Jr. - The Best Is Yet To Come",11,11,11,8.0,11,The Best Is Yet To Come,24.0,6,0,0,0,0,stay,1982-12-18
21531,"Grover Washington, Jr.",1983-02-05,"Grover Washington, Jr. - The Best Is Yet To Come",11,11,10,8.0,11,The Best Is Yet To Come,24.0,7,1,0,0,1,up,1982-12-18
21532,"Grover Washington, Jr.",1983-02-12,"Grover Washington, Jr. - The Best Is Yet To Come",11,11,8,8.0,10,The Best Is Yet To Come,24.0,8,2,1,0,1,up,1982-12-18
21533,"Grover Washington, Jr.",1983-02-19,"Grover Washington, Jr. - The Best Is Yet To Come",10,11,8,8.0,8,The Best Is Yet To Come,24.0,9,0,2,1,0,stay,1982-12-18
21534,"Grover Washington, Jr.",1983-02-26,"Grover Washington, Jr. - The Best Is Yet To Come",8,10,14,8.0,8,The Best Is Yet To Come,24.0,10,-6,0,2,1,down,1982-12-18
21535,"Grover Washington, Jr.",1983-03-05,"Grover Washington, Jr. - The Best Is Yet To Come",8,8,14,8.0,14,The Best Is Yet To Come,24.0,11,0,-6,0,0,stay,1982-12-18
21536,"Grover Washington, Jr.",1983-03-12,"Grover Washington, Jr. - The Best Is Yet To Come",14,8,16,8.0,14,The Best Is Yet To Come,24.0,12,-2,0,-6,1,down,1982-12-18
21537,"Grover Washington, Jr.",1983-03-19,"Grover Washington, Jr. - The Best Is Yet To Come",14,14,16,8.0,16,The Best Is Yet To Come,24.0,13,0,-2,0,0,stay,1982-12-18
21538,"Grover Washington, Jr.",1983-03-26,"Grover Washington, Jr. - The Best Is Yet To Come",16,14,16,8.0,16,The Best Is Yet To Come,24.0,14,0,0,-2,0,stay,1982-12-18
21539,"Grover Washington, Jr.",1983-04-02,"Grover Washington, Jr. - The Best Is Yet To Come",16,16,20,8.0,16,The Best Is Yet To Come,24.0,15,-4,0,0,1,down,1982-12-18
21540,"Grover Washington, Jr.",1983-04-09,"Grover Washington, Jr. - The Best Is Yet To Come",16,16,21,8.0,20,The Best Is Yet To Come,24.0,16,-1,-4,0,1,down,1982-12-18
21541,"Grover Washington, Jr.",1983-04-16,"Grover Washington, Jr. - The Best Is Yet To Come",20,16,24,8.0,21,The Best Is Yet To Come,24.0,17,-3,-1,-4,1,down,1982-12-18
21542,"Grover Washington, Jr.",1983-04-23,"Grover Washington, Jr. - The Best Is Yet To Come",21,20,24,8.0,24,The Best Is Yet To Come,24.0,18,0,-3,-1,0,stay,1982-12-18
21543,"Grover Washington, Jr.",1983-04-30,"Grover Washington, Jr. - The Best Is Yet To Come",24,21,23,8.0,24,The Best Is Yet To Come,24.0,19,1,0,-3,1,up,1982-12-18
21544,"Grover Washington, Jr.",1983-05-07,"Grover Washington, Jr. - The Best Is Yet To Come",24,24,31,8.0,23,The Best Is Yet To Come,24.0,20,-8,1,0,1,down,1982-12-18
21545,"Grover Washington, Jr.",1983-05-14,"Grover Washington, Jr. - The Best Is Yet To Come",23,24,41,8.0,31,The Best Is Yet To Come,24.0,21,-10,-8,1,1,down,1982-12-18
21546,"Grover Washington, Jr.",1983-05-21,"Grover Washington, Jr. - The Best Is Yet To Come",31,23,48,8.0,41,The Best Is Yet To Come,24.0,22,-7,-10,-8,1,down,1982-12-18
21547,"Grover Washington, Jr.",1983-05-28,"Grover Washington, Jr. - The Best Is Yet To Come",41,31,48,8.0,48,The Best Is Yet To Come,24.0,23,0,-7,-10,0,stay,1982-12-18
21548,"Grover Washington, Jr.",1983-06-04,"Grover Washington, Jr. - The Best Is Yet To Come",48,41,51,8.0,48,The Best Is Yet To Come,24.0,24,-3,0,-7,1,down,1982-12-18
21549,George Clinton,1982-12-18,George Clinton - Computer Games,51,51,23,3.0,34,Computer Games,34.0,0,11,17,0,1,up,1982-12-18
21550,George Clinton,1982-12-25,George Clinton - Computer Games,34,51,23,3.0,23,Computer Games,34.0,1,0,11,17,0,stay,1982-12-18
21551,George Clinton,1983-01-01,George Clinton - Computer Games,23,34,18,3.0,23,Computer Games,34.0,2,5,0,11,1,up,1982-12-18
21552,George Clinton,1983-01-08,George Clinton - Computer Games,23,23,16,3.0,18,Computer Games,34.0,3,2,5,0,1,up,1982-12-18
21553,George Clinton,1983-01-15,George Clinton - Computer Games,18,23,14,3.0,16,Computer Games,34.0,4,2,2,5,1,up,1982-12-18
21554,George Clinton,1983-01-22,George Clinton - Computer Games,16,18,13,3.0,14,Computer Games,34.0,5,1,2,2,1,up,1982-12-18
21555,George Clinton,1983-01-29,George Clinton - Computer Games,14,16,13,3.0,13,Computer Games,34.0,6,0,1,2,0,stay,1982-12-18
21556,George Clinton,1983-02-05,George Clinton - Computer Games,13,14,11,3.0,13,Computer Games,34.0,7,2,0,1,1,up,1982-12-18
21557,George Clinton,1983-02-12,George Clinton - Computer Games,13,13,10,3.0,11,Computer Games,34.0,8,1,2,0,1,up,1982-12-18
21558,George Clinton,1983-02-19,George Clinton - Computer Games,11,13,10,3.0,10,Computer Games,34.0,9,0,1,2,0,stay,1982-12-18
21559,George Clinton,1983-02-26,George Clinton - Computer Games,10,11,7,3.0,10,Computer Games,34.0,10,3,0,1,1,up,1982-12-18
21560,George Clinton,1983-03-05,George Clinton - Computer Games,10,10,5,3.0,7,Computer Games,34.0,11,2,3,0,1,up,1982-12-18
21561,George Clinton,1983-03-12,George Clinton - Computer Games,7,10,4,3.0,5,Computer Games,34.0,12,1,2,3,1,up,1982-12-18
21562,George Clinton,1983-03-19,George Clinton - Computer Games,5,7,4,3.0,4,Computer Games,34.0,13,0,1,2,0,stay,1982-12-18
21563,George Clinton,1983-03-26,George Clinton - Computer Games,4,5,4,3.0,4,Computer Games,34.0,14,0,0,1,0,stay,1982-12-18
21564,George Clinton,1983-04-02,George Clinton - Computer Games,4,4,3,3.0,4,Computer Games,34.0,15,1,0,0,1,up,1982-12-18
21565,George Clinton,1983-04-09,George Clinton - Computer Games,4,4,3,3.0,3,Computer Games,34.0,16,0,1,0,0,stay,1982-12-18
21566,George Clinton,1983-04-16,George Clinton - Computer Games,3,4,3,3.0,3,Computer Games,34.0,17,0,0,1,0,stay,1982-12-18
21567,George Clinton,1983-04-23,George Clinton - Computer Games,3,3,3,3.0,3,Computer Games,34.0,18,0,0,0,0,stay,1982-12-18
21568,George Clinton,1983-04-30,George Clinton - Computer Games,3,3,3,3.0,3,Computer Games,34.0,19,0,0,0,0,stay,1982-12-18
21569,George Clinton,1983-05-07,George Clinton - Computer Games,3,3,3,3.0,3,Computer Games,34.0,20,0,0,0,0,stay,1982-12-18
21570,George Clinton,1983-05-14,George Clinton - Computer Games,3,3,3,3.0,3,Computer Games,34.0,21,0,0,0,0,stay,1982-12-18
21571,George Clinton,1983-05-21,George Clinton - Computer Games,3,3,5,3.0,3,Computer Games,34.0,22,-2,0,0,1,down,1982-12-18
21572,George Clinton,1983-05-28,George Clinton - Computer Games,3,3,11,3.0,5,Computer Games,34.0,23,-6,-2,0,1,down,1982-12-18
21573,George Clinton,1983-06-04,George Clinton - Computer Games,5,3,15,3.0,11,Computer Games,34.0,24,-4,-6,-2,1,down,1982-12-18
21574,George Clinton,1983-06-11,George Clinton - Computer Games,11,5,17,3.0,15,Computer Games,34.0,25,-2,-4,-6,1,down,1982-12-18
21575,George Clinton,1983-06-18,George Clinton - Computer Games,15,11,18,3.0,17,Computer Games,34.0,26,-1,-2,-4,1,down,1982-12-18
21576,George Clinton,1983-06-25,George Clinton - Computer Games,17,15,24,3.0,18,Computer Games,34.0,27,-6,-1,-2,1,down,1982-12-18
21577,George Clinton,1983-07-02,George Clinton - Computer Games,18,17,28,3.0,24,Computer Games,34.0,28,-4,-6,-1,1,down,1982-12-18
21578,George Clinton,1983-07-09,George Clinton - Computer Games,24,18,29,3.0,28,Computer Games,34.0,29,-1,-4,-6,1,down,1982-12-18
21579,George Clinton,1983-07-16,George Clinton - Computer Games,28,24,29,3.0,29,Computer Games,34.0,30,0,-1,-4,0,stay,1982-12-18
21580,George Clinton,1983-07-23,George Clinton - Computer Games,29,28,30,3.0,29,Computer Games,34.0,31,-1,0,-1,1,down,1982-12-18
21581,George Clinton,1983-07-30,George Clinton - Computer Games,29,29,37,3.0,30,Computer Games,34.0,32,-7,-1,0,1,down,1982-12-18
21582,George Clinton,1983-08-06,George Clinton - Computer Games,30,29,49,3.0,37,Computer Games,34.0,33,-12,-7,-1,1,down,1982-12-18
21583,George Clinton,1983-08-13,George Clinton - Computer Games,37,30,51,3.0,49,Computer Games,34.0,34,-2,-12,-7,1,down,1982-12-18
21584,Ray Parker Jr.,1982-12-18,Ray Parker Jr. - Greatest Hits,51,51,31,17.0,41,Greatest Hits,20.0,0,10,10,0,1,up,1982-12-18
21585,Ray Parker Jr.,1982-12-25,Ray Parker Jr. - Greatest Hits,41,51,31,17.0,31,Greatest Hits,20.0,1,0,10,10,0,stay,1982-12-18
21586,Ray Parker Jr.,1983-01-01,Ray Parker Jr. - Greatest Hits,31,41,20,17.0,31,Greatest Hits,20.0,2,11,0,10,1,up,1982-12-18
21587,Ray Parker Jr.,1983-01-08,Ray Parker Jr. - Greatest Hits,31,31,18,17.0,20,Greatest Hits,20.0,3,2,11,0,1,up,1982-12-18
21588,Ray Parker Jr.,1983-01-15,Ray Parker Jr. - Greatest Hits,20,31,18,17.0,18,Greatest Hits,20.0,4,0,2,11,0,stay,1982-12-18
21589,Ray Parker Jr.,1983-01-22,Ray Parker Jr. - Greatest Hits,18,20,17,17.0,18,Greatest Hits,20.0,5,1,0,2,1,up,1982-12-18
21590,Ray Parker Jr.,1983-01-29,Ray Parker Jr. - Greatest Hits,18,18,17,17.0,17,Greatest Hits,20.0,6,0,1,0,0,stay,1982-12-18
21591,Ray Parker Jr.,1983-02-05,Ray Parker Jr. - Greatest Hits,17,18,19,17.0,17,Greatest Hits,20.0,7,-2,0,1,1,down,1982-12-18
21592,Ray Parker Jr.,1983-02-12,Ray Parker Jr. - Greatest Hits,17,17,19,17.0,19,Greatest Hits,20.0,8,0,-2,0,0,stay,1982-12-18
21593,Ray Parker Jr.,1983-02-19,Ray Parker Jr. - Greatest Hits,19,17,20,17.0,19,Greatest Hits,20.0,9,-1,0,-2,1,down,1982-12-18
21594,Ray Parker Jr.,1983-02-26,Ray Parker Jr. - Greatest Hits,19,19,21,17.0,20,Greatest Hits,20.0,10,-1,-1,0,1,down,1982-12-18
21595,Ray Parker Jr.,1983-03-05,Ray Parker Jr. - Greatest Hits,20,19,23,17.0,21,Greatest Hits,20.0,11,-2,-1,-1,1,down,1982-12-18
21596,Ray Parker Jr.,1983-03-12,Ray Parker Jr. - Greatest Hits,21,20,23,17.0,23,Greatest Hits,20.0,12,0,-2,-1,0,stay,1982-12-18
21597,Ray Parker Jr.,1983-03-19,Ray Parker Jr. - Greatest Hits,23,21,22,17.0,23,Greatest Hits,20.0,13,1,0,-2,1,up,1982-12-18
21598,Ray Parker Jr.,1983-03-26,Ray Parker Jr. - Greatest Hits,23,23,28,17.0,22,Greatest Hits,20.0,14,-6,1,0,1,down,1982-12-18
21599,Ray Parker Jr.,1983-04-02,Ray Parker Jr. - Greatest Hits,22,23,36,17.0,28,Greatest Hits,20.0,15,-8,-6,1,1,down,1982-12-18
21600,Ray Parker Jr.,1983-04-09,Ray Parker Jr. - Greatest Hits,28,22,36,17.0,36,Greatest Hits,20.0,16,0,-8,-6,0,stay,1982-12-18
21601,Ray Parker Jr.,1983-04-16,Ray Parker Jr. - Greatest Hits,36,28,36,17.0,36,Greatest Hits,20.0,17,0,0,-8,0,stay,1982-12-18
21602,Ray Parker Jr.,1983-04-23,Ray Parker Jr. - Greatest Hits,36,36,41,17.0,36,Greatest Hits,20.0,18,-5,0,0,1,down,1982-12-18
21603,Ray Parker Jr.,1983-04-30,Ray Parker Jr. - Greatest Hits,36,36,48,17.0,41,Greatest Hits,20.0,19,-7,-5,0,1,down,1982-12-18
21604,Ray Parker Jr.,1983-05-07,Ray Parker Jr. - Greatest Hits,41,36,51,17.0,48,Greatest Hits,20.0,20,-3,-7,-5,1,down,1982-12-18
21605,Chic,1982-12-18,Chic - Tongue In Chic,51,51,47,47.0,50,Tongue In Chic,3.0,0,3,1,0,1,up,1982-12-18
21606,Chic,1982-12-25,Chic - Tongue In Chic,50,51,47,47.0,47,Tongue In Chic,3.0,1,0,3,1,0,stay,1982-12-18
21607,Chic,1983-01-01,Chic - Tongue In Chic,47,50,47,47.0,47,Tongue In Chic,3.0,2,0,0,3,0,stay,1982-12-18
21608,Chic,1983-01-08,Chic - Tongue In Chic,47,47,51,47.0,47,Tongue In Chic,3.0,3,-4,0,0,1,down,1982-12-18
21609,Michael Jackson,1982-12-25,Michael Jackson - Thriller,51,51,14,1.0,14,Thriller,96.0,0,0,37,0,0,stay,1982-12-25
21610,Michael Jackson,1983-01-01,Michael Jackson - Thriller,14,51,5,1.0,14,Thriller,96.0,1,9,0,37,1,up,1982-12-25
21611,Michael Jackson,1983-01-08,Michael Jackson - Thriller,14,14,5,1.0,5,Thriller,96.0,2,0,9,0,0,stay,1982-12-25
21612,Michael Jackson,1983-01-15,Michael Jackson - Thriller,5,14,3,1.0,5,Thriller,96.0,3,2,0,9,1,up,1982-12-25
21613,Michael Jackson,1983-01-22,Michael Jackson - Thriller,5,5,1,1.0,3,Thriller,96.0,4,2,2,0,1,up,1982-12-25
21614,Michael Jackson,1983-01-29,Michael Jackson - Thriller,3,5,1,1.0,1,Thriller,96.0,5,0,2,2,0,stay,1982-12-25
21615,Michael Jackson,1983-02-05,Michael Jackson - Thriller,1,3,1,1.0,1,Thriller,96.0,6,0,0,2,0,stay,1982-12-25
21616,Michael Jackson,1983-02-12,Michael Jackson - Thriller,1,1,1,1.0,1,Thriller,96.0,7,0,0,0,0,stay,1982-12-25
21617,Michael Jackson,1983-02-19,Michael Jackson - Thriller,1,1,1,1.0,1,Thriller,96.0,8,0,0,0,0,stay,1982-12-25
21618,Michael Jackson,1983-02-26,Michael Jackson - Thriller,1,1,1,1.0,1,Thriller,96.0,9,0,0,0,0,stay,1982-12-25
21619,Michael Jackson,1983-03-05,Michael Jackson - Thriller,1,1,1,1.0,1,Thriller,96.0,10,0,0,0,0,stay,1982-12-25
21620,Michael Jackson,1983-03-12,Michael Jackson - Thriller,1,1,1,1.0,1,Thriller,96.0,11,0,0,0,0,stay,1982-12-25
21621,Michael Jackson,1983-03-19,Michael Jackson - Thriller,1,1,1,1.0,1,Thriller,96.0,12,0,0,0,0,stay,1982-12-25
21622,Michael Jackson,1983-03-26,Michael Jackson - Thriller,1,1,1,1.0,1,Thriller,96.0,13,0,0,0,0,stay,1982-12-25
21623,Michael Jackson,1983-04-02,Michael Jackson - Thriller,1,1,1,1.0,1,Thriller,96.0,14,0,0,0,0,stay,1982-12-25
21624,Michael Jackson,1983-04-09,Michael Jackson - Thriller,1,1,1,1.0,1,Thriller,96.0,15,0,0,0,0,stay,1982-12-25
21625,Michael Jackson,1983-04-16,Michael Jackson - Thriller,1,1,1,1.0,1,Thriller,96.0,16,0,0,0,0,stay,1982-12-25
21626,Michael Jackson,1983-04-23,Michael Jackson - Thriller,1,1,1,1.0,1,Thriller,96.0,17,0,0,0,0,stay,1982-12-25
21627,Michael Jackson,1983-04-30,Michael Jackson - Thriller,1,1,1,1.0,1,Thriller,96.0,18,0,0,0,0,stay,1982-12-25
21628,Michael Jackson,1983-05-07,Michael Jackson - Thriller,1,1,1,1.0,1,Thriller,96.0,19,0,0,0,0,stay,1982-12-25
21629,Michael Jackson,1983-05-14,Michael Jackson - Thriller,1,1,1,1.0,1,Thriller,96.0,20,0,0,0,0,stay,1982-12-25
21630,Michael Jackson,1983-05-21,Michael Jackson - Thriller,1,1,1,1.0,1,Thriller,96.0,21,0,0,0,0,stay,1982-12-25
21631,Michael Jackson,1983-05-28,Michael Jackson - Thriller,1,1,1,1.0,1,Thriller,96.0,22,0,0,0,0,stay,1982-12-25
21632,Michael Jackson,1983-06-04,Michael Jackson - Thriller,1,1,1,1.0,1,Thriller,96.0,23,0,0,0,0,stay,1982-12-25
21633,Michael Jackson,1983-06-11,Michael Jackson - Thriller,1,1,1,1.0,1,Thriller,96.0,24,0,0,0,0,stay,1982-12-25
21634,Michael Jackson,1983-06-18,Michael Jackson - Thriller,1,1,1,1.0,1,Thriller,96.0,25,0,0,0,0,stay,1982-12-25
21635,Michael Jackson,1983-06-25,Michael Jackson - Thriller,1,1,1,1.0,1,Thriller,96.0,26,0,0,0,0,stay,1982-12-25
21636,Michael Jackson,1983-07-02,Michael Jackson - Thriller,1,1,1,1.0,1,Thriller,96.0,27,0,0,0,0,stay,1982-12-25
21637,Michael Jackson,1983-07-09,Michael Jackson - Thriller,1,1,1,1.0,1,Thriller,96.0,28,0,0,0,0,stay,1982-12-25
21638,Michael Jackson,1983-07-16,Michael Jackson - Thriller,1,1,2,1.0,1,Thriller,96.0,29,-1,0,0,1,down,1982-12-25
21639,Michael Jackson,1983-07-23,Michael Jackson - Thriller,1,1,1,1.0,2,Thriller,96.0,30,1,-1,0,1,up,1982-12-25
21640,Michael Jackson,1983-07-30,Michael Jackson - Thriller,2,1,1,1.0,1,Thriller,96.0,31,0,1,-1,0,stay,1982-12-25
21641,Michael Jackson,1983-08-06,Michael Jackson - Thriller,1,2,1,1.0,1,Thriller,96.0,32,0,0,1,0,stay,1982-12-25
21642,Michael Jackson,1983-08-13,Michael Jackson - Thriller,1,1,1,1.0,1,Thriller,96.0,33,0,0,0,0,stay,1982-12-25
21643,Michael Jackson,1983-08-20,Michael Jackson - Thriller,1,1,1,1.0,1,Thriller,96.0,34,0,0,0,0,stay,1982-12-25
21644,Michael Jackson,1983-08-27,Michael Jackson - Thriller,1,1,1,1.0,1,Thriller,96.0,35,0,0,0,0,stay,1982-12-25
21645,Michael Jackson,1983-09-03,Michael Jackson - Thriller,1,1,1,1.0,1,Thriller,96.0,36,0,0,0,0,stay,1982-12-25
21646,Michael Jackson,1983-09-10,Michael Jackson - Thriller,1,1,2,1.0,1,Thriller,96.0,37,-1,0,0,1,down,1982-12-25
21647,Michael Jackson,1983-09-17,Michael Jackson - Thriller,1,1,2,1.0,2,Thriller,96.0,38,0,-1,0,0,stay,1982-12-25
21648,Michael Jackson,1983-09-24,Michael Jackson - Thriller,2,1,2,1.0,2,Thriller,96.0,39,0,0,-1,0,stay,1982-12-25
21649,Michael Jackson,1983-10-01,Michael Jackson - Thriller,2,2,2,1.0,2,Thriller,96.0,40,0,0,0,0,stay,1982-12-25
21650,Michael Jackson,1983-10-08,Michael Jackson - Thriller,2,2,4,1.0,2,Thriller,96.0,41,-2,0,0,1,down,1982-12-25
21651,Michael Jackson,1983-10-15,Michael Jackson - Thriller,2,2,3,1.0,4,Thriller,96.0,42,1,-2,0,1,up,1982-12-25
21652,Michael Jackson,1983-10-22,Michael Jackson - Thriller,4,2,3,1.0,3,Thriller,96.0,43,0,1,-2,0,stay,1982-12-25
21653,Michael Jackson,1983-10-29,Michael Jackson - Thriller,3,4,3,1.0,3,Thriller,96.0,44,0,0,1,0,stay,1982-12-25
21654,Michael Jackson,1983-11-05,Michael Jackson - Thriller,3,3,5,1.0,3,Thriller,96.0,45,-2,0,0,1,down,1982-12-25
21655,Michael Jackson,1983-11-12,Michael Jackson - Thriller,3,3,5,1.0,5,Thriller,96.0,46,0,-2,0,0,stay,1982-12-25
21656,Michael Jackson,1983-11-19,Michael Jackson - Thriller,5,3,7,1.0,5,Thriller,96.0,47,-2,0,-2,1,down,1982-12-25
21657,Michael Jackson,1983-11-26,Michael Jackson - Thriller,5,5,7,1.0,7,Thriller,96.0,48,0,-2,0,0,stay,1982-12-25
21658,Michael Jackson,1983-12-03,Michael Jackson - Thriller,7,5,6,1.0,7,Thriller,96.0,49,1,0,-2,1,up,1982-12-25
21659,Michael Jackson,1983-12-10,Michael Jackson - Thriller,7,7,6,1.0,6,Thriller,96.0,50,0,1,0,0,stay,1982-12-25
21660,Michael Jackson,1983-12-17,Michael Jackson - Thriller,6,7,6,1.0,6,Thriller,96.0,51,0,0,1,0,stay,1982-12-25
21661,Michael Jackson,1983-12-24,Michael Jackson - Thriller,6,6,6,1.0,6,Thriller,96.0,52,0,0,0,0,stay,1982-12-25
21662,Michael Jackson,1983-12-31,Michael Jackson - Thriller,6,6,4,1.0,6,Thriller,96.0,53,2,0,0,1,up,1982-12-25
21663,Michael Jackson,1984-01-07,Michael Jackson - Thriller,6,6,3,1.0,4,Thriller,96.0,54,1,2,0,1,up,1982-12-25
21664,Michael Jackson,1984-01-14,Michael Jackson - Thriller,4,6,3,1.0,3,Thriller,96.0,55,0,1,2,0,stay,1982-12-25
21665,Michael Jackson,1984-01-21,Michael Jackson - Thriller,3,4,3,1.0,3,Thriller,96.0,56,0,0,1,0,stay,1982-12-25
21666,Michael Jackson,1984-01-28,Michael Jackson - Thriller,3,3,3,1.0,3,Thriller,96.0,57,0,0,0,0,stay,1982-12-25
21667,Michael Jackson,1984-02-04,Michael Jackson - Thriller,3,3,2,1.0,3,Thriller,96.0,58,1,0,0,1,up,1982-12-25
21668,Michael Jackson,1984-02-11,Michael Jackson - Thriller,3,3,2,1.0,2,Thriller,96.0,59,0,1,0,0,stay,1982-12-25
21669,Michael Jackson,1984-02-18,Michael Jackson - Thriller,2,3,2,1.0,2,Thriller,96.0,60,0,0,1,0,stay,1982-12-25
21670,Michael Jackson,1984-02-25,Michael Jackson - Thriller,2,2,2,1.0,2,Thriller,96.0,61,0,0,0,0,stay,1982-12-25
21671,Michael Jackson,1984-03-03,Michael Jackson - Thriller,2,2,1,1.0,2,Thriller,96.0,62,1,0,0,1,up,1982-12-25
21672,Michael Jackson,1984-03-10,Michael Jackson - Thriller,2,2,1,1.0,1,Thriller,96.0,63,0,1,0,0,stay,1982-12-25
21673,Michael Jackson,1984-03-17,Michael Jackson - Thriller,1,2,1,1.0,1,Thriller,96.0,64,0,0,1,0,stay,1982-12-25
21674,Michael Jackson,1984-03-24,Michael Jackson - Thriller,1,1,1,1.0,1,Thriller,96.0,65,0,0,0,0,stay,1982-12-25
21675,Michael Jackson,1984-03-31,Michael Jackson - Thriller,1,1,1,1.0,1,Thriller,96.0,66,0,0,0,0,stay,1982-12-25
21676,Michael Jackson,1984-04-07,Michael Jackson - Thriller,1,1,2,1.0,1,Thriller,96.0,67,-1,0,0,1,down,1982-12-25
21677,Michael Jackson,1984-04-14,Michael Jackson - Thriller,1,1,3,1.0,2,Thriller,96.0,68,-1,-1,0,1,down,1982-12-25
21678,Michael Jackson,1984-04-21,Michael Jackson - Thriller,2,1,4,1.0,3,Thriller,96.0,69,-1,-1,-1,1,down,1982-12-25
21679,Michael Jackson,1984-04-28,Michael Jackson - Thriller,3,2,5,1.0,4,Thriller,96.0,70,-1,-1,-1,1,down,1982-12-25
21680,Michael Jackson,1984-05-05,Michael Jackson - Thriller,4,3,5,1.0,5,Thriller,96.0,71,0,-1,-1,0,stay,1982-12-25
21681,Michael Jackson,1984-05-12,Michael Jackson - Thriller,5,4,5,1.0,5,Thriller,96.0,72,0,0,-1,0,stay,1982-12-25
21682,Michael Jackson,1984-05-19,Michael Jackson - Thriller,5,5,5,1.0,5,Thriller,96.0,73,0,0,0,0,stay,1982-12-25
21683,Michael Jackson,1984-05-26,Michael Jackson - Thriller,5,5,10,1.0,5,Thriller,96.0,74,-5,0,0,1,down,1982-12-25
21684,Michael Jackson,1984-06-02,Michael Jackson - Thriller,5,5,8,1.0,10,Thriller,96.0,75,2,-5,0,1,up,1982-12-25
21685,Michael Jackson,1984-06-09,Michael Jackson - Thriller,10,5,8,1.0,8,Thriller,96.0,76,0,2,-5,0,stay,1982-12-25
21686,Michael Jackson,1984-06-16,Michael Jackson - Thriller,8,10,16,1.0,8,Thriller,96.0,77,-8,0,2,1,down,1982-12-25
21687,Michael Jackson,1984-06-23,Michael Jackson - Thriller,8,8,21,1.0,16,Thriller,96.0,78,-5,-8,0,1,down,1982-12-25
21688,Michael Jackson,1984-06-30,Michael Jackson - Thriller,16,8,21,1.0,21,Thriller,96.0,79,0,-5,-8,0,stay,1982-12-25
21689,Michael Jackson,1984-07-07,Michael Jackson - Thriller,21,16,21,1.0,21,Thriller,96.0,80,0,0,-5,0,stay,1982-12-25
21690,Michael Jackson,1984-07-14,Michael Jackson - Thriller,21,21,22,1.0,21,Thriller,96.0,81,-1,0,0,1,down,1982-12-25
21691,Michael Jackson,1984-07-21,Michael Jackson - Thriller,21,21,28,1.0,22,Thriller,96.0,82,-6,-1,0,1,down,1982-12-25
21692,Michael Jackson,1984-07-28,Michael Jackson - Thriller,22,21,33,1.0,28,Thriller,96.0,83,-5,-6,-1,1,down,1982-12-25
21693,Michael Jackson,1984-08-04,Michael Jackson - Thriller,28,22,32,1.0,33,Thriller,96.0,84,1,-5,-6,1,up,1982-12-25
21694,Michael Jackson,1984-08-11,Michael Jackson - Thriller,33,28,31,1.0,32,Thriller,96.0,85,1,1,-5,1,up,1982-12-25
21695,Michael Jackson,1984-08-18,Michael Jackson - Thriller,32,33,32,1.0,31,Thriller,96.0,86,-1,1,1,1,down,1982-12-25
21696,Michael Jackson,1984-08-25,Michael Jackson - Thriller,31,32,34,1.0,32,Thriller,96.0,87,-2,-1,1,1,down,1982-12-25
21697,Michael Jackson,1984-09-01,Michael Jackson - Thriller,32,31,34,1.0,34,Thriller,96.0,88,0,-2,-1,0,stay,1982-12-25
21698,Michael Jackson,1984-09-08,Michael Jackson - Thriller,34,32,42,1.0,34,Thriller,96.0,89,-8,0,-2,1,down,1982-12-25
21699,Michael Jackson,1984-09-15,Michael Jackson - Thriller,34,34,42,1.0,42,Thriller,96.0,90,0,-8,0,0,stay,1982-12-25
21700,Michael Jackson,1984-09-22,Michael Jackson - Thriller,42,34,41,1.0,42,Thriller,96.0,91,1,0,-8,1,up,1982-12-25
21701,Michael Jackson,1984-09-29,Michael Jackson - Thriller,42,42,45,1.0,41,Thriller,96.0,92,-4,1,0,1,down,1982-12-25
21702,Michael Jackson,1984-10-06,Michael Jackson - Thriller,41,42,50,1.0,45,Thriller,96.0,93,-5,-4,1,1,down,1982-12-25
21703,Michael Jackson,1984-10-20,Michael Jackson - Thriller,45,41,50,1.0,50,Thriller,96.0,94,0,-5,-4,0,stay,1982-12-25
21704,Michael Jackson,1984-10-27,Michael Jackson - Thriller,50,45,49,1.0,50,Thriller,96.0,95,1,0,-5,1,up,1982-12-25
21705,Michael Jackson,1984-11-03,Michael Jackson - Thriller,50,50,51,1.0,49,Thriller,96.0,96,-2,1,0,1,down,1982-12-25
21706,Chaka Khan,1982-12-25,Chaka Khan - Chaka Khan,51,51,21,5.0,21,Chaka Khan,19.0,0,0,30,0,0,stay,1982-12-25
21707,Chaka Khan,1983-01-01,Chaka Khan - Chaka Khan,21,51,12,5.0,21,Chaka Khan,19.0,1,9,0,30,1,up,1982-12-25
21708,Chaka Khan,1983-01-08,Chaka Khan - Chaka Khan,21,21,10,5.0,12,Chaka Khan,19.0,2,2,9,0,1,up,1982-12-25
21709,Chaka Khan,1983-01-15,Chaka Khan - Chaka Khan,12,21,7,5.0,10,Chaka Khan,19.0,3,3,2,9,1,up,1982-12-25
21710,Chaka Khan,1983-01-22,Chaka Khan - Chaka Khan,10,12,5,5.0,7,Chaka Khan,19.0,4,2,3,2,1,up,1982-12-25
21711,Chaka Khan,1983-01-29,Chaka Khan - Chaka Khan,7,10,5,5.0,5,Chaka Khan,19.0,5,0,2,3,0,stay,1982-12-25
21712,Chaka Khan,1983-02-05,Chaka Khan - Chaka Khan,5,7,5,5.0,5,Chaka Khan,19.0,6,0,0,2,0,stay,1982-12-25
21713,Chaka Khan,1983-02-12,Chaka Khan - Chaka Khan,5,5,5,5.0,5,Chaka Khan,19.0,7,0,0,0,0,stay,1982-12-25
21714,Chaka Khan,1983-02-19,Chaka Khan - Chaka Khan,5,5,6,5.0,5,Chaka Khan,19.0,8,-1,0,0,1,down,1982-12-25
21715,Chaka Khan,1983-02-26,Chaka Khan - Chaka Khan,5,5,15,5.0,6,Chaka Khan,19.0,9,-9,-1,0,1,down,1982-12-25
21716,Chaka Khan,1983-03-05,Chaka Khan - Chaka Khan,6,5,15,5.0,15,Chaka Khan,19.0,10,0,-9,-1,0,stay,1982-12-25
21717,Chaka Khan,1983-03-12,Chaka Khan - Chaka Khan,15,6,19,5.0,15,Chaka Khan,19.0,11,-4,0,-9,1,down,1982-12-25
21718,Chaka Khan,1983-03-19,Chaka Khan - Chaka Khan,15,15,19,5.0,19,Chaka Khan,19.0,12,0,-4,0,0,stay,1982-12-25
21719,Chaka Khan,1983-03-26,Chaka Khan - Chaka Khan,19,15,22,5.0,19,Chaka Khan,19.0,13,-3,0,-4,1,down,1982-12-25
21720,Chaka Khan,1983-04-02,Chaka Khan - Chaka Khan,19,19,22,5.0,22,Chaka Khan,19.0,14,0,-3,0,0,stay,1982-12-25
21721,Chaka Khan,1983-04-09,Chaka Khan - Chaka Khan,22,19,27,5.0,22,Chaka Khan,19.0,15,-5,0,-3,1,down,1982-12-25
21722,Chaka Khan,1983-04-16,Chaka Khan - Chaka Khan,22,22,34,5.0,27,Chaka Khan,19.0,16,-7,-5,0,1,down,1982-12-25
21723,Chaka Khan,1983-04-23,Chaka Khan - Chaka Khan,27,22,34,5.0,34,Chaka Khan,19.0,17,0,-7,-5,0,stay,1982-12-25
21724,Chaka Khan,1983-04-30,Chaka Khan - Chaka Khan,34,27,37,5.0,34,Chaka Khan,19.0,18,-3,0,-7,1,down,1982-12-25
21725,Chaka Khan,1983-05-07,Chaka Khan - Chaka Khan,34,34,51,5.0,37,Chaka Khan,19.0,19,-14,-3,0,1,down,1982-12-25
21726,Z.Z. Hill,1982-12-25,Z.Z. Hill - The Rhythm And The Blues,51,51,42,16.0,42,The Rhythm And The Blues,41.0,0,0,9,0,0,stay,1982-12-25
21727,Z.Z. Hill,1983-01-01,Z.Z. Hill - The Rhythm And The Blues,42,51,32,16.0,42,The Rhythm And The Blues,41.0,1,10,0,9,1,up,1982-12-25
21728,Z.Z. Hill,1983-01-08,Z.Z. Hill - The Rhythm And The Blues,42,42,27,16.0,32,The Rhythm And The Blues,41.0,2,5,10,0,1,up,1982-12-25
21729,Z.Z. Hill,1983-01-15,Z.Z. Hill - The Rhythm And The Blues,32,42,25,16.0,27,The Rhythm And The Blues,41.0,3,2,5,10,1,up,1982-12-25
21730,Z.Z. Hill,1983-01-22,Z.Z. Hill - The Rhythm And The Blues,27,32,21,16.0,25,The Rhythm And The Blues,41.0,4,4,2,5,1,up,1982-12-25
21731,Z.Z. Hill,1983-01-29,Z.Z. Hill - The Rhythm And The Blues,25,27,21,16.0,21,The Rhythm And The Blues,41.0,5,0,4,2,0,stay,1982-12-25
21732,Z.Z. Hill,1983-02-05,Z.Z. Hill - The Rhythm And The Blues,21,25,20,16.0,21,The Rhythm And The Blues,41.0,6,1,0,4,1,up,1982-12-25
21733,Z.Z. Hill,1983-02-12,Z.Z. Hill - The Rhythm And The Blues,21,21,24,16.0,20,The Rhythm And The Blues,41.0,7,-4,1,0,1,down,1982-12-25
21734,Z.Z. Hill,1983-02-19,Z.Z. Hill - The Rhythm And The Blues,20,21,22,16.0,24,The Rhythm And The Blues,41.0,8,2,-4,1,1,up,1982-12-25
21735,Z.Z. Hill,1983-02-26,Z.Z. Hill - The Rhythm And The Blues,24,20,20,16.0,22,The Rhythm And The Blues,41.0,9,2,2,-4,1,up,1982-12-25
21736,Z.Z. Hill,1983-03-05,Z.Z. Hill - The Rhythm And The Blues,22,24,18,16.0,20,The Rhythm And The Blues,41.0,10,2,2,2,1,up,1982-12-25
21737,Z.Z. Hill,1983-03-12,Z.Z. Hill - The Rhythm And The Blues,20,22,18,16.0,18,The Rhythm And The Blues,41.0,11,0,2,2,0,stay,1982-12-25
21738,Z.Z. Hill,1983-03-19,Z.Z. Hill - The Rhythm And The Blues,18,20,18,16.0,18,The Rhythm And The Blues,41.0,12,0,0,2,0,stay,1982-12-25
21739,Z.Z. Hill,1983-03-26,Z.Z. Hill - The Rhythm And The Blues,18,18,18,16.0,18,The Rhythm And The Blues,41.0,13,0,0,0,0,stay,1982-12-25
21740,Z.Z. Hill,1983-04-02,Z.Z. Hill - The Rhythm And The Blues,18,18,16,16.0,18,The Rhythm And The Blues,41.0,14,2,0,0,1,up,1982-12-25
21741,Z.Z. Hill,1983-04-09,Z.Z. Hill - The Rhythm And The Blues,18,18,16,16.0,16,The Rhythm And The Blues,41.0,15,0,2,0,0,stay,1982-12-25
21742,Z.Z. Hill,1983-04-16,Z.Z. Hill - The Rhythm And The Blues,16,18,16,16.0,16,The Rhythm And The Blues,41.0,16,0,0,2,0,stay,1982-12-25
21743,Z.Z. Hill,1983-04-23,Z.Z. Hill - The Rhythm And The Blues,16,16,16,16.0,16,The Rhythm And The Blues,41.0,17,0,0,0,0,stay,1982-12-25
21744,Z.Z. Hill,1983-04-30,Z.Z. Hill - The Rhythm And The Blues,16,16,18,16.0,16,The Rhythm And The Blues,41.0,18,-2,0,0,1,down,1982-12-25
21745,Z.Z. Hill,1983-05-07,Z.Z. Hill - The Rhythm And The Blues,16,16,18,16.0,18,The Rhythm And The Blues,41.0,19,0,-2,0,0,stay,1982-12-25
21746,Z.Z. Hill,1983-05-14,Z.Z. Hill - The Rhythm And The Blues,18,16,18,16.0,18,The Rhythm And The Blues,41.0,20,0,0,-2,0,stay,1982-12-25
21747,Z.Z. Hill,1983-05-21,Z.Z. Hill - The Rhythm And The Blues,18,18,20,16.0,18,The Rhythm And The Blues,41.0,21,-2,0,0,1,down,1982-12-25
21748,Z.Z. Hill,1983-05-28,Z.Z. Hill - The Rhythm And The Blues,18,18,25,16.0,20,The Rhythm And The Blues,41.0,22,-5,-2,0,1,down,1982-12-25
21749,Z.Z. Hill,1983-06-04,Z.Z. Hill - The Rhythm And The Blues,20,18,26,16.0,25,The Rhythm And The Blues,41.0,23,-1,-5,-2,1,down,1982-12-25
21750,Z.Z. Hill,1983-06-11,Z.Z. Hill - The Rhythm And The Blues,25,20,26,16.0,26,The Rhythm And The Blues,41.0,24,0,-1,-5,0,stay,1982-12-25
21751,Z.Z. Hill,1983-06-18,Z.Z. Hill - The Rhythm And The Blues,26,25,27,16.0,26,The Rhythm And The Blues,41.0,25,-1,0,-1,1,down,1982-12-25
21752,Z.Z. Hill,1983-06-25,Z.Z. Hill - The Rhythm And The Blues,26,26,28,16.0,27,The Rhythm And The Blues,41.0,26,-1,-1,0,1,down,1982-12-25
21753,Z.Z. Hill,1983-07-02,Z.Z. Hill - The Rhythm And The Blues,27,26,26,16.0,28,The Rhythm And The Blues,41.0,27,2,-1,-1,1,up,1982-12-25
21754,Z.Z. Hill,1983-07-09,Z.Z. Hill - The Rhythm And The Blues,28,27,26,16.0,26,The Rhythm And The Blues,41.0,28,0,2,-1,0,stay,1982-12-25
21755,Z.Z. Hill,1983-07-16,Z.Z. Hill - The Rhythm And The Blues,26,28,30,16.0,26,The Rhythm And The Blues,41.0,29,-4,0,2,1,down,1982-12-25
21756,Z.Z. Hill,1983-07-23,Z.Z. Hill - The Rhythm And The Blues,26,26,28,16.0,30,The Rhythm And The Blues,41.0,30,2,-4,0,1,up,1982-12-25
21757,Z.Z. Hill,1983-07-30,Z.Z. Hill - The Rhythm And The Blues,30,26,28,16.0,28,The Rhythm And The Blues,41.0,31,0,2,-4,0,stay,1982-12-25
21758,Z.Z. Hill,1983-08-06,Z.Z. Hill - The Rhythm And The Blues,28,30,35,16.0,28,The Rhythm And The Blues,41.0,32,-7,0,2,1,down,1982-12-25
21759,Z.Z. Hill,1983-08-13,Z.Z. Hill - The Rhythm And The Blues,28,28,43,16.0,35,The Rhythm And The Blues,41.0,33,-8,-7,0,1,down,1982-12-25
21760,Z.Z. Hill,1983-08-20,Z.Z. Hill - The Rhythm And The Blues,35,28,36,16.0,43,The Rhythm And The Blues,41.0,34,7,-8,-7,1,up,1982-12-25
21761,Z.Z. Hill,1983-08-27,Z.Z. Hill - The Rhythm And The Blues,43,35,35,16.0,36,The Rhythm And The Blues,41.0,35,1,7,-8,1,up,1982-12-25
21762,Z.Z. Hill,1983-09-03,Z.Z. Hill - The Rhythm And The Blues,36,43,41,16.0,35,The Rhythm And The Blues,41.0,36,-6,1,7,1,down,1982-12-25
21763,Z.Z. Hill,1983-09-10,Z.Z. Hill - The Rhythm And The Blues,35,36,48,16.0,41,The Rhythm And The Blues,41.0,37,-7,-6,1,1,down,1982-12-25
21764,Z.Z. Hill,1983-09-17,Z.Z. Hill - The Rhythm And The Blues,41,35,48,16.0,48,The Rhythm And The Blues,41.0,38,0,-7,-6,0,stay,1982-12-25
21765,Z.Z. Hill,1983-10-01,Z.Z. Hill - The Rhythm And The Blues,48,41,47,16.0,48,The Rhythm And The Blues,41.0,39,1,0,-7,1,up,1982-12-25
21766,Z.Z. Hill,1983-10-08,Z.Z. Hill - The Rhythm And The Blues,48,48,47,16.0,47,The Rhythm And The Blues,41.0,40,0,1,0,0,stay,1982-12-25
21767,Z.Z. Hill,1983-10-15,Z.Z. Hill - The Rhythm And The Blues,47,48,51,16.0,47,The Rhythm And The Blues,41.0,41,-4,0,1,1,down,1982-12-25
21768,Sonny Charles,1982-12-25,Sonny Charles - The Sun Still Shines,51,51,43,14.0,43,The Sun Still Shines,9.0,0,0,8,0,0,stay,1982-12-25
21769,Sonny Charles,1983-01-01,Sonny Charles - The Sun Still Shines,43,51,34,14.0,43,The Sun Still Shines,9.0,1,9,0,8,1,up,1982-12-25
21770,Sonny Charles,1983-01-08,Sonny Charles - The Sun Still Shines,43,43,21,14.0,34,The Sun Still Shines,9.0,2,13,9,0,1,up,1982-12-25
21771,Sonny Charles,1983-01-15,Sonny Charles - The Sun Still Shines,34,43,15,14.0,21,The Sun Still Shines,9.0,3,6,13,9,1,up,1982-12-25
21772,Sonny Charles,1983-01-22,Sonny Charles - The Sun Still Shines,21,34,14,14.0,15,The Sun Still Shines,9.0,4,1,6,13,1,up,1982-12-25
21773,Sonny Charles,1983-01-29,Sonny Charles - The Sun Still Shines,15,21,14,14.0,14,The Sun Still Shines,9.0,5,0,1,6,0,stay,1982-12-25
21774,Sonny Charles,1983-02-05,Sonny Charles - The Sun Still Shines,14,15,27,14.0,14,The Sun Still Shines,9.0,6,-13,0,1,1,down,1982-12-25
21775,Sonny Charles,1983-02-12,Sonny Charles - The Sun Still Shines,14,14,38,14.0,27,The Sun Still Shines,9.0,7,-11,-13,0,1,down,1982-12-25
21776,Sonny Charles,1983-02-19,Sonny Charles - The Sun Still Shines,27,14,48,14.0,38,The Sun Still Shines,9.0,8,-10,-11,-13,1,down,1982-12-25
21777,Sonny Charles,1983-02-26,Sonny Charles - The Sun Still Shines,38,27,51,14.0,48,The Sun Still Shines,9.0,9,-3,-10,-11,1,down,1982-12-25
21778,Tyrone Davis,1982-12-25,Tyrone Davis - Tyrone Davis,51,51,46,10.0,46,Tyrone Davis,16.0,0,0,5,0,0,stay,1982-12-25
21779,Tyrone Davis,1983-01-01,Tyrone Davis - Tyrone Davis,46,51,27,10.0,46,Tyrone Davis,16.0,1,19,0,5,1,up,1982-12-25
21780,Tyrone Davis,1983-01-08,Tyrone Davis - Tyrone Davis,46,46,14,10.0,27,Tyrone Davis,16.0,2,13,19,0,1,up,1982-12-25
21781,Tyrone Davis,1983-01-15,Tyrone Davis - Tyrone Davis,27,46,10,10.0,14,Tyrone Davis,16.0,3,4,13,19,1,up,1982-12-25
21782,Tyrone Davis,1983-01-22,Tyrone Davis - Tyrone Davis,14,27,10,10.0,10,Tyrone Davis,16.0,4,0,4,13,0,stay,1982-12-25
21783,Tyrone Davis,1983-01-29,Tyrone Davis - Tyrone Davis,10,14,10,10.0,10,Tyrone Davis,16.0,5,0,0,4,0,stay,1982-12-25
21784,Tyrone Davis,1983-02-05,Tyrone Davis - Tyrone Davis,10,10,25,10.0,10,Tyrone Davis,16.0,6,-15,0,0,1,down,1982-12-25
21785,Tyrone Davis,1983-02-12,Tyrone Davis - Tyrone Davis,10,10,27,10.0,25,Tyrone Davis,16.0,7,-2,-15,0,1,down,1982-12-25
21786,Tyrone Davis,1983-02-19,Tyrone Davis - Tyrone Davis,25,10,27,10.0,27,Tyrone Davis,16.0,8,0,-2,-15,0,stay,1982-12-25
21787,Tyrone Davis,1983-02-26,Tyrone Davis - Tyrone Davis,27,25,27,10.0,27,Tyrone Davis,16.0,9,0,0,-2,0,stay,1982-12-25
21788,Tyrone Davis,1983-03-05,Tyrone Davis - Tyrone Davis,27,27,27,10.0,27,Tyrone Davis,16.0,10,0,0,0,0,stay,1982-12-25
21789,Tyrone Davis,1983-03-12,Tyrone Davis - Tyrone Davis,27,27,27,10.0,27,Tyrone Davis,16.0,11,0,0,0,0,stay,1982-12-25
21790,Tyrone Davis,1983-03-19,Tyrone Davis - Tyrone Davis,27,27,34,10.0,27,Tyrone Davis,16.0,12,-7,0,0,1,down,1982-12-25
21791,Tyrone Davis,1983-03-26,Tyrone Davis - Tyrone Davis,27,27,48,10.0,34,Tyrone Davis,16.0,13,-14,-7,0,1,down,1982-12-25
21792,Tyrone Davis,1983-04-02,Tyrone Davis - Tyrone Davis,34,27,48,10.0,48,Tyrone Davis,16.0,14,0,-14,-7,0,stay,1982-12-25
21793,Tyrone Davis,1983-04-09,Tyrone Davis - Tyrone Davis,48,34,49,10.0,48,Tyrone Davis,16.0,15,-1,0,-14,1,down,1982-12-25
21794,Tyrone Davis,1983-04-23,Tyrone Davis - Tyrone Davis,48,48,51,10.0,49,Tyrone Davis,16.0,16,-2,-1,0,1,down,1982-12-25
21795,Chocolate Milk,1982-12-25,Chocolate Milk - Friction,51,51,50,50.0,50,Friction,2.0,0,0,1,0,0,stay,1982-12-25
21796,Chocolate Milk,1983-01-01,Chocolate Milk - Friction,50,51,50,50.0,50,Friction,2.0,1,0,0,1,0,stay,1982-12-25
21797,Chocolate Milk,1983-01-08,Chocolate Milk - Friction,50,50,51,50.0,50,Friction,2.0,2,-1,0,0,1,down,1982-12-25
21798,Bill Cosby,1983-01-08,"Bill Cosby - Bill Cosby ""Himself""",51,51,36,33.0,41,"Bill Cosby ""Himself""",8.0,0,5,10,0,1,up,1983-01-08
21799,Bill Cosby,1983-01-15,"Bill Cosby - Bill Cosby ""Himself""",41,51,33,33.0,36,"Bill Cosby ""Himself""",8.0,1,3,5,10,1,up,1983-01-08
21800,Bill Cosby,1983-01-22,"Bill Cosby - Bill Cosby ""Himself""",36,41,33,33.0,33,"Bill Cosby ""Himself""",8.0,2,0,3,5,0,stay,1983-01-08
21801,Bill Cosby,1983-01-29,"Bill Cosby - Bill Cosby ""Himself""",33,36,33,33.0,33,"Bill Cosby ""Himself""",8.0,3,0,0,3,0,stay,1983-01-08
21802,Bill Cosby,1983-02-05,"Bill Cosby - Bill Cosby ""Himself""",33,33,33,33.0,33,"Bill Cosby ""Himself""",8.0,4,0,0,0,0,stay,1983-01-08
21803,Bill Cosby,1983-02-12,"Bill Cosby - Bill Cosby ""Himself""",33,33,34,33.0,33,"Bill Cosby ""Himself""",8.0,5,-1,0,0,1,down,1983-01-08
21804,Bill Cosby,1983-02-19,"Bill Cosby - Bill Cosby ""Himself""",33,33,35,33.0,34,"Bill Cosby ""Himself""",8.0,6,-1,-1,0,1,down,1983-01-08
21805,Bill Cosby,1983-02-26,"Bill Cosby - Bill Cosby ""Himself""",34,33,43,33.0,35,"Bill Cosby ""Himself""",8.0,7,-8,-1,-1,1,down,1983-01-08
21806,Bill Cosby,1983-03-05,"Bill Cosby - Bill Cosby ""Himself""",35,34,51,33.0,43,"Bill Cosby ""Himself""",8.0,8,-8,-8,-1,1,down,1983-01-08
21807,The Brothers Johnson,1983-01-08,The Brothers Johnson - Blast! (The Latest And The Greatest),51,51,35,23.0,45,Blast! (The Latest And The Greatest),9.0,0,10,6,0,1,up,1983-01-08
21808,The Brothers Johnson,1983-01-15,The Brothers Johnson - Blast! (The Latest And The Greatest),45,51,27,23.0,35,Blast! (The Latest And The Greatest),9.0,1,8,10,6,1,up,1983-01-08
21809,The Brothers Johnson,1983-01-22,The Brothers Johnson - Blast! (The Latest And The Greatest),35,45,23,23.0,27,Blast! (The Latest And The Greatest),9.0,2,4,8,10,1,up,1983-01-08
21810,The Brothers Johnson,1983-01-29,The Brothers Johnson - Blast! (The Latest And The Greatest),27,35,23,23.0,23,Blast! (The Latest And The Greatest),9.0,3,0,4,8,0,stay,1983-01-08
21811,The Brothers Johnson,1983-02-05,The Brothers Johnson - Blast! (The Latest And The Greatest),23,27,23,23.0,23,Blast! (The Latest And The Greatest),9.0,4,0,0,4,0,stay,1983-01-08
21812,The Brothers Johnson,1983-02-12,The Brothers Johnson - Blast! (The Latest And The Greatest),23,23,26,23.0,23,Blast! (The Latest And The Greatest),9.0,5,-3,0,0,1,down,1983-01-08
21813,The Brothers Johnson,1983-02-19,The Brothers Johnson - Blast! (The Latest And The Greatest),23,23,26,23.0,26,Blast! (The Latest And The Greatest),9.0,6,0,-3,0,0,stay,1983-01-08
21814,The Brothers Johnson,1983-02-26,The Brothers Johnson - Blast! (The Latest And The Greatest),26,23,26,23.0,26,Blast! (The Latest And The Greatest),9.0,7,0,0,-3,0,stay,1983-01-08
21815,The Brothers Johnson,1983-03-05,The Brothers Johnson - Blast! (The Latest And The Greatest),26,26,45,23.0,26,Blast! (The Latest And The Greatest),9.0,8,-19,0,0,1,down,1983-01-08
21816,The Brothers Johnson,1983-03-12,The Brothers Johnson - Blast! (The Latest And The Greatest),26,26,51,23.0,45,Blast! (The Latest And The Greatest),9.0,9,-6,-19,0,1,down,1983-01-08
21817,Rodney Franklin,1983-01-08,Rodney Franklin - Learning To Love,51,51,45,45.0,48,Learning To Love,5.0,0,3,3,0,1,up,1983-01-08
21818,Rodney Franklin,1983-01-15,Rodney Franklin - Learning To Love,48,51,45,45.0,45,Learning To Love,5.0,1,0,3,3,0,stay,1983-01-08
21819,Rodney Franklin,1983-01-22,Rodney Franklin - Learning To Love,45,48,45,45.0,45,Learning To Love,5.0,2,0,0,3,0,stay,1983-01-08
21820,Rodney Franklin,1983-01-29,Rodney Franklin - Learning To Love,45,45,50,45.0,45,Learning To Love,5.0,3,-5,0,0,1,down,1983-01-08
21821,Rodney Franklin,1983-02-26,Rodney Franklin - Learning To Love,45,45,49,45.0,50,Learning To Love,5.0,4,1,-5,0,1,up,1983-01-08
21822,Rodney Franklin,1983-03-05,Rodney Franklin - Learning To Love,50,45,51,45.0,49,Learning To Love,5.0,5,-2,1,-5,1,down,1983-01-08
21823,Slave,1983-01-08,Slave - Visions Of The Lite,51,51,46,46.0,49,Visions Of The Lite,3.0,0,3,2,0,1,up,1983-01-08
21824,Slave,1983-01-15,Slave - Visions Of The Lite,49,51,46,46.0,46,Visions Of The Lite,3.0,1,0,3,2,0,stay,1983-01-08
21825,Slave,1983-01-22,Slave - Visions Of The Lite,46,49,46,46.0,46,Visions Of The Lite,3.0,2,0,0,3,0,stay,1983-01-08
21826,Slave,1983-01-29,Slave - Visions Of The Lite,46,46,51,46.0,46,Visions Of The Lite,3.0,3,-5,0,0,1,down,1983-01-08
21827,Maxine Nightingale,1983-01-15,Maxine Nightingale - It's A Beautiful Thing,51,51,35,35.0,41,It's A Beautiful Thing,5.0,0,6,10,0,1,up,1983-01-15
21828,Maxine Nightingale,1983-01-22,Maxine Nightingale - It's A Beautiful Thing,41,51,35,35.0,35,It's A Beautiful Thing,5.0,1,0,6,10,0,stay,1983-01-15
21829,Maxine Nightingale,1983-01-29,Maxine Nightingale - It's A Beautiful Thing,35,41,35,35.0,35,It's A Beautiful Thing,5.0,2,0,0,6,0,stay,1983-01-15
21830,Maxine Nightingale,1983-02-05,Maxine Nightingale - It's A Beautiful Thing,35,35,42,35.0,35,It's A Beautiful Thing,5.0,3,-7,0,0,1,down,1983-01-15
21831,Maxine Nightingale,1983-02-12,Maxine Nightingale - It's A Beautiful Thing,35,35,49,35.0,42,It's A Beautiful Thing,5.0,4,-7,-7,0,1,down,1983-01-15
21832,Maxine Nightingale,1983-02-19,Maxine Nightingale - It's A Beautiful Thing,42,35,51,35.0,49,It's A Beautiful Thing,5.0,5,-2,-7,-7,1,down,1983-01-15
21833,Musical Youth,1983-01-15,Musical Youth - The Youth Of Today,51,51,31,11.0,43,The Youth Of Today,16.0,0,12,8,0,1,up,1983-01-15
21834,Musical Youth,1983-01-22,Musical Youth - The Youth Of Today,43,51,22,11.0,31,The Youth Of Today,16.0,1,9,12,8,1,up,1983-01-15
21835,Musical Youth,1983-01-29,Musical Youth - The Youth Of Today,31,43,19,11.0,22,The Youth Of Today,16.0,2,3,9,12,1,up,1983-01-15
21836,Musical Youth,1983-02-05,Musical Youth - The Youth Of Today,22,31,14,11.0,19,The Youth Of Today,16.0,3,5,3,9,1,up,1983-01-15
21837,Musical Youth,1983-02-12,Musical Youth - The Youth Of Today,19,22,11,11.0,14,The Youth Of Today,16.0,4,3,5,3,1,up,1983-01-15
21838,Musical Youth,1983-02-19,Musical Youth - The Youth Of Today,14,19,11,11.0,11,The Youth Of Today,16.0,5,0,3,5,0,stay,1983-01-15
21839,Musical Youth,1983-02-26,Musical Youth - The Youth Of Today,11,14,11,11.0,11,The Youth Of Today,16.0,6,0,0,3,0,stay,1983-01-15
21840,Musical Youth,1983-03-05,Musical Youth - The Youth Of Today,11,11,11,11.0,11,The Youth Of Today,16.0,7,0,0,0,0,stay,1983-01-15
21841,Musical Youth,1983-03-12,Musical Youth - The Youth Of Today,11,11,20,11.0,11,The Youth Of Today,16.0,8,-9,0,0,1,down,1983-01-15
21842,Musical Youth,1983-03-19,Musical Youth - The Youth Of Today,11,11,20,11.0,20,The Youth Of Today,16.0,9,0,-9,0,0,stay,1983-01-15
21843,Musical Youth,1983-03-26,Musical Youth - The Youth Of Today,20,11,23,11.0,20,The Youth Of Today,16.0,10,-3,0,-9,1,down,1983-01-15
21844,Musical Youth,1983-04-02,Musical Youth - The Youth Of Today,20,20,25,11.0,23,The Youth Of Today,16.0,11,-2,-3,0,1,down,1983-01-15
21845,Musical Youth,1983-04-09,Musical Youth - The Youth Of Today,23,20,28,11.0,25,The Youth Of Today,16.0,12,-3,-2,-3,1,down,1983-01-15
21846,Musical Youth,1983-04-16,Musical Youth - The Youth Of Today,25,23,30,11.0,28,The Youth Of Today,16.0,13,-2,-3,-2,1,down,1983-01-15
21847,Musical Youth,1983-04-23,Musical Youth - The Youth Of Today,28,25,45,11.0,30,The Youth Of Today,16.0,14,-15,-2,-3,1,down,1983-01-15
21848,Musical Youth,1983-04-30,Musical Youth - The Youth Of Today,30,28,43,11.0,45,The Youth Of Today,16.0,15,2,-15,-2,1,up,1983-01-15
21849,Musical Youth,1983-05-07,Musical Youth - The Youth Of Today,45,30,51,11.0,43,The Youth Of Today,16.0,16,-8,2,-15,1,down,1983-01-15
21850,Smokey Robinson,1983-02-05,Smokey Robinson - Touch The Sky,51,51,15,8.0,22,Touch The Sky,16.0,0,7,29,0,1,up,1983-02-05
21851,Smokey Robinson,1983-02-12,Smokey Robinson - Touch The Sky,22,51,12,8.0,15,Touch The Sky,16.0,1,3,7,29,1,up,1983-02-05
21852,Smokey Robinson,1983-02-19,Smokey Robinson - Touch The Sky,15,22,12,8.0,12,Touch The Sky,16.0,2,0,3,7,0,stay,1983-02-05
21853,Smokey Robinson,1983-02-26,Smokey Robinson - Touch The Sky,12,15,10,8.0,12,Touch The Sky,16.0,3,2,0,3,1,up,1983-02-05
21854,Smokey Robinson,1983-03-05,Smokey Robinson - Touch The Sky,12,12,8,8.0,10,Touch The Sky,16.0,4,2,2,0,1,up,1983-02-05
21855,Smokey Robinson,1983-03-12,Smokey Robinson - Touch The Sky,10,12,8,8.0,8,Touch The Sky,16.0,5,0,2,2,0,stay,1983-02-05
21856,Smokey Robinson,1983-03-19,Smokey Robinson - Touch The Sky,8,10,8,8.0,8,Touch The Sky,16.0,6,0,0,2,0,stay,1983-02-05
21857,Smokey Robinson,1983-03-26,Smokey Robinson - Touch The Sky,8,8,14,8.0,8,Touch The Sky,16.0,7,-6,0,0,1,down,1983-02-05
21858,Smokey Robinson,1983-04-02,Smokey Robinson - Touch The Sky,8,8,19,8.0,14,Touch The Sky,16.0,8,-5,-6,0,1,down,1983-02-05
21859,Smokey Robinson,1983-04-09,Smokey Robinson - Touch The Sky,14,8,20,8.0,19,Touch The Sky,16.0,9,-1,-5,-6,1,down,1983-02-05
21860,Smokey Robinson,1983-04-16,Smokey Robinson - Touch The Sky,19,14,28,8.0,20,Touch The Sky,16.0,10,-8,-1,-5,1,down,1983-02-05
21861,Smokey Robinson,1983-04-23,Smokey Robinson - Touch The Sky,20,19,27,8.0,28,Touch The Sky,16.0,11,1,-8,-1,1,up,1983-02-05
21862,Smokey Robinson,1983-04-30,Smokey Robinson - Touch The Sky,28,20,32,8.0,27,Touch The Sky,16.0,12,-5,1,-8,1,down,1983-02-05
21863,Smokey Robinson,1983-05-07,Smokey Robinson - Touch The Sky,27,28,39,8.0,32,Touch The Sky,16.0,13,-7,-5,1,1,down,1983-02-05
21864,Smokey Robinson,1983-05-14,Smokey Robinson - Touch The Sky,32,27,39,8.0,39,Touch The Sky,16.0,14,0,-7,-5,0,stay,1983-02-05
21865,Smokey Robinson,1983-05-21,Smokey Robinson - Touch The Sky,39,32,42,8.0,39,Touch The Sky,16.0,15,-3,0,-7,1,down,1983-02-05
21866,Smokey Robinson,1983-05-28,Smokey Robinson - Touch The Sky,39,39,51,8.0,42,Touch The Sky,16.0,16,-9,-3,0,1,down,1983-02-05
21867,Men At Work,1983-02-05,Men At Work - Business As Usual,51,51,35,29.0,41,Business As Usual,14.0,0,6,10,0,1,up,1983-02-05
21868,Men At Work,1983-02-12,Men At Work - Business As Usual,41,51,31,29.0,35,Business As Usual,14.0,1,4,6,10,1,up,1983-02-05
21869,Men At Work,1983-02-19,Men At Work - Business As Usual,35,41,31,29.0,31,Business As Usual,14.0,2,0,4,6,0,stay,1983-02-05
21870,Men At Work,1983-02-26,Men At Work - Business As Usual,31,35,32,29.0,31,Business As Usual,14.0,3,-1,0,4,1,down,1983-02-05
21871,Men At Work,1983-03-05,Men At Work - Business As Usual,31,31,31,29.0,32,Business As Usual,14.0,4,1,-1,0,1,up,1983-02-05
21872,Men At Work,1983-03-12,Men At Work - Business As Usual,32,31,30,29.0,31,Business As Usual,14.0,5,1,1,-1,1,up,1983-02-05
21873,Men At Work,1983-03-19,Men At Work - Business As Usual,31,32,29,29.0,30,Business As Usual,14.0,6,1,1,1,1,up,1983-02-05
21874,Men At Work,1983-03-26,Men At Work - Business As Usual,30,31,32,29.0,29,Business As Usual,14.0,7,-3,1,1,1,down,1983-02-05
21875,Men At Work,1983-04-02,Men At Work - Business As Usual,29,30,38,29.0,32,Business As Usual,14.0,8,-6,-3,1,1,down,1983-02-05
21876,Men At Work,1983-04-09,Men At Work - Business As Usual,32,29,37,29.0,38,Business As Usual,14.0,9,1,-6,-3,1,up,1983-02-05
21877,Men At Work,1983-04-16,Men At Work - Business As Usual,38,32,37,29.0,37,Business As Usual,14.0,10,0,1,-6,0,stay,1983-02-05
21878,Men At Work,1983-04-23,Men At Work - Business As Usual,37,38,37,29.0,37,Business As Usual,14.0,11,0,0,1,0,stay,1983-02-05
21879,Men At Work,1983-04-30,Men At Work - Business As Usual,37,37,36,29.0,37,Business As Usual,14.0,12,1,0,0,1,up,1983-02-05
21880,Men At Work,1983-05-07,Men At Work - Business As Usual,37,37,42,29.0,36,Business As Usual,14.0,13,-6,1,0,1,down,1983-02-05
21881,Men At Work,1983-05-14,Men At Work - Business As Usual,36,37,51,29.0,42,Business As Usual,14.0,14,-9,-6,1,1,down,1983-02-05
21882,Angela Bofill,1983-02-05,Angela Bofill - Too Tough,51,51,24,6.0,42,Too Tough,34.0,0,18,9,0,1,up,1983-02-05
21883,Angela Bofill,1983-02-12,Angela Bofill - Too Tough,42,51,15,6.0,24,Too Tough,34.0,1,9,18,9,1,up,1983-02-05
21884,Angela Bofill,1983-02-19,Angela Bofill - Too Tough,24,42,14,6.0,15,Too Tough,34.0,2,1,9,18,1,up,1983-02-05
21885,Angela Bofill,1983-02-26,Angela Bofill - Too Tough,15,24,8,6.0,14,Too Tough,34.0,3,6,1,9,1,up,1983-02-05
21886,Angela Bofill,1983-03-05,Angela Bofill - Too Tough,14,15,7,6.0,8,Too Tough,34.0,4,1,6,1,1,up,1983-02-05
21887,Angela Bofill,1983-03-12,Angela Bofill - Too Tough,8,14,7,6.0,7,Too Tough,34.0,5,0,1,6,0,stay,1983-02-05
21888,Angela Bofill,1983-03-19,Angela Bofill - Too Tough,7,8,6,6.0,7,Too Tough,34.0,6,1,0,1,1,up,1983-02-05
21889,Angela Bofill,1983-03-26,Angela Bofill - Too Tough,7,7,6,6.0,6,Too Tough,34.0,7,0,1,0,0,stay,1983-02-05
21890,Angela Bofill,1983-04-02,Angela Bofill - Too Tough,6,7,6,6.0,6,Too Tough,34.0,8,0,0,1,0,stay,1983-02-05
21891,Angela Bofill,1983-04-09,Angela Bofill - Too Tough,6,6,6,6.0,6,Too Tough,34.0,9,0,0,0,0,stay,1983-02-05
21892,Angela Bofill,1983-04-16,Angela Bofill - Too Tough,6,6,7,6.0,6,Too Tough,34.0,10,-1,0,0,1,down,1983-02-05
21893,Angela Bofill,1983-04-23,Angela Bofill - Too Tough,6,6,11,6.0,7,Too Tough,34.0,11,-4,-1,0,1,down,1983-02-05
21894,Angela Bofill,1983-04-30,Angela Bofill - Too Tough,7,6,17,6.0,11,Too Tough,34.0,12,-6,-4,-1,1,down,1983-02-05
21895,Angela Bofill,1983-05-07,Angela Bofill - Too Tough,11,7,17,6.0,17,Too Tough,34.0,13,0,-6,-4,0,stay,1983-02-05
21896,Angela Bofill,1983-05-14,Angela Bofill - Too Tough,17,11,15,6.0,17,Too Tough,34.0,14,2,0,-6,1,up,1983-02-05
21897,Angela Bofill,1983-05-21,Angela Bofill - Too Tough,17,17,18,6.0,15,Too Tough,34.0,15,-3,2,0,1,down,1983-02-05
21898,Angela Bofill,1983-05-28,Angela Bofill - Too Tough,15,17,18,6.0,18,Too Tough,34.0,16,0,-3,2,0,stay,1983-02-05
21899,Angela Bofill,1983-06-04,Angela Bofill - Too Tough,18,15,21,6.0,18,Too Tough,34.0,17,-3,0,-3,1,down,1983-02-05
21900,Angela Bofill,1983-06-11,Angela Bofill - Too Tough,18,18,21,6.0,21,Too Tough,34.0,18,0,-3,0,0,stay,1983-02-05
21901,Angela Bofill,1983-06-18,Angela Bofill - Too Tough,21,18,21,6.0,21,Too Tough,34.0,19,0,0,-3,0,stay,1983-02-05
21902,Angela Bofill,1983-06-25,Angela Bofill - Too Tough,21,21,19,6.0,21,Too Tough,34.0,20,2,0,0,1,up,1983-02-05
21903,Angela Bofill,1983-07-02,Angela Bofill - Too Tough,21,21,19,6.0,19,Too Tough,34.0,21,0,2,0,0,stay,1983-02-05
21904,Angela Bofill,1983-07-09,Angela Bofill - Too Tough,19,21,19,6.0,19,Too Tough,34.0,22,0,0,2,0,stay,1983-02-05
21905,Angela Bofill,1983-07-16,Angela Bofill - Too Tough,19,19,19,6.0,19,Too Tough,34.0,23,0,0,0,0,stay,1983-02-05
21906,Angela Bofill,1983-07-23,Angela Bofill - Too Tough,19,19,17,6.0,19,Too Tough,34.0,24,2,0,0,1,up,1983-02-05
21907,Angela Bofill,1983-07-30,Angela Bofill - Too Tough,19,19,17,6.0,17,Too Tough,34.0,25,0,2,0,0,stay,1983-02-05
21908,Angela Bofill,1983-08-06,Angela Bofill - Too Tough,17,19,26,6.0,17,Too Tough,34.0,26,-9,0,2,1,down,1983-02-05
21909,Angela Bofill,1983-08-13,Angela Bofill - Too Tough,17,17,26,6.0,26,Too Tough,34.0,27,0,-9,0,0,stay,1983-02-05
21910,Angela Bofill,1983-08-20,Angela Bofill - Too Tough,26,17,31,6.0,26,Too Tough,34.0,28,-5,0,-9,1,down,1983-02-05
21911,Angela Bofill,1983-08-27,Angela Bofill - Too Tough,26,26,32,6.0,31,Too Tough,34.0,29,-1,-5,0,1,down,1983-02-05
21912,Angela Bofill,1983-09-03,Angela Bofill - Too Tough,31,26,34,6.0,32,Too Tough,34.0,30,-2,-1,-5,1,down,1983-02-05
21913,Angela Bofill,1983-09-10,Angela Bofill - Too Tough,32,31,45,6.0,34,Too Tough,34.0,31,-11,-2,-1,1,down,1983-02-05
21914,Angela Bofill,1983-09-17,Angela Bofill - Too Tough,34,32,46,6.0,45,Too Tough,34.0,32,-1,-11,-2,1,down,1983-02-05
21915,Angela Bofill,1983-09-24,Angela Bofill - Too Tough,45,34,46,6.0,46,Too Tough,34.0,33,0,-1,-11,0,stay,1983-02-05
21916,Angela Bofill,1983-10-01,Angela Bofill - Too Tough,46,45,51,6.0,46,Too Tough,34.0,34,-5,0,-1,1,down,1983-02-05
21917,Dazz Band,1983-02-12,Dazz Band - On The One,51,51,25,12.0,40,On The One,17.0,0,15,11,0,1,up,1983-02-12
21918,Dazz Band,1983-02-19,Dazz Band - On The One,40,51,16,12.0,25,On The One,17.0,1,9,15,11,1,up,1983-02-12
21919,Dazz Band,1983-02-26,Dazz Band - On The One,25,40,13,12.0,16,On The One,17.0,2,3,9,15,1,up,1983-02-12
21920,Dazz Band,1983-03-05,Dazz Band - On The One,16,25,13,12.0,13,On The One,17.0,3,0,3,9,0,stay,1983-02-12
21921,Dazz Band,1983-03-12,Dazz Band - On The One,13,16,12,12.0,13,On The One,17.0,4,1,0,3,1,up,1983-02-12
21922,Dazz Band,1983-03-19,Dazz Band - On The One,13,13,12,12.0,12,On The One,17.0,5,0,1,0,0,stay,1983-02-12
21923,Dazz Band,1983-03-26,Dazz Band - On The One,12,13,12,12.0,12,On The One,17.0,6,0,0,1,0,stay,1983-02-12
21924,Dazz Band,1983-04-02,Dazz Band - On The One,12,12,12,12.0,12,On The One,17.0,7,0,0,0,0,stay,1983-02-12
21925,Dazz Band,1983-04-09,Dazz Band - On The One,12,12,18,12.0,12,On The One,17.0,8,-6,0,0,1,down,1983-02-12
21926,Dazz Band,1983-04-16,Dazz Band - On The One,12,12,23,12.0,18,On The One,17.0,9,-5,-6,0,1,down,1983-02-12
21927,Dazz Band,1983-04-23,Dazz Band - On The One,18,12,23,12.0,23,On The One,17.0,10,0,-5,-6,0,stay,1983-02-12
21928,Dazz Band,1983-04-30,Dazz Band - On The One,23,18,24,12.0,23,On The One,17.0,11,-1,0,-5,1,down,1983-02-12
21929,Dazz Band,1983-05-07,Dazz Band - On The One,23,23,30,12.0,24,On The One,17.0,12,-6,-1,0,1,down,1983-02-12
21930,Dazz Band,1983-05-14,Dazz Band - On The One,24,23,33,12.0,30,On The One,17.0,13,-3,-6,-1,1,down,1983-02-12
21931,Dazz Band,1983-05-21,Dazz Band - On The One,30,24,37,12.0,33,On The One,17.0,14,-4,-3,-6,1,down,1983-02-12
21932,Dazz Band,1983-05-28,Dazz Band - On The One,33,30,40,12.0,37,On The One,17.0,15,-3,-4,-3,1,down,1983-02-12
21933,Dazz Band,1983-06-04,Dazz Band - On The One,37,33,47,12.0,40,On The One,17.0,16,-7,-3,-4,1,down,1983-02-12
21934,Dazz Band,1983-06-11,Dazz Band - On The One,40,37,51,12.0,47,On The One,17.0,17,-4,-7,-3,1,down,1983-02-12
21935,Bill Wolfer,1983-02-12,Bill Wolfer - Wolf,51,51,50,50.0,50,Wolf,1.0,0,0,1,0,0,stay,1983-02-12
21936,Bill Wolfer,1983-02-19,Bill Wolfer - Wolf,50,51,51,50.0,50,Wolf,1.0,1,-1,0,1,1,down,1983-02-12
21937,Sylvester,1983-02-19,Sylvester - All I Need,51,51,37,35.0,45,All I Need,7.0,0,8,6,0,1,up,1983-02-19
21938,Sylvester,1983-02-26,Sylvester - All I Need,45,51,35,35.0,37,All I Need,7.0,1,2,8,6,1,up,1983-02-19
21939,Sylvester,1983-03-05,Sylvester - All I Need,37,45,35,35.0,35,All I Need,7.0,2,0,2,8,0,stay,1983-02-19
21940,Sylvester,1983-03-12,Sylvester - All I Need,35,37,41,35.0,35,All I Need,7.0,3,-6,0,2,1,down,1983-02-19
21941,Sylvester,1983-03-19,Sylvester - All I Need,35,35,40,35.0,41,All I Need,7.0,4,1,-6,0,1,up,1983-02-19
21942,Sylvester,1983-03-26,Sylvester - All I Need,41,35,40,35.0,40,All I Need,7.0,5,0,1,-6,0,stay,1983-02-19
21943,Sylvester,1983-04-02,Sylvester - All I Need,40,41,49,35.0,40,All I Need,7.0,6,-9,0,1,1,down,1983-02-19
21944,Sylvester,1983-04-09,Sylvester - All I Need,40,40,51,35.0,49,All I Need,7.0,7,-2,-9,0,1,down,1983-02-19
21945,Daryl Hall John Oates,1983-02-26,Daryl Hall John Oates - H2O,51,51,30,8.0,45,H2O,18.0,0,15,6,0,1,up,1983-02-26
21946,Daryl Hall John Oates,1983-03-05,Daryl Hall John Oates - H2O,45,51,19,8.0,30,H2O,18.0,1,11,15,6,1,up,1983-02-26
21947,Daryl Hall John Oates,1983-03-12,Daryl Hall John Oates - H2O,30,45,14,8.0,19,H2O,18.0,2,5,11,15,1,up,1983-02-26
21948,Daryl Hall John Oates,1983-03-19,Daryl Hall John Oates - H2O,19,30,13,8.0,14,H2O,18.0,3,1,5,11,1,up,1983-02-26
21949,Daryl Hall John Oates,1983-03-26,Daryl Hall John Oates - H2O,14,19,11,8.0,13,H2O,18.0,4,2,1,5,1,up,1983-02-26
21950,Daryl Hall John Oates,1983-04-02,Daryl Hall John Oates - H2O,13,14,8,8.0,11,H2O,18.0,5,3,2,1,1,up,1983-02-26
21951,Daryl Hall John Oates,1983-04-09,Daryl Hall John Oates - H2O,11,13,8,8.0,8,H2O,18.0,6,0,3,2,0,stay,1983-02-26
21952,Daryl Hall John Oates,1983-04-16,Daryl Hall John Oates - H2O,8,11,8,8.0,8,H2O,18.0,7,0,0,3,0,stay,1983-02-26
21953,Daryl Hall John Oates,1983-04-23,Daryl Hall John Oates - H2O,8,8,8,8.0,8,H2O,18.0,8,0,0,0,0,stay,1983-02-26
21954,Daryl Hall John Oates,1983-04-30,Daryl Hall John Oates - H2O,8,8,11,8.0,8,H2O,18.0,9,-3,0,0,1,down,1983-02-26
21955,Daryl Hall John Oates,1983-05-07,Daryl Hall John Oates - H2O,8,8,12,8.0,11,H2O,18.0,10,-1,-3,0,1,down,1983-02-26
21956,Daryl Hall John Oates,1983-05-14,Daryl Hall John Oates - H2O,11,8,12,8.0,12,H2O,18.0,11,0,-1,-3,0,stay,1983-02-26
21957,Daryl Hall John Oates,1983-05-21,Daryl Hall John Oates - H2O,12,11,13,8.0,12,H2O,18.0,12,-1,0,-1,1,down,1983-02-26
21958,Daryl Hall John Oates,1983-05-28,Daryl Hall John Oates - H2O,12,12,30,8.0,13,H2O,18.0,13,-17,-1,0,1,down,1983-02-26
21959,Daryl Hall John Oates,1983-06-04,Daryl Hall John Oates - H2O,13,12,33,8.0,30,H2O,18.0,14,-3,-17,-1,1,down,1983-02-26
21960,Daryl Hall John Oates,1983-06-11,Daryl Hall John Oates - H2O,30,13,31,8.0,33,H2O,18.0,15,2,-3,-17,1,up,1983-02-26
21961,Daryl Hall John Oates,1983-06-18,Daryl Hall John Oates - H2O,33,30,30,8.0,31,H2O,18.0,16,1,2,-3,1,up,1983-02-26
21962,Daryl Hall John Oates,1983-06-25,Daryl Hall John Oates - H2O,31,33,34,8.0,30,H2O,18.0,17,-4,1,2,1,down,1983-02-26
21963,Daryl Hall John Oates,1983-07-02,Daryl Hall John Oates - H2O,30,31,51,8.0,34,H2O,18.0,18,-17,-4,1,1,down,1983-02-26
21964,Aurra,1983-03-05,Aurra - Live And Let Live,51,51,36,36.0,39,Live And Let Live,3.0,0,3,12,0,1,up,1983-03-05
21965,Aurra,1983-03-12,Aurra - Live And Let Live,39,51,36,36.0,36,Live And Let Live,3.0,1,0,3,12,0,stay,1983-03-05
21966,Aurra,1983-03-19,Aurra - Live And Let Live,36,39,48,36.0,36,Live And Let Live,3.0,2,-12,0,3,1,down,1983-03-05
21967,Aurra,1983-03-26,Aurra - Live And Let Live,36,36,51,36.0,48,Live And Let Live,3.0,3,-3,-12,0,1,down,1983-03-05
21968,The System,1983-03-05,The System - Sweat,51,51,34,14.0,45,Sweat,17.0,0,11,6,0,1,up,1983-03-05
21969,The System,1983-03-12,The System - Sweat,45,51,28,14.0,34,Sweat,17.0,1,6,11,6,1,up,1983-03-05
21970,The System,1983-03-19,The System - Sweat,34,45,24,14.0,28,Sweat,17.0,2,4,6,11,1,up,1983-03-05
21971,The System,1983-03-26,The System - Sweat,28,34,20,14.0,24,Sweat,17.0,3,4,4,6,1,up,1983-03-05
21972,The System,1983-04-02,The System - Sweat,24,28,17,14.0,20,Sweat,17.0,4,3,4,4,1,up,1983-03-05
21973,The System,1983-04-09,The System - Sweat,20,24,14,14.0,17,Sweat,17.0,5,3,3,4,1,up,1983-03-05
21974,The System,1983-04-16,The System - Sweat,17,20,14,14.0,14,Sweat,17.0,6,0,3,3,0,stay,1983-03-05
21975,The System,1983-04-23,The System - Sweat,14,17,14,14.0,14,Sweat,17.0,7,0,0,3,0,stay,1983-03-05
21976,The System,1983-04-30,The System - Sweat,14,14,14,14.0,14,Sweat,17.0,8,0,0,0,0,stay,1983-03-05
21977,The System,1983-05-07,The System - Sweat,14,14,14,14.0,14,Sweat,17.0,9,0,0,0,0,stay,1983-03-05
21978,The System,1983-05-14,The System - Sweat,14,14,21,14.0,14,Sweat,17.0,10,-7,0,0,1,down,1983-03-05
21979,The System,1983-05-21,The System - Sweat,14,14,32,14.0,21,Sweat,17.0,11,-11,-7,0,1,down,1983-03-05
21980,The System,1983-05-28,The System - Sweat,21,14,31,14.0,32,Sweat,17.0,12,1,-11,-7,1,up,1983-03-05
21981,The System,1983-06-04,The System - Sweat,32,21,31,14.0,31,Sweat,17.0,13,0,1,-11,0,stay,1983-03-05
21982,The System,1983-06-11,The System - Sweat,31,32,40,14.0,31,Sweat,17.0,14,-9,0,1,1,down,1983-03-05
21983,The System,1983-06-18,The System - Sweat,31,31,49,14.0,40,Sweat,17.0,15,-9,-9,0,1,down,1983-03-05
21984,The System,1983-06-25,The System - Sweat,40,31,48,14.0,49,Sweat,17.0,16,1,-9,-9,1,up,1983-03-05
21985,The System,1983-07-02,The System - Sweat,49,40,51,14.0,48,Sweat,17.0,17,-3,1,-9,1,down,1983-03-05
21986,Instant Funk,1983-03-05,Instant Funk - Instant Funk V,51,51,48,38.0,48,Instant Funk V,11.0,0,0,3,0,0,stay,1983-03-05
21987,Instant Funk,1983-03-12,Instant Funk - Instant Funk V,48,51,46,38.0,48,Instant Funk V,11.0,1,2,0,3,1,up,1983-03-05
21988,Instant Funk,1983-03-19,Instant Funk - Instant Funk V,48,48,46,38.0,46,Instant Funk V,11.0,2,0,2,0,0,stay,1983-03-05
21989,Instant Funk,1983-03-26,Instant Funk - Instant Funk V,46,48,44,38.0,46,Instant Funk V,11.0,3,2,0,2,1,up,1983-03-05
21990,Instant Funk,1983-04-16,Instant Funk - Instant Funk V,46,46,44,38.0,44,Instant Funk V,11.0,4,0,2,0,0,stay,1983-03-05
21991,Instant Funk,1983-04-23,Instant Funk - Instant Funk V,44,46,39,38.0,44,Instant Funk V,11.0,5,5,0,2,1,up,1983-03-05
21992,Instant Funk,1983-04-30,Instant Funk - Instant Funk V,44,44,38,38.0,39,Instant Funk V,11.0,6,1,5,0,1,up,1983-03-05
21993,Instant Funk,1983-05-07,Instant Funk - Instant Funk V,39,44,47,38.0,38,Instant Funk V,11.0,7,-9,1,5,1,down,1983-03-05
21994,Instant Funk,1983-05-14,Instant Funk - Instant Funk V,38,39,45,38.0,47,Instant Funk V,11.0,8,2,-9,1,1,up,1983-03-05
21995,Instant Funk,1983-05-21,Instant Funk - Instant Funk V,47,38,45,38.0,45,Instant Funk V,11.0,9,0,2,-9,0,stay,1983-03-05
21996,Instant Funk,1983-05-28,Instant Funk - Instant Funk V,45,47,47,38.0,45,Instant Funk V,11.0,10,-2,0,2,1,down,1983-03-05
21997,Instant Funk,1983-06-04,Instant Funk - Instant Funk V,45,45,51,38.0,47,Instant Funk V,11.0,11,-4,-2,0,1,down,1983-03-05
21998,"Earth, Wind & Fire",1983-03-12,"Earth, Wind & Fire - Powerlight",51,51,6,4.0,20,Powerlight,18.0,0,14,31,0,1,up,1983-03-12
21999,"Earth, Wind & Fire",1983-03-19,"Earth, Wind & Fire - Powerlight",20,51,5,4.0,6,Powerlight,18.0,1,1,14,31,1,up,1983-03-12
22000,"Earth, Wind & Fire",1983-03-26,"Earth, Wind & Fire - Powerlight",6,20,5,4.0,5,Powerlight,18.0,2,0,1,14,0,stay,1983-03-12
22001,"Earth, Wind & Fire",1983-04-02,"Earth, Wind & Fire - Powerlight",5,6,4,4.0,5,Powerlight,18.0,3,1,0,1,1,up,1983-03-12
22002,"Earth, Wind & Fire",1983-04-09,"Earth, Wind & Fire - Powerlight",5,5,4,4.0,4,Powerlight,18.0,4,0,1,0,0,stay,1983-03-12
22003,"Earth, Wind & Fire",1983-04-16,"Earth, Wind & Fire - Powerlight",4,5,4,4.0,4,Powerlight,18.0,5,0,0,1,0,stay,1983-03-12
22004,"Earth, Wind & Fire",1983-04-23,"Earth, Wind & Fire - Powerlight",4,4,4,4.0,4,Powerlight,18.0,6,0,0,0,0,stay,1983-03-12
22005,"Earth, Wind & Fire",1983-04-30,"Earth, Wind & Fire - Powerlight",4,4,4,4.0,4,Powerlight,18.0,7,0,0,0,0,stay,1983-03-12
22006,"Earth, Wind & Fire",1983-05-07,"Earth, Wind & Fire - Powerlight",4,4,4,4.0,4,Powerlight,18.0,8,0,0,0,0,stay,1983-03-12
22007,"Earth, Wind & Fire",1983-05-14,"Earth, Wind & Fire - Powerlight",4,4,8,4.0,4,Powerlight,18.0,9,-4,0,0,1,down,1983-03-12
22008,"Earth, Wind & Fire",1983-05-21,"Earth, Wind & Fire - Powerlight",4,4,8,4.0,8,Powerlight,18.0,10,0,-4,0,0,stay,1983-03-12
22009,"Earth, Wind & Fire",1983-05-28,"Earth, Wind & Fire - Powerlight",8,4,17,4.0,8,Powerlight,18.0,11,-9,0,-4,1,down,1983-03-12
22010,"Earth, Wind & Fire",1983-06-04,"Earth, Wind & Fire - Powerlight",8,8,17,4.0,17,Powerlight,18.0,12,0,-9,0,0,stay,1983-03-12
22011,"Earth, Wind & Fire",1983-06-11,"Earth, Wind & Fire - Powerlight",17,8,25,4.0,17,Powerlight,18.0,13,-8,0,-9,1,down,1983-03-12
22012,"Earth, Wind & Fire",1983-06-18,"Earth, Wind & Fire - Powerlight",17,17,26,4.0,25,Powerlight,18.0,14,-1,-8,0,1,down,1983-03-12
22013,"Earth, Wind & Fire",1983-06-25,"Earth, Wind & Fire - Powerlight",25,17,27,4.0,26,Powerlight,18.0,15,-1,-1,-8,1,down,1983-03-12
22014,"Earth, Wind & Fire",1983-07-02,"Earth, Wind & Fire - Powerlight",26,25,42,4.0,27,Powerlight,18.0,16,-15,-1,-1,1,down,1983-03-12
22015,"Earth, Wind & Fire",1983-07-09,"Earth, Wind & Fire - Powerlight",27,26,44,4.0,42,Powerlight,18.0,17,-2,-15,-1,1,down,1983-03-12
22016,"Earth, Wind & Fire",1983-07-16,"Earth, Wind & Fire - Powerlight",42,27,51,4.0,44,Powerlight,18.0,18,-7,-2,-15,1,down,1983-03-12
22017,Yarbrough & Peoples,1983-03-12,Yarbrough & Peoples - Heartbeats,51,51,34,25.0,40,Heartbeats,10.0,0,6,11,0,1,up,1983-03-12
22018,Yarbrough & Peoples,1983-03-19,Yarbrough & Peoples - Heartbeats,40,51,30,25.0,34,Heartbeats,10.0,1,4,6,11,1,up,1983-03-12
22019,Yarbrough & Peoples,1983-03-26,Yarbrough & Peoples - Heartbeats,34,40,27,25.0,30,Heartbeats,10.0,2,3,4,6,1,up,1983-03-12
22020,Yarbrough & Peoples,1983-04-02,Yarbrough & Peoples - Heartbeats,30,34,27,25.0,27,Heartbeats,10.0,3,0,3,4,0,stay,1983-03-12
22021,Yarbrough & Peoples,1983-04-09,Yarbrough & Peoples - Heartbeats,27,30,25,25.0,27,Heartbeats,10.0,4,2,0,3,1,up,1983-03-12
22022,Yarbrough & Peoples,1983-04-16,Yarbrough & Peoples - Heartbeats,27,27,25,25.0,25,Heartbeats,10.0,5,0,2,0,0,stay,1983-03-12
22023,Yarbrough & Peoples,1983-04-23,Yarbrough & Peoples - Heartbeats,25,27,25,25.0,25,Heartbeats,10.0,6,0,0,2,0,stay,1983-03-12
22024,Yarbrough & Peoples,1983-04-30,Yarbrough & Peoples - Heartbeats,25,25,26,25.0,25,Heartbeats,10.0,7,-1,0,0,1,down,1983-03-12
22025,Yarbrough & Peoples,1983-05-07,Yarbrough & Peoples - Heartbeats,25,25,44,25.0,26,Heartbeats,10.0,8,-18,-1,0,1,down,1983-03-12
22026,Yarbrough & Peoples,1983-05-14,Yarbrough & Peoples - Heartbeats,26,25,50,25.0,44,Heartbeats,10.0,9,-6,-18,-1,1,down,1983-03-12
22027,Yarbrough & Peoples,1983-05-21,Yarbrough & Peoples - Heartbeats,44,26,51,25.0,50,Heartbeats,10.0,10,-1,-6,-18,1,down,1983-03-12
22028,O'Bryan,1983-03-12,O'Bryan - You And I,51,51,33,13.0,41,You And I,27.0,0,8,10,0,1,up,1983-03-12
22029,O'Bryan,1983-03-19,O'Bryan - You And I,41,51,28,13.0,33,You And I,27.0,1,5,8,10,1,up,1983-03-12
22030,O'Bryan,1983-03-26,O'Bryan - You And I,33,41,25,13.0,28,You And I,27.0,2,3,5,8,1,up,1983-03-12
22031,O'Bryan,1983-04-02,O'Bryan - You And I,28,33,21,13.0,25,You And I,27.0,3,4,3,5,1,up,1983-03-12
22032,O'Bryan,1983-04-09,O'Bryan - You And I,25,28,19,13.0,21,You And I,27.0,4,2,4,3,1,up,1983-03-12
22033,O'Bryan,1983-04-16,O'Bryan - You And I,21,25,18,13.0,19,You And I,27.0,5,1,2,4,1,up,1983-03-12
22034,O'Bryan,1983-04-23,O'Bryan - You And I,19,21,15,13.0,18,You And I,27.0,6,3,1,2,1,up,1983-03-12
22035,O'Bryan,1983-04-30,O'Bryan - You And I,18,19,15,13.0,15,You And I,27.0,7,0,3,1,0,stay,1983-03-12
22036,O'Bryan,1983-05-07,O'Bryan - You And I,15,18,13,13.0,15,You And I,27.0,8,2,0,3,1,up,1983-03-12
22037,O'Bryan,1983-05-14,O'Bryan - You And I,15,15,13,13.0,13,You And I,27.0,9,0,2,0,0,stay,1983-03-12
22038,O'Bryan,1983-05-21,O'Bryan - You And I,13,15,16,13.0,13,You And I,27.0,10,-3,0,2,1,down,1983-03-12
22039,O'Bryan,1983-05-28,O'Bryan - You And I,13,13,16,13.0,16,You And I,27.0,11,0,-3,0,0,stay,1983-03-12
22040,O'Bryan,1983-06-04,O'Bryan - You And I,16,13,22,13.0,16,You And I,27.0,12,-6,0,-3,1,down,1983-03-12
22041,O'Bryan,1983-06-11,O'Bryan - You And I,16,16,20,13.0,22,You And I,27.0,13,2,-6,0,1,up,1983-03-12
22042,O'Bryan,1983-06-18,O'Bryan - You And I,22,16,20,13.0,20,You And I,27.0,14,0,2,-6,0,stay,1983-03-12
22043,O'Bryan,1983-06-25,O'Bryan - You And I,20,22,22,13.0,20,You And I,27.0,15,-2,0,2,1,down,1983-03-12
22044,O'Bryan,1983-07-02,O'Bryan - You And I,20,20,24,13.0,22,You And I,27.0,16,-2,-2,0,1,down,1983-03-12
22045,O'Bryan,1983-07-09,O'Bryan - You And I,22,20,28,13.0,24,You And I,27.0,17,-4,-2,-2,1,down,1983-03-12
22046,O'Bryan,1983-07-16,O'Bryan - You And I,24,22,28,13.0,28,You And I,27.0,18,0,-4,-2,0,stay,1983-03-12
22047,O'Bryan,1983-07-23,O'Bryan - You And I,28,24,26,13.0,28,You And I,27.0,19,2,0,-4,1,up,1983-03-12
22048,O'Bryan,1983-07-30,O'Bryan - You And I,28,28,26,13.0,26,You And I,27.0,20,0,2,0,0,stay,1983-03-12
22049,O'Bryan,1983-08-06,O'Bryan - You And I,26,28,25,13.0,26,You And I,27.0,21,1,0,2,1,up,1983-03-12
22050,O'Bryan,1983-08-13,O'Bryan - You And I,26,26,30,13.0,25,You And I,27.0,22,-5,1,0,1,down,1983-03-12
22051,O'Bryan,1983-08-20,O'Bryan - You And I,25,26,32,13.0,30,You And I,27.0,23,-2,-5,1,1,down,1983-03-12
22052,O'Bryan,1983-08-27,O'Bryan - You And I,30,25,37,13.0,32,You And I,27.0,24,-5,-2,-5,1,down,1983-03-12
22053,O'Bryan,1983-09-03,O'Bryan - You And I,32,30,37,13.0,37,You And I,27.0,25,0,-5,-2,0,stay,1983-03-12
22054,O'Bryan,1983-09-10,O'Bryan - You And I,37,32,49,13.0,37,You And I,27.0,26,-12,0,-5,1,down,1983-03-12
22055,O'Bryan,1983-09-24,O'Bryan - You And I,37,37,51,13.0,49,You And I,27.0,27,-2,-12,0,1,down,1983-03-12
22056,Culture Club,1983-03-12,Culture Club - Kissing To Be Clever,51,51,37,24.0,43,Kissing To Be Clever,31.0,0,6,8,0,1,up,1983-03-12
22057,Culture Club,1983-03-19,Culture Club - Kissing To Be Clever,43,51,33,24.0,37,Kissing To Be Clever,31.0,1,4,6,8,1,up,1983-03-12
22058,Culture Club,1983-03-26,Culture Club - Kissing To Be Clever,37,43,33,24.0,33,Kissing To Be Clever,31.0,2,0,4,6,0,stay,1983-03-12
22059,Culture Club,1983-04-02,Culture Club - Kissing To Be Clever,33,37,32,24.0,33,Kissing To Be Clever,31.0,3,1,0,4,1,up,1983-03-12
22060,Culture Club,1983-04-09,Culture Club - Kissing To Be Clever,33,33,30,24.0,32,Kissing To Be Clever,31.0,4,2,1,0,1,up,1983-03-12
22061,Culture Club,1983-04-16,Culture Club - Kissing To Be Clever,32,33,29,24.0,30,Kissing To Be Clever,31.0,5,1,2,1,1,up,1983-03-12
22062,Culture Club,1983-04-23,Culture Club - Kissing To Be Clever,30,32,28,24.0,29,Kissing To Be Clever,31.0,6,1,1,2,1,up,1983-03-12
22063,Culture Club,1983-04-30,Culture Club - Kissing To Be Clever,29,30,27,24.0,28,Kissing To Be Clever,31.0,7,1,1,1,1,up,1983-03-12
22064,Culture Club,1983-05-07,Culture Club - Kissing To Be Clever,28,29,24,24.0,27,Kissing To Be Clever,31.0,8,3,1,1,1,up,1983-03-12
22065,Culture Club,1983-05-14,Culture Club - Kissing To Be Clever,27,28,24,24.0,24,Kissing To Be Clever,31.0,9,0,3,1,0,stay,1983-03-12
22066,Culture Club,1983-05-21,Culture Club - Kissing To Be Clever,24,27,35,24.0,24,Kissing To Be Clever,31.0,10,-11,0,3,1,down,1983-03-12
22067,Culture Club,1983-05-28,Culture Club - Kissing To Be Clever,24,24,36,24.0,35,Kissing To Be Clever,31.0,11,-1,-11,0,1,down,1983-03-12
22068,Culture Club,1983-06-04,Culture Club - Kissing To Be Clever,35,24,41,24.0,36,Kissing To Be Clever,31.0,12,-5,-1,-11,1,down,1983-03-12
22069,Culture Club,1983-06-11,Culture Club - Kissing To Be Clever,36,35,39,24.0,41,Kissing To Be Clever,31.0,13,2,-5,-1,1,up,1983-03-12
22070,Culture Club,1983-06-18,Culture Club - Kissing To Be Clever,41,36,37,24.0,39,Kissing To Be Clever,31.0,14,2,2,-5,1,up,1983-03-12
22071,Culture Club,1983-06-25,Culture Club - Kissing To Be Clever,39,41,37,24.0,37,Kissing To Be Clever,31.0,15,0,2,2,0,stay,1983-03-12
22072,Culture Club,1983-07-02,Culture Club - Kissing To Be Clever,37,39,36,24.0,37,Kissing To Be Clever,31.0,16,1,0,2,1,up,1983-03-12
22073,Culture Club,1983-07-09,Culture Club - Kissing To Be Clever,37,37,36,24.0,36,Kissing To Be Clever,31.0,17,0,1,0,0,stay,1983-03-12
22074,Culture Club,1983-07-16,Culture Club - Kissing To Be Clever,36,37,35,24.0,36,Kissing To Be Clever,31.0,18,1,0,1,1,up,1983-03-12
22075,Culture Club,1983-07-23,Culture Club - Kissing To Be Clever,36,36,35,24.0,35,Kissing To Be Clever,31.0,19,0,1,0,0,stay,1983-03-12
22076,Culture Club,1983-07-30,Culture Club - Kissing To Be Clever,35,36,30,24.0,35,Kissing To Be Clever,31.0,20,5,0,1,1,up,1983-03-12
22077,Culture Club,1983-08-06,Culture Club - Kissing To Be Clever,35,35,30,24.0,30,Kissing To Be Clever,31.0,21,0,5,0,0,stay,1983-03-12
22078,Culture Club,1983-08-13,Culture Club - Kissing To Be Clever,30,35,31,24.0,30,Kissing To Be Clever,31.0,22,-1,0,5,1,down,1983-03-12
22079,Culture Club,1983-08-20,Culture Club - Kissing To Be Clever,30,30,35,24.0,31,Kissing To Be Clever,31.0,23,-4,-1,0,1,down,1983-03-12
22080,Culture Club,1983-08-27,Culture Club - Kissing To Be Clever,31,30,38,24.0,35,Kissing To Be Clever,31.0,24,-3,-4,-1,1,down,1983-03-12
22081,Culture Club,1983-09-03,Culture Club - Kissing To Be Clever,35,31,38,24.0,38,Kissing To Be Clever,31.0,25,0,-3,-4,0,stay,1983-03-12
22082,Culture Club,1983-09-10,Culture Club - Kissing To Be Clever,38,35,40,24.0,38,Kissing To Be Clever,31.0,26,-2,0,-3,1,down,1983-03-12
22083,Culture Club,1983-09-17,Culture Club - Kissing To Be Clever,38,38,45,24.0,40,Kissing To Be Clever,31.0,27,-5,-2,0,1,down,1983-03-12
22084,Culture Club,1983-09-24,Culture Club - Kissing To Be Clever,40,38,44,24.0,45,Kissing To Be Clever,31.0,28,1,-5,-2,1,up,1983-03-12
22085,Culture Club,1983-10-01,Culture Club - Kissing To Be Clever,45,40,44,24.0,44,Kissing To Be Clever,31.0,29,0,1,-5,0,stay,1983-03-12
22086,Culture Club,1983-10-08,Culture Club - Kissing To Be Clever,44,45,46,24.0,44,Kissing To Be Clever,31.0,30,-2,0,1,1,down,1983-03-12
22087,Culture Club,1983-10-15,Culture Club - Kissing To Be Clever,44,44,51,24.0,46,Kissing To Be Clever,31.0,31,-5,-2,0,1,down,1983-03-12
22088,Andre Cymone,1983-03-12,Andre Cymone - Livin' In The New Wave,51,51,49,49.0,49,Livin' In The New Wave,1.0,0,0,2,0,0,stay,1983-03-12
22089,Andre Cymone,1983-03-19,Andre Cymone - Livin' In The New Wave,49,51,51,49.0,49,Livin' In The New Wave,1.0,1,-2,0,2,1,down,1983-03-12
22090,Alfonzo,1983-03-12,Alfonzo - Alfonzo,51,51,50,50.0,50,Alfonzo,2.0,0,0,1,0,0,stay,1983-03-12
22091,Alfonzo,1983-03-19,Alfonzo - Alfonzo,50,51,50,50.0,50,Alfonzo,2.0,1,0,0,1,0,stay,1983-03-12
22092,Alfonzo,1983-03-26,Alfonzo - Alfonzo,50,50,51,50.0,50,Alfonzo,2.0,2,-1,0,0,1,down,1983-03-12
22093,Steve Arrington,1983-03-19,Steve Arrington - Steve Arrington's Hall Of Fame: I,51,51,27,12.0,43,Steve Arrington's Hall Of Fame: I,24.0,0,16,8,0,1,up,1983-03-19
22094,Steve Arrington,1983-03-26,Steve Arrington - Steve Arrington's Hall Of Fame: I,43,51,19,12.0,27,Steve Arrington's Hall Of Fame: I,24.0,1,8,16,8,1,up,1983-03-19
22095,Steve Arrington,1983-04-02,Steve Arrington - Steve Arrington's Hall Of Fame: I,27,43,15,12.0,19,Steve Arrington's Hall Of Fame: I,24.0,2,4,8,16,1,up,1983-03-19
22096,Steve Arrington,1983-04-09,Steve Arrington - Steve Arrington's Hall Of Fame: I,19,27,15,12.0,15,Steve Arrington's Hall Of Fame: I,24.0,3,0,4,8,0,stay,1983-03-19
22097,Steve Arrington,1983-04-16,Steve Arrington - Steve Arrington's Hall Of Fame: I,15,19,12,12.0,15,Steve Arrington's Hall Of Fame: I,24.0,4,3,0,4,1,up,1983-03-19
22098,Steve Arrington,1983-04-23,Steve Arrington - Steve Arrington's Hall Of Fame: I,15,15,12,12.0,12,Steve Arrington's Hall Of Fame: I,24.0,5,0,3,0,0,stay,1983-03-19
22099,Steve Arrington,1983-04-30,Steve Arrington - Steve Arrington's Hall Of Fame: I,12,15,12,12.0,12,Steve Arrington's Hall Of Fame: I,24.0,6,0,0,3,0,stay,1983-03-19
22100,Steve Arrington,1983-05-07,Steve Arrington - Steve Arrington's Hall Of Fame: I,12,12,16,12.0,12,Steve Arrington's Hall Of Fame: I,24.0,7,-4,0,0,1,down,1983-03-19
22101,Steve Arrington,1983-05-14,Steve Arrington - Steve Arrington's Hall Of Fame: I,12,12,16,12.0,16,Steve Arrington's Hall Of Fame: I,24.0,8,0,-4,0,0,stay,1983-03-19
22102,Steve Arrington,1983-05-21,Steve Arrington - Steve Arrington's Hall Of Fame: I,16,12,21,12.0,16,Steve Arrington's Hall Of Fame: I,24.0,9,-5,0,-4,1,down,1983-03-19
22103,Steve Arrington,1983-05-28,Steve Arrington - Steve Arrington's Hall Of Fame: I,16,16,32,12.0,21,Steve Arrington's Hall Of Fame: I,24.0,10,-11,-5,0,1,down,1983-03-19
22104,Steve Arrington,1983-06-04,Steve Arrington - Steve Arrington's Hall Of Fame: I,21,16,39,12.0,32,Steve Arrington's Hall Of Fame: I,24.0,11,-7,-11,-5,1,down,1983-03-19
22105,Steve Arrington,1983-06-11,Steve Arrington - Steve Arrington's Hall Of Fame: I,32,21,38,12.0,39,Steve Arrington's Hall Of Fame: I,24.0,12,1,-7,-11,1,up,1983-03-19
22106,Steve Arrington,1983-06-18,Steve Arrington - Steve Arrington's Hall Of Fame: I,39,32,34,12.0,38,Steve Arrington's Hall Of Fame: I,24.0,13,4,1,-7,1,up,1983-03-19
22107,Steve Arrington,1983-06-25,Steve Arrington - Steve Arrington's Hall Of Fame: I,38,39,33,12.0,34,Steve Arrington's Hall Of Fame: I,24.0,14,1,4,1,1,up,1983-03-19
22108,Steve Arrington,1983-07-02,Steve Arrington - Steve Arrington's Hall Of Fame: I,34,38,33,12.0,33,Steve Arrington's Hall Of Fame: I,24.0,15,0,1,4,0,stay,1983-03-19
22109,Steve Arrington,1983-07-09,Steve Arrington - Steve Arrington's Hall Of Fame: I,33,34,39,12.0,33,Steve Arrington's Hall Of Fame: I,24.0,16,-6,0,1,1,down,1983-03-19
22110,Steve Arrington,1983-07-16,Steve Arrington - Steve Arrington's Hall Of Fame: I,33,33,39,12.0,39,Steve Arrington's Hall Of Fame: I,24.0,17,0,-6,0,0,stay,1983-03-19
22111,Steve Arrington,1983-07-23,Steve Arrington - Steve Arrington's Hall Of Fame: I,39,33,39,12.0,39,Steve Arrington's Hall Of Fame: I,24.0,18,0,0,-6,0,stay,1983-03-19
22112,Steve Arrington,1983-07-30,Steve Arrington - Steve Arrington's Hall Of Fame: I,39,39,38,12.0,39,Steve Arrington's Hall Of Fame: I,24.0,19,1,0,0,1,up,1983-03-19
22113,Steve Arrington,1983-08-06,Steve Arrington - Steve Arrington's Hall Of Fame: I,39,39,39,12.0,38,Steve Arrington's Hall Of Fame: I,24.0,20,-1,1,0,1,down,1983-03-19
22114,Steve Arrington,1983-08-13,Steve Arrington - Steve Arrington's Hall Of Fame: I,38,39,46,12.0,39,Steve Arrington's Hall Of Fame: I,24.0,21,-7,-1,1,1,down,1983-03-19
22115,Steve Arrington,1983-08-20,Steve Arrington - Steve Arrington's Hall Of Fame: I,39,38,45,12.0,46,Steve Arrington's Hall Of Fame: I,24.0,22,1,-7,-1,1,up,1983-03-19
22116,Steve Arrington,1983-08-27,Steve Arrington - Steve Arrington's Hall Of Fame: I,46,39,45,12.0,45,Steve Arrington's Hall Of Fame: I,24.0,23,0,1,-7,0,stay,1983-03-19
22117,Steve Arrington,1983-09-03,Steve Arrington - Steve Arrington's Hall Of Fame: I,45,46,51,12.0,45,Steve Arrington's Hall Of Fame: I,24.0,24,-6,0,1,1,down,1983-03-19
22118,Man Parrish,1983-03-19,Man Parrish - Man Parrish,51,51,44,43.0,47,Man Parrish,2.0,0,3,4,0,1,up,1983-03-19
22119,Man Parrish,1983-03-26,Man Parrish - Man Parrish,47,51,43,43.0,44,Man Parrish,2.0,1,1,3,4,1,up,1983-03-19
22120,Man Parrish,1983-04-02,Man Parrish - Man Parrish,44,47,51,43.0,43,Man Parrish,2.0,2,-8,1,3,1,down,1983-03-19
22121,Margie Joseph,1983-03-19,Margie Joseph - Knockout,51,51,41,34.0,48,Knockout,6.0,0,7,3,0,1,up,1983-03-19
22122,Margie Joseph,1983-03-26,Margie Joseph - Knockout,48,51,36,34.0,41,Knockout,6.0,1,5,7,3,1,up,1983-03-19
22123,Margie Joseph,1983-04-02,Margie Joseph - Knockout,41,48,34,34.0,36,Knockout,6.0,2,2,5,7,1,up,1983-03-19
22124,Margie Joseph,1983-04-09,Margie Joseph - Knockout,36,41,34,34.0,34,Knockout,6.0,3,0,2,5,0,stay,1983-03-19
22125,Margie Joseph,1983-04-16,Margie Joseph - Knockout,34,36,45,34.0,34,Knockout,6.0,4,-11,0,2,1,down,1983-03-19
22126,Margie Joseph,1983-04-23,Margie Joseph - Knockout,34,34,49,34.0,45,Knockout,6.0,5,-4,-11,0,1,down,1983-03-19
22127,Margie Joseph,1983-04-30,Margie Joseph - Knockout,45,34,51,34.0,49,Knockout,6.0,6,-2,-4,-11,1,down,1983-03-19
22128,The Temptations,1983-03-26,The Temptations - Surface Thrills,51,51,30,19.0,42,Surface Thrills,12.0,0,12,9,0,1,up,1983-03-26
22129,The Temptations,1983-04-02,The Temptations - Surface Thrills,42,51,26,19.0,30,Surface Thrills,12.0,1,4,12,9,1,up,1983-03-26
22130,The Temptations,1983-04-09,The Temptations - Surface Thrills,30,42,22,19.0,26,Surface Thrills,12.0,2,4,4,12,1,up,1983-03-26
22131,The Temptations,1983-04-16,The Temptations - Surface Thrills,26,30,22,19.0,22,Surface Thrills,12.0,3,0,4,4,0,stay,1983-03-26
22132,The Temptations,1983-04-23,The Temptations - Surface Thrills,22,26,19,19.0,22,Surface Thrills,12.0,4,3,0,4,1,up,1983-03-26
22133,The Temptations,1983-04-30,The Temptations - Surface Thrills,22,22,19,19.0,19,Surface Thrills,12.0,5,0,3,0,0,stay,1983-03-26
22134,The Temptations,1983-05-07,The Temptations - Surface Thrills,19,22,19,19.0,19,Surface Thrills,12.0,6,0,0,3,0,stay,1983-03-26
22135,The Temptations,1983-05-14,The Temptations - Surface Thrills,19,19,28,19.0,19,Surface Thrills,12.0,7,-9,0,0,1,down,1983-03-26
22136,The Temptations,1983-05-21,The Temptations - Surface Thrills,19,19,33,19.0,28,Surface Thrills,12.0,8,-5,-9,0,1,down,1983-03-26
22137,The Temptations,1983-05-28,The Temptations - Surface Thrills,28,19,37,19.0,33,Surface Thrills,12.0,9,-4,-5,-9,1,down,1983-03-26
22138,The Temptations,1983-06-04,The Temptations - Surface Thrills,33,28,44,19.0,37,Surface Thrills,12.0,10,-7,-4,-5,1,down,1983-03-26
22139,The Temptations,1983-06-11,The Temptations - Surface Thrills,37,33,42,19.0,44,Surface Thrills,12.0,11,2,-7,-4,1,up,1983-03-26
22140,The Temptations,1983-06-18,The Temptations - Surface Thrills,44,37,51,19.0,42,Surface Thrills,12.0,12,-9,2,-7,1,down,1983-03-26
22141,Rufus,1983-03-26,Rufus - Seal In Red,51,51,49,49.0,49,Seal In Red,1.0,0,0,2,0,0,stay,1983-03-26
22142,Rufus,1983-04-02,Rufus - Seal In Red,49,51,51,49.0,49,Seal In Red,1.0,1,-2,0,2,1,down,1983-03-26
22143,The Whispers,1983-04-02,The Whispers - Love For Love,51,51,11,2.0,17,Love For Love,33.0,0,6,34,0,1,up,1983-04-02
22144,The Whispers,1983-04-09,The Whispers - Love For Love,17,51,9,2.0,11,Love For Love,33.0,1,2,6,34,1,up,1983-04-02
22145,The Whispers,1983-04-16,The Whispers - Love For Love,11,17,6,2.0,9,Love For Love,33.0,2,3,2,6,1,up,1983-04-02
22146,The Whispers,1983-04-23,The Whispers - Love For Love,9,11,5,2.0,6,Love For Love,33.0,3,1,3,2,1,up,1983-04-02
22147,The Whispers,1983-04-30,The Whispers - Love For Love,6,9,5,2.0,5,Love For Love,33.0,4,0,1,3,0,stay,1983-04-02
22148,The Whispers,1983-05-07,The Whispers - Love For Love,5,6,5,2.0,5,Love For Love,33.0,5,0,0,1,0,stay,1983-04-02
22149,The Whispers,1983-05-14,The Whispers - Love For Love,5,5,2,2.0,5,Love For Love,33.0,6,3,0,0,1,up,1983-04-02
22150,The Whispers,1983-05-21,The Whispers - Love For Love,5,5,2,2.0,2,Love For Love,33.0,7,0,3,0,0,stay,1983-04-02
22151,The Whispers,1983-05-28,The Whispers - Love For Love,2,5,2,2.0,2,Love For Love,33.0,8,0,0,3,0,stay,1983-04-02
22152,The Whispers,1983-06-04,The Whispers - Love For Love,2,2,2,2.0,2,Love For Love,33.0,9,0,0,0,0,stay,1983-04-02
22153,The Whispers,1983-06-11,The Whispers - Love For Love,2,2,5,2.0,2,Love For Love,33.0,10,-3,0,0,1,down,1983-04-02
22154,The Whispers,1983-06-18,The Whispers - Love For Love,2,2,8,2.0,5,Love For Love,33.0,11,-3,-3,0,1,down,1983-04-02
22155,The Whispers,1983-06-25,The Whispers - Love For Love,5,2,8,2.0,8,Love For Love,33.0,12,0,-3,-3,0,stay,1983-04-02
22156,The Whispers,1983-07-02,The Whispers - Love For Love,8,5,8,2.0,8,Love For Love,33.0,13,0,0,-3,0,stay,1983-04-02
22157,The Whispers,1983-07-09,The Whispers - Love For Love,8,8,8,2.0,8,Love For Love,33.0,14,0,0,0,0,stay,1983-04-02
22158,The Whispers,1983-07-16,The Whispers - Love For Love,8,8,7,2.0,8,Love For Love,33.0,15,1,0,0,1,up,1983-04-02
22159,The Whispers,1983-07-23,The Whispers - Love For Love,8,8,7,2.0,7,Love For Love,33.0,16,0,1,0,0,stay,1983-04-02
22160,The Whispers,1983-07-30,The Whispers - Love For Love,7,8,7,2.0,7,Love For Love,33.0,17,0,0,1,0,stay,1983-04-02
22161,The Whispers,1983-08-06,The Whispers - Love For Love,7,7,10,2.0,7,Love For Love,33.0,18,-3,0,0,1,down,1983-04-02
22162,The Whispers,1983-08-13,The Whispers - Love For Love,7,7,10,2.0,10,Love For Love,33.0,19,0,-3,0,0,stay,1983-04-02
22163,The Whispers,1983-08-20,The Whispers - Love For Love,10,7,10,2.0,10,Love For Love,33.0,20,0,0,-3,0,stay,1983-04-02
22164,The Whispers,1983-08-27,The Whispers - Love For Love,10,10,11,2.0,10,Love For Love,33.0,21,-1,0,0,1,down,1983-04-02
22165,The Whispers,1983-09-03,The Whispers - Love For Love,10,10,16,2.0,11,Love For Love,33.0,22,-5,-1,0,1,down,1983-04-02
22166,The Whispers,1983-09-10,The Whispers - Love For Love,11,10,18,2.0,16,Love For Love,33.0,23,-2,-5,-1,1,down,1983-04-02
22167,The Whispers,1983-09-17,The Whispers - Love For Love,16,11,31,2.0,18,Love For Love,33.0,24,-13,-2,-5,1,down,1983-04-02
22168,The Whispers,1983-09-24,The Whispers - Love For Love,18,16,30,2.0,31,Love For Love,33.0,25,1,-13,-2,1,up,1983-04-02
22169,The Whispers,1983-10-01,The Whispers - Love For Love,31,18,30,2.0,30,Love For Love,33.0,26,0,1,-13,0,stay,1983-04-02
22170,The Whispers,1983-10-08,The Whispers - Love For Love,30,31,31,2.0,30,Love For Love,33.0,27,-1,0,1,1,down,1983-04-02
22171,The Whispers,1983-10-15,The Whispers - Love For Love,30,30,36,2.0,31,Love For Love,33.0,28,-5,-1,0,1,down,1983-04-02
22172,The Whispers,1983-10-22,The Whispers - Love For Love,31,30,37,2.0,36,Love For Love,33.0,29,-1,-5,-1,1,down,1983-04-02
22173,The Whispers,1983-10-29,The Whispers - Love For Love,36,31,37,2.0,37,Love For Love,33.0,30,0,-1,-5,0,stay,1983-04-02
22174,The Whispers,1983-11-05,The Whispers - Love For Love,37,36,39,2.0,37,Love For Love,33.0,31,-2,0,-1,1,down,1983-04-02
22175,The Whispers,1983-11-12,The Whispers - Love For Love,37,37,39,2.0,39,Love For Love,33.0,32,0,-2,0,0,stay,1983-04-02
22176,The Whispers,1983-11-19,The Whispers - Love For Love,39,37,51,2.0,39,Love For Love,33.0,33,-12,0,-2,1,down,1983-04-02
22177,Champaign,1983-04-02,Champaign - Modern Heart,51,51,30,9.0,38,Modern Heart,22.0,0,8,13,0,1,up,1983-04-02
22178,Champaign,1983-04-09,Champaign - Modern Heart,38,51,24,9.0,30,Modern Heart,22.0,1,6,8,13,1,up,1983-04-02
22179,Champaign,1983-04-16,Champaign - Modern Heart,30,38,20,9.0,24,Modern Heart,22.0,2,4,6,8,1,up,1983-04-02
22180,Champaign,1983-04-23,Champaign - Modern Heart,24,30,18,9.0,20,Modern Heart,22.0,3,2,4,6,1,up,1983-04-02
22181,Champaign,1983-04-30,Champaign - Modern Heart,20,24,13,9.0,18,Modern Heart,22.0,4,5,2,4,1,up,1983-04-02
22182,Champaign,1983-05-07,Champaign - Modern Heart,18,20,11,9.0,13,Modern Heart,22.0,5,2,5,2,1,up,1983-04-02
22183,Champaign,1983-05-14,Champaign - Modern Heart,13,18,11,9.0,11,Modern Heart,22.0,6,0,2,5,0,stay,1983-04-02
22184,Champaign,1983-05-21,Champaign - Modern Heart,11,13,9,9.0,11,Modern Heart,22.0,7,2,0,2,1,up,1983-04-02
22185,Champaign,1983-05-28,Champaign - Modern Heart,11,11,9,9.0,9,Modern Heart,22.0,8,0,2,0,0,stay,1983-04-02
22186,Champaign,1983-06-04,Champaign - Modern Heart,9,11,19,9.0,9,Modern Heart,22.0,9,-10,0,2,1,down,1983-04-02
22187,Champaign,1983-06-11,Champaign - Modern Heart,9,9,19,9.0,19,Modern Heart,22.0,10,0,-10,0,0,stay,1983-04-02
22188,Champaign,1983-06-18,Champaign - Modern Heart,19,9,19,9.0,19,Modern Heart,22.0,11,0,0,-10,0,stay,1983-04-02
22189,Champaign,1983-06-25,Champaign - Modern Heart,19,19,18,9.0,19,Modern Heart,22.0,12,1,0,0,1,up,1983-04-02
22190,Champaign,1983-07-02,Champaign - Modern Heart,19,19,21,9.0,18,Modern Heart,22.0,13,-3,1,0,1,down,1983-04-02
22191,Champaign,1983-07-09,Champaign - Modern Heart,18,19,22,9.0,21,Modern Heart,22.0,14,-1,-3,1,1,down,1983-04-02
22192,Champaign,1983-07-16,Champaign - Modern Heart,21,18,23,9.0,22,Modern Heart,22.0,15,-1,-1,-3,1,down,1983-04-02
22193,Champaign,1983-07-23,Champaign - Modern Heart,22,21,29,9.0,23,Modern Heart,22.0,16,-6,-1,-1,1,down,1983-04-02
22194,Champaign,1983-07-30,Champaign - Modern Heart,23,22,29,9.0,29,Modern Heart,22.0,17,0,-6,-1,0,stay,1983-04-02
22195,Champaign,1983-08-06,Champaign - Modern Heart,29,23,34,9.0,29,Modern Heart,22.0,18,-5,0,-6,1,down,1983-04-02
22196,Champaign,1983-08-13,Champaign - Modern Heart,29,29,33,9.0,34,Modern Heart,22.0,19,1,-5,0,1,up,1983-04-02
22197,Champaign,1983-08-20,Champaign - Modern Heart,34,29,42,9.0,33,Modern Heart,22.0,20,-9,1,-5,1,down,1983-04-02
22198,Champaign,1983-08-27,Champaign - Modern Heart,33,34,41,9.0,42,Modern Heart,22.0,21,1,-9,1,1,up,1983-04-02
22199,Champaign,1983-09-03,Champaign - Modern Heart,42,33,51,9.0,41,Modern Heart,22.0,22,-10,1,-9,1,down,1983-04-02
22200,"Tyrone ""Tystick"" Brunson",1983-04-02,"Tyrone ""Tystick"" Brunson - Sticky Situation",51,51,35,25.0,44,Sticky Situation,9.0,0,9,7,0,1,up,1983-04-02
22201,"Tyrone ""Tystick"" Brunson",1983-04-09,"Tyrone ""Tystick"" Brunson - Sticky Situation",44,51,29,25.0,35,Sticky Situation,9.0,1,6,9,7,1,up,1983-04-02
22202,"Tyrone ""Tystick"" Brunson",1983-04-16,"Tyrone ""Tystick"" Brunson - Sticky Situation",35,44,26,25.0,29,Sticky Situation,9.0,2,3,6,9,1,up,1983-04-02
22203,"Tyrone ""Tystick"" Brunson",1983-04-23,"Tyrone ""Tystick"" Brunson - Sticky Situation",29,35,26,25.0,26,Sticky Situation,9.0,3,0,3,6,0,stay,1983-04-02
22204,"Tyrone ""Tystick"" Brunson",1983-04-30,"Tyrone ""Tystick"" Brunson - Sticky Situation",26,29,25,25.0,26,Sticky Situation,9.0,4,1,0,3,1,up,1983-04-02
22205,"Tyrone ""Tystick"" Brunson",1983-05-07,"Tyrone ""Tystick"" Brunson - Sticky Situation",26,26,25,25.0,25,Sticky Situation,9.0,5,0,1,0,0,stay,1983-04-02
22206,"Tyrone ""Tystick"" Brunson",1983-05-14,"Tyrone ""Tystick"" Brunson - Sticky Situation",25,26,36,25.0,25,Sticky Situation,9.0,6,-11,0,1,1,down,1983-04-02
22207,"Tyrone ""Tystick"" Brunson",1983-05-21,"Tyrone ""Tystick"" Brunson - Sticky Situation",25,25,40,25.0,36,Sticky Situation,9.0,7,-4,-11,0,1,down,1983-04-02
22208,"Tyrone ""Tystick"" Brunson",1983-05-28,"Tyrone ""Tystick"" Brunson - Sticky Situation",36,25,44,25.0,40,Sticky Situation,9.0,8,-4,-4,-11,1,down,1983-04-02
22209,"Tyrone ""Tystick"" Brunson",1983-06-04,"Tyrone ""Tystick"" Brunson - Sticky Situation",40,36,51,25.0,44,Sticky Situation,9.0,9,-7,-4,-4,1,down,1983-04-02
22210,Lanier & Co.,1983-04-02,Lanier & Co. - Lanier & Co.,51,51,47,47.0,47,Lanier & Co.,2.0,0,0,4,0,0,stay,1983-04-02
22211,Lanier & Co.,1983-04-09,Lanier & Co. - Lanier & Co.,47,51,47,47.0,47,Lanier & Co.,2.0,1,0,0,4,0,stay,1983-04-02
22212,Lanier & Co.,1983-04-16,Lanier & Co. - Lanier & Co.,47,47,51,47.0,47,Lanier & Co.,2.0,2,-4,0,0,1,down,1983-04-02
22213,Ebonee Webb,1983-04-02,Ebonee Webb - Too Hot,51,51,46,45.0,50,Too Hot,2.0,0,4,1,0,1,up,1983-04-02
22214,Ebonee Webb,1983-04-09,Ebonee Webb - Too Hot,50,51,45,45.0,46,Too Hot,2.0,1,1,4,1,1,up,1983-04-02
22215,Ebonee Webb,1983-04-16,Ebonee Webb - Too Hot,46,50,51,45.0,45,Too Hot,2.0,2,-6,1,4,1,down,1983-04-02
22216,Kashif,1983-04-09,Kashif - Kashif,51,51,23,10.0,33,Kashif,33.0,0,10,18,0,1,up,1983-04-09
22217,Kashif,1983-04-16,Kashif - Kashif,33,51,15,10.0,23,Kashif,33.0,1,8,10,18,1,up,1983-04-09
22218,Kashif,1983-04-23,Kashif - Kashif,23,33,13,10.0,15,Kashif,33.0,2,2,8,10,1,up,1983-04-09
22219,Kashif,1983-04-30,Kashif - Kashif,15,23,10,10.0,13,Kashif,33.0,3,3,2,8,1,up,1983-04-09
22220,Kashif,1983-05-07,Kashif - Kashif,13,15,10,10.0,10,Kashif,33.0,4,0,3,2,0,stay,1983-04-09
22221,Kashif,1983-05-14,Kashif - Kashif,10,13,10,10.0,10,Kashif,33.0,5,0,0,3,0,stay,1983-04-09
22222,Kashif,1983-05-21,Kashif - Kashif,10,10,10,10.0,10,Kashif,33.0,6,0,0,0,0,stay,1983-04-09
22223,Kashif,1983-05-28,Kashif - Kashif,10,10,15,10.0,10,Kashif,33.0,7,-5,0,0,1,down,1983-04-09
22224,Kashif,1983-06-04,Kashif - Kashif,10,10,13,10.0,15,Kashif,33.0,8,2,-5,0,1,up,1983-04-09
22225,Kashif,1983-06-11,Kashif - Kashif,15,10,12,10.0,13,Kashif,33.0,9,1,2,-5,1,up,1983-04-09
22226,Kashif,1983-06-18,Kashif - Kashif,13,15,12,10.0,12,Kashif,33.0,10,0,1,2,0,stay,1983-04-09
22227,Kashif,1983-06-25,Kashif - Kashif,12,13,21,10.0,12,Kashif,33.0,11,-9,0,1,1,down,1983-04-09
22228,Kashif,1983-07-02,Kashif - Kashif,12,12,18,10.0,21,Kashif,33.0,12,3,-9,0,1,up,1983-04-09
22229,Kashif,1983-07-09,Kashif - Kashif,21,12,16,10.0,18,Kashif,33.0,13,2,3,-9,1,up,1983-04-09
22230,Kashif,1983-07-16,Kashif - Kashif,18,21,11,10.0,16,Kashif,33.0,14,5,2,3,1,up,1983-04-09
22231,Kashif,1983-07-23,Kashif - Kashif,16,18,10,10.0,11,Kashif,33.0,15,1,5,2,1,up,1983-04-09
22232,Kashif,1983-07-30,Kashif - Kashif,11,16,10,10.0,10,Kashif,33.0,16,0,1,5,0,stay,1983-04-09
22233,Kashif,1983-08-06,Kashif - Kashif,10,11,14,10.0,10,Kashif,33.0,17,-4,0,1,1,down,1983-04-09
22234,Kashif,1983-08-13,Kashif - Kashif,10,10,14,10.0,14,Kashif,33.0,18,0,-4,0,0,stay,1983-04-09
22235,Kashif,1983-08-20,Kashif - Kashif,14,10,20,10.0,14,Kashif,33.0,19,-6,0,-4,1,down,1983-04-09
22236,Kashif,1983-08-27,Kashif - Kashif,14,14,20,10.0,20,Kashif,33.0,20,0,-6,0,0,stay,1983-04-09
22237,Kashif,1983-09-03,Kashif - Kashif,20,14,19,10.0,20,Kashif,33.0,21,1,0,-6,1,up,1983-04-09
22238,Kashif,1983-09-10,Kashif - Kashif,20,20,23,10.0,19,Kashif,33.0,22,-4,1,0,1,down,1983-04-09
22239,Kashif,1983-09-17,Kashif - Kashif,19,20,23,10.0,23,Kashif,33.0,23,0,-4,1,0,stay,1983-04-09
22240,Kashif,1983-09-24,Kashif - Kashif,23,19,25,10.0,23,Kashif,33.0,24,-2,0,-4,1,down,1983-04-09
22241,Kashif,1983-10-01,Kashif - Kashif,23,23,24,10.0,25,Kashif,33.0,25,1,-2,0,1,up,1983-04-09
22242,Kashif,1983-10-08,Kashif - Kashif,25,23,25,10.0,24,Kashif,33.0,26,-1,1,-2,1,down,1983-04-09
22243,Kashif,1983-10-15,Kashif - Kashif,24,25,30,10.0,25,Kashif,33.0,27,-5,-1,1,1,down,1983-04-09
22244,Kashif,1983-10-22,Kashif - Kashif,25,24,29,10.0,30,Kashif,33.0,28,1,-5,-1,1,up,1983-04-09
22245,Kashif,1983-10-29,Kashif - Kashif,30,25,34,10.0,29,Kashif,33.0,29,-5,1,-5,1,down,1983-04-09
22246,Kashif,1983-11-05,Kashif - Kashif,29,30,37,10.0,34,Kashif,33.0,30,-3,-5,1,1,down,1983-04-09
22247,Kashif,1983-11-12,Kashif - Kashif,34,29,37,10.0,37,Kashif,33.0,31,0,-3,-5,0,stay,1983-04-09
22248,Kashif,1983-11-19,Kashif - Kashif,37,34,40,10.0,37,Kashif,33.0,32,-3,0,-3,1,down,1983-04-09
22249,Kashif,1983-11-26,Kashif - Kashif,37,37,51,10.0,40,Kashif,33.0,33,-11,-3,0,1,down,1983-04-09
22250,Kiddo,1983-04-09,Kiddo - Kiddo,51,51,41,29.0,43,Kiddo,7.0,0,2,8,0,1,up,1983-04-09
22251,Kiddo,1983-04-16,Kiddo - Kiddo,43,51,39,29.0,41,Kiddo,7.0,1,2,2,8,1,up,1983-04-09
22252,Kiddo,1983-04-23,Kiddo - Kiddo,41,43,29,29.0,39,Kiddo,7.0,2,10,2,2,1,up,1983-04-09
22253,Kiddo,1983-04-30,Kiddo - Kiddo,39,41,29,29.0,29,Kiddo,7.0,3,0,10,2,0,stay,1983-04-09
22254,Kiddo,1983-05-07,Kiddo - Kiddo,29,39,29,29.0,29,Kiddo,7.0,4,0,0,10,0,stay,1983-04-09
22255,Kiddo,1983-05-14,Kiddo - Kiddo,29,29,37,29.0,29,Kiddo,7.0,5,-8,0,0,1,down,1983-04-09
22256,Kiddo,1983-05-21,Kiddo - Kiddo,29,29,41,29.0,37,Kiddo,7.0,6,-4,-8,0,1,down,1983-04-09
22257,Kiddo,1983-05-28,Kiddo - Kiddo,37,29,51,29.0,41,Kiddo,7.0,7,-10,-4,-8,1,down,1983-04-09
22258,Change,1983-04-09,Change - This Is Your Time,51,51,42,34.0,44,This Is Your Time,6.0,0,2,7,0,1,up,1983-04-09
22259,Change,1983-04-16,Change - This Is Your Time,44,51,40,34.0,42,This Is Your Time,6.0,1,2,2,7,1,up,1983-04-09
22260,Change,1983-04-23,Change - This Is Your Time,42,44,35,34.0,40,This Is Your Time,6.0,2,5,2,2,1,up,1983-04-09
22261,Change,1983-04-30,Change - This Is Your Time,40,42,35,34.0,35,This Is Your Time,6.0,3,0,5,2,0,stay,1983-04-09
22262,Change,1983-05-07,Change - This Is Your Time,35,40,34,34.0,35,This Is Your Time,6.0,4,1,0,5,1,up,1983-04-09
22263,Change,1983-05-14,Change - This Is Your Time,35,35,42,34.0,34,This Is Your Time,6.0,5,-8,1,0,1,down,1983-04-09
22264,Change,1983-05-21,Change - This Is Your Time,34,35,51,34.0,42,This Is Your Time,6.0,6,-9,-8,1,1,down,1983-04-09
22265,Jarreau,1983-04-16,Jarreau - Jarreau,51,51,19,4.0,38,Jarreau,30.0,0,19,13,0,1,up,1983-04-16
22266,Jarreau,1983-04-23,Jarreau - Jarreau,38,51,7,4.0,19,Jarreau,30.0,1,12,19,13,1,up,1983-04-16
22267,Jarreau,1983-04-30,Jarreau - Jarreau,19,38,7,4.0,7,Jarreau,30.0,2,0,12,19,0,stay,1983-04-16
22268,Jarreau,1983-05-07,Jarreau - Jarreau,7,19,6,4.0,7,Jarreau,30.0,3,1,0,12,1,up,1983-04-16
22269,Jarreau,1983-05-14,Jarreau - Jarreau,7,7,5,4.0,6,Jarreau,30.0,4,1,1,0,1,up,1983-04-16
22270,Jarreau,1983-05-21,Jarreau - Jarreau,6,7,4,4.0,5,Jarreau,30.0,5,1,1,1,1,up,1983-04-16
22271,Jarreau,1983-05-28,Jarreau - Jarreau,5,6,4,4.0,4,Jarreau,30.0,6,0,1,1,0,stay,1983-04-16
22272,Jarreau,1983-06-04,Jarreau - Jarreau,4,5,4,4.0,4,Jarreau,30.0,7,0,0,1,0,stay,1983-04-16
22273,Jarreau,1983-06-11,Jarreau - Jarreau,4,4,8,4.0,4,Jarreau,30.0,8,-4,0,0,1,down,1983-04-16
22274,Jarreau,1983-06-18,Jarreau - Jarreau,4,4,5,4.0,8,Jarreau,30.0,9,3,-4,0,1,up,1983-04-16
22275,Jarreau,1983-06-25,Jarreau - Jarreau,8,4,5,4.0,5,Jarreau,30.0,10,0,3,-4,0,stay,1983-04-16
22276,Jarreau,1983-07-02,Jarreau - Jarreau,5,8,9,4.0,5,Jarreau,30.0,11,-4,0,3,1,down,1983-04-16
22277,Jarreau,1983-07-09,Jarreau - Jarreau,5,5,9,4.0,9,Jarreau,30.0,12,0,-4,0,0,stay,1983-04-16
22278,Jarreau,1983-07-16,Jarreau - Jarreau,9,5,9,4.0,9,Jarreau,30.0,13,0,0,-4,0,stay,1983-04-16
22279,Jarreau,1983-07-23,Jarreau - Jarreau,9,9,9,4.0,9,Jarreau,30.0,14,0,0,0,0,stay,1983-04-16
22280,Jarreau,1983-07-30,Jarreau - Jarreau,9,9,16,4.0,9,Jarreau,30.0,15,-7,0,0,1,down,1983-04-16
22281,Jarreau,1983-08-06,Jarreau - Jarreau,9,9,16,4.0,16,Jarreau,30.0,16,0,-7,0,0,stay,1983-04-16
22282,Jarreau,1983-08-13,Jarreau - Jarreau,16,9,19,4.0,16,Jarreau,30.0,17,-3,0,-7,1,down,1983-04-16
22283,Jarreau,1983-08-20,Jarreau - Jarreau,16,16,19,4.0,19,Jarreau,30.0,18,0,-3,0,0,stay,1983-04-16
22284,Jarreau,1983-08-27,Jarreau - Jarreau,19,16,23,4.0,19,Jarreau,30.0,19,-4,0,-3,1,down,1983-04-16
22285,Jarreau,1983-09-03,Jarreau - Jarreau,19,19,23,4.0,23,Jarreau,30.0,20,0,-4,0,0,stay,1983-04-16
22286,Jarreau,1983-09-10,Jarreau - Jarreau,23,19,22,4.0,23,Jarreau,30.0,21,1,0,-4,1,up,1983-04-16
22287,Jarreau,1983-09-17,Jarreau - Jarreau,23,23,27,4.0,22,Jarreau,30.0,22,-5,1,0,1,down,1983-04-16
22288,Jarreau,1983-09-24,Jarreau - Jarreau,22,23,27,4.0,27,Jarreau,30.0,23,0,-5,1,0,stay,1983-04-16
22289,Jarreau,1983-10-01,Jarreau - Jarreau,27,22,27,4.0,27,Jarreau,30.0,24,0,0,-5,0,stay,1983-04-16
22290,Jarreau,1983-10-08,Jarreau - Jarreau,27,27,27,4.0,27,Jarreau,30.0,25,0,0,0,0,stay,1983-04-16
22291,Jarreau,1983-10-15,Jarreau - Jarreau,27,27,26,4.0,27,Jarreau,30.0,26,1,0,0,1,up,1983-04-16
22292,Jarreau,1983-10-22,Jarreau - Jarreau,27,27,36,4.0,26,Jarreau,30.0,27,-10,1,0,1,down,1983-04-16
22293,Jarreau,1983-10-29,Jarreau - Jarreau,26,27,43,4.0,36,Jarreau,30.0,28,-7,-10,1,1,down,1983-04-16
22294,Jarreau,1983-11-05,Jarreau - Jarreau,36,26,47,4.0,43,Jarreau,30.0,29,-4,-7,-10,1,down,1983-04-16
22295,Jarreau,1983-11-12,Jarreau - Jarreau,43,36,51,4.0,47,Jarreau,30.0,30,-4,-4,-7,1,down,1983-04-16
22296,The Fatback Band,1983-04-16,The Fatback Band - Is This The Future,51,51,33,27.0,40,Is This The Future,16.0,0,7,11,0,1,up,1983-04-16
22297,The Fatback Band,1983-04-23,The Fatback Band - Is This The Future,40,51,30,27.0,33,Is This The Future,16.0,1,3,7,11,1,up,1983-04-16
22298,The Fatback Band,1983-04-30,The Fatback Band - Is This The Future,33,40,30,27.0,30,Is This The Future,16.0,2,0,3,7,0,stay,1983-04-16
22299,The Fatback Band,1983-05-07,The Fatback Band - Is This The Future,30,33,27,27.0,30,Is This The Future,16.0,3,3,0,3,1,up,1983-04-16
22300,The Fatback Band,1983-05-14,The Fatback Band - Is This The Future,30,30,27,27.0,27,Is This The Future,16.0,4,0,3,0,0,stay,1983-04-16
22301,The Fatback Band,1983-05-21,The Fatback Band - Is This The Future,27,30,34,27.0,27,Is This The Future,16.0,5,-7,0,3,1,down,1983-04-16
22302,The Fatback Band,1983-05-28,The Fatback Band - Is This The Future,27,27,35,27.0,34,Is This The Future,16.0,6,-1,-7,0,1,down,1983-04-16
22303,The Fatback Band,1983-06-04,The Fatback Band - Is This The Future,34,27,34,27.0,35,Is This The Future,16.0,7,1,-1,-7,1,up,1983-04-16
22304,The Fatback Band,1983-06-11,The Fatback Band - Is This The Future,35,34,43,27.0,34,Is This The Future,16.0,8,-9,1,-1,1,down,1983-04-16
22305,The Fatback Band,1983-06-18,The Fatback Band - Is This The Future,34,35,40,27.0,43,Is This The Future,16.0,9,3,-9,1,1,up,1983-04-16
22306,The Fatback Band,1983-06-25,The Fatback Band - Is This The Future,43,34,39,27.0,40,Is This The Future,16.0,10,1,3,-9,1,up,1983-04-16
22307,The Fatback Band,1983-07-02,The Fatback Band - Is This The Future,40,43,40,27.0,39,Is This The Future,16.0,11,-1,1,3,1,down,1983-04-16
22308,The Fatback Band,1983-07-09,The Fatback Band - Is This The Future,39,40,31,27.0,40,Is This The Future,16.0,12,9,-1,1,1,up,1983-04-16
22309,The Fatback Band,1983-07-16,The Fatback Band - Is This The Future,40,39,31,27.0,31,Is This The Future,16.0,13,0,9,-1,0,stay,1983-04-16
22310,The Fatback Band,1983-07-23,The Fatback Band - Is This The Future,31,40,32,27.0,31,Is This The Future,16.0,14,-1,0,9,1,down,1983-04-16
22311,The Fatback Band,1983-07-30,The Fatback Band - Is This The Future,31,31,44,27.0,32,Is This The Future,16.0,15,-12,-1,0,1,down,1983-04-16
22312,The Fatback Band,1983-08-06,The Fatback Band - Is This The Future,32,31,51,27.0,44,Is This The Future,16.0,16,-7,-12,-1,1,down,1983-04-16
22313,Weather Report,1983-04-16,Weather Report - Procession,51,51,46,46.0,46,Procession,2.0,0,0,5,0,0,stay,1983-04-16
22314,Weather Report,1983-04-23,Weather Report - Procession,46,51,50,46.0,46,Procession,2.0,1,-4,0,5,1,down,1983-04-16
22315,Weather Report,1983-04-30,Weather Report - Procession,46,46,51,46.0,50,Procession,2.0,2,-1,-4,0,1,down,1983-04-16
22316,Nona Hendryx,1983-04-16,Nona Hendryx - Nona,51,51,41,25.0,50,Nona,23.0,0,9,1,0,1,up,1983-04-16
22317,Nona Hendryx,1983-04-23,Nona Hendryx - Nona,50,51,36,25.0,41,Nona,23.0,1,5,9,1,1,up,1983-04-16
22318,Nona Hendryx,1983-04-30,Nona Hendryx - Nona,41,50,28,25.0,36,Nona,23.0,2,8,5,9,1,up,1983-04-16
22319,Nona Hendryx,1983-05-07,Nona Hendryx - Nona,36,41,28,25.0,28,Nona,23.0,3,0,8,5,0,stay,1983-04-16
22320,Nona Hendryx,1983-05-14,Nona Hendryx - Nona,28,36,25,25.0,28,Nona,23.0,4,3,0,8,1,up,1983-04-16
22321,Nona Hendryx,1983-05-21,Nona Hendryx - Nona,28,28,25,25.0,25,Nona,23.0,5,0,3,0,0,stay,1983-04-16
22322,Nona Hendryx,1983-05-28,Nona Hendryx - Nona,25,28,34,25.0,25,Nona,23.0,6,-9,0,3,1,down,1983-04-16
22323,Nona Hendryx,1983-06-04,Nona Hendryx - Nona,25,25,32,25.0,34,Nona,23.0,7,2,-9,0,1,up,1983-04-16
22324,Nona Hendryx,1983-06-11,Nona Hendryx - Nona,34,25,32,25.0,32,Nona,23.0,8,0,2,-9,0,stay,1983-04-16
22325,Nona Hendryx,1983-06-18,Nona Hendryx - Nona,32,34,45,25.0,32,Nona,23.0,9,-13,0,2,1,down,1983-04-16
22326,Nona Hendryx,1983-06-25,Nona Hendryx - Nona,32,32,42,25.0,45,Nona,23.0,10,3,-13,0,1,up,1983-04-16
22327,Nona Hendryx,1983-07-02,Nona Hendryx - Nona,45,32,39,25.0,42,Nona,23.0,11,3,3,-13,1,up,1983-04-16
22328,Nona Hendryx,1983-07-09,Nona Hendryx - Nona,42,45,37,25.0,39,Nona,23.0,12,2,3,3,1,up,1983-04-16
22329,Nona Hendryx,1983-07-16,Nona Hendryx - Nona,39,42,37,25.0,37,Nona,23.0,13,0,2,3,0,stay,1983-04-16
22330,Nona Hendryx,1983-07-23,Nona Hendryx - Nona,37,39,41,25.0,37,Nona,23.0,14,-4,0,2,1,down,1983-04-16
22331,Nona Hendryx,1983-07-30,Nona Hendryx - Nona,37,37,46,25.0,41,Nona,23.0,15,-5,-4,0,1,down,1983-04-16
22332,Nona Hendryx,1983-08-06,Nona Hendryx - Nona,41,37,49,25.0,46,Nona,23.0,16,-3,-5,-4,1,down,1983-04-16
22333,Nona Hendryx,1983-08-27,Nona Hendryx - Nona,46,41,49,25.0,49,Nona,23.0,17,0,-3,-5,0,stay,1983-04-16
22334,Nona Hendryx,1983-09-03,Nona Hendryx - Nona,49,46,46,25.0,49,Nona,23.0,18,3,0,-3,1,up,1983-04-16
22335,Nona Hendryx,1983-09-10,Nona Hendryx - Nona,49,49,46,25.0,46,Nona,23.0,19,0,3,0,0,stay,1983-04-16
22336,Nona Hendryx,1983-09-17,Nona Hendryx - Nona,46,49,47,25.0,46,Nona,23.0,20,-1,0,3,1,down,1983-04-16
22337,Nona Hendryx,1983-09-24,Nona Hendryx - Nona,46,46,45,25.0,47,Nona,23.0,21,2,-1,0,1,up,1983-04-16
22338,Nona Hendryx,1983-10-01,Nona Hendryx - Nona,47,46,45,25.0,45,Nona,23.0,22,0,2,-1,0,stay,1983-04-16
22339,Nona Hendryx,1983-10-08,Nona Hendryx - Nona,45,47,51,25.0,45,Nona,23.0,23,-6,0,2,1,down,1983-04-16
22340,Joe Sample,1983-04-23,Joe Sample - The Hunter,51,51,44,44.0,50,The Hunter,2.0,0,6,1,0,1,up,1983-04-23
22341,Joe Sample,1983-04-30,Joe Sample - The Hunter,50,51,44,44.0,44,The Hunter,2.0,1,0,6,1,0,stay,1983-04-23
22342,Joe Sample,1983-05-07,Joe Sample - The Hunter,44,50,51,44.0,44,The Hunter,2.0,2,-7,0,6,1,down,1983-04-23
22343,Eddy Grant,1983-04-30,Eddy Grant - Killer On The Rampage,51,51,42,13.0,47,Killer On The Rampage,24.0,0,5,4,0,1,up,1983-04-30
22344,Eddy Grant,1983-05-07,Eddy Grant - Killer On The Rampage,47,51,37,13.0,42,Killer On The Rampage,24.0,1,5,5,4,1,up,1983-04-30
22345,Eddy Grant,1983-05-14,Eddy Grant - Killer On The Rampage,42,47,29,13.0,37,Killer On The Rampage,24.0,2,8,5,5,1,up,1983-04-30
22346,Eddy Grant,1983-05-21,Eddy Grant - Killer On The Rampage,37,42,27,13.0,29,Killer On The Rampage,24.0,3,2,8,5,1,up,1983-04-30
22347,Eddy Grant,1983-05-28,Eddy Grant - Killer On The Rampage,29,37,21,13.0,27,Killer On The Rampage,24.0,4,6,2,8,1,up,1983-04-30
22348,Eddy Grant,1983-06-04,Eddy Grant - Killer On The Rampage,27,29,18,13.0,21,Killer On The Rampage,24.0,5,3,6,2,1,up,1983-04-30
22349,Eddy Grant,1983-06-11,Eddy Grant - Killer On The Rampage,21,27,18,13.0,18,Killer On The Rampage,24.0,6,0,3,6,0,stay,1983-04-30
22350,Eddy Grant,1983-06-18,Eddy Grant - Killer On The Rampage,18,21,16,13.0,18,Killer On The Rampage,24.0,7,2,0,3,1,up,1983-04-30
22351,Eddy Grant,1983-06-25,Eddy Grant - Killer On The Rampage,18,18,16,13.0,16,Killer On The Rampage,24.0,8,0,2,0,0,stay,1983-04-30
22352,Eddy Grant,1983-07-02,Eddy Grant - Killer On The Rampage,16,18,14,13.0,16,Killer On The Rampage,24.0,9,2,0,2,1,up,1983-04-30
22353,Eddy Grant,1983-07-09,Eddy Grant - Killer On The Rampage,16,16,13,13.0,14,Killer On The Rampage,24.0,10,1,2,0,1,up,1983-04-30
22354,Eddy Grant,1983-07-16,Eddy Grant - Killer On The Rampage,14,16,13,13.0,13,Killer On The Rampage,24.0,11,0,1,2,0,stay,1983-04-30
22355,Eddy Grant,1983-07-23,Eddy Grant - Killer On The Rampage,13,14,15,13.0,13,Killer On The Rampage,24.0,12,-2,0,1,1,down,1983-04-30
22356,Eddy Grant,1983-07-30,Eddy Grant - Killer On The Rampage,13,13,13,13.0,15,Killer On The Rampage,24.0,13,2,-2,0,1,up,1983-04-30
22357,Eddy Grant,1983-08-06,Eddy Grant - Killer On The Rampage,15,13,13,13.0,13,Killer On The Rampage,24.0,14,0,2,-2,0,stay,1983-04-30
22358,Eddy Grant,1983-08-13,Eddy Grant - Killer On The Rampage,13,15,23,13.0,13,Killer On The Rampage,24.0,15,-10,0,2,1,down,1983-04-30
22359,Eddy Grant,1983-08-20,Eddy Grant - Killer On The Rampage,13,13,23,13.0,23,Killer On The Rampage,24.0,16,0,-10,0,0,stay,1983-04-30
22360,Eddy Grant,1983-08-27,Eddy Grant - Killer On The Rampage,23,13,31,13.0,23,Killer On The Rampage,24.0,17,-8,0,-10,1,down,1983-04-30
22361,Eddy Grant,1983-09-03,Eddy Grant - Killer On The Rampage,23,23,32,13.0,31,Killer On The Rampage,24.0,18,-1,-8,0,1,down,1983-04-30
22362,Eddy Grant,1983-09-10,Eddy Grant - Killer On The Rampage,31,23,44,13.0,32,Killer On The Rampage,24.0,19,-12,-1,-8,1,down,1983-04-30
22363,Eddy Grant,1983-09-17,Eddy Grant - Killer On The Rampage,32,31,44,13.0,44,Killer On The Rampage,24.0,20,0,-12,-1,0,stay,1983-04-30
22364,Eddy Grant,1983-09-24,Eddy Grant - Killer On The Rampage,44,32,47,13.0,44,Killer On The Rampage,24.0,21,-3,0,-12,1,down,1983-04-30
22365,Eddy Grant,1983-10-01,Eddy Grant - Killer On The Rampage,44,44,49,13.0,47,Killer On The Rampage,24.0,22,-2,-3,0,1,down,1983-04-30
22366,Eddy Grant,1983-10-08,Eddy Grant - Killer On The Rampage,47,44,49,13.0,49,Killer On The Rampage,24.0,23,0,-2,-3,0,stay,1983-04-30
22367,Eddy Grant,1983-10-15,Eddy Grant - Killer On The Rampage,49,47,51,13.0,49,Killer On The Rampage,24.0,24,-2,0,-2,1,down,1983-04-30
22368,Cameo,1983-05-07,Cameo - Style,51,51,20,14.0,34,Style,13.0,0,14,17,0,1,up,1983-05-07
22369,Cameo,1983-05-14,Cameo - Style,34,51,17,14.0,20,Style,13.0,1,3,14,17,1,up,1983-05-07
22370,Cameo,1983-05-21,Cameo - Style,20,34,14,14.0,17,Style,13.0,2,3,3,14,1,up,1983-05-07
22371,Cameo,1983-05-28,Cameo - Style,17,20,14,14.0,14,Style,13.0,3,0,3,3,0,stay,1983-05-07
22372,Cameo,1983-06-04,Cameo - Style,14,17,14,14.0,14,Style,13.0,4,0,0,3,0,stay,1983-05-07
22373,Cameo,1983-06-11,Cameo - Style,14,14,24,14.0,14,Style,13.0,5,-10,0,0,1,down,1983-05-07
22374,Cameo,1983-06-18,Cameo - Style,14,14,24,14.0,24,Style,13.0,6,0,-10,0,0,stay,1983-05-07
22375,Cameo,1983-06-25,Cameo - Style,24,14,26,14.0,24,Style,13.0,7,-2,0,-10,1,down,1983-05-07
22376,Cameo,1983-07-02,Cameo - Style,24,24,29,14.0,26,Style,13.0,8,-3,-2,0,1,down,1983-05-07
22377,Cameo,1983-07-09,Cameo - Style,26,24,30,14.0,29,Style,13.0,9,-1,-3,-2,1,down,1983-05-07
22378,Cameo,1983-07-16,Cameo - Style,29,26,40,14.0,30,Style,13.0,10,-10,-1,-3,1,down,1983-05-07
22379,Cameo,1983-07-23,Cameo - Style,30,29,42,14.0,40,Style,13.0,11,-2,-10,-1,1,down,1983-05-07
22380,Cameo,1983-07-30,Cameo - Style,40,30,49,14.0,42,Style,13.0,12,-7,-2,-10,1,down,1983-05-07
22381,Cameo,1983-08-06,Cameo - Style,42,40,51,14.0,49,Style,13.0,13,-2,-7,-2,1,down,1983-05-07
22382,Betty Wright,1983-05-07,Betty Wright - Wright Back At You,51,51,41,41.0,41,Wright Back At You,3.0,0,0,10,0,0,stay,1983-05-07
22383,Betty Wright,1983-05-14,Betty Wright - Wright Back At You,41,51,44,41.0,41,Wright Back At You,3.0,1,-3,0,10,1,down,1983-05-07
22384,Betty Wright,1983-05-21,Betty Wright - Wright Back At You,41,41,50,41.0,44,Wright Back At You,3.0,2,-6,-3,0,1,down,1983-05-07
22385,Betty Wright,1983-05-28,Betty Wright - Wright Back At You,44,41,51,41.0,50,Wright Back At You,3.0,3,-1,-6,-3,1,down,1983-05-07
22386,Denise LaSalle,1983-05-07,Denise LaSalle - A Lady In The Street,51,51,35,23.0,49,A Lady In The Street,17.0,0,14,2,0,1,up,1983-05-07
22387,Denise LaSalle,1983-05-14,Denise LaSalle - A Lady In The Street,49,51,26,23.0,35,A Lady In The Street,17.0,1,9,14,2,1,up,1983-05-07
22388,Denise LaSalle,1983-05-21,Denise LaSalle - A Lady In The Street,35,49,26,23.0,26,A Lady In The Street,17.0,2,0,9,14,0,stay,1983-05-07
22389,Denise LaSalle,1983-05-28,Denise LaSalle - A Lady In The Street,26,35,23,23.0,26,A Lady In The Street,17.0,3,3,0,9,1,up,1983-05-07
22390,Denise LaSalle,1983-06-04,Denise LaSalle - A Lady In The Street,26,26,23,23.0,23,A Lady In The Street,17.0,4,0,3,0,0,stay,1983-05-07
22391,Denise LaSalle,1983-06-11,Denise LaSalle - A Lady In The Street,23,26,23,23.0,23,A Lady In The Street,17.0,5,0,0,3,0,stay,1983-05-07
22392,Denise LaSalle,1983-06-18,Denise LaSalle - A Lady In The Street,23,23,23,23.0,23,A Lady In The Street,17.0,6,0,0,0,0,stay,1983-05-07
22393,Denise LaSalle,1983-06-25,Denise LaSalle - A Lady In The Street,23,23,29,23.0,23,A Lady In The Street,17.0,7,-6,0,0,1,down,1983-05-07
22394,Denise LaSalle,1983-07-02,Denise LaSalle - A Lady In The Street,23,23,27,23.0,29,A Lady In The Street,17.0,8,2,-6,0,1,up,1983-05-07
22395,Denise LaSalle,1983-07-09,Denise LaSalle - A Lady In The Street,29,23,27,23.0,27,A Lady In The Street,17.0,9,0,2,-6,0,stay,1983-05-07
22396,Denise LaSalle,1983-07-16,Denise LaSalle - A Lady In The Street,27,29,36,23.0,27,A Lady In The Street,17.0,10,-9,0,2,1,down,1983-05-07
22397,Denise LaSalle,1983-07-23,Denise LaSalle - A Lady In The Street,27,27,36,23.0,36,A Lady In The Street,17.0,11,0,-9,0,0,stay,1983-05-07
22398,Denise LaSalle,1983-07-30,Denise LaSalle - A Lady In The Street,36,27,35,23.0,36,A Lady In The Street,17.0,12,1,0,-9,1,up,1983-05-07
22399,Denise LaSalle,1983-08-06,Denise LaSalle - A Lady In The Street,36,36,47,23.0,35,A Lady In The Street,17.0,13,-12,1,0,1,down,1983-05-07
22400,Denise LaSalle,1983-08-13,Denise LaSalle - A Lady In The Street,35,36,47,23.0,47,A Lady In The Street,17.0,14,0,-12,1,0,stay,1983-05-07
22401,Denise LaSalle,1983-08-20,Denise LaSalle - A Lady In The Street,47,35,50,23.0,47,A Lady In The Street,17.0,15,-3,0,-12,1,down,1983-05-07
22402,Denise LaSalle,1983-09-03,Denise LaSalle - A Lady In The Street,47,47,50,23.0,50,A Lady In The Street,17.0,16,0,-3,0,0,stay,1983-05-07
22403,Denise LaSalle,1983-10-08,Denise LaSalle - A Lady In The Street,50,47,51,23.0,50,A Lady In The Street,17.0,17,-1,0,-3,1,down,1983-05-07
22404,George Duke,1983-05-07,George Duke - Guardian Of The Light,51,51,46,46.0,50,Guardian Of The Light,3.0,0,4,1,0,1,up,1983-05-07
22405,George Duke,1983-05-14,George Duke - Guardian Of The Light,50,51,46,46.0,46,Guardian Of The Light,3.0,1,0,4,1,0,stay,1983-05-07
22406,George Duke,1983-05-21,George Duke - Guardian Of The Light,46,50,47,46.0,46,Guardian Of The Light,3.0,2,-1,0,4,1,down,1983-05-07
22407,George Duke,1983-05-28,George Duke - Guardian Of The Light,46,46,51,46.0,47,Guardian Of The Light,3.0,3,-4,-1,0,1,down,1983-05-07
22408,Soundtrack,1983-05-14,Soundtrack - Flashdance,51,51,14,6.0,26,Flashdance,27.0,0,12,25,0,1,up,1983-05-14
22409,Soundtrack,1983-05-21,Soundtrack - Flashdance,26,51,11,6.0,14,Flashdance,27.0,1,3,12,25,1,up,1983-05-14
22410,Soundtrack,1983-05-28,Soundtrack - Flashdance,14,26,7,6.0,11,Flashdance,27.0,2,4,3,12,1,up,1983-05-14
22411,Soundtrack,1983-06-04,Soundtrack - Flashdance,11,14,7,6.0,7,Flashdance,27.0,3,0,4,3,0,stay,1983-05-14
22412,Soundtrack,1983-06-11,Soundtrack - Flashdance,7,11,6,6.0,7,Flashdance,27.0,4,1,0,4,1,up,1983-05-14
22413,Soundtrack,1983-06-18,Soundtrack - Flashdance,7,7,6,6.0,6,Flashdance,27.0,5,0,1,0,0,stay,1983-05-14
22414,Soundtrack,1983-06-25,Soundtrack - Flashdance,6,7,6,6.0,6,Flashdance,27.0,6,0,0,1,0,stay,1983-05-14
22415,Soundtrack,1983-07-02,Soundtrack - Flashdance,6,6,6,6.0,6,Flashdance,27.0,7,0,0,0,0,stay,1983-05-14
22416,Soundtrack,1983-07-09,Soundtrack - Flashdance,6,6,7,6.0,6,Flashdance,27.0,8,-1,0,0,1,down,1983-05-14
22417,Soundtrack,1983-07-16,Soundtrack - Flashdance,6,6,8,6.0,7,Flashdance,27.0,9,-1,-1,0,1,down,1983-05-14
22418,Soundtrack,1983-07-23,Soundtrack - Flashdance,7,6,8,6.0,8,Flashdance,27.0,10,0,-1,-1,0,stay,1983-05-14
22419,Soundtrack,1983-07-30,Soundtrack - Flashdance,8,7,8,6.0,8,Flashdance,27.0,11,0,0,-1,0,stay,1983-05-14
22420,Soundtrack,1983-08-06,Soundtrack - Flashdance,8,8,11,6.0,8,Flashdance,27.0,12,-3,0,0,1,down,1983-05-14
22421,Soundtrack,1983-08-13,Soundtrack - Flashdance,8,8,13,6.0,11,Flashdance,27.0,13,-2,-3,0,1,down,1983-05-14
22422,Soundtrack,1983-08-20,Soundtrack - Flashdance,11,8,13,6.0,13,Flashdance,27.0,14,0,-2,-3,0,stay,1983-05-14
22423,Soundtrack,1983-08-27,Soundtrack - Flashdance,13,11,15,6.0,13,Flashdance,27.0,15,-2,0,-2,1,down,1983-05-14
22424,Soundtrack,1983-09-03,Soundtrack - Flashdance,13,13,15,6.0,15,Flashdance,27.0,16,0,-2,0,0,stay,1983-05-14
22425,Soundtrack,1983-09-10,Soundtrack - Flashdance,15,13,16,6.0,15,Flashdance,27.0,17,-1,0,-2,1,down,1983-05-14
22426,Soundtrack,1983-09-17,Soundtrack - Flashdance,15,15,20,6.0,16,Flashdance,27.0,18,-4,-1,0,1,down,1983-05-14
22427,Soundtrack,1983-09-24,Soundtrack - Flashdance,16,15,24,6.0,20,Flashdance,27.0,19,-4,-4,-1,1,down,1983-05-14
22428,Soundtrack,1983-10-01,Soundtrack - Flashdance,20,16,32,6.0,24,Flashdance,27.0,20,-8,-4,-4,1,down,1983-05-14
22429,Soundtrack,1983-10-08,Soundtrack - Flashdance,24,20,32,6.0,32,Flashdance,27.0,21,0,-8,-4,0,stay,1983-05-14
22430,Soundtrack,1983-10-15,Soundtrack - Flashdance,32,24,31,6.0,32,Flashdance,27.0,22,1,0,-8,1,up,1983-05-14
22431,Soundtrack,1983-10-22,Soundtrack - Flashdance,32,32,33,6.0,31,Flashdance,27.0,23,-2,1,0,1,down,1983-05-14
22432,Soundtrack,1983-10-29,Soundtrack - Flashdance,31,32,35,6.0,33,Flashdance,27.0,24,-2,-2,1,1,down,1983-05-14
22433,Soundtrack,1983-11-05,Soundtrack - Flashdance,33,31,34,6.0,35,Flashdance,27.0,25,1,-2,-2,1,up,1983-05-14
22434,Soundtrack,1983-11-12,Soundtrack - Flashdance,35,33,43,6.0,34,Flashdance,27.0,26,-9,1,-2,1,down,1983-05-14
22435,Soundtrack,1983-11-19,Soundtrack - Flashdance,34,35,51,6.0,43,Flashdance,27.0,27,-8,-9,1,1,down,1983-05-14
22436,The Chi-lites,1983-05-14,The Chi-lites - Bottoms Up,51,51,23,15.0,32,Bottoms Up,16.0,0,9,19,0,1,up,1983-05-14
22437,The Chi-lites,1983-05-21,The Chi-lites - Bottoms Up,32,51,19,15.0,23,Bottoms Up,16.0,1,4,9,19,1,up,1983-05-14
22438,The Chi-lites,1983-05-28,The Chi-lites - Bottoms Up,23,32,19,15.0,19,Bottoms Up,16.0,2,0,4,9,0,stay,1983-05-14
22439,The Chi-lites,1983-06-04,The Chi-lites - Bottoms Up,19,23,16,15.0,19,Bottoms Up,16.0,3,3,0,4,1,up,1983-05-14
22440,The Chi-lites,1983-06-11,The Chi-lites - Bottoms Up,19,19,16,15.0,16,Bottoms Up,16.0,4,0,3,0,0,stay,1983-05-14
22441,The Chi-lites,1983-06-18,The Chi-lites - Bottoms Up,16,19,15,15.0,16,Bottoms Up,16.0,5,1,0,3,1,up,1983-05-14
22442,The Chi-lites,1983-06-25,The Chi-lites - Bottoms Up,16,16,15,15.0,15,Bottoms Up,16.0,6,0,1,0,0,stay,1983-05-14
22443,The Chi-lites,1983-07-02,The Chi-lites - Bottoms Up,15,16,16,15.0,15,Bottoms Up,16.0,7,-1,0,1,1,down,1983-05-14
22444,The Chi-lites,1983-07-09,The Chi-lites - Bottoms Up,15,15,23,15.0,16,Bottoms Up,16.0,8,-7,-1,0,1,down,1983-05-14
22445,The Chi-lites,1983-07-16,The Chi-lites - Bottoms Up,16,15,26,15.0,23,Bottoms Up,16.0,9,-3,-7,-1,1,down,1983-05-14
22446,The Chi-lites,1983-07-23,The Chi-lites - Bottoms Up,23,16,25,15.0,26,Bottoms Up,16.0,10,1,-3,-7,1,up,1983-05-14
22447,The Chi-lites,1983-07-30,The Chi-lites - Bottoms Up,26,23,27,15.0,25,Bottoms Up,16.0,11,-2,1,-3,1,down,1983-05-14
22448,The Chi-lites,1983-08-06,The Chi-lites - Bottoms Up,25,26,37,15.0,27,Bottoms Up,16.0,12,-10,-2,1,1,down,1983-05-14
22449,The Chi-lites,1983-08-13,The Chi-lites - Bottoms Up,27,25,38,15.0,37,Bottoms Up,16.0,13,-1,-10,-2,1,down,1983-05-14
22450,The Chi-lites,1983-08-20,The Chi-lites - Bottoms Up,37,27,39,15.0,38,Bottoms Up,16.0,14,-1,-1,-10,1,down,1983-05-14
22451,The Chi-lites,1983-08-27,The Chi-lites - Bottoms Up,38,37,48,15.0,39,Bottoms Up,16.0,15,-9,-1,-1,1,down,1983-05-14
22452,The Chi-lites,1983-09-03,The Chi-lites - Bottoms Up,39,38,51,15.0,48,Bottoms Up,16.0,16,-3,-9,-1,1,down,1983-05-14
22453,Earl Klugh,1983-05-14,Earl Klugh - Low Ride,51,51,31,27.0,36,Low Ride,8.0,0,5,15,0,1,up,1983-05-14
22454,Earl Klugh,1983-05-21,Earl Klugh - Low Ride,36,51,31,27.0,31,Low Ride,8.0,1,0,5,15,0,stay,1983-05-14
22455,Earl Klugh,1983-05-28,Earl Klugh - Low Ride,31,36,28,27.0,31,Low Ride,8.0,2,3,0,5,1,up,1983-05-14
22456,Earl Klugh,1983-06-04,Earl Klugh - Low Ride,31,31,27,27.0,28,Low Ride,8.0,3,1,3,0,1,up,1983-05-14
22457,Earl Klugh,1983-06-11,Earl Klugh - Low Ride,28,31,28,27.0,27,Low Ride,8.0,4,-1,1,3,1,down,1983-05-14
22458,Earl Klugh,1983-06-18,Earl Klugh - Low Ride,27,28,42,27.0,28,Low Ride,8.0,5,-14,-1,1,1,down,1983-05-14
22459,Earl Klugh,1983-06-25,Earl Klugh - Low Ride,28,27,46,27.0,42,Low Ride,8.0,6,-4,-14,-1,1,down,1983-05-14
22460,Earl Klugh,1983-07-23,Earl Klugh - Low Ride,42,28,46,27.0,46,Low Ride,8.0,7,0,-4,-14,0,stay,1983-05-14
22461,Earl Klugh,1983-07-30,Earl Klugh - Low Ride,46,42,51,27.0,46,Low Ride,8.0,8,-5,0,-4,1,down,1983-05-14
22462,The Jonzun Crew,1983-05-14,The Jonzun Crew - Lost In Space,51,51,30,17.0,38,Lost In Space,18.0,0,8,13,0,1,up,1983-05-14
22463,The Jonzun Crew,1983-05-21,The Jonzun Crew - Lost In Space,38,51,28,17.0,30,Lost In Space,18.0,1,2,8,13,1,up,1983-05-14
22464,The Jonzun Crew,1983-05-28,The Jonzun Crew - Lost In Space,30,38,26,17.0,28,Lost In Space,18.0,2,2,2,8,1,up,1983-05-14
22465,The Jonzun Crew,1983-06-04,The Jonzun Crew - Lost In Space,28,30,24,17.0,26,Lost In Space,18.0,3,2,2,2,1,up,1983-05-14
22466,The Jonzun Crew,1983-06-11,The Jonzun Crew - Lost In Space,26,28,22,17.0,24,Lost In Space,18.0,4,2,2,2,1,up,1983-05-14
22467,The Jonzun Crew,1983-06-18,The Jonzun Crew - Lost In Space,24,26,22,17.0,22,Lost In Space,18.0,5,0,2,2,0,stay,1983-05-14
22468,The Jonzun Crew,1983-06-25,The Jonzun Crew - Lost In Space,22,24,20,17.0,22,Lost In Space,18.0,6,2,0,2,1,up,1983-05-14
22469,The Jonzun Crew,1983-07-02,The Jonzun Crew - Lost In Space,22,22,17,17.0,20,Lost In Space,18.0,7,3,2,0,1,up,1983-05-14
22470,The Jonzun Crew,1983-07-09,The Jonzun Crew - Lost In Space,20,22,17,17.0,17,Lost In Space,18.0,8,0,3,2,0,stay,1983-05-14
22471,The Jonzun Crew,1983-07-16,The Jonzun Crew - Lost In Space,17,20,17,17.0,17,Lost In Space,18.0,9,0,0,3,0,stay,1983-05-14
22472,The Jonzun Crew,1983-07-23,The Jonzun Crew - Lost In Space,17,17,21,17.0,17,Lost In Space,18.0,10,-4,0,0,1,down,1983-05-14
22473,The Jonzun Crew,1983-07-30,The Jonzun Crew - Lost In Space,17,17,21,17.0,21,Lost In Space,18.0,11,0,-4,0,0,stay,1983-05-14
22474,The Jonzun Crew,1983-08-06,The Jonzun Crew - Lost In Space,21,17,27,17.0,21,Lost In Space,18.0,12,-6,0,-4,1,down,1983-05-14
22475,The Jonzun Crew,1983-08-13,The Jonzun Crew - Lost In Space,21,21,29,17.0,27,Lost In Space,18.0,13,-2,-6,0,1,down,1983-05-14
22476,The Jonzun Crew,1983-08-20,The Jonzun Crew - Lost In Space,27,21,34,17.0,29,Lost In Space,18.0,14,-5,-2,-6,1,down,1983-05-14
22477,The Jonzun Crew,1983-08-27,The Jonzun Crew - Lost In Space,29,27,33,17.0,34,Lost In Space,18.0,15,1,-5,-2,1,up,1983-05-14
22478,The Jonzun Crew,1983-09-03,The Jonzun Crew - Lost In Space,34,29,35,17.0,33,Lost In Space,18.0,16,-2,1,-5,1,down,1983-05-14
22479,The Jonzun Crew,1983-09-10,The Jonzun Crew - Lost In Space,33,34,47,17.0,35,Lost In Space,18.0,17,-12,-2,1,1,down,1983-05-14
22480,The Jonzun Crew,1983-09-17,The Jonzun Crew - Lost In Space,35,33,51,17.0,47,Lost In Space,18.0,18,-4,-12,-2,1,down,1983-05-14
22481,Mary Jane Girls,1983-05-14,Mary Jane Girls - Mary Jane Girls,51,51,35,6.0,43,Mary Jane Girls,42.0,0,8,8,0,1,up,1983-05-14
22482,Mary Jane Girls,1983-05-21,Mary Jane Girls - Mary Jane Girls,43,51,24,6.0,35,Mary Jane Girls,42.0,1,11,8,8,1,up,1983-05-14
22483,Mary Jane Girls,1983-05-28,Mary Jane Girls - Mary Jane Girls,35,43,24,6.0,24,Mary Jane Girls,42.0,2,0,11,8,0,stay,1983-05-14
22484,Mary Jane Girls,1983-06-04,Mary Jane Girls - Mary Jane Girls,24,35,20,6.0,24,Mary Jane Girls,42.0,3,4,0,11,1,up,1983-05-14
22485,Mary Jane Girls,1983-06-11,Mary Jane Girls - Mary Jane Girls,24,24,15,6.0,20,Mary Jane Girls,42.0,4,5,4,0,1,up,1983-05-14
22486,Mary Jane Girls,1983-06-18,Mary Jane Girls - Mary Jane Girls,20,24,14,6.0,15,Mary Jane Girls,42.0,5,1,5,4,1,up,1983-05-14
22487,Mary Jane Girls,1983-06-25,Mary Jane Girls - Mary Jane Girls,15,20,12,6.0,14,Mary Jane Girls,42.0,6,2,1,5,1,up,1983-05-14
22488,Mary Jane Girls,1983-07-02,Mary Jane Girls - Mary Jane Girls,14,15,12,6.0,12,Mary Jane Girls,42.0,7,0,2,1,0,stay,1983-05-14
22489,Mary Jane Girls,1983-07-09,Mary Jane Girls - Mary Jane Girls,12,14,12,6.0,12,Mary Jane Girls,42.0,8,0,0,2,0,stay,1983-05-14
22490,Mary Jane Girls,1983-07-16,Mary Jane Girls - Mary Jane Girls,12,12,12,6.0,12,Mary Jane Girls,42.0,9,0,0,0,0,stay,1983-05-14
22491,Mary Jane Girls,1983-07-23,Mary Jane Girls - Mary Jane Girls,12,12,12,6.0,12,Mary Jane Girls,42.0,10,0,0,0,0,stay,1983-05-14
22492,Mary Jane Girls,1983-07-30,Mary Jane Girls - Mary Jane Girls,12,12,9,6.0,12,Mary Jane Girls,42.0,11,3,0,0,1,up,1983-05-14
22493,Mary Jane Girls,1983-08-06,Mary Jane Girls - Mary Jane Girls,12,12,9,6.0,9,Mary Jane Girls,42.0,12,0,3,0,0,stay,1983-05-14
22494,Mary Jane Girls,1983-08-13,Mary Jane Girls - Mary Jane Girls,9,12,8,6.0,9,Mary Jane Girls,42.0,13,1,0,3,1,up,1983-05-14
22495,Mary Jane Girls,1983-08-20,Mary Jane Girls - Mary Jane Girls,9,9,6,6.0,8,Mary Jane Girls,42.0,14,2,1,0,1,up,1983-05-14
22496,Mary Jane Girls,1983-08-27,Mary Jane Girls - Mary Jane Girls,8,9,6,6.0,6,Mary Jane Girls,42.0,15,0,2,1,0,stay,1983-05-14
22497,Mary Jane Girls,1983-09-03,Mary Jane Girls - Mary Jane Girls,6,8,6,6.0,6,Mary Jane Girls,42.0,16,0,0,2,0,stay,1983-05-14
22498,Mary Jane Girls,1983-09-10,Mary Jane Girls - Mary Jane Girls,6,6,6,6.0,6,Mary Jane Girls,42.0,17,0,0,0,0,stay,1983-05-14
22499,Mary Jane Girls,1983-09-17,Mary Jane Girls - Mary Jane Girls,6,6,6,6.0,6,Mary Jane Girls,42.0,18,0,0,0,0,stay,1983-05-14
22500,Mary Jane Girls,1983-09-24,Mary Jane Girls - Mary Jane Girls,6,6,12,6.0,6,Mary Jane Girls,42.0,19,-6,0,0,1,down,1983-05-14
22501,Mary Jane Girls,1983-10-01,Mary Jane Girls - Mary Jane Girls,6,6,12,6.0,12,Mary Jane Girls,42.0,20,0,-6,0,0,stay,1983-05-14
22502,Mary Jane Girls,1983-10-08,Mary Jane Girls - Mary Jane Girls,12,6,11,6.0,12,Mary Jane Girls,42.0,21,1,0,-6,1,up,1983-05-14
22503,Mary Jane Girls,1983-10-15,Mary Jane Girls - Mary Jane Girls,12,12,13,6.0,11,Mary Jane Girls,42.0,22,-2,1,0,1,down,1983-05-14
22504,Mary Jane Girls,1983-10-22,Mary Jane Girls - Mary Jane Girls,11,12,15,6.0,13,Mary Jane Girls,42.0,23,-2,-2,1,1,down,1983-05-14
22505,Mary Jane Girls,1983-10-29,Mary Jane Girls - Mary Jane Girls,13,11,15,6.0,15,Mary Jane Girls,42.0,24,0,-2,-2,0,stay,1983-05-14
22506,Mary Jane Girls,1983-11-05,Mary Jane Girls - Mary Jane Girls,15,13,16,6.0,15,Mary Jane Girls,42.0,25,-1,0,-2,1,down,1983-05-14
22507,Mary Jane Girls,1983-11-12,Mary Jane Girls - Mary Jane Girls,15,15,16,6.0,16,Mary Jane Girls,42.0,26,0,-1,0,0,stay,1983-05-14
22508,Mary Jane Girls,1983-11-19,Mary Jane Girls - Mary Jane Girls,16,15,16,6.0,16,Mary Jane Girls,42.0,27,0,0,-1,0,stay,1983-05-14
22509,Mary Jane Girls,1983-11-26,Mary Jane Girls - Mary Jane Girls,16,16,16,6.0,16,Mary Jane Girls,42.0,28,0,0,0,0,stay,1983-05-14
22510,Mary Jane Girls,1983-12-03,Mary Jane Girls - Mary Jane Girls,16,16,16,6.0,16,Mary Jane Girls,42.0,29,0,0,0,0,stay,1983-05-14
22511,Mary Jane Girls,1983-12-10,Mary Jane Girls - Mary Jane Girls,16,16,18,6.0,16,Mary Jane Girls,42.0,30,-2,0,0,1,down,1983-05-14
22512,Mary Jane Girls,1983-12-17,Mary Jane Girls - Mary Jane Girls,16,16,21,6.0,18,Mary Jane Girls,42.0,31,-3,-2,0,1,down,1983-05-14
22513,Mary Jane Girls,1983-12-24,Mary Jane Girls - Mary Jane Girls,18,16,21,6.0,21,Mary Jane Girls,42.0,32,0,-3,-2,0,stay,1983-05-14
22514,Mary Jane Girls,1983-12-31,Mary Jane Girls - Mary Jane Girls,21,18,23,6.0,21,Mary Jane Girls,42.0,33,-2,0,-3,1,down,1983-05-14
22515,Mary Jane Girls,1984-01-07,Mary Jane Girls - Mary Jane Girls,21,21,24,6.0,23,Mary Jane Girls,42.0,34,-1,-2,0,1,down,1983-05-14
22516,Mary Jane Girls,1984-01-14,Mary Jane Girls - Mary Jane Girls,23,21,37,6.0,24,Mary Jane Girls,42.0,35,-13,-1,-2,1,down,1983-05-14
22517,Mary Jane Girls,1984-01-21,Mary Jane Girls - Mary Jane Girls,24,23,34,6.0,37,Mary Jane Girls,42.0,36,3,-13,-1,1,up,1983-05-14
22518,Mary Jane Girls,1984-01-28,Mary Jane Girls - Mary Jane Girls,37,24,34,6.0,34,Mary Jane Girls,42.0,37,0,3,-13,0,stay,1983-05-14
22519,Mary Jane Girls,1984-02-04,Mary Jane Girls - Mary Jane Girls,34,37,38,6.0,34,Mary Jane Girls,42.0,38,-4,0,3,1,down,1983-05-14
22520,Mary Jane Girls,1984-02-11,Mary Jane Girls - Mary Jane Girls,34,34,44,6.0,38,Mary Jane Girls,42.0,39,-6,-4,0,1,down,1983-05-14
22521,Mary Jane Girls,1984-02-18,Mary Jane Girls - Mary Jane Girls,38,34,50,6.0,44,Mary Jane Girls,42.0,40,-6,-6,-4,1,down,1983-05-14
22522,Mary Jane Girls,1984-02-25,Mary Jane Girls - Mary Jane Girls,44,38,49,6.0,50,Mary Jane Girls,42.0,41,1,-6,-6,1,up,1983-05-14
22523,Mary Jane Girls,1984-03-03,Mary Jane Girls - Mary Jane Girls,50,44,51,6.0,49,Mary Jane Girls,42.0,42,-2,1,-6,1,down,1983-05-14
22524,Lakeside,1983-05-14,Lakeside - Untouchables,51,51,20,10.0,45,Untouchables,28.0,0,25,6,0,1,up,1983-05-14
22525,Lakeside,1983-05-21,Lakeside - Untouchables,45,51,12,10.0,20,Untouchables,28.0,1,8,25,6,1,up,1983-05-14
22526,Lakeside,1983-05-28,Lakeside - Untouchables,20,45,10,10.0,12,Untouchables,28.0,2,2,8,25,1,up,1983-05-14
22527,Lakeside,1983-06-04,Lakeside - Untouchables,12,20,10,10.0,10,Untouchables,28.0,3,0,2,8,0,stay,1983-05-14
22528,Lakeside,1983-06-11,Lakeside - Untouchables,10,12,10,10.0,10,Untouchables,28.0,4,0,0,2,0,stay,1983-05-14
22529,Lakeside,1983-06-18,Lakeside - Untouchables,10,10,10,10.0,10,Untouchables,28.0,5,0,0,0,0,stay,1983-05-14
22530,Lakeside,1983-06-25,Lakeside - Untouchables,10,10,14,10.0,10,Untouchables,28.0,6,-4,0,0,1,down,1983-05-14
22531,Lakeside,1983-07-02,Lakeside - Untouchables,10,10,15,10.0,14,Untouchables,28.0,7,-1,-4,0,1,down,1983-05-14
22532,Lakeside,1983-07-09,Lakeside - Untouchables,14,10,15,10.0,15,Untouchables,28.0,8,0,-1,-4,0,stay,1983-05-14
22533,Lakeside,1983-07-16,Lakeside - Untouchables,15,14,14,10.0,15,Untouchables,28.0,9,1,0,-1,1,up,1983-05-14
22534,Lakeside,1983-07-23,Lakeside - Untouchables,15,15,19,10.0,14,Untouchables,28.0,10,-5,1,0,1,down,1983-05-14
22535,Lakeside,1983-07-30,Lakeside - Untouchables,14,15,18,10.0,19,Untouchables,28.0,11,1,-5,1,1,up,1983-05-14
22536,Lakeside,1983-08-06,Lakeside - Untouchables,19,14,23,10.0,18,Untouchables,28.0,12,-5,1,-5,1,down,1983-05-14
22537,Lakeside,1983-08-13,Lakeside - Untouchables,18,19,21,10.0,23,Untouchables,28.0,13,2,-5,1,1,up,1983-05-14
22538,Lakeside,1983-08-20,Lakeside - Untouchables,23,18,21,10.0,21,Untouchables,28.0,14,0,2,-5,0,stay,1983-05-14
22539,Lakeside,1983-08-27,Lakeside - Untouchables,21,23,30,10.0,21,Untouchables,28.0,15,-9,0,2,1,down,1983-05-14
22540,Lakeside,1983-09-03,Lakeside - Untouchables,21,21,29,10.0,30,Untouchables,28.0,16,1,-9,0,1,up,1983-05-14
22541,Lakeside,1983-09-10,Lakeside - Untouchables,30,21,34,10.0,29,Untouchables,28.0,17,-5,1,-9,1,down,1983-05-14
22542,Lakeside,1983-09-17,Lakeside - Untouchables,29,30,34,10.0,34,Untouchables,28.0,18,0,-5,1,0,stay,1983-05-14
22543,Lakeside,1983-09-24,Lakeside - Untouchables,34,29,33,10.0,34,Untouchables,28.0,19,1,0,-5,1,up,1983-05-14
22544,Lakeside,1983-10-01,Lakeside - Untouchables,34,34,33,10.0,33,Untouchables,28.0,20,0,1,0,0,stay,1983-05-14
22545,Lakeside,1983-10-08,Lakeside - Untouchables,33,34,34,10.0,33,Untouchables,28.0,21,-1,0,1,1,down,1983-05-14
22546,Lakeside,1983-10-15,Lakeside - Untouchables,33,33,34,10.0,34,Untouchables,28.0,22,0,-1,0,0,stay,1983-05-14
22547,Lakeside,1983-10-22,Lakeside - Untouchables,34,33,32,10.0,34,Untouchables,28.0,23,2,0,-1,1,up,1983-05-14
22548,Lakeside,1983-10-29,Lakeside - Untouchables,34,34,29,10.0,32,Untouchables,28.0,24,3,2,0,1,up,1983-05-14
22549,Lakeside,1983-11-05,Lakeside - Untouchables,32,34,29,10.0,29,Untouchables,28.0,25,0,3,2,0,stay,1983-05-14
22550,Lakeside,1983-11-12,Lakeside - Untouchables,29,32,38,10.0,29,Untouchables,28.0,26,-9,0,3,1,down,1983-05-14
22551,Lakeside,1983-11-19,Lakeside - Untouchables,29,29,42,10.0,38,Untouchables,28.0,27,-4,-9,0,1,down,1983-05-14
22552,Lakeside,1983-11-26,Lakeside - Untouchables,38,29,51,10.0,42,Untouchables,28.0,28,-9,-4,-9,1,down,1983-05-14
22553,Gladys Knight And The Pips,1983-05-21,Gladys Knight And The Pips - Visions,51,51,15,3.0,40,Visions,42.0,0,25,11,0,1,up,1983-05-21
22554,Gladys Knight And The Pips,1983-05-28,Gladys Knight And The Pips - Visions,40,51,8,3.0,15,Visions,42.0,1,7,25,11,1,up,1983-05-21
22555,Gladys Knight And The Pips,1983-06-04,Gladys Knight And The Pips - Visions,15,40,8,3.0,8,Visions,42.0,2,0,7,25,0,stay,1983-05-21
22556,Gladys Knight And The Pips,1983-06-11,Gladys Knight And The Pips - Visions,8,15,4,3.0,8,Visions,42.0,3,4,0,7,1,up,1983-05-21
22557,Gladys Knight And The Pips,1983-06-18,Gladys Knight And The Pips - Visions,8,8,4,3.0,4,Visions,42.0,4,0,4,0,0,stay,1983-05-21
22558,Gladys Knight And The Pips,1983-06-25,Gladys Knight And The Pips - Visions,4,8,4,3.0,4,Visions,42.0,5,0,0,4,0,stay,1983-05-21
22559,Gladys Knight And The Pips,1983-07-02,Gladys Knight And The Pips - Visions,4,4,4,3.0,4,Visions,42.0,6,0,0,0,0,stay,1983-05-21
22560,Gladys Knight And The Pips,1983-07-09,Gladys Knight And The Pips - Visions,4,4,4,3.0,4,Visions,42.0,7,0,0,0,0,stay,1983-05-21
22561,Gladys Knight And The Pips,1983-07-16,Gladys Knight And The Pips - Visions,4,4,4,3.0,4,Visions,42.0,8,0,0,0,0,stay,1983-05-21
22562,Gladys Knight And The Pips,1983-07-23,Gladys Knight And The Pips - Visions,4,4,3,3.0,4,Visions,42.0,9,1,0,0,1,up,1983-05-21
22563,Gladys Knight And The Pips,1983-07-30,Gladys Knight And The Pips - Visions,4,4,3,3.0,3,Visions,42.0,10,0,1,0,0,stay,1983-05-21
22564,Gladys Knight And The Pips,1983-08-06,Gladys Knight And The Pips - Visions,3,4,3,3.0,3,Visions,42.0,11,0,0,1,0,stay,1983-05-21
22565,Gladys Knight And The Pips,1983-08-13,Gladys Knight And The Pips - Visions,3,3,3,3.0,3,Visions,42.0,12,0,0,0,0,stay,1983-05-21
22566,Gladys Knight And The Pips,1983-08-20,Gladys Knight And The Pips - Visions,3,3,3,3.0,3,Visions,42.0,13,0,0,0,0,stay,1983-05-21
22567,Gladys Knight And The Pips,1983-08-27,Gladys Knight And The Pips - Visions,3,3,3,3.0,3,Visions,42.0,14,0,0,0,0,stay,1983-05-21
22568,Gladys Knight And The Pips,1983-09-03,Gladys Knight And The Pips - Visions,3,3,3,3.0,3,Visions,42.0,15,0,0,0,0,stay,1983-05-21
22569,Gladys Knight And The Pips,1983-09-10,Gladys Knight And The Pips - Visions,3,3,3,3.0,3,Visions,42.0,16,0,0,0,0,stay,1983-05-21
22570,Gladys Knight And The Pips,1983-09-17,Gladys Knight And The Pips - Visions,3,3,3,3.0,3,Visions,42.0,17,0,0,0,0,stay,1983-05-21
22571,Gladys Knight And The Pips,1983-09-24,Gladys Knight And The Pips - Visions,3,3,4,3.0,3,Visions,42.0,18,-1,0,0,1,down,1983-05-21
22572,Gladys Knight And The Pips,1983-10-01,Gladys Knight And The Pips - Visions,3,3,6,3.0,4,Visions,42.0,19,-2,-1,0,1,down,1983-05-21
22573,Gladys Knight And The Pips,1983-10-08,Gladys Knight And The Pips - Visions,4,3,5,3.0,6,Visions,42.0,20,1,-2,-1,1,up,1983-05-21
22574,Gladys Knight And The Pips,1983-10-15,Gladys Knight And The Pips - Visions,6,4,5,3.0,5,Visions,42.0,21,0,1,-2,0,stay,1983-05-21
22575,Gladys Knight And The Pips,1983-10-22,Gladys Knight And The Pips - Visions,5,6,5,3.0,5,Visions,42.0,22,0,0,1,0,stay,1983-05-21
22576,Gladys Knight And The Pips,1983-10-29,Gladys Knight And The Pips - Visions,5,5,6,3.0,5,Visions,42.0,23,-1,0,0,1,down,1983-05-21
22577,Gladys Knight And The Pips,1983-11-05,Gladys Knight And The Pips - Visions,5,5,10,3.0,6,Visions,42.0,24,-4,-1,0,1,down,1983-05-21
22578,Gladys Knight And The Pips,1983-11-12,Gladys Knight And The Pips - Visions,6,5,11,3.0,10,Visions,42.0,25,-1,-4,-1,1,down,1983-05-21
22579,Gladys Knight And The Pips,1983-11-19,Gladys Knight And The Pips - Visions,10,6,11,3.0,11,Visions,42.0,26,0,-1,-4,0,stay,1983-05-21
22580,Gladys Knight And The Pips,1983-11-26,Gladys Knight And The Pips - Visions,11,10,12,3.0,11,Visions,42.0,27,-1,0,-1,1,down,1983-05-21
22581,Gladys Knight And The Pips,1983-12-03,Gladys Knight And The Pips - Visions,11,11,20,3.0,12,Visions,42.0,28,-8,-1,0,1,down,1983-05-21
22582,Gladys Knight And The Pips,1983-12-10,Gladys Knight And The Pips - Visions,12,11,31,3.0,20,Visions,42.0,29,-11,-8,-1,1,down,1983-05-21
22583,Gladys Knight And The Pips,1983-12-17,Gladys Knight And The Pips - Visions,20,12,45,3.0,31,Visions,42.0,30,-14,-11,-8,1,down,1983-05-21
22584,Gladys Knight And The Pips,1983-12-24,Gladys Knight And The Pips - Visions,31,20,45,3.0,45,Visions,42.0,31,0,-14,-11,0,stay,1983-05-21
22585,Gladys Knight And The Pips,1983-12-31,Gladys Knight And The Pips - Visions,45,31,44,3.0,45,Visions,42.0,32,1,0,-14,1,up,1983-05-21
22586,Gladys Knight And The Pips,1984-01-07,Gladys Knight And The Pips - Visions,45,45,44,3.0,44,Visions,42.0,33,0,1,0,0,stay,1983-05-21
22587,Gladys Knight And The Pips,1984-01-14,Gladys Knight And The Pips - Visions,44,45,45,3.0,44,Visions,42.0,34,-1,0,1,1,down,1983-05-21
22588,Gladys Knight And The Pips,1984-01-21,Gladys Knight And The Pips - Visions,44,44,43,3.0,45,Visions,42.0,35,2,-1,0,1,up,1983-05-21
22589,Gladys Knight And The Pips,1984-01-28,Gladys Knight And The Pips - Visions,45,44,40,3.0,43,Visions,42.0,36,3,2,-1,1,up,1983-05-21
22590,Gladys Knight And The Pips,1984-02-04,Gladys Knight And The Pips - Visions,43,45,40,3.0,40,Visions,42.0,37,0,3,2,0,stay,1983-05-21
22591,Gladys Knight And The Pips,1984-02-11,Gladys Knight And The Pips - Visions,40,43,43,3.0,40,Visions,42.0,38,-3,0,3,1,down,1983-05-21
22592,Gladys Knight And The Pips,1984-02-18,Gladys Knight And The Pips - Visions,40,40,45,3.0,43,Visions,42.0,39,-2,-3,0,1,down,1983-05-21
22593,Gladys Knight And The Pips,1984-02-25,Gladys Knight And The Pips - Visions,43,40,48,3.0,45,Visions,42.0,40,-3,-2,-3,1,down,1983-05-21
22594,Gladys Knight And The Pips,1984-03-24,Gladys Knight And The Pips - Visions,45,43,50,3.0,48,Visions,42.0,41,-2,-3,-2,1,down,1983-05-21
22595,Gladys Knight And The Pips,1984-03-31,Gladys Knight And The Pips - Visions,48,45,51,3.0,50,Visions,42.0,42,-1,-2,-3,1,down,1983-05-21
22596,Mtume,1983-05-21,Mtume - Juicy Fruit,51,51,17,3.0,47,Juicy Fruit,26.0,0,30,4,0,1,up,1983-05-21
22597,Mtume,1983-05-28,Mtume - Juicy Fruit,47,51,6,3.0,17,Juicy Fruit,26.0,1,11,30,4,1,up,1983-05-21
22598,Mtume,1983-06-04,Mtume - Juicy Fruit,17,47,6,3.0,6,Juicy Fruit,26.0,2,0,11,30,0,stay,1983-05-21
22599,Mtume,1983-06-11,Mtume - Juicy Fruit,6,17,3,3.0,6,Juicy Fruit,26.0,3,3,0,11,1,up,1983-05-21
22600,Mtume,1983-06-18,Mtume - Juicy Fruit,6,6,3,3.0,3,Juicy Fruit,26.0,4,0,3,0,0,stay,1983-05-21
22601,Mtume,1983-06-25,Mtume - Juicy Fruit,3,6,3,3.0,3,Juicy Fruit,26.0,5,0,0,3,0,stay,1983-05-21
22602,Mtume,1983-07-02,Mtume - Juicy Fruit,3,3,3,3.0,3,Juicy Fruit,26.0,6,0,0,0,0,stay,1983-05-21
22603,Mtume,1983-07-09,Mtume - Juicy Fruit,3,3,3,3.0,3,Juicy Fruit,26.0,7,0,0,0,0,stay,1983-05-21
22604,Mtume,1983-07-16,Mtume - Juicy Fruit,3,3,3,3.0,3,Juicy Fruit,26.0,8,0,0,0,0,stay,1983-05-21
22605,Mtume,1983-07-23,Mtume - Juicy Fruit,3,3,4,3.0,3,Juicy Fruit,26.0,9,-1,0,0,1,down,1983-05-21
22606,Mtume,1983-07-30,Mtume - Juicy Fruit,3,3,4,3.0,4,Juicy Fruit,26.0,10,0,-1,0,0,stay,1983-05-21
22607,Mtume,1983-08-06,Mtume - Juicy Fruit,4,3,4,3.0,4,Juicy Fruit,26.0,11,0,0,-1,0,stay,1983-05-21
22608,Mtume,1983-08-13,Mtume - Juicy Fruit,4,4,7,3.0,4,Juicy Fruit,26.0,12,-3,0,0,1,down,1983-05-21
22609,Mtume,1983-08-20,Mtume - Juicy Fruit,4,4,11,3.0,7,Juicy Fruit,26.0,13,-4,-3,0,1,down,1983-05-21
22610,Mtume,1983-08-27,Mtume - Juicy Fruit,7,4,13,3.0,11,Juicy Fruit,26.0,14,-2,-4,-3,1,down,1983-05-21
22611,Mtume,1983-09-03,Mtume - Juicy Fruit,11,7,20,3.0,13,Juicy Fruit,26.0,15,-7,-2,-4,1,down,1983-05-21
22612,Mtume,1983-09-10,Mtume - Juicy Fruit,13,11,30,3.0,20,Juicy Fruit,26.0,16,-10,-7,-2,1,down,1983-05-21
22613,Mtume,1983-09-17,Mtume - Juicy Fruit,20,13,29,3.0,30,Juicy Fruit,26.0,17,1,-10,-7,1,up,1983-05-21
22614,Mtume,1983-09-24,Mtume - Juicy Fruit,30,20,36,3.0,29,Juicy Fruit,26.0,18,-7,1,-10,1,down,1983-05-21
22615,Mtume,1983-10-01,Mtume - Juicy Fruit,29,30,36,3.0,36,Juicy Fruit,26.0,19,0,-7,1,0,stay,1983-05-21
22616,Mtume,1983-10-08,Mtume - Juicy Fruit,36,29,35,3.0,36,Juicy Fruit,26.0,20,1,0,-7,1,up,1983-05-21
22617,Mtume,1983-10-15,Mtume - Juicy Fruit,36,36,38,3.0,35,Juicy Fruit,26.0,21,-3,1,0,1,down,1983-05-21
22618,Mtume,1983-10-22,Mtume - Juicy Fruit,35,36,44,3.0,38,Juicy Fruit,26.0,22,-6,-3,1,1,down,1983-05-21
22619,Mtume,1983-10-29,Mtume - Juicy Fruit,38,35,42,3.0,44,Juicy Fruit,26.0,23,2,-6,-3,1,up,1983-05-21
22620,Mtume,1983-11-05,Mtume - Juicy Fruit,44,38,43,3.0,42,Juicy Fruit,26.0,24,-1,2,-6,1,down,1983-05-21
22621,Mtume,1983-11-12,Mtume - Juicy Fruit,42,44,48,3.0,43,Juicy Fruit,26.0,25,-5,-1,2,1,down,1983-05-21
22622,Mtume,1983-11-19,Mtume - Juicy Fruit,43,42,51,3.0,48,Juicy Fruit,26.0,26,-3,-5,-1,1,down,1983-05-21
22623,Sergio Mendes,1983-05-21,Sergio Mendes - Sergio Mendes,51,51,44,22.0,48,Sergio Mendes,16.0,0,4,3,0,1,up,1983-05-21
22624,Sergio Mendes,1983-05-28,Sergio Mendes - Sergio Mendes,48,51,33,22.0,44,Sergio Mendes,16.0,1,11,4,3,1,up,1983-05-21
22625,Sergio Mendes,1983-06-04,Sergio Mendes - Sergio Mendes,44,48,30,22.0,33,Sergio Mendes,16.0,2,3,11,4,1,up,1983-05-21
22626,Sergio Mendes,1983-06-11,Sergio Mendes - Sergio Mendes,33,44,27,22.0,30,Sergio Mendes,16.0,3,3,3,11,1,up,1983-05-21
22627,Sergio Mendes,1983-06-18,Sergio Mendes - Sergio Mendes,30,33,25,22.0,27,Sergio Mendes,16.0,4,2,3,3,1,up,1983-05-21
22628,Sergio Mendes,1983-06-25,Sergio Mendes - Sergio Mendes,27,30,25,22.0,25,Sergio Mendes,16.0,5,0,2,3,0,stay,1983-05-21
22629,Sergio Mendes,1983-07-02,Sergio Mendes - Sergio Mendes,25,27,25,22.0,25,Sergio Mendes,16.0,6,0,0,2,0,stay,1983-05-21
22630,Sergio Mendes,1983-07-09,Sergio Mendes - Sergio Mendes,25,25,24,22.0,25,Sergio Mendes,16.0,7,1,0,0,1,up,1983-05-21
22631,Sergio Mendes,1983-07-16,Sergio Mendes - Sergio Mendes,25,25,24,22.0,24,Sergio Mendes,16.0,8,0,1,0,0,stay,1983-05-21
22632,Sergio Mendes,1983-07-23,Sergio Mendes - Sergio Mendes,24,25,22,22.0,24,Sergio Mendes,16.0,9,2,0,1,1,up,1983-05-21
22633,Sergio Mendes,1983-07-30,Sergio Mendes - Sergio Mendes,24,24,22,22.0,22,Sergio Mendes,16.0,10,0,2,0,0,stay,1983-05-21
22634,Sergio Mendes,1983-08-06,Sergio Mendes - Sergio Mendes,22,24,32,22.0,22,Sergio Mendes,16.0,11,-10,0,2,1,down,1983-05-21
22635,Sergio Mendes,1983-08-13,Sergio Mendes - Sergio Mendes,22,22,32,22.0,32,Sergio Mendes,16.0,12,0,-10,0,0,stay,1983-05-21
22636,Sergio Mendes,1983-08-20,Sergio Mendes - Sergio Mendes,32,22,33,22.0,32,Sergio Mendes,16.0,13,-1,0,-10,1,down,1983-05-21
22637,Sergio Mendes,1983-08-27,Sergio Mendes - Sergio Mendes,32,32,34,22.0,33,Sergio Mendes,16.0,14,-1,-1,0,1,down,1983-05-21
22638,Sergio Mendes,1983-09-03,Sergio Mendes - Sergio Mendes,33,32,40,22.0,34,Sergio Mendes,16.0,15,-6,-1,-1,1,down,1983-05-21
22639,Sergio Mendes,1983-09-10,Sergio Mendes - Sergio Mendes,34,33,51,22.0,40,Sergio Mendes,16.0,16,-11,-6,-1,1,down,1983-05-21
22640,Maze,1983-05-28,Maze - We Are One,51,51,13,5.0,30,We Are One,29.0,0,17,21,0,1,up,1983-05-28
22641,Maze,1983-06-04,Maze - We Are One,30,51,9,5.0,13,We Are One,29.0,1,4,17,21,1,up,1983-05-28
22642,Maze,1983-06-11,Maze - We Are One,13,30,9,5.0,9,We Are One,29.0,2,0,4,17,0,stay,1983-05-28
22643,Maze,1983-06-18,Maze - We Are One,9,13,7,5.0,9,We Are One,29.0,3,2,0,4,1,up,1983-05-28
22644,Maze,1983-06-25,Maze - We Are One,9,9,7,5.0,7,We Are One,29.0,4,0,2,0,0,stay,1983-05-28
22645,Maze,1983-07-02,Maze - We Are One,7,9,5,5.0,7,We Are One,29.0,5,2,0,2,1,up,1983-05-28
22646,Maze,1983-07-09,Maze - We Are One,7,7,5,5.0,5,We Are One,29.0,6,0,2,0,0,stay,1983-05-28
22647,Maze,1983-07-16,Maze - We Are One,5,7,5,5.0,5,We Are One,29.0,7,0,0,2,0,stay,1983-05-28
22648,Maze,1983-07-23,Maze - We Are One,5,5,5,5.0,5,We Are One,29.0,8,0,0,0,0,stay,1983-05-28
22649,Maze,1983-07-30,Maze - We Are One,5,5,5,5.0,5,We Are One,29.0,9,0,0,0,0,stay,1983-05-28
22650,Maze,1983-08-06,Maze - We Are One,5,5,5,5.0,5,We Are One,29.0,10,0,0,0,0,stay,1983-05-28
22651,Maze,1983-08-13,Maze - We Are One,5,5,12,5.0,5,We Are One,29.0,11,-7,0,0,1,down,1983-05-28
22652,Maze,1983-08-20,Maze - We Are One,5,5,9,5.0,12,We Are One,29.0,12,3,-7,0,1,up,1983-05-28
22653,Maze,1983-08-27,Maze - We Are One,12,5,9,5.0,9,We Are One,29.0,13,0,3,-7,0,stay,1983-05-28
22654,Maze,1983-09-03,Maze - We Are One,9,12,12,5.0,9,We Are One,29.0,14,-3,0,3,1,down,1983-05-28
22655,Maze,1983-09-10,Maze - We Are One,9,9,10,5.0,12,We Are One,29.0,15,2,-3,0,1,up,1983-05-28
22656,Maze,1983-09-17,Maze - We Are One,12,9,17,5.0,10,We Are One,29.0,16,-7,2,-3,1,down,1983-05-28
22657,Maze,1983-09-24,Maze - We Are One,10,12,18,5.0,17,We Are One,29.0,17,-1,-7,2,1,down,1983-05-28
22658,Maze,1983-10-01,Maze - We Are One,17,10,17,5.0,18,We Are One,29.0,18,1,-1,-7,1,up,1983-05-28
22659,Maze,1983-10-08,Maze - We Are One,18,17,19,5.0,17,We Are One,29.0,19,-2,1,-1,1,down,1983-05-28
22660,Maze,1983-10-15,Maze - We Are One,17,18,24,5.0,19,We Are One,29.0,20,-5,-2,1,1,down,1983-05-28
22661,Maze,1983-10-22,Maze - We Are One,19,17,24,5.0,24,We Are One,29.0,21,0,-5,-2,0,stay,1983-05-28
22662,Maze,1983-10-29,Maze - We Are One,24,19,32,5.0,24,We Are One,29.0,22,-8,0,-5,1,down,1983-05-28
22663,Maze,1983-11-05,Maze - We Are One,24,24,32,5.0,32,We Are One,29.0,23,0,-8,0,0,stay,1983-05-28
22664,Maze,1983-11-12,Maze - We Are One,32,24,31,5.0,32,We Are One,29.0,24,1,0,-8,1,up,1983-05-28
22665,Maze,1983-11-19,Maze - We Are One,32,32,30,5.0,31,We Are One,29.0,25,1,1,0,1,up,1983-05-28
22666,Maze,1983-11-26,Maze - We Are One,31,32,36,5.0,30,We Are One,29.0,26,-6,1,1,1,down,1983-05-28
22667,Maze,1983-12-03,Maze - We Are One,30,31,41,5.0,36,We Are One,29.0,27,-5,-6,1,1,down,1983-05-28
22668,Maze,1983-12-10,Maze - We Are One,36,30,41,5.0,41,We Are One,29.0,28,0,-5,-6,0,stay,1983-05-28
22669,Maze,1983-12-17,Maze - We Are One,41,36,51,5.0,41,We Are One,29.0,29,-10,0,-5,1,down,1983-05-28
22670,Sister Sledge,1983-05-28,Sister Sledge - Bet Cha Say That To All The Girls,51,51,43,35.0,46,Bet Cha Say That To All The Girls,10.0,0,3,5,0,1,up,1983-05-28
22671,Sister Sledge,1983-06-04,Sister Sledge - Bet Cha Say That To All The Girls,46,51,40,35.0,43,Bet Cha Say That To All The Girls,10.0,1,3,3,5,1,up,1983-05-28
22672,Sister Sledge,1983-06-11,Sister Sledge - Bet Cha Say That To All The Girls,43,46,36,35.0,40,Bet Cha Say That To All The Girls,10.0,2,4,3,3,1,up,1983-05-28
22673,Sister Sledge,1983-06-18,Sister Sledge - Bet Cha Say That To All The Girls,40,43,36,35.0,36,Bet Cha Say That To All The Girls,10.0,3,0,4,3,0,stay,1983-05-28
22674,Sister Sledge,1983-06-25,Sister Sledge - Bet Cha Say That To All The Girls,36,40,35,35.0,36,Bet Cha Say That To All The Girls,10.0,4,1,0,4,1,up,1983-05-28
22675,Sister Sledge,1983-07-02,Sister Sledge - Bet Cha Say That To All The Girls,36,36,49,35.0,35,Bet Cha Say That To All The Girls,10.0,5,-14,1,0,1,down,1983-05-28
22676,Sister Sledge,1983-07-09,Sister Sledge - Bet Cha Say That To All The Girls,35,36,46,35.0,49,Bet Cha Say That To All The Girls,10.0,6,3,-14,1,1,up,1983-05-28
22677,Sister Sledge,1983-07-16,Sister Sledge - Bet Cha Say That To All The Girls,49,35,44,35.0,46,Bet Cha Say That To All The Girls,10.0,7,2,3,-14,1,up,1983-05-28
22678,Sister Sledge,1983-07-23,Sister Sledge - Bet Cha Say That To All The Girls,46,49,44,35.0,44,Bet Cha Say That To All The Girls,10.0,8,0,2,3,0,stay,1983-05-28
22679,Sister Sledge,1983-07-30,Sister Sledge - Bet Cha Say That To All The Girls,44,46,50,35.0,44,Bet Cha Say That To All The Girls,10.0,9,-6,0,2,1,down,1983-05-28
22680,Sister Sledge,1983-08-06,Sister Sledge - Bet Cha Say That To All The Girls,44,44,51,35.0,50,Bet Cha Say That To All The Girls,10.0,10,-1,-6,0,1,down,1983-05-28
22681,Lonnie Liston Smith,1983-05-28,Lonnie Liston Smith - Dreams Of Tomorrow,51,51,46,46.0,49,Dreams Of Tomorrow,2.0,0,3,2,0,1,up,1983-05-28
22682,Lonnie Liston Smith,1983-06-04,Lonnie Liston Smith - Dreams Of Tomorrow,49,51,46,46.0,46,Dreams Of Tomorrow,2.0,1,0,3,2,0,stay,1983-05-28
22683,Lonnie Liston Smith,1983-06-11,Lonnie Liston Smith - Dreams Of Tomorrow,46,49,51,46.0,46,Dreams Of Tomorrow,2.0,2,-5,0,3,1,down,1983-05-28
22684,The Isley Brothers,1983-06-04,The Isley Brothers - Between The Sheets,51,51,3,1.0,20,Between The Sheets,25.0,0,17,31,0,1,up,1983-06-04
22685,The Isley Brothers,1983-06-11,The Isley Brothers - Between The Sheets,20,51,2,1.0,3,Between The Sheets,25.0,1,1,17,31,1,up,1983-06-04
22686,The Isley Brothers,1983-06-18,The Isley Brothers - Between The Sheets,3,20,2,1.0,2,Between The Sheets,25.0,2,0,1,17,0,stay,1983-06-04
22687,The Isley Brothers,1983-06-25,The Isley Brothers - Between The Sheets,2,3,2,1.0,2,Between The Sheets,25.0,3,0,0,1,0,stay,1983-06-04
22688,The Isley Brothers,1983-07-02,The Isley Brothers - Between The Sheets,2,2,2,1.0,2,Between The Sheets,25.0,4,0,0,0,0,stay,1983-06-04
22689,The Isley Brothers,1983-07-09,The Isley Brothers - Between The Sheets,2,2,2,1.0,2,Between The Sheets,25.0,5,0,0,0,0,stay,1983-06-04
22690,The Isley Brothers,1983-07-16,The Isley Brothers - Between The Sheets,2,2,1,1.0,2,Between The Sheets,25.0,6,1,0,0,1,up,1983-06-04
22691,The Isley Brothers,1983-07-23,The Isley Brothers - Between The Sheets,2,2,2,1.0,1,Between The Sheets,25.0,7,-1,1,0,1,down,1983-06-04
22692,The Isley Brothers,1983-07-30,The Isley Brothers - Between The Sheets,1,2,2,1.0,2,Between The Sheets,25.0,8,0,-1,1,0,stay,1983-06-04
22693,The Isley Brothers,1983-08-06,The Isley Brothers - Between The Sheets,2,1,2,1.0,2,Between The Sheets,25.0,9,0,0,-1,0,stay,1983-06-04
22694,The Isley Brothers,1983-08-13,The Isley Brothers - Between The Sheets,2,2,2,1.0,2,Between The Sheets,25.0,10,0,0,0,0,stay,1983-06-04
22695,The Isley Brothers,1983-08-20,The Isley Brothers - Between The Sheets,2,2,2,1.0,2,Between The Sheets,25.0,11,0,0,0,0,stay,1983-06-04
22696,The Isley Brothers,1983-08-27,The Isley Brothers - Between The Sheets,2,2,2,1.0,2,Between The Sheets,25.0,12,0,0,0,0,stay,1983-06-04
22697,The Isley Brothers,1983-09-03,The Isley Brothers - Between The Sheets,2,2,2,1.0,2,Between The Sheets,25.0,13,0,0,0,0,stay,1983-06-04
22698,The Isley Brothers,1983-09-10,The Isley Brothers - Between The Sheets,2,2,4,1.0,2,Between The Sheets,25.0,14,-2,0,0,1,down,1983-06-04
22699,The Isley Brothers,1983-09-17,The Isley Brothers - Between The Sheets,2,2,5,1.0,4,Between The Sheets,25.0,15,-1,-2,0,1,down,1983-06-04
22700,The Isley Brothers,1983-09-24,The Isley Brothers - Between The Sheets,4,2,11,1.0,5,Between The Sheets,25.0,16,-6,-1,-2,1,down,1983-06-04
22701,The Isley Brothers,1983-10-01,The Isley Brothers - Between The Sheets,5,4,11,1.0,11,Between The Sheets,25.0,17,0,-6,-1,0,stay,1983-06-04
22702,The Isley Brothers,1983-10-08,The Isley Brothers - Between The Sheets,11,5,14,1.0,11,Between The Sheets,25.0,18,-3,0,-6,1,down,1983-06-04
22703,The Isley Brothers,1983-10-15,The Isley Brothers - Between The Sheets,11,11,16,1.0,14,Between The Sheets,25.0,19,-2,-3,0,1,down,1983-06-04
22704,The Isley Brothers,1983-10-22,The Isley Brothers - Between The Sheets,14,11,27,1.0,16,Between The Sheets,25.0,20,-11,-2,-3,1,down,1983-06-04
22705,The Isley Brothers,1983-10-29,The Isley Brothers - Between The Sheets,16,14,27,1.0,27,Between The Sheets,25.0,21,0,-11,-2,0,stay,1983-06-04
22706,The Isley Brothers,1983-11-05,The Isley Brothers - Between The Sheets,27,16,30,1.0,27,Between The Sheets,25.0,22,-3,0,-11,1,down,1983-06-04
22707,The Isley Brothers,1983-11-12,The Isley Brothers - Between The Sheets,27,27,36,1.0,30,Between The Sheets,25.0,23,-6,-3,0,1,down,1983-06-04
22708,The Isley Brothers,1983-11-19,The Isley Brothers - Between The Sheets,30,27,37,1.0,36,Between The Sheets,25.0,24,-1,-6,-3,1,down,1983-06-04
22709,The Isley Brothers,1983-11-26,The Isley Brothers - Between The Sheets,36,30,51,1.0,37,Between The Sheets,25.0,25,-14,-1,-6,1,down,1983-06-04
22710,James 'D-Train' Williams,1983-06-04,James 'D-Train' Williams - Music,51,51,37,31.0,41,Music,7.0,0,4,10,0,1,up,1983-06-04
22711,James 'D-Train' Williams,1983-06-11,James 'D-Train' Williams - Music,41,51,33,31.0,37,Music,7.0,1,4,4,10,1,up,1983-06-04
22712,James 'D-Train' Williams,1983-06-18,James 'D-Train' Williams - Music,37,41,31,31.0,33,Music,7.0,2,2,4,4,1,up,1983-06-04
22713,James 'D-Train' Williams,1983-06-25,James 'D-Train' Williams - Music,33,37,31,31.0,31,Music,7.0,3,0,2,4,0,stay,1983-06-04
22714,James 'D-Train' Williams,1983-07-02,James 'D-Train' Williams - Music,31,33,31,31.0,31,Music,7.0,4,0,0,2,0,stay,1983-06-04
22715,James 'D-Train' Williams,1983-07-09,James 'D-Train' Williams - Music,31,31,43,31.0,31,Music,7.0,5,-12,0,0,1,down,1983-06-04
22716,James 'D-Train' Williams,1983-07-16,James 'D-Train' Williams - Music,31,31,43,31.0,43,Music,7.0,6,0,-12,0,0,stay,1983-06-04
22717,James 'D-Train' Williams,1983-07-23,James 'D-Train' Williams - Music,43,31,51,31.0,43,Music,7.0,7,-8,0,-12,1,down,1983-06-04
22718,Brass Construction,1983-06-04,Brass Construction - Conversations,51,51,36,29.0,45,Conversations,7.0,0,9,6,0,1,up,1983-06-04
22719,Brass Construction,1983-06-11,Brass Construction - Conversations,45,51,30,29.0,36,Conversations,7.0,1,6,9,6,1,up,1983-06-04
22720,Brass Construction,1983-06-18,Brass Construction - Conversations,36,45,29,29.0,30,Conversations,7.0,2,1,6,9,1,up,1983-06-04
22721,Brass Construction,1983-06-25,Brass Construction - Conversations,30,36,36,29.0,29,Conversations,7.0,3,-7,1,6,1,down,1983-06-04
22722,Brass Construction,1983-07-02,Brass Construction - Conversations,29,30,34,29.0,36,Conversations,7.0,4,2,-7,1,1,up,1983-06-04
22723,Brass Construction,1983-07-09,Brass Construction - Conversations,36,29,34,29.0,34,Conversations,7.0,5,0,2,-7,0,stay,1983-06-04
22724,Brass Construction,1983-07-16,Brass Construction - Conversations,34,36,41,29.0,34,Conversations,7.0,6,-7,0,2,1,down,1983-06-04
22725,Brass Construction,1983-07-23,Brass Construction - Conversations,34,34,51,29.0,41,Conversations,7.0,7,-10,-7,0,1,down,1983-06-04
22726,Ozone,1983-06-04,Ozone - Glasses,51,51,51,50.0,50,Glasses,0.0,0,-1,1,0,1,down,1983-06-04
22727,Deniece Williams,1983-06-11,Deniece Williams - I'm So Proud,51,51,14,10.0,25,I'm So Proud,21.0,0,11,26,0,1,up,1983-06-11
22728,Deniece Williams,1983-06-18,Deniece Williams - I'm So Proud,25,51,13,10.0,14,I'm So Proud,21.0,1,1,11,26,1,up,1983-06-11
22729,Deniece Williams,1983-06-25,Deniece Williams - I'm So Proud,14,25,11,10.0,13,I'm So Proud,21.0,2,2,1,11,1,up,1983-06-11
22730,Deniece Williams,1983-07-02,Deniece Williams - I'm So Proud,13,14,10,10.0,11,I'm So Proud,21.0,3,1,2,1,1,up,1983-06-11
22731,Deniece Williams,1983-07-09,Deniece Williams - I'm So Proud,11,13,10,10.0,10,I'm So Proud,21.0,4,0,1,2,0,stay,1983-06-11
22732,Deniece Williams,1983-07-16,Deniece Williams - I'm So Proud,10,11,10,10.0,10,I'm So Proud,21.0,5,0,0,1,0,stay,1983-06-11
22733,Deniece Williams,1983-07-23,Deniece Williams - I'm So Proud,10,10,11,10.0,10,I'm So Proud,21.0,6,-1,0,0,1,down,1983-06-11
22734,Deniece Williams,1983-07-30,Deniece Williams - I'm So Proud,10,10,12,10.0,11,I'm So Proud,21.0,7,-1,-1,0,1,down,1983-06-11
22735,Deniece Williams,1983-08-06,Deniece Williams - I'm So Proud,11,10,15,10.0,12,I'm So Proud,21.0,8,-3,-1,-1,1,down,1983-06-11
22736,Deniece Williams,1983-08-13,Deniece Williams - I'm So Proud,12,11,18,10.0,15,I'm So Proud,21.0,9,-3,-3,-1,1,down,1983-06-11
22737,Deniece Williams,1983-08-20,Deniece Williams - I'm So Proud,15,12,26,10.0,18,I'm So Proud,21.0,10,-8,-3,-3,1,down,1983-06-11
22738,Deniece Williams,1983-08-27,Deniece Williams - I'm So Proud,18,15,26,10.0,26,I'm So Proud,21.0,11,0,-8,-3,0,stay,1983-06-11
22739,Deniece Williams,1983-09-03,Deniece Williams - I'm So Proud,26,18,25,10.0,26,I'm So Proud,21.0,12,1,0,-8,1,up,1983-06-11
22740,Deniece Williams,1983-09-10,Deniece Williams - I'm So Proud,26,26,25,10.0,25,I'm So Proud,21.0,13,0,1,0,0,stay,1983-06-11
22741,Deniece Williams,1983-09-17,Deniece Williams - I'm So Proud,25,26,32,10.0,25,I'm So Proud,21.0,14,-7,0,1,1,down,1983-06-11
22742,Deniece Williams,1983-09-24,Deniece Williams - I'm So Proud,25,25,34,10.0,32,I'm So Proud,21.0,15,-2,-7,0,1,down,1983-06-11
22743,Deniece Williams,1983-10-01,Deniece Williams - I'm So Proud,32,25,34,10.0,34,I'm So Proud,21.0,16,0,-2,-7,0,stay,1983-06-11
22744,Deniece Williams,1983-10-08,Deniece Williams - I'm So Proud,34,32,37,10.0,34,I'm So Proud,21.0,17,-3,0,-2,1,down,1983-06-11
22745,Deniece Williams,1983-10-15,Deniece Williams - I'm So Proud,34,34,39,10.0,37,I'm So Proud,21.0,18,-2,-3,0,1,down,1983-06-11
22746,Deniece Williams,1983-10-22,Deniece Williams - I'm So Proud,37,34,43,10.0,39,I'm So Proud,21.0,19,-4,-2,-3,1,down,1983-06-11
22747,Deniece Williams,1983-10-29,Deniece Williams - I'm So Proud,39,37,46,10.0,43,I'm So Proud,21.0,20,-3,-4,-2,1,down,1983-06-11
22748,Deniece Williams,1983-11-05,Deniece Williams - I'm So Proud,43,39,51,10.0,46,I'm So Proud,21.0,21,-5,-3,-4,1,down,1983-06-11
22749,Various Artists,1983-06-11,Various Artists - 25 #1 Hits From 25 Years,51,51,37,32.0,43,25 #1 Hits From 25 Years,7.0,0,6,8,0,1,up,1983-06-11
22750,Various Artists,1983-06-18,Various Artists - 25 #1 Hits From 25 Years,43,51,32,32.0,37,25 #1 Hits From 25 Years,7.0,1,5,6,8,1,up,1983-06-11
22751,Various Artists,1983-06-25,Various Artists - 25 #1 Hits From 25 Years,37,43,32,32.0,32,25 #1 Hits From 25 Years,7.0,2,0,5,6,0,stay,1983-06-11
22752,Various Artists,1983-07-02,Various Artists - 25 #1 Hits From 25 Years,32,37,32,32.0,32,25 #1 Hits From 25 Years,7.0,3,0,0,5,0,stay,1983-06-11
22753,Various Artists,1983-07-09,Various Artists - 25 #1 Hits From 25 Years,32,32,42,32.0,32,25 #1 Hits From 25 Years,7.0,4,-10,0,0,1,down,1983-06-11
22754,Various Artists,1983-07-16,Various Artists - 25 #1 Hits From 25 Years,32,32,42,32.0,42,25 #1 Hits From 25 Years,7.0,5,0,-10,0,0,stay,1983-06-11
22755,Various Artists,1983-07-23,Various Artists - 25 #1 Hits From 25 Years,42,32,43,32.0,42,25 #1 Hits From 25 Years,7.0,6,-1,0,-10,1,down,1983-06-11
22756,Various Artists,1983-07-30,Various Artists - 25 #1 Hits From 25 Years,42,42,51,32.0,43,25 #1 Hits From 25 Years,7.0,7,-8,-1,0,1,down,1983-06-11
22757,Michael Henderson,1983-06-11,Michael Henderson - Fickle,51,51,44,41.0,48,Fickle,4.0,0,4,3,0,1,up,1983-06-11
22758,Michael Henderson,1983-06-18,Michael Henderson - Fickle,48,51,41,41.0,44,Fickle,4.0,1,3,4,3,1,up,1983-06-11
22759,Michael Henderson,1983-06-25,Michael Henderson - Fickle,44,48,41,41.0,41,Fickle,4.0,2,0,3,4,0,stay,1983-06-11
22760,Michael Henderson,1983-07-02,Michael Henderson - Fickle,41,44,50,41.0,41,Fickle,4.0,3,-9,0,3,1,down,1983-06-11
22761,Michael Henderson,1983-07-16,Michael Henderson - Fickle,41,41,51,41.0,50,Fickle,4.0,4,-1,-9,0,1,down,1983-06-11
22762,Fonzi Thornton,1983-06-11,Fonzi Thornton - The Leader,51,51,50,50.0,50,The Leader,1.0,0,0,1,0,0,stay,1983-06-11
22763,Fonzi Thornton,1983-06-18,Fonzi Thornton - The Leader,50,51,51,50.0,50,The Leader,1.0,1,-1,0,1,1,down,1983-06-11
22764,David Bowie,1983-06-18,David Bowie - Let's Dance,51,51,28,21.0,46,Let's Dance,15.0,0,18,5,0,1,up,1983-06-18
22765,David Bowie,1983-06-25,David Bowie - Let's Dance,46,51,23,21.0,28,Let's Dance,15.0,1,5,18,5,1,up,1983-06-18
22766,David Bowie,1983-07-02,David Bowie - Let's Dance,28,46,23,21.0,23,Let's Dance,15.0,2,0,5,18,0,stay,1983-06-18
22767,David Bowie,1983-07-09,David Bowie - Let's Dance,23,28,21,21.0,23,Let's Dance,15.0,3,2,0,5,1,up,1983-06-18
22768,David Bowie,1983-07-16,David Bowie - Let's Dance,23,23,21,21.0,21,Let's Dance,15.0,4,0,2,0,0,stay,1983-06-18
22769,David Bowie,1983-07-23,David Bowie - Let's Dance,21,23,27,21.0,21,Let's Dance,15.0,5,-6,0,2,1,down,1983-06-18
22770,David Bowie,1983-07-30,David Bowie - Let's Dance,21,21,34,21.0,27,Let's Dance,15.0,6,-7,-6,0,1,down,1983-06-18
22771,David Bowie,1983-08-06,David Bowie - Let's Dance,27,21,38,21.0,34,Let's Dance,15.0,7,-4,-7,-6,1,down,1983-06-18
22772,David Bowie,1983-08-13,David Bowie - Let's Dance,34,27,40,21.0,38,Let's Dance,15.0,8,-2,-4,-7,1,down,1983-06-18
22773,David Bowie,1983-08-20,David Bowie - Let's Dance,38,34,40,21.0,40,Let's Dance,15.0,9,0,-2,-4,0,stay,1983-06-18
22774,David Bowie,1983-08-27,David Bowie - Let's Dance,40,38,43,21.0,40,Let's Dance,15.0,10,-3,0,-2,1,down,1983-06-18
22775,David Bowie,1983-09-03,David Bowie - Let's Dance,40,40,42,21.0,43,Let's Dance,15.0,11,1,-3,0,1,up,1983-06-18
22776,David Bowie,1983-09-10,David Bowie - Let's Dance,43,40,42,21.0,42,Let's Dance,15.0,12,0,1,-3,0,stay,1983-06-18
22777,David Bowie,1983-09-17,David Bowie - Let's Dance,42,43,42,21.0,42,Let's Dance,15.0,13,0,0,1,0,stay,1983-06-18
22778,David Bowie,1983-09-24,David Bowie - Let's Dance,42,42,43,21.0,42,Let's Dance,15.0,14,-1,0,0,1,down,1983-06-18
22779,David Bowie,1983-10-01,David Bowie - Let's Dance,42,42,51,21.0,43,Let's Dance,15.0,15,-8,-1,0,1,down,1983-06-18
22780,Bob Marley And The Wailers,1983-06-18,Bob Marley And The Wailers - Confrontation,51,51,43,31.0,47,Confrontation,10.0,0,4,4,0,1,up,1983-06-18
22781,Bob Marley And The Wailers,1983-06-25,Bob Marley And The Wailers - Confrontation,47,51,40,31.0,43,Confrontation,10.0,1,3,4,4,1,up,1983-06-18
22782,Bob Marley And The Wailers,1983-07-02,Bob Marley And The Wailers - Confrontation,43,47,38,31.0,40,Confrontation,10.0,2,2,3,4,1,up,1983-06-18
22783,Bob Marley And The Wailers,1983-07-09,Bob Marley And The Wailers - Confrontation,40,43,33,31.0,38,Confrontation,10.0,3,5,2,3,1,up,1983-06-18
22784,Bob Marley And The Wailers,1983-07-16,Bob Marley And The Wailers - Confrontation,38,40,33,31.0,33,Confrontation,10.0,4,0,5,2,0,stay,1983-06-18
22785,Bob Marley And The Wailers,1983-07-23,Bob Marley And The Wailers - Confrontation,33,38,31,31.0,33,Confrontation,10.0,5,2,0,5,1,up,1983-06-18
22786,Bob Marley And The Wailers,1983-07-30,Bob Marley And The Wailers - Confrontation,33,33,31,31.0,31,Confrontation,10.0,6,0,2,0,0,stay,1983-06-18
22787,Bob Marley And The Wailers,1983-08-06,Bob Marley And The Wailers - Confrontation,31,33,41,31.0,31,Confrontation,10.0,7,-10,0,2,1,down,1983-06-18
22788,Bob Marley And The Wailers,1983-08-13,Bob Marley And The Wailers - Confrontation,31,31,41,31.0,41,Confrontation,10.0,8,0,-10,0,0,stay,1983-06-18
22789,Bob Marley And The Wailers,1983-08-20,Bob Marley And The Wailers - Confrontation,41,31,46,31.0,41,Confrontation,10.0,9,-5,0,-10,1,down,1983-06-18
22790,Bob Marley And The Wailers,1983-08-27,Bob Marley And The Wailers - Confrontation,41,41,51,31.0,46,Confrontation,10.0,10,-5,-5,0,1,down,1983-06-18
22791,Diana Ross,1983-06-18,Diana Ross - Diana Ross Anthology,51,51,44,44.0,49,Diana Ross Anthology,2.0,0,5,2,0,1,up,1983-06-18
22792,Diana Ross,1983-06-25,Diana Ross - Diana Ross Anthology,49,51,44,44.0,44,Diana Ross Anthology,2.0,1,0,5,2,0,stay,1983-06-18
22793,Diana Ross,1983-07-02,Diana Ross - Diana Ross Anthology,44,49,51,44.0,44,Diana Ross Anthology,2.0,2,-7,0,5,1,down,1983-06-18
22794,George Benson,1983-06-25,George Benson - In Your Eyes,51,51,13,6.0,33,In Your Eyes,22.0,0,20,18,0,1,up,1983-06-25
22795,George Benson,1983-07-02,George Benson - In Your Eyes,33,51,7,6.0,13,In Your Eyes,22.0,1,6,20,18,1,up,1983-06-25
22796,George Benson,1983-07-09,George Benson - In Your Eyes,13,33,6,6.0,7,In Your Eyes,22.0,2,1,6,20,1,up,1983-06-25
22797,George Benson,1983-07-16,George Benson - In Your Eyes,7,13,6,6.0,6,In Your Eyes,22.0,3,0,1,6,0,stay,1983-06-25
22798,George Benson,1983-07-23,George Benson - In Your Eyes,6,7,6,6.0,6,In Your Eyes,22.0,4,0,0,1,0,stay,1983-06-25
22799,George Benson,1983-07-30,George Benson - In Your Eyes,6,6,6,6.0,6,In Your Eyes,22.0,5,0,0,0,0,stay,1983-06-25
22800,George Benson,1983-08-06,George Benson - In Your Eyes,6,6,6,6.0,6,In Your Eyes,22.0,6,0,0,0,0,stay,1983-06-25
22801,George Benson,1983-08-13,George Benson - In Your Eyes,6,6,6,6.0,6,In Your Eyes,22.0,7,0,0,0,0,stay,1983-06-25
22802,George Benson,1983-08-20,George Benson - In Your Eyes,6,6,16,6.0,6,In Your Eyes,22.0,8,-10,0,0,1,down,1983-06-25
22803,George Benson,1983-08-27,George Benson - In Your Eyes,6,6,16,6.0,16,In Your Eyes,22.0,9,0,-10,0,0,stay,1983-06-25
22804,George Benson,1983-09-03,George Benson - In Your Eyes,16,6,17,6.0,16,In Your Eyes,22.0,10,-1,0,-10,1,down,1983-06-25
22805,George Benson,1983-09-10,George Benson - In Your Eyes,16,16,17,6.0,17,In Your Eyes,22.0,11,0,-1,0,0,stay,1983-06-25
22806,George Benson,1983-09-17,George Benson - In Your Eyes,17,16,19,6.0,17,In Your Eyes,22.0,12,-2,0,-1,1,down,1983-06-25
22807,George Benson,1983-09-24,George Benson - In Your Eyes,17,17,19,6.0,19,In Your Eyes,22.0,13,0,-2,0,0,stay,1983-06-25
22808,George Benson,1983-10-01,George Benson - In Your Eyes,19,17,23,6.0,19,In Your Eyes,22.0,14,-4,0,-2,1,down,1983-06-25
22809,George Benson,1983-10-08,George Benson - In Your Eyes,19,19,24,6.0,23,In Your Eyes,22.0,15,-1,-4,0,1,down,1983-06-25
22810,George Benson,1983-10-15,George Benson - In Your Eyes,23,19,23,6.0,24,In Your Eyes,22.0,16,1,-1,-4,1,up,1983-06-25
22811,George Benson,1983-10-22,George Benson - In Your Eyes,24,23,28,6.0,23,In Your Eyes,22.0,17,-5,1,-1,1,down,1983-06-25
22812,George Benson,1983-10-29,George Benson - In Your Eyes,23,24,28,6.0,28,In Your Eyes,22.0,18,0,-5,1,0,stay,1983-06-25
22813,George Benson,1983-11-05,George Benson - In Your Eyes,28,23,31,6.0,28,In Your Eyes,22.0,19,-3,0,-5,1,down,1983-06-25
22814,George Benson,1983-11-12,George Benson - In Your Eyes,28,28,33,6.0,31,In Your Eyes,22.0,20,-2,-3,0,1,down,1983-06-25
22815,George Benson,1983-11-19,George Benson - In Your Eyes,31,28,35,6.0,33,In Your Eyes,22.0,21,-2,-2,-3,1,down,1983-06-25
22816,George Benson,1983-11-26,George Benson - In Your Eyes,33,31,51,6.0,35,In Your Eyes,22.0,22,-16,-2,-2,1,down,1983-06-25
22817,Phyllis Hyman,1983-06-25,Phyllis Hyman - Goddess Of Love,51,51,30,20.0,38,Goddess Of Love,10.0,0,8,13,0,1,up,1983-06-25
22818,Phyllis Hyman,1983-07-02,Phyllis Hyman - Goddess Of Love,38,51,22,20.0,30,Goddess Of Love,10.0,1,8,8,13,1,up,1983-06-25
22819,Phyllis Hyman,1983-07-09,Phyllis Hyman - Goddess Of Love,30,38,20,20.0,22,Goddess Of Love,10.0,2,2,8,8,1,up,1983-06-25
22820,Phyllis Hyman,1983-07-16,Phyllis Hyman - Goddess Of Love,22,30,20,20.0,20,Goddess Of Love,10.0,3,0,2,8,0,stay,1983-06-25
22821,Phyllis Hyman,1983-07-23,Phyllis Hyman - Goddess Of Love,20,22,24,20.0,20,Goddess Of Love,10.0,4,-4,0,2,1,down,1983-06-25
22822,Phyllis Hyman,1983-07-30,Phyllis Hyman - Goddess Of Love,20,20,25,20.0,24,Goddess Of Love,10.0,5,-1,-4,0,1,down,1983-06-25
22823,Phyllis Hyman,1983-08-06,Phyllis Hyman - Goddess Of Love,24,20,33,20.0,25,Goddess Of Love,10.0,6,-8,-1,-4,1,down,1983-06-25
22824,Phyllis Hyman,1983-08-13,Phyllis Hyman - Goddess Of Love,25,24,34,20.0,33,Goddess Of Love,10.0,7,-1,-8,-1,1,down,1983-06-25
22825,Phyllis Hyman,1983-08-20,Phyllis Hyman - Goddess Of Love,33,25,37,20.0,34,Goddess Of Love,10.0,8,-3,-1,-8,1,down,1983-06-25
22826,Phyllis Hyman,1983-08-27,Phyllis Hyman - Goddess Of Love,34,33,39,20.0,37,Goddess Of Love,10.0,9,-2,-3,-1,1,down,1983-06-25
22827,Phyllis Hyman,1983-09-03,Phyllis Hyman - Goddess Of Love,37,34,51,20.0,39,Goddess Of Love,10.0,10,-12,-2,-3,1,down,1983-06-25
22828,Bob James,1983-06-25,"Bob James - The Genie (Themes & Variations From The TV Series ""Taxi"")",51,51,43,43.0,46,"The Genie (Themes & Variations From The TV Series ""Taxi"")",3.0,0,3,5,0,1,up,1983-06-25
22829,Bob James,1983-07-02,"Bob James - The Genie (Themes & Variations From The TV Series ""Taxi"")",46,51,43,43.0,43,"The Genie (Themes & Variations From The TV Series ""Taxi"")",3.0,1,0,3,5,0,stay,1983-06-25
22830,Bob James,1983-07-09,"Bob James - The Genie (Themes & Variations From The TV Series ""Taxi"")",43,46,45,43.0,43,"The Genie (Themes & Variations From The TV Series ""Taxi"")",3.0,2,-2,0,3,1,down,1983-06-25
22831,Bob James,1983-07-16,"Bob James - The Genie (Themes & Variations From The TV Series ""Taxi"")",43,43,51,43.0,45,"The Genie (Themes & Variations From The TV Series ""Taxi"")",3.0,3,-6,-2,0,1,down,1983-06-25
22832,Various Artists,1983-06-25,Various Artists - 25 Years Of Grammy Greats,51,51,45,45.0,47,25 Years Of Grammy Greats,2.0,0,2,4,0,1,up,1983-06-25
22833,Various Artists,1983-07-02,Various Artists - 25 Years Of Grammy Greats,47,51,45,45.0,45,25 Years Of Grammy Greats,2.0,1,0,2,4,0,stay,1983-06-25
22834,Various Artists,1983-07-09,Various Artists - 25 Years Of Grammy Greats,45,47,51,45.0,45,25 Years Of Grammy Greats,2.0,2,-6,0,2,1,down,1983-06-25
22835,Commodores,1983-06-25,Commodores - Commodores Anthology,51,51,50,50.0,50,Commodores Anthology,1.0,0,0,1,0,0,stay,1983-06-25
22836,Commodores,1983-07-02,Commodores - Commodores Anthology,50,51,51,50.0,50,Commodores Anthology,1.0,1,-1,0,1,1,down,1983-06-25
22837,B.B. King,1983-07-02,B.B. King - Blues 'n Jazz,51,51,44,38.0,47,Blues 'n Jazz,5.0,0,3,4,0,1,up,1983-07-02
22838,B.B. King,1983-07-09,B.B. King - Blues 'n Jazz,47,51,41,38.0,44,Blues 'n Jazz,5.0,1,3,3,4,1,up,1983-07-02
22839,B.B. King,1983-07-16,B.B. King - Blues 'n Jazz,44,47,38,38.0,41,Blues 'n Jazz,5.0,2,3,3,3,1,up,1983-07-02
22840,B.B. King,1983-07-23,B.B. King - Blues 'n Jazz,41,44,38,38.0,38,Blues 'n Jazz,5.0,3,0,3,3,0,stay,1983-07-02
22841,B.B. King,1983-07-30,B.B. King - Blues 'n Jazz,38,41,41,38.0,38,Blues 'n Jazz,5.0,4,-3,0,3,1,down,1983-07-02
22842,B.B. King,1983-08-06,B.B. King - Blues 'n Jazz,38,38,51,38.0,41,Blues 'n Jazz,5.0,5,-10,-3,0,1,down,1983-07-02
22843,The O'Jays,1983-07-09,The O'Jays - When Will I See You Again,51,51,25,19.0,30,When Will I See You Again,15.0,0,5,21,0,1,up,1983-07-09
22844,The O'Jays,1983-07-16,The O'Jays - When Will I See You Again,30,51,22,19.0,25,When Will I See You Again,15.0,1,3,5,21,1,up,1983-07-09
22845,The O'Jays,1983-07-23,The O'Jays - When Will I See You Again,25,30,20,19.0,22,When Will I See You Again,15.0,2,2,3,5,1,up,1983-07-09
22846,The O'Jays,1983-07-30,The O'Jays - When Will I See You Again,22,25,19,19.0,20,When Will I See You Again,15.0,3,1,2,3,1,up,1983-07-09
22847,The O'Jays,1983-08-06,The O'Jays - When Will I See You Again,20,22,19,19.0,19,When Will I See You Again,15.0,4,0,1,2,0,stay,1983-07-09
22848,The O'Jays,1983-08-13,The O'Jays - When Will I See You Again,19,20,28,19.0,19,When Will I See You Again,15.0,5,-9,0,1,1,down,1983-07-09
22849,The O'Jays,1983-08-20,The O'Jays - When Will I See You Again,19,19,28,19.0,28,When Will I See You Again,15.0,6,0,-9,0,0,stay,1983-07-09
22850,The O'Jays,1983-08-27,The O'Jays - When Will I See You Again,28,19,28,19.0,28,When Will I See You Again,15.0,7,0,0,-9,0,stay,1983-07-09
22851,The O'Jays,1983-09-03,The O'Jays - When Will I See You Again,28,28,33,19.0,28,When Will I See You Again,15.0,8,-5,0,0,1,down,1983-07-09
22852,The O'Jays,1983-09-10,The O'Jays - When Will I See You Again,28,28,41,19.0,33,When Will I See You Again,15.0,9,-8,-5,0,1,down,1983-07-09
22853,The O'Jays,1983-09-17,The O'Jays - When Will I See You Again,33,28,41,19.0,41,When Will I See You Again,15.0,10,0,-8,-5,0,stay,1983-07-09
22854,The O'Jays,1983-09-24,The O'Jays - When Will I See You Again,41,33,42,19.0,41,When Will I See You Again,15.0,11,-1,0,-8,1,down,1983-07-09
22855,The O'Jays,1983-10-01,The O'Jays - When Will I See You Again,41,41,41,19.0,42,When Will I See You Again,15.0,12,1,-1,0,1,up,1983-07-09
22856,The O'Jays,1983-10-08,The O'Jays - When Will I See You Again,42,41,42,19.0,41,When Will I See You Again,15.0,13,-1,1,-1,1,down,1983-07-09
22857,The O'Jays,1983-10-15,The O'Jays - When Will I See You Again,41,42,48,19.0,42,When Will I See You Again,15.0,14,-6,-1,1,1,down,1983-07-09
22858,The O'Jays,1983-10-22,The O'Jays - When Will I See You Again,42,41,51,19.0,48,When Will I See You Again,15.0,15,-3,-6,-1,1,down,1983-07-09
22859,Starpoint,1983-07-09,Starpoint - It's So Delicious,51,51,32,32.0,41,It's So Delicious,5.0,0,9,10,0,1,up,1983-07-09
22860,Starpoint,1983-07-16,Starpoint - It's So Delicious,41,51,32,32.0,32,It's So Delicious,5.0,1,0,9,10,0,stay,1983-07-09
22861,Starpoint,1983-07-23,Starpoint - It's So Delicious,32,41,33,32.0,32,It's So Delicious,5.0,2,-1,0,9,1,down,1983-07-09
22862,Starpoint,1983-07-30,Starpoint - It's So Delicious,32,32,47,32.0,33,It's So Delicious,5.0,3,-14,-1,0,1,down,1983-07-09
22863,Starpoint,1983-08-06,Starpoint - It's So Delicious,33,32,50,32.0,47,It's So Delicious,5.0,4,-3,-14,-1,1,down,1983-07-09
22864,Starpoint,1983-08-13,Starpoint - It's So Delicious,47,33,51,32.0,50,It's So Delicious,5.0,5,-1,-3,-14,1,down,1983-07-09
22865,Midnight Star,1983-07-09,Midnight Star - No Parking On The Dance Floor,51,51,38,2.0,46,No Parking On The Dance Floor,60.0,0,8,5,0,1,up,1983-07-09
22866,Midnight Star,1983-07-16,Midnight Star - No Parking On The Dance Floor,46,51,25,2.0,38,No Parking On The Dance Floor,60.0,1,13,8,5,1,up,1983-07-09
22867,Midnight Star,1983-07-23,Midnight Star - No Parking On The Dance Floor,38,46,16,2.0,25,No Parking On The Dance Floor,60.0,2,9,13,8,1,up,1983-07-09
22868,Midnight Star,1983-07-30,Midnight Star - No Parking On The Dance Floor,25,38,15,2.0,16,No Parking On The Dance Floor,60.0,3,1,9,13,1,up,1983-07-09
22869,Midnight Star,1983-08-06,Midnight Star - No Parking On The Dance Floor,16,25,12,2.0,15,No Parking On The Dance Floor,60.0,4,3,1,9,1,up,1983-07-09
22870,Midnight Star,1983-08-13,Midnight Star - No Parking On The Dance Floor,15,16,11,2.0,12,No Parking On The Dance Floor,60.0,5,1,3,1,1,up,1983-07-09
22871,Midnight Star,1983-08-20,Midnight Star - No Parking On The Dance Floor,12,15,8,2.0,11,No Parking On The Dance Floor,60.0,6,3,1,3,1,up,1983-07-09
22872,Midnight Star,1983-08-27,Midnight Star - No Parking On The Dance Floor,11,12,8,2.0,8,No Parking On The Dance Floor,60.0,7,0,3,1,0,stay,1983-07-09
22873,Midnight Star,1983-09-03,Midnight Star - No Parking On The Dance Floor,8,11,8,2.0,8,No Parking On The Dance Floor,60.0,8,0,0,3,0,stay,1983-07-09
22874,Midnight Star,1983-09-10,Midnight Star - No Parking On The Dance Floor,8,8,7,2.0,8,No Parking On The Dance Floor,60.0,9,1,0,0,1,up,1983-07-09
22875,Midnight Star,1983-09-17,Midnight Star - No Parking On The Dance Floor,8,8,7,2.0,7,No Parking On The Dance Floor,60.0,10,0,1,0,0,stay,1983-07-09
22876,Midnight Star,1983-09-24,Midnight Star - No Parking On The Dance Floor,7,8,5,2.0,7,No Parking On The Dance Floor,60.0,11,2,0,1,1,up,1983-07-09
22877,Midnight Star,1983-10-01,Midnight Star - No Parking On The Dance Floor,7,7,5,2.0,5,No Parking On The Dance Floor,60.0,12,0,2,0,0,stay,1983-07-09
22878,Midnight Star,1983-10-08,Midnight Star - No Parking On The Dance Floor,5,7,7,2.0,5,No Parking On The Dance Floor,60.0,13,-2,0,2,1,down,1983-07-09
22879,Midnight Star,1983-10-15,Midnight Star - No Parking On The Dance Floor,5,5,7,2.0,7,No Parking On The Dance Floor,60.0,14,0,-2,0,0,stay,1983-07-09
22880,Midnight Star,1983-10-22,Midnight Star - No Parking On The Dance Floor,7,5,6,2.0,7,No Parking On The Dance Floor,60.0,15,1,0,-2,1,up,1983-07-09
22881,Midnight Star,1983-10-29,Midnight Star - No Parking On The Dance Floor,7,7,5,2.0,6,No Parking On The Dance Floor,60.0,16,1,1,0,1,up,1983-07-09
22882,Midnight Star,1983-11-05,Midnight Star - No Parking On The Dance Floor,6,7,2,2.0,5,No Parking On The Dance Floor,60.0,17,3,1,1,1,up,1983-07-09
22883,Midnight Star,1983-11-12,Midnight Star - No Parking On The Dance Floor,5,6,3,2.0,2,No Parking On The Dance Floor,60.0,18,-1,3,1,1,down,1983-07-09
22884,Midnight Star,1983-11-19,Midnight Star - No Parking On The Dance Floor,2,5,3,2.0,3,No Parking On The Dance Floor,60.0,19,0,-1,3,0,stay,1983-07-09
22885,Midnight Star,1983-11-26,Midnight Star - No Parking On The Dance Floor,3,2,3,2.0,3,No Parking On The Dance Floor,60.0,20,0,0,-1,0,stay,1983-07-09
22886,Midnight Star,1983-12-03,Midnight Star - No Parking On The Dance Floor,3,3,2,2.0,3,No Parking On The Dance Floor,60.0,21,1,0,0,1,up,1983-07-09
22887,Midnight Star,1983-12-10,Midnight Star - No Parking On The Dance Floor,3,3,2,2.0,2,No Parking On The Dance Floor,60.0,22,0,1,0,0,stay,1983-07-09
22888,Midnight Star,1983-12-17,Midnight Star - No Parking On The Dance Floor,2,3,2,2.0,2,No Parking On The Dance Floor,60.0,23,0,0,1,0,stay,1983-07-09
22889,Midnight Star,1983-12-24,Midnight Star - No Parking On The Dance Floor,2,2,2,2.0,2,No Parking On The Dance Floor,60.0,24,0,0,0,0,stay,1983-07-09
22890,Midnight Star,1983-12-31,Midnight Star - No Parking On The Dance Floor,2,2,2,2.0,2,No Parking On The Dance Floor,60.0,25,0,0,0,0,stay,1983-07-09
22891,Midnight Star,1984-01-07,Midnight Star - No Parking On The Dance Floor,2,2,2,2.0,2,No Parking On The Dance Floor,60.0,26,0,0,0,0,stay,1983-07-09
22892,Midnight Star,1984-01-14,Midnight Star - No Parking On The Dance Floor,2,2,2,2.0,2,No Parking On The Dance Floor,60.0,27,0,0,0,0,stay,1983-07-09
22893,Midnight Star,1984-01-21,Midnight Star - No Parking On The Dance Floor,2,2,2,2.0,2,No Parking On The Dance Floor,60.0,28,0,0,0,0,stay,1983-07-09
22894,Midnight Star,1984-01-28,Midnight Star - No Parking On The Dance Floor,2,2,2,2.0,2,No Parking On The Dance Floor,60.0,29,0,0,0,0,stay,1983-07-09
22895,Midnight Star,1984-02-04,Midnight Star - No Parking On The Dance Floor,2,2,6,2.0,2,No Parking On The Dance Floor,60.0,30,-4,0,0,1,down,1983-07-09
22896,Midnight Star,1984-02-11,Midnight Star - No Parking On The Dance Floor,2,2,5,2.0,6,No Parking On The Dance Floor,60.0,31,1,-4,0,1,up,1983-07-09
22897,Midnight Star,1984-02-18,Midnight Star - No Parking On The Dance Floor,6,2,5,2.0,5,No Parking On The Dance Floor,60.0,32,0,1,-4,0,stay,1983-07-09
22898,Midnight Star,1984-02-25,Midnight Star - No Parking On The Dance Floor,5,6,5,2.0,5,No Parking On The Dance Floor,60.0,33,0,0,1,0,stay,1983-07-09
22899,Midnight Star,1984-03-03,Midnight Star - No Parking On The Dance Floor,5,5,5,2.0,5,No Parking On The Dance Floor,60.0,34,0,0,0,0,stay,1983-07-09
22900,Midnight Star,1984-03-10,Midnight Star - No Parking On The Dance Floor,5,5,7,2.0,5,No Parking On The Dance Floor,60.0,35,-2,0,0,1,down,1983-07-09
22901,Midnight Star,1984-03-17,Midnight Star - No Parking On The Dance Floor,5,5,7,2.0,7,No Parking On The Dance Floor,60.0,36,0,-2,0,0,stay,1983-07-09
22902,Midnight Star,1984-03-24,Midnight Star - No Parking On The Dance Floor,7,5,7,2.0,7,No Parking On The Dance Floor,60.0,37,0,0,-2,0,stay,1983-07-09
22903,Midnight Star,1984-03-31,Midnight Star - No Parking On The Dance Floor,7,7,10,2.0,7,No Parking On The Dance Floor,60.0,38,-3,0,0,1,down,1983-07-09
22904,Midnight Star,1984-04-07,Midnight Star - No Parking On The Dance Floor,7,7,13,2.0,10,No Parking On The Dance Floor,60.0,39,-3,-3,0,1,down,1983-07-09
22905,Midnight Star,1984-04-14,Midnight Star - No Parking On The Dance Floor,10,7,13,2.0,13,No Parking On The Dance Floor,60.0,40,0,-3,-3,0,stay,1983-07-09
22906,Midnight Star,1984-04-21,Midnight Star - No Parking On The Dance Floor,13,10,13,2.0,13,No Parking On The Dance Floor,60.0,41,0,0,-3,0,stay,1983-07-09
22907,Midnight Star,1984-04-28,Midnight Star - No Parking On The Dance Floor,13,13,14,2.0,13,No Parking On The Dance Floor,60.0,42,-1,0,0,1,down,1983-07-09
22908,Midnight Star,1984-05-05,Midnight Star - No Parking On The Dance Floor,13,13,12,2.0,14,No Parking On The Dance Floor,60.0,43,2,-1,0,1,up,1983-07-09
22909,Midnight Star,1984-05-12,Midnight Star - No Parking On The Dance Floor,14,13,12,2.0,12,No Parking On The Dance Floor,60.0,44,0,2,-1,0,stay,1983-07-09
22910,Midnight Star,1984-05-19,Midnight Star - No Parking On The Dance Floor,12,14,13,2.0,12,No Parking On The Dance Floor,60.0,45,-1,0,2,1,down,1983-07-09
22911,Midnight Star,1984-05-26,Midnight Star - No Parking On The Dance Floor,12,12,13,2.0,13,No Parking On The Dance Floor,60.0,46,0,-1,0,0,stay,1983-07-09
22912,Midnight Star,1984-06-02,Midnight Star - No Parking On The Dance Floor,13,12,24,2.0,13,No Parking On The Dance Floor,60.0,47,-11,0,-1,1,down,1983-07-09
22913,Midnight Star,1984-06-09,Midnight Star - No Parking On The Dance Floor,13,13,23,2.0,24,No Parking On The Dance Floor,60.0,48,1,-11,0,1,up,1983-07-09
22914,Midnight Star,1984-06-16,Midnight Star - No Parking On The Dance Floor,24,13,22,2.0,23,No Parking On The Dance Floor,60.0,49,1,1,-11,1,up,1983-07-09
22915,Midnight Star,1984-06-23,Midnight Star - No Parking On The Dance Floor,23,24,24,2.0,22,No Parking On The Dance Floor,60.0,50,-2,1,1,1,down,1983-07-09
22916,Midnight Star,1984-06-30,Midnight Star - No Parking On The Dance Floor,22,23,24,2.0,24,No Parking On The Dance Floor,60.0,51,0,-2,1,0,stay,1983-07-09
22917,Midnight Star,1984-07-07,Midnight Star - No Parking On The Dance Floor,24,22,27,2.0,24,No Parking On The Dance Floor,60.0,52,-3,0,-2,1,down,1983-07-09
22918,Midnight Star,1984-07-14,Midnight Star - No Parking On The Dance Floor,24,24,30,2.0,27,No Parking On The Dance Floor,60.0,53,-3,-3,0,1,down,1983-07-09
22919,Midnight Star,1984-07-21,Midnight Star - No Parking On The Dance Floor,27,24,42,2.0,30,No Parking On The Dance Floor,60.0,54,-12,-3,-3,1,down,1983-07-09
22920,Midnight Star,1984-07-28,Midnight Star - No Parking On The Dance Floor,30,27,41,2.0,42,No Parking On The Dance Floor,60.0,55,1,-12,-3,1,up,1983-07-09
22921,Midnight Star,1984-08-04,Midnight Star - No Parking On The Dance Floor,42,30,40,2.0,41,No Parking On The Dance Floor,60.0,56,1,1,-12,1,up,1983-07-09
22922,Midnight Star,1984-08-11,Midnight Star - No Parking On The Dance Floor,41,42,47,2.0,40,No Parking On The Dance Floor,60.0,57,-7,1,1,1,down,1983-07-09
22923,Midnight Star,1984-08-18,Midnight Star - No Parking On The Dance Floor,40,41,47,2.0,47,No Parking On The Dance Floor,60.0,58,0,-7,1,0,stay,1983-07-09
22924,Midnight Star,1984-08-25,Midnight Star - No Parking On The Dance Floor,47,40,50,2.0,47,No Parking On The Dance Floor,60.0,59,-3,0,-7,1,down,1983-07-09
22925,Midnight Star,1984-09-01,Midnight Star - No Parking On The Dance Floor,47,47,51,2.0,50,No Parking On The Dance Floor,60.0,60,-1,-3,0,1,down,1983-07-09
22926,Indeep,1983-07-09,Indeep - Last Night A D.j. Saved My Life,51,51,47,43.0,47,Last Night A D.j. Saved My Life,5.0,0,0,4,0,0,stay,1983-07-09
22927,Indeep,1983-07-16,Indeep - Last Night A D.j. Saved My Life,47,51,47,43.0,47,Last Night A D.j. Saved My Life,5.0,1,0,0,4,0,stay,1983-07-09
22928,Indeep,1983-07-23,Indeep - Last Night A D.j. Saved My Life,47,47,47,43.0,47,Last Night A D.j. Saved My Life,5.0,2,0,0,0,0,stay,1983-07-09
22929,Indeep,1983-07-30,Indeep - Last Night A D.j. Saved My Life,47,47,43,43.0,47,Last Night A D.j. Saved My Life,5.0,3,4,0,0,1,up,1983-07-09
22930,Indeep,1983-08-06,Indeep - Last Night A D.j. Saved My Life,47,47,43,43.0,43,Last Night A D.j. Saved My Life,5.0,4,0,4,0,0,stay,1983-07-09
22931,Indeep,1983-08-13,Indeep - Last Night A D.j. Saved My Life,43,47,51,43.0,43,Last Night A D.j. Saved My Life,5.0,5,-8,0,4,1,down,1983-07-09
22932,Leon Haywood,1983-07-09,Leon Haywood - It's Me Again,51,51,48,48.0,48,It's Me Again,1.0,0,0,3,0,0,stay,1983-07-09
22933,Leon Haywood,1983-07-16,Leon Haywood - It's Me Again,48,51,51,48.0,48,It's Me Again,1.0,1,-3,0,3,1,down,1983-07-09
22934,Thomas Dolby,1983-07-09,Thomas Dolby - The Golden Age Of Wireless,51,51,49,45.0,50,The Golden Age Of Wireless,3.0,0,1,1,0,1,up,1983-07-09
22935,Thomas Dolby,1983-07-16,Thomas Dolby - The Golden Age Of Wireless,50,51,45,45.0,49,The Golden Age Of Wireless,3.0,1,4,1,1,1,up,1983-07-09
22936,Thomas Dolby,1983-07-23,Thomas Dolby - The Golden Age Of Wireless,49,50,45,45.0,45,The Golden Age Of Wireless,3.0,2,0,4,1,0,stay,1983-07-09
22937,Thomas Dolby,1983-07-30,Thomas Dolby - The Golden Age Of Wireless,45,49,51,45.0,45,The Golden Age Of Wireless,3.0,3,-6,0,4,1,down,1983-07-09
22938,Donna Summer,1983-07-23,Donna Summer - She Works Hard For The Money,51,51,13,5.0,27,She Works Hard For The Money,24.0,0,14,24,0,1,up,1983-07-23
22939,Donna Summer,1983-07-30,Donna Summer - She Works Hard For The Money,27,51,11,5.0,13,She Works Hard For The Money,24.0,1,2,14,24,1,up,1983-07-23
22940,Donna Summer,1983-08-06,Donna Summer - She Works Hard For The Money,13,27,8,5.0,11,She Works Hard For The Money,24.0,2,3,2,14,1,up,1983-07-23
22941,Donna Summer,1983-08-13,Donna Summer - She Works Hard For The Money,11,13,5,5.0,8,She Works Hard For The Money,24.0,3,3,3,2,1,up,1983-07-23
22942,Donna Summer,1983-08-20,Donna Summer - She Works Hard For The Money,8,11,5,5.0,5,She Works Hard For The Money,24.0,4,0,3,3,0,stay,1983-07-23
22943,Donna Summer,1983-08-27,Donna Summer - She Works Hard For The Money,5,8,5,5.0,5,She Works Hard For The Money,24.0,5,0,0,3,0,stay,1983-07-23
22944,Donna Summer,1983-09-03,Donna Summer - She Works Hard For The Money,5,5,11,5.0,5,She Works Hard For The Money,24.0,6,-6,0,0,1,down,1983-07-23
22945,Donna Summer,1983-09-10,Donna Summer - She Works Hard For The Money,5,5,11,5.0,11,She Works Hard For The Money,24.0,7,0,-6,0,0,stay,1983-07-23
22946,Donna Summer,1983-09-17,Donna Summer - She Works Hard For The Money,11,5,11,5.0,11,She Works Hard For The Money,24.0,8,0,0,-6,0,stay,1983-07-23
22947,Donna Summer,1983-09-24,Donna Summer - She Works Hard For The Money,11,11,13,5.0,11,She Works Hard For The Money,24.0,9,-2,0,0,1,down,1983-07-23
22948,Donna Summer,1983-10-01,Donna Summer - She Works Hard For The Money,11,11,14,5.0,13,She Works Hard For The Money,24.0,10,-1,-2,0,1,down,1983-07-23
22949,Donna Summer,1983-10-08,Donna Summer - She Works Hard For The Money,13,11,18,5.0,14,She Works Hard For The Money,24.0,11,-4,-1,-2,1,down,1983-07-23
22950,Donna Summer,1983-10-15,Donna Summer - She Works Hard For The Money,14,13,18,5.0,18,She Works Hard For The Money,24.0,12,0,-4,-1,0,stay,1983-07-23
22951,Donna Summer,1983-10-22,Donna Summer - She Works Hard For The Money,18,14,21,5.0,18,She Works Hard For The Money,24.0,13,-3,0,-4,1,down,1983-07-23
22952,Donna Summer,1983-10-29,Donna Summer - She Works Hard For The Money,18,18,25,5.0,21,She Works Hard For The Money,24.0,14,-4,-3,0,1,down,1983-07-23
22953,Donna Summer,1983-11-05,Donna Summer - She Works Hard For The Money,21,18,23,5.0,25,She Works Hard For The Money,24.0,15,2,-4,-3,1,up,1983-07-23
22954,Donna Summer,1983-11-12,Donna Summer - She Works Hard For The Money,25,21,23,5.0,23,She Works Hard For The Money,24.0,16,0,2,-4,0,stay,1983-07-23
22955,Donna Summer,1983-11-19,Donna Summer - She Works Hard For The Money,23,25,22,5.0,23,She Works Hard For The Money,24.0,17,1,0,2,1,up,1983-07-23
22956,Donna Summer,1983-11-26,Donna Summer - She Works Hard For The Money,23,23,23,5.0,22,She Works Hard For The Money,24.0,18,-1,1,0,1,down,1983-07-23
22957,Donna Summer,1983-12-03,Donna Summer - She Works Hard For The Money,22,23,36,5.0,23,She Works Hard For The Money,24.0,19,-13,-1,1,1,down,1983-07-23
22958,Donna Summer,1983-12-10,Donna Summer - She Works Hard For The Money,23,22,36,5.0,36,She Works Hard For The Money,24.0,20,0,-13,-1,0,stay,1983-07-23
22959,Donna Summer,1983-12-17,Donna Summer - She Works Hard For The Money,36,23,36,5.0,36,She Works Hard For The Money,24.0,21,0,0,-13,0,stay,1983-07-23
22960,Donna Summer,1983-12-24,Donna Summer - She Works Hard For The Money,36,36,36,5.0,36,She Works Hard For The Money,24.0,22,0,0,0,0,stay,1983-07-23
22961,Donna Summer,1983-12-31,Donna Summer - She Works Hard For The Money,36,36,50,5.0,36,She Works Hard For The Money,24.0,23,-14,0,0,1,down,1983-07-23
22962,Donna Summer,1984-01-28,Donna Summer - She Works Hard For The Money,36,36,51,5.0,50,She Works Hard For The Money,24.0,24,-1,-14,0,1,down,1983-07-23
22963,Peter Tosh,1983-07-23,Peter Tosh - Mama Africa,51,51,49,49.0,49,Mama Africa,1.0,0,0,2,0,0,stay,1983-07-23
22964,Peter Tosh,1983-07-30,Peter Tosh - Mama Africa,49,51,51,49.0,49,Mama Africa,1.0,1,-2,0,2,1,down,1983-07-23
22965,Finis Henderson,1983-07-23,Finis Henderson - Finis,51,51,48,42.0,50,Finis,6.0,0,2,1,0,1,up,1983-07-23
22966,Finis Henderson,1983-07-30,Finis Henderson - Finis,50,51,45,42.0,48,Finis,6.0,1,3,2,1,1,up,1983-07-23
22967,Finis Henderson,1983-08-06,Finis Henderson - Finis,48,50,42,42.0,45,Finis,6.0,2,3,3,2,1,up,1983-07-23
22968,Finis Henderson,1983-08-13,Finis Henderson - Finis,45,48,42,42.0,42,Finis,6.0,3,0,3,3,0,stay,1983-07-23
22969,Finis Henderson,1983-08-20,Finis Henderson - Finis,42,45,47,42.0,42,Finis,6.0,4,-5,0,3,1,down,1983-07-23
22970,Finis Henderson,1983-08-27,Finis Henderson - Finis,42,42,46,42.0,47,Finis,6.0,5,1,-5,0,1,up,1983-07-23
22971,Finis Henderson,1983-09-03,Finis Henderson - Finis,47,42,51,42.0,46,Finis,6.0,6,-5,1,-5,1,down,1983-07-23
22972,One Way,1983-07-30,One Way - Shine On Me,51,51,33,27.0,37,Shine On Me,14.0,0,4,14,0,1,up,1983-07-30
22973,One Way,1983-08-06,One Way - Shine On Me,37,51,29,27.0,33,Shine On Me,14.0,1,4,4,14,1,up,1983-07-30
22974,One Way,1983-08-13,One Way - Shine On Me,33,37,27,27.0,29,Shine On Me,14.0,2,2,4,4,1,up,1983-07-30
22975,One Way,1983-08-20,One Way - Shine On Me,29,33,27,27.0,27,Shine On Me,14.0,3,0,2,4,0,stay,1983-07-30
22976,One Way,1983-08-27,One Way - Shine On Me,27,29,27,27.0,27,Shine On Me,14.0,4,0,0,2,0,stay,1983-07-30
22977,One Way,1983-09-03,One Way - Shine On Me,27,27,31,27.0,27,Shine On Me,14.0,5,-4,0,0,1,down,1983-07-30
22978,One Way,1983-09-10,One Way - Shine On Me,27,27,33,27.0,31,Shine On Me,14.0,6,-2,-4,0,1,down,1983-07-30
22979,One Way,1983-09-17,One Way - Shine On Me,31,27,37,27.0,33,Shine On Me,14.0,7,-4,-2,-4,1,down,1983-07-30
22980,One Way,1983-09-24,One Way - Shine On Me,33,31,38,27.0,37,Shine On Me,14.0,8,-1,-4,-2,1,down,1983-07-30
22981,One Way,1983-10-01,One Way - Shine On Me,37,33,38,27.0,38,Shine On Me,14.0,9,0,-1,-4,0,stay,1983-07-30
22982,One Way,1983-10-08,One Way - Shine On Me,38,37,38,27.0,38,Shine On Me,14.0,10,0,0,-1,0,stay,1983-07-30
22983,One Way,1983-10-15,One Way - Shine On Me,38,38,40,27.0,38,Shine On Me,14.0,11,-2,0,0,1,down,1983-07-30
22984,One Way,1983-10-22,One Way - Shine On Me,38,38,39,27.0,40,Shine On Me,14.0,12,1,-2,0,1,up,1983-07-30
22985,One Way,1983-10-29,One Way - Shine On Me,40,38,44,27.0,39,Shine On Me,14.0,13,-5,1,-2,1,down,1983-07-30
22986,One Way,1983-11-05,One Way - Shine On Me,39,40,51,27.0,44,Shine On Me,14.0,14,-7,-5,1,1,down,1983-07-30
22987,Diana Ross,1983-07-30,Diana Ross - Ross (II),51,51,24,14.0,40,Ross (II),13.0,0,16,11,0,1,up,1983-07-30
22988,Diana Ross,1983-08-06,Diana Ross - Ross (II),40,51,18,14.0,24,Ross (II),13.0,1,6,16,11,1,up,1983-07-30
22989,Diana Ross,1983-08-13,Diana Ross - Ross (II),24,40,16,14.0,18,Ross (II),13.0,2,2,6,16,1,up,1983-07-30
22990,Diana Ross,1983-08-20,Diana Ross - Ross (II),18,24,14,14.0,16,Ross (II),13.0,3,2,2,6,1,up,1983-07-30
22991,Diana Ross,1983-08-27,Diana Ross - Ross (II),16,18,14,14.0,14,Ross (II),13.0,4,0,2,2,0,stay,1983-07-30
22992,Diana Ross,1983-09-03,Diana Ross - Ross (II),14,16,21,14.0,14,Ross (II),13.0,5,-7,0,2,1,down,1983-07-30
22993,Diana Ross,1983-09-10,Diana Ross - Ross (II),14,14,26,14.0,21,Ross (II),13.0,6,-5,-7,0,1,down,1983-07-30
22994,Diana Ross,1983-09-17,Diana Ross - Ross (II),21,14,39,14.0,26,Ross (II),13.0,7,-13,-5,-7,1,down,1983-07-30
22995,Diana Ross,1983-09-24,Diana Ross - Ross (II),26,21,39,14.0,39,Ross (II),13.0,8,0,-13,-5,0,stay,1983-07-30
22996,Diana Ross,1983-10-01,Diana Ross - Ross (II),39,26,40,14.0,39,Ross (II),13.0,9,-1,0,-13,1,down,1983-07-30
22997,Diana Ross,1983-10-08,Diana Ross - Ross (II),39,39,40,14.0,40,Ross (II),13.0,10,0,-1,0,0,stay,1983-07-30
22998,Diana Ross,1983-10-15,Diana Ross - Ross (II),40,39,47,14.0,40,Ross (II),13.0,11,-7,0,-1,1,down,1983-07-30
22999,Diana Ross,1983-10-22,Diana Ross - Ross (II),40,40,47,14.0,47,Ross (II),13.0,12,0,-7,0,0,stay,1983-07-30
23000,Diana Ross,1983-10-29,Diana Ross - Ross (II),47,40,51,14.0,47,Ross (II),13.0,13,-4,0,-7,1,down,1983-07-30
23001,War,1983-07-30,War - Life Is So Strange,51,51,39,36.0,50,Life Is So Strange,4.0,0,11,1,0,1,up,1983-07-30
23002,War,1983-08-06,War - Life Is So Strange,50,51,36,36.0,39,Life Is So Strange,4.0,1,3,11,1,1,up,1983-07-30
23003,War,1983-08-13,War - Life Is So Strange,39,50,36,36.0,36,Life Is So Strange,4.0,2,0,3,11,0,stay,1983-07-30
23004,War,1983-08-20,War - Life Is So Strange,36,39,43,36.0,36,Life Is So Strange,4.0,3,-7,0,3,1,down,1983-07-30
23005,War,1983-08-27,War - Life Is So Strange,36,36,51,36.0,43,Life Is So Strange,4.0,4,-8,-7,0,1,down,1983-07-30
23006,The Manhattans,1983-08-06,The Manhattans - Forever By Your Side,51,51,24,17.0,32,Forever By Your Side,14.0,0,8,19,0,1,up,1983-08-06
23007,The Manhattans,1983-08-13,The Manhattans - Forever By Your Side,32,51,22,17.0,24,Forever By Your Side,14.0,1,2,8,19,1,up,1983-08-06
23008,The Manhattans,1983-08-20,The Manhattans - Forever By Your Side,24,32,17,17.0,22,Forever By Your Side,14.0,2,5,2,8,1,up,1983-08-06
23009,The Manhattans,1983-08-27,The Manhattans - Forever By Your Side,22,24,17,17.0,17,Forever By Your Side,14.0,3,0,5,2,0,stay,1983-08-06
23010,The Manhattans,1983-09-03,The Manhattans - Forever By Your Side,17,22,26,17.0,17,Forever By Your Side,14.0,4,-9,0,5,1,down,1983-08-06
23011,The Manhattans,1983-09-10,The Manhattans - Forever By Your Side,17,17,31,17.0,26,Forever By Your Side,14.0,5,-5,-9,0,1,down,1983-08-06
23012,The Manhattans,1983-09-17,The Manhattans - Forever By Your Side,26,17,28,17.0,31,Forever By Your Side,14.0,6,3,-5,-9,1,up,1983-08-06
23013,The Manhattans,1983-09-24,The Manhattans - Forever By Your Side,31,26,28,17.0,28,Forever By Your Side,14.0,7,0,3,-5,0,stay,1983-08-06
23014,The Manhattans,1983-10-01,The Manhattans - Forever By Your Side,28,31,28,17.0,28,Forever By Your Side,14.0,8,0,0,3,0,stay,1983-08-06
23015,The Manhattans,1983-10-08,The Manhattans - Forever By Your Side,28,28,33,17.0,28,Forever By Your Side,14.0,9,-5,0,0,1,down,1983-08-06
23016,The Manhattans,1983-10-15,The Manhattans - Forever By Your Side,28,28,41,17.0,33,Forever By Your Side,14.0,10,-8,-5,0,1,down,1983-08-06
23017,The Manhattans,1983-10-22,The Manhattans - Forever By Your Side,33,28,50,17.0,41,Forever By Your Side,14.0,11,-9,-8,-5,1,down,1983-08-06
23018,The Manhattans,1983-11-12,The Manhattans - Forever By Your Side,41,33,50,17.0,50,Forever By Your Side,14.0,12,0,-9,-8,0,stay,1983-08-06
23019,The Manhattans,1983-11-19,The Manhattans - Forever By Your Side,50,41,48,17.0,50,Forever By Your Side,14.0,13,2,0,-9,1,up,1983-08-06
23020,The Manhattans,1983-11-26,The Manhattans - Forever By Your Side,50,50,51,17.0,48,Forever By Your Side,14.0,14,-3,2,0,1,down,1983-08-06
23021,The S.O.S. Band,1983-08-06,The S.O.S. Band - On The Rise,51,51,21,7.0,36,On The Rise,27.0,0,15,15,0,1,up,1983-08-06
23022,The S.O.S. Band,1983-08-13,The S.O.S. Band - On The Rise,36,51,17,7.0,21,On The Rise,27.0,1,4,15,15,1,up,1983-08-06
23023,The S.O.S. Band,1983-08-20,The S.O.S. Band - On The Rise,21,36,12,7.0,17,On The Rise,27.0,2,5,4,15,1,up,1983-08-06
23024,The S.O.S. Band,1983-08-27,The S.O.S. Band - On The Rise,17,21,10,7.0,12,On The Rise,27.0,3,2,5,4,1,up,1983-08-06
23025,The S.O.S. Band,1983-09-03,The S.O.S. Band - On The Rise,12,17,10,7.0,10,On The Rise,27.0,4,0,2,5,0,stay,1983-08-06
23026,The S.O.S. Band,1983-09-10,The S.O.S. Band - On The Rise,10,12,9,7.0,10,On The Rise,27.0,5,1,0,2,1,up,1983-08-06
23027,The S.O.S. Band,1983-09-17,The S.O.S. Band - On The Rise,10,10,9,7.0,9,On The Rise,27.0,6,0,1,0,0,stay,1983-08-06
23028,The S.O.S. Band,1983-09-24,The S.O.S. Band - On The Rise,9,10,7,7.0,9,On The Rise,27.0,7,2,0,1,1,up,1983-08-06
23029,The S.O.S. Band,1983-10-01,The S.O.S. Band - On The Rise,9,9,10,7.0,7,On The Rise,27.0,8,-3,2,0,1,down,1983-08-06
23030,The S.O.S. Band,1983-10-08,The S.O.S. Band - On The Rise,7,9,10,7.0,10,On The Rise,27.0,9,0,-3,2,0,stay,1983-08-06
23031,The S.O.S. Band,1983-10-15,The S.O.S. Band - On The Rise,10,7,9,7.0,10,On The Rise,27.0,10,1,0,-3,1,up,1983-08-06
23032,The S.O.S. Band,1983-10-22,The S.O.S. Band - On The Rise,10,10,9,7.0,9,On The Rise,27.0,11,0,1,0,0,stay,1983-08-06
23033,The S.O.S. Band,1983-10-29,The S.O.S. Band - On The Rise,9,10,8,7.0,9,On The Rise,27.0,12,1,0,1,1,up,1983-08-06
23034,The S.O.S. Band,1983-11-05,The S.O.S. Band - On The Rise,9,9,7,7.0,8,On The Rise,27.0,13,1,1,0,1,up,1983-08-06
23035,The S.O.S. Band,1983-11-12,The S.O.S. Band - On The Rise,8,9,10,7.0,7,On The Rise,27.0,14,-3,1,1,1,down,1983-08-06
23036,The S.O.S. Band,1983-11-19,The S.O.S. Band - On The Rise,7,8,9,7.0,10,On The Rise,27.0,15,1,-3,1,1,up,1983-08-06
23037,The S.O.S. Band,1983-11-26,The S.O.S. Band - On The Rise,10,7,9,7.0,9,On The Rise,27.0,16,0,1,-3,0,stay,1983-08-06
23038,The S.O.S. Band,1983-12-03,The S.O.S. Band - On The Rise,9,10,9,7.0,9,On The Rise,27.0,17,0,0,1,0,stay,1983-08-06
23039,The S.O.S. Band,1983-12-10,The S.O.S. Band - On The Rise,9,9,11,7.0,9,On The Rise,27.0,18,-2,0,0,1,down,1983-08-06
23040,The S.O.S. Band,1983-12-17,The S.O.S. Band - On The Rise,9,9,11,7.0,11,On The Rise,27.0,19,0,-2,0,0,stay,1983-08-06
23041,The S.O.S. Band,1983-12-24,The S.O.S. Band - On The Rise,11,9,11,7.0,11,On The Rise,27.0,20,0,0,-2,0,stay,1983-08-06
23042,The S.O.S. Band,1983-12-31,The S.O.S. Band - On The Rise,11,11,11,7.0,11,On The Rise,27.0,21,0,0,0,0,stay,1983-08-06
23043,The S.O.S. Band,1984-01-07,The S.O.S. Band - On The Rise,11,11,21,7.0,11,On The Rise,27.0,22,-10,0,0,1,down,1983-08-06
23044,The S.O.S. Band,1984-01-14,The S.O.S. Band - On The Rise,11,11,21,7.0,21,On The Rise,27.0,23,0,-10,0,0,stay,1983-08-06
23045,The S.O.S. Band,1984-01-21,The S.O.S. Band - On The Rise,21,11,31,7.0,21,On The Rise,27.0,24,-10,0,-10,1,down,1983-08-06
23046,The S.O.S. Band,1984-01-28,The S.O.S. Band - On The Rise,21,21,41,7.0,31,On The Rise,27.0,25,-10,-10,0,1,down,1983-08-06
23047,The S.O.S. Band,1984-02-04,The S.O.S. Band - On The Rise,31,21,41,7.0,41,On The Rise,27.0,26,0,-10,-10,0,stay,1983-08-06
23048,The S.O.S. Band,1984-02-11,The S.O.S. Band - On The Rise,41,31,51,7.0,41,On The Rise,27.0,27,-10,0,-10,1,down,1983-08-06
23049,Aretha Franklin,1983-08-06,Aretha Franklin - Get It Right,51,51,7,4.0,40,Get It Right,18.0,0,33,11,0,1,up,1983-08-06
23050,Aretha Franklin,1983-08-13,Aretha Franklin - Get It Right,40,51,4,4.0,7,Get It Right,18.0,1,3,33,11,1,up,1983-08-06
23051,Aretha Franklin,1983-08-20,Aretha Franklin - Get It Right,7,40,4,4.0,4,Get It Right,18.0,2,0,3,33,0,stay,1983-08-06
23052,Aretha Franklin,1983-08-27,Aretha Franklin - Get It Right,4,7,4,4.0,4,Get It Right,18.0,3,0,0,3,0,stay,1983-08-06
23053,Aretha Franklin,1983-09-03,Aretha Franklin - Get It Right,4,4,4,4.0,4,Get It Right,18.0,4,0,0,0,0,stay,1983-08-06
23054,Aretha Franklin,1983-09-10,Aretha Franklin - Get It Right,4,4,12,4.0,4,Get It Right,18.0,5,-8,0,0,1,down,1983-08-06
23055,Aretha Franklin,1983-09-17,Aretha Franklin - Get It Right,4,4,10,4.0,12,Get It Right,18.0,6,2,-8,0,1,up,1983-08-06
23056,Aretha Franklin,1983-09-24,Aretha Franklin - Get It Right,12,4,16,4.0,10,Get It Right,18.0,7,-6,2,-8,1,down,1983-08-06
23057,Aretha Franklin,1983-10-01,Aretha Franklin - Get It Right,10,12,16,4.0,16,Get It Right,18.0,8,0,-6,2,0,stay,1983-08-06
23058,Aretha Franklin,1983-10-08,Aretha Franklin - Get It Right,16,10,16,4.0,16,Get It Right,18.0,9,0,0,-6,0,stay,1983-08-06
23059,Aretha Franklin,1983-10-15,Aretha Franklin - Get It Right,16,16,22,4.0,16,Get It Right,18.0,10,-6,0,0,1,down,1983-08-06
23060,Aretha Franklin,1983-10-22,Aretha Franklin - Get It Right,16,16,22,4.0,22,Get It Right,18.0,11,0,-6,0,0,stay,1983-08-06
23061,Aretha Franklin,1983-10-29,Aretha Franklin - Get It Right,22,16,21,4.0,22,Get It Right,18.0,12,1,0,-6,1,up,1983-08-06
23062,Aretha Franklin,1983-11-05,Aretha Franklin - Get It Right,22,22,25,4.0,21,Get It Right,18.0,13,-4,1,0,1,down,1983-08-06
23063,Aretha Franklin,1983-11-12,Aretha Franklin - Get It Right,21,22,30,4.0,25,Get It Right,18.0,14,-5,-4,1,1,down,1983-08-06
23064,Aretha Franklin,1983-11-19,Aretha Franklin - Get It Right,25,21,25,4.0,30,Get It Right,18.0,15,5,-5,-4,1,up,1983-08-06
23065,Aretha Franklin,1983-11-26,Aretha Franklin - Get It Right,30,25,25,4.0,25,Get It Right,18.0,16,0,5,-5,0,stay,1983-08-06
23066,Aretha Franklin,1983-12-03,Aretha Franklin - Get It Right,25,30,40,4.0,25,Get It Right,18.0,17,-15,0,5,1,down,1983-08-06
23067,Aretha Franklin,1983-12-10,Aretha Franklin - Get It Right,25,25,51,4.0,40,Get It Right,18.0,18,-11,-15,0,1,down,1983-08-06
23068,Anita Baker,1983-08-06,Anita Baker - The Songstress,51,51,48,12.0,48,The Songstress,41.0,0,0,3,0,0,stay,1983-08-06
23069,Anita Baker,1983-08-13,Anita Baker - The Songstress,48,51,49,12.0,48,The Songstress,41.0,1,-1,0,3,1,down,1983-08-06
23070,Anita Baker,1983-08-20,Anita Baker - The Songstress,48,48,48,12.0,49,The Songstress,41.0,2,1,-1,0,1,up,1983-08-06
23071,Anita Baker,1983-08-27,Anita Baker - The Songstress,49,48,42,12.0,48,The Songstress,41.0,3,6,1,-1,1,up,1983-08-06
23072,Anita Baker,1983-09-03,Anita Baker - The Songstress,48,49,39,12.0,42,The Songstress,41.0,4,3,6,1,1,up,1983-08-06
23073,Anita Baker,1983-09-10,Anita Baker - The Songstress,42,48,28,12.0,39,The Songstress,41.0,5,11,3,6,1,up,1983-08-06
23074,Anita Baker,1983-09-17,Anita Baker - The Songstress,39,42,25,12.0,28,The Songstress,41.0,6,3,11,3,1,up,1983-08-06
23075,Anita Baker,1983-09-24,Anita Baker - The Songstress,28,39,23,12.0,25,The Songstress,41.0,7,2,3,11,1,up,1983-08-06
23076,Anita Baker,1983-10-01,Anita Baker - The Songstress,25,28,19,12.0,23,The Songstress,41.0,8,4,2,3,1,up,1983-08-06
23077,Anita Baker,1983-10-08,Anita Baker - The Songstress,23,25,17,12.0,19,The Songstress,41.0,9,2,4,2,1,up,1983-08-06
23078,Anita Baker,1983-10-15,Anita Baker - The Songstress,19,23,15,12.0,17,The Songstress,41.0,10,2,2,4,1,up,1983-08-06
23079,Anita Baker,1983-10-22,Anita Baker - The Songstress,17,19,13,12.0,15,The Songstress,41.0,11,2,2,2,1,up,1983-08-06
23080,Anita Baker,1983-10-29,Anita Baker - The Songstress,15,17,12,12.0,13,The Songstress,41.0,12,1,2,2,1,up,1983-08-06
23081,Anita Baker,1983-11-05,Anita Baker - The Songstress,13,15,12,12.0,12,The Songstress,41.0,13,0,1,2,0,stay,1983-08-06
23082,Anita Baker,1983-11-12,Anita Baker - The Songstress,12,13,12,12.0,12,The Songstress,41.0,14,0,0,1,0,stay,1983-08-06
23083,Anita Baker,1983-11-19,Anita Baker - The Songstress,12,12,13,12.0,12,The Songstress,41.0,15,-1,0,0,1,down,1983-08-06
23084,Anita Baker,1983-11-26,Anita Baker - The Songstress,12,12,13,12.0,13,The Songstress,41.0,16,0,-1,0,0,stay,1983-08-06
23085,Anita Baker,1983-12-03,Anita Baker - The Songstress,13,12,13,12.0,13,The Songstress,41.0,17,0,0,-1,0,stay,1983-08-06
23086,Anita Baker,1983-12-10,Anita Baker - The Songstress,13,13,22,12.0,13,The Songstress,41.0,18,-9,0,0,1,down,1983-08-06
23087,Anita Baker,1983-12-17,Anita Baker - The Songstress,13,13,19,12.0,22,The Songstress,41.0,19,3,-9,0,1,up,1983-08-06
23088,Anita Baker,1983-12-24,Anita Baker - The Songstress,22,13,19,12.0,19,The Songstress,41.0,20,0,3,-9,0,stay,1983-08-06
23089,Anita Baker,1983-12-31,Anita Baker - The Songstress,19,22,19,12.0,19,The Songstress,41.0,21,0,0,3,0,stay,1983-08-06
23090,Anita Baker,1984-01-07,Anita Baker - The Songstress,19,19,19,12.0,19,The Songstress,41.0,22,0,0,0,0,stay,1983-08-06
23091,Anita Baker,1984-01-14,Anita Baker - The Songstress,19,19,19,12.0,19,The Songstress,41.0,23,0,0,0,0,stay,1983-08-06
23092,Anita Baker,1984-01-21,Anita Baker - The Songstress,19,19,18,12.0,19,The Songstress,41.0,24,1,0,0,1,up,1983-08-06
23093,Anita Baker,1984-01-28,Anita Baker - The Songstress,19,19,17,12.0,18,The Songstress,41.0,25,1,1,0,1,up,1983-08-06
23094,Anita Baker,1984-02-04,Anita Baker - The Songstress,18,19,17,12.0,17,The Songstress,41.0,26,0,1,1,0,stay,1983-08-06
23095,Anita Baker,1984-02-11,Anita Baker - The Songstress,17,18,16,12.0,17,The Songstress,41.0,27,1,0,1,1,up,1983-08-06
23096,Anita Baker,1984-02-18,Anita Baker - The Songstress,17,17,16,12.0,16,The Songstress,41.0,28,0,1,0,0,stay,1983-08-06
23097,Anita Baker,1984-02-25,Anita Baker - The Songstress,16,17,17,12.0,16,The Songstress,41.0,29,-1,0,1,1,down,1983-08-06
23098,Anita Baker,1984-03-03,Anita Baker - The Songstress,16,16,20,12.0,17,The Songstress,41.0,30,-3,-1,0,1,down,1983-08-06
23099,Anita Baker,1984-03-10,Anita Baker - The Songstress,17,16,20,12.0,20,The Songstress,41.0,31,0,-3,-1,0,stay,1983-08-06
23100,Anita Baker,1984-03-17,Anita Baker - The Songstress,20,17,28,12.0,20,The Songstress,41.0,32,-8,0,-3,1,down,1983-08-06
23101,Anita Baker,1984-03-24,Anita Baker - The Songstress,20,20,31,12.0,28,The Songstress,41.0,33,-3,-8,0,1,down,1983-08-06
23102,Anita Baker,1984-03-31,Anita Baker - The Songstress,28,20,37,12.0,31,The Songstress,41.0,34,-6,-3,-8,1,down,1983-08-06
23103,Anita Baker,1984-04-07,Anita Baker - The Songstress,31,28,39,12.0,37,The Songstress,41.0,35,-2,-6,-3,1,down,1983-08-06
23104,Anita Baker,1984-04-14,Anita Baker - The Songstress,37,31,50,12.0,39,The Songstress,41.0,36,-11,-2,-6,1,down,1983-08-06
23105,Anita Baker,1984-04-28,Anita Baker - The Songstress,39,37,48,12.0,50,The Songstress,41.0,37,2,-11,-2,1,up,1983-08-06
23106,Anita Baker,1984-05-05,Anita Baker - The Songstress,50,39,46,12.0,48,The Songstress,41.0,38,2,2,-11,1,up,1983-08-06
23107,Anita Baker,1984-05-12,Anita Baker - The Songstress,48,50,48,12.0,46,The Songstress,41.0,39,-2,2,2,1,down,1983-08-06
23108,Anita Baker,1984-05-19,Anita Baker - The Songstress,46,48,49,12.0,48,The Songstress,41.0,40,-1,-2,2,1,down,1983-08-06
23109,Anita Baker,1984-05-26,Anita Baker - The Songstress,48,46,51,12.0,49,The Songstress,41.0,41,-2,-1,-2,1,down,1983-08-06
23110,Jeffrey Osborne,1983-08-13,Jeffrey Osborne - Stay With Me Tonight,51,51,9,3.0,20,Stay With Me Tonight,59.0,0,11,31,0,1,up,1983-08-13
23111,Jeffrey Osborne,1983-08-20,Jeffrey Osborne - Stay With Me Tonight,20,51,7,3.0,9,Stay With Me Tonight,59.0,1,2,11,31,1,up,1983-08-13
23112,Jeffrey Osborne,1983-08-27,Jeffrey Osborne - Stay With Me Tonight,9,20,7,3.0,7,Stay With Me Tonight,59.0,2,0,2,11,0,stay,1983-08-13
23113,Jeffrey Osborne,1983-09-03,Jeffrey Osborne - Stay With Me Tonight,7,9,7,3.0,7,Stay With Me Tonight,59.0,3,0,0,2,0,stay,1983-08-13
23114,Jeffrey Osborne,1983-09-10,Jeffrey Osborne - Stay With Me Tonight,7,7,5,3.0,7,Stay With Me Tonight,59.0,4,2,0,0,1,up,1983-08-13
23115,Jeffrey Osborne,1983-09-17,Jeffrey Osborne - Stay With Me Tonight,7,7,4,3.0,5,Stay With Me Tonight,59.0,5,1,2,0,1,up,1983-08-13
23116,Jeffrey Osborne,1983-09-24,Jeffrey Osborne - Stay With Me Tonight,5,7,3,3.0,4,Stay With Me Tonight,59.0,6,1,1,2,1,up,1983-08-13
23117,Jeffrey Osborne,1983-10-01,Jeffrey Osborne - Stay With Me Tonight,4,5,3,3.0,3,Stay With Me Tonight,59.0,7,0,1,1,0,stay,1983-08-13
23118,Jeffrey Osborne,1983-10-08,Jeffrey Osborne - Stay With Me Tonight,3,4,3,3.0,3,Stay With Me Tonight,59.0,8,0,0,1,0,stay,1983-08-13
23119,Jeffrey Osborne,1983-10-15,Jeffrey Osborne - Stay With Me Tonight,3,3,6,3.0,3,Stay With Me Tonight,59.0,9,-3,0,0,1,down,1983-08-13
23120,Jeffrey Osborne,1983-10-22,Jeffrey Osborne - Stay With Me Tonight,3,3,7,3.0,6,Stay With Me Tonight,59.0,10,-1,-3,0,1,down,1983-08-13
23121,Jeffrey Osborne,1983-10-29,Jeffrey Osborne - Stay With Me Tonight,6,3,7,3.0,7,Stay With Me Tonight,59.0,11,0,-1,-3,0,stay,1983-08-13
23122,Jeffrey Osborne,1983-11-05,Jeffrey Osborne - Stay With Me Tonight,7,6,6,3.0,7,Stay With Me Tonight,59.0,12,1,0,-1,1,up,1983-08-13
23123,Jeffrey Osborne,1983-11-12,Jeffrey Osborne - Stay With Me Tonight,7,7,6,3.0,6,Stay With Me Tonight,59.0,13,0,1,0,0,stay,1983-08-13
23124,Jeffrey Osborne,1983-11-19,Jeffrey Osborne - Stay With Me Tonight,6,7,4,3.0,6,Stay With Me Tonight,59.0,14,2,0,1,1,up,1983-08-13
23125,Jeffrey Osborne,1983-11-26,Jeffrey Osborne - Stay With Me Tonight,6,6,4,3.0,4,Stay With Me Tonight,59.0,15,0,2,0,0,stay,1983-08-13
23126,Jeffrey Osborne,1983-12-03,Jeffrey Osborne - Stay With Me Tonight,4,6,4,3.0,4,Stay With Me Tonight,59.0,16,0,0,2,0,stay,1983-08-13
23127,Jeffrey Osborne,1983-12-10,Jeffrey Osborne - Stay With Me Tonight,4,4,4,3.0,4,Stay With Me Tonight,59.0,17,0,0,0,0,stay,1983-08-13
23128,Jeffrey Osborne,1983-12-17,Jeffrey Osborne - Stay With Me Tonight,4,4,3,3.0,4,Stay With Me Tonight,59.0,18,1,0,0,1,up,1983-08-13
23129,Jeffrey Osborne,1983-12-24,Jeffrey Osborne - Stay With Me Tonight,4,4,3,3.0,3,Stay With Me Tonight,59.0,19,0,1,0,0,stay,1983-08-13
23130,Jeffrey Osborne,1983-12-31,Jeffrey Osborne - Stay With Me Tonight,3,4,3,3.0,3,Stay With Me Tonight,59.0,20,0,0,1,0,stay,1983-08-13
23131,Jeffrey Osborne,1984-01-07,Jeffrey Osborne - Stay With Me Tonight,3,3,4,3.0,3,Stay With Me Tonight,59.0,21,-1,0,0,1,down,1983-08-13
23132,Jeffrey Osborne,1984-01-14,Jeffrey Osborne - Stay With Me Tonight,3,3,7,3.0,4,Stay With Me Tonight,59.0,22,-3,-1,0,1,down,1983-08-13
23133,Jeffrey Osborne,1984-01-21,Jeffrey Osborne - Stay With Me Tonight,4,3,9,3.0,7,Stay With Me Tonight,59.0,23,-2,-3,-1,1,down,1983-08-13
23134,Jeffrey Osborne,1984-01-28,Jeffrey Osborne - Stay With Me Tonight,7,4,9,3.0,9,Stay With Me Tonight,59.0,24,0,-2,-3,0,stay,1983-08-13
23135,Jeffrey Osborne,1984-02-04,Jeffrey Osborne - Stay With Me Tonight,9,7,8,3.0,9,Stay With Me Tonight,59.0,25,1,0,-2,1,up,1983-08-13
23136,Jeffrey Osborne,1984-02-11,Jeffrey Osborne - Stay With Me Tonight,9,9,8,3.0,8,Stay With Me Tonight,59.0,26,0,1,0,0,stay,1983-08-13
23137,Jeffrey Osborne,1984-02-18,Jeffrey Osborne - Stay With Me Tonight,8,9,8,3.0,8,Stay With Me Tonight,59.0,27,0,0,1,0,stay,1983-08-13
23138,Jeffrey Osborne,1984-02-25,Jeffrey Osborne - Stay With Me Tonight,8,8,6,3.0,8,Stay With Me Tonight,59.0,28,2,0,0,1,up,1983-08-13
23139,Jeffrey Osborne,1984-03-03,Jeffrey Osborne - Stay With Me Tonight,8,8,6,3.0,6,Stay With Me Tonight,59.0,29,0,2,0,0,stay,1983-08-13
23140,Jeffrey Osborne,1984-03-10,Jeffrey Osborne - Stay With Me Tonight,6,8,5,3.0,6,Stay With Me Tonight,59.0,30,1,0,2,1,up,1983-08-13
23141,Jeffrey Osborne,1984-03-17,Jeffrey Osborne - Stay With Me Tonight,6,6,6,3.0,5,Stay With Me Tonight,59.0,31,-1,1,0,1,down,1983-08-13
23142,Jeffrey Osborne,1984-03-24,Jeffrey Osborne - Stay With Me Tonight,5,6,13,3.0,6,Stay With Me Tonight,59.0,32,-7,-1,1,1,down,1983-08-13
23143,Jeffrey Osborne,1984-03-31,Jeffrey Osborne - Stay With Me Tonight,6,5,13,3.0,13,Stay With Me Tonight,59.0,33,0,-7,-1,0,stay,1983-08-13
23144,Jeffrey Osborne,1984-04-07,Jeffrey Osborne - Stay With Me Tonight,13,6,10,3.0,13,Stay With Me Tonight,59.0,34,3,0,-7,1,up,1983-08-13
23145,Jeffrey Osborne,1984-04-14,Jeffrey Osborne - Stay With Me Tonight,13,13,10,3.0,10,Stay With Me Tonight,59.0,35,0,3,0,0,stay,1983-08-13
23146,Jeffrey Osborne,1984-04-21,Jeffrey Osborne - Stay With Me Tonight,10,13,11,3.0,10,Stay With Me Tonight,59.0,36,-1,0,3,1,down,1983-08-13
23147,Jeffrey Osborne,1984-04-28,Jeffrey Osborne - Stay With Me Tonight,10,10,11,3.0,11,Stay With Me Tonight,59.0,37,0,-1,0,0,stay,1983-08-13
23148,Jeffrey Osborne,1984-05-05,Jeffrey Osborne - Stay With Me Tonight,11,10,17,3.0,11,Stay With Me Tonight,59.0,38,-6,0,-1,1,down,1983-08-13
23149,Jeffrey Osborne,1984-05-12,Jeffrey Osborne - Stay With Me Tonight,11,11,17,3.0,17,Stay With Me Tonight,59.0,39,0,-6,0,0,stay,1983-08-13
23150,Jeffrey Osborne,1984-05-19,Jeffrey Osborne - Stay With Me Tonight,17,11,18,3.0,17,Stay With Me Tonight,59.0,40,-1,0,-6,1,down,1983-08-13
23151,Jeffrey Osborne,1984-05-26,Jeffrey Osborne - Stay With Me Tonight,17,17,24,3.0,18,Stay With Me Tonight,59.0,41,-6,-1,0,1,down,1983-08-13
23152,Jeffrey Osborne,1984-06-02,Jeffrey Osborne - Stay With Me Tonight,18,17,23,3.0,24,Stay With Me Tonight,59.0,42,1,-6,-1,1,up,1983-08-13
23153,Jeffrey Osborne,1984-06-09,Jeffrey Osborne - Stay With Me Tonight,24,18,24,3.0,23,Stay With Me Tonight,59.0,43,-1,1,-6,1,down,1983-08-13
23154,Jeffrey Osborne,1984-06-16,Jeffrey Osborne - Stay With Me Tonight,23,24,36,3.0,24,Stay With Me Tonight,59.0,44,-12,-1,1,1,down,1983-08-13
23155,Jeffrey Osborne,1984-06-23,Jeffrey Osborne - Stay With Me Tonight,24,23,36,3.0,36,Stay With Me Tonight,59.0,45,0,-12,-1,0,stay,1983-08-13
23156,Jeffrey Osborne,1984-06-30,Jeffrey Osborne - Stay With Me Tonight,36,24,36,3.0,36,Stay With Me Tonight,59.0,46,0,0,-12,0,stay,1983-08-13
23157,Jeffrey Osborne,1984-07-07,Jeffrey Osborne - Stay With Me Tonight,36,36,44,3.0,36,Stay With Me Tonight,59.0,47,-8,0,0,1,down,1983-08-13
23158,Jeffrey Osborne,1984-07-14,Jeffrey Osborne - Stay With Me Tonight,36,36,43,3.0,44,Stay With Me Tonight,59.0,48,1,-8,0,1,up,1983-08-13
23159,Jeffrey Osborne,1984-07-21,Jeffrey Osborne - Stay With Me Tonight,44,36,41,3.0,43,Stay With Me Tonight,59.0,49,2,1,-8,1,up,1983-08-13
23160,Jeffrey Osborne,1984-07-28,Jeffrey Osborne - Stay With Me Tonight,43,44,40,3.0,41,Stay With Me Tonight,59.0,50,1,2,1,1,up,1983-08-13
23161,Jeffrey Osborne,1984-08-04,Jeffrey Osborne - Stay With Me Tonight,41,43,45,3.0,40,Stay With Me Tonight,59.0,51,-5,1,2,1,down,1983-08-13
23162,Jeffrey Osborne,1984-08-11,Jeffrey Osborne - Stay With Me Tonight,40,41,44,3.0,45,Stay With Me Tonight,59.0,52,1,-5,1,1,up,1983-08-13
23163,Jeffrey Osborne,1984-08-18,Jeffrey Osborne - Stay With Me Tonight,45,40,44,3.0,44,Stay With Me Tonight,59.0,53,0,1,-5,0,stay,1983-08-13
23164,Jeffrey Osborne,1984-08-25,Jeffrey Osborne - Stay With Me Tonight,44,45,45,3.0,44,Stay With Me Tonight,59.0,54,-1,0,1,1,down,1983-08-13
23165,Jeffrey Osborne,1984-09-01,Jeffrey Osborne - Stay With Me Tonight,44,44,44,3.0,45,Stay With Me Tonight,59.0,55,1,-1,0,1,up,1983-08-13
23166,Jeffrey Osborne,1984-09-08,Jeffrey Osborne - Stay With Me Tonight,45,44,47,3.0,44,Stay With Me Tonight,59.0,56,-3,1,-1,1,down,1983-08-13
23167,Jeffrey Osborne,1984-09-15,Jeffrey Osborne - Stay With Me Tonight,44,45,45,3.0,47,Stay With Me Tonight,59.0,57,2,-3,1,1,up,1983-08-13
23168,Jeffrey Osborne,1984-09-22,Jeffrey Osborne - Stay With Me Tonight,47,44,48,3.0,45,Stay With Me Tonight,59.0,58,-3,2,-3,1,down,1983-08-13
23169,Jeffrey Osborne,1984-09-29,Jeffrey Osborne - Stay With Me Tonight,45,47,51,3.0,48,Stay With Me Tonight,59.0,59,-3,-3,2,1,down,1983-08-13
23170,Shalamar,1983-08-13,Shalamar - The Look,51,51,20,13.0,28,The Look,22.0,0,8,23,0,1,up,1983-08-13
23171,Shalamar,1983-08-20,Shalamar - The Look,28,51,18,13.0,20,The Look,22.0,1,2,8,23,1,up,1983-08-13
23172,Shalamar,1983-08-27,Shalamar - The Look,20,28,18,13.0,18,The Look,22.0,2,0,2,8,0,stay,1983-08-13
23173,Shalamar,1983-09-03,Shalamar - The Look,18,20,13,13.0,18,The Look,22.0,3,5,0,2,1,up,1983-08-13
23174,Shalamar,1983-09-10,Shalamar - The Look,18,18,13,13.0,13,The Look,22.0,4,0,5,0,0,stay,1983-08-13
23175,Shalamar,1983-09-17,Shalamar - The Look,13,18,22,13.0,13,The Look,22.0,5,-9,0,5,1,down,1983-08-13
23176,Shalamar,1983-09-24,Shalamar - The Look,13,13,21,13.0,22,The Look,22.0,6,1,-9,0,1,up,1983-08-13
23177,Shalamar,1983-10-01,Shalamar - The Look,22,13,21,13.0,21,The Look,22.0,7,0,1,-9,0,stay,1983-08-13
23178,Shalamar,1983-10-08,Shalamar - The Look,21,22,21,13.0,21,The Look,22.0,8,0,0,1,0,stay,1983-08-13
23179,Shalamar,1983-10-15,Shalamar - The Look,21,21,17,13.0,21,The Look,22.0,9,4,0,0,1,up,1983-08-13
23180,Shalamar,1983-10-22,Shalamar - The Look,21,21,16,13.0,17,The Look,22.0,10,1,4,0,1,up,1983-08-13
23181,Shalamar,1983-10-29,Shalamar - The Look,17,21,16,13.0,16,The Look,22.0,11,0,1,4,0,stay,1983-08-13
23182,Shalamar,1983-11-05,Shalamar - The Look,16,17,19,13.0,16,The Look,22.0,12,-3,0,1,1,down,1983-08-13
23183,Shalamar,1983-11-12,Shalamar - The Look,16,16,19,13.0,19,The Look,22.0,13,0,-3,0,0,stay,1983-08-13
23184,Shalamar,1983-11-19,Shalamar - The Look,19,16,23,13.0,19,The Look,22.0,14,-4,0,-3,1,down,1983-08-13
23185,Shalamar,1983-11-26,Shalamar - The Look,19,19,34,13.0,23,The Look,22.0,15,-11,-4,0,1,down,1983-08-13
23186,Shalamar,1983-12-03,Shalamar - The Look,23,19,44,13.0,34,The Look,22.0,16,-10,-11,-4,1,down,1983-08-13
23187,Shalamar,1983-12-10,Shalamar - The Look,34,23,47,13.0,44,The Look,22.0,17,-3,-10,-11,1,down,1983-08-13
23188,Shalamar,1983-12-17,Shalamar - The Look,44,34,47,13.0,47,The Look,22.0,18,0,-3,-10,0,stay,1983-08-13
23189,Shalamar,1983-12-24,Shalamar - The Look,47,44,47,13.0,47,The Look,22.0,19,0,0,-3,0,stay,1983-08-13
23190,Shalamar,1983-12-31,Shalamar - The Look,47,47,47,13.0,47,The Look,22.0,20,0,0,0,0,stay,1983-08-13
23191,Shalamar,1984-01-07,Shalamar - The Look,47,47,50,13.0,47,The Look,22.0,21,-3,0,0,1,down,1983-08-13
23192,Shalamar,1984-01-14,Shalamar - The Look,47,47,51,13.0,50,The Look,22.0,22,-1,-3,0,1,down,1983-08-13
23193,Stacy Lattisaw,1983-08-13,Stacy Lattisaw - Sixteen,51,51,37,26.0,40,Sixteen,9.0,0,3,11,0,1,up,1983-08-13
23194,Stacy Lattisaw,1983-08-20,Stacy Lattisaw - Sixteen,40,51,29,26.0,37,Sixteen,9.0,1,8,3,11,1,up,1983-08-13
23195,Stacy Lattisaw,1983-08-27,Stacy Lattisaw - Sixteen,37,40,29,26.0,29,Sixteen,9.0,2,0,8,3,0,stay,1983-08-13
23196,Stacy Lattisaw,1983-09-03,Stacy Lattisaw - Sixteen,29,37,27,26.0,29,Sixteen,9.0,3,2,0,8,1,up,1983-08-13
23197,Stacy Lattisaw,1983-09-10,Stacy Lattisaw - Sixteen,29,29,27,26.0,27,Sixteen,9.0,4,0,2,0,0,stay,1983-08-13
23198,Stacy Lattisaw,1983-09-17,Stacy Lattisaw - Sixteen,27,29,26,26.0,27,Sixteen,9.0,5,1,0,2,1,up,1983-08-13
23199,Stacy Lattisaw,1983-09-24,Stacy Lattisaw - Sixteen,27,27,29,26.0,26,Sixteen,9.0,6,-3,1,0,1,down,1983-08-13
23200,Stacy Lattisaw,1983-10-01,Stacy Lattisaw - Sixteen,26,27,39,26.0,29,Sixteen,9.0,7,-10,-3,1,1,down,1983-08-13
23201,Stacy Lattisaw,1983-10-08,Stacy Lattisaw - Sixteen,29,26,39,26.0,39,Sixteen,9.0,8,0,-10,-3,0,stay,1983-08-13
23202,Stacy Lattisaw,1983-10-15,Stacy Lattisaw - Sixteen,39,29,51,26.0,39,Sixteen,9.0,9,-12,0,-10,1,down,1983-08-13
23203,New Edition,1983-08-13,New Edition - Candy Girl,51,51,25,14.0,44,Candy Girl,34.0,0,19,7,0,1,up,1983-08-13
23204,New Edition,1983-08-20,New Edition - Candy Girl,44,51,22,14.0,25,Candy Girl,34.0,1,3,19,7,1,up,1983-08-13
23205,New Edition,1983-08-27,New Edition - Candy Girl,25,44,19,14.0,22,Candy Girl,34.0,2,3,3,19,1,up,1983-08-13
23206,New Edition,1983-09-03,New Edition - Candy Girl,22,25,14,14.0,19,Candy Girl,34.0,3,5,3,3,1,up,1983-08-13
23207,New Edition,1983-09-10,New Edition - Candy Girl,19,22,14,14.0,14,Candy Girl,34.0,4,0,5,3,0,stay,1983-08-13
23208,New Edition,1983-09-17,New Edition - Candy Girl,14,19,14,14.0,14,Candy Girl,34.0,5,0,0,5,0,stay,1983-08-13
23209,New Edition,1983-09-24,New Edition - Candy Girl,14,14,14,14.0,14,Candy Girl,34.0,6,0,0,0,0,stay,1983-08-13
23210,New Edition,1983-10-01,New Edition - Candy Girl,14,14,22,14.0,14,Candy Girl,34.0,7,-8,0,0,1,down,1983-08-13
23211,New Edition,1983-10-08,New Edition - Candy Girl,14,14,22,14.0,22,Candy Girl,34.0,8,0,-8,0,0,stay,1983-08-13
23212,New Edition,1983-10-15,New Edition - Candy Girl,22,14,20,14.0,22,Candy Girl,34.0,9,2,0,-8,1,up,1983-08-13
23213,New Edition,1983-10-22,New Edition - Candy Girl,22,22,20,14.0,20,Candy Girl,34.0,10,0,2,0,0,stay,1983-08-13
23214,New Edition,1983-10-29,New Edition - Candy Girl,20,22,22,14.0,20,Candy Girl,34.0,11,-2,0,2,1,down,1983-08-13
23215,New Edition,1983-11-05,New Edition - Candy Girl,20,20,22,14.0,22,Candy Girl,34.0,12,0,-2,0,0,stay,1983-08-13
23216,New Edition,1983-11-12,New Edition - Candy Girl,22,20,32,14.0,22,Candy Girl,34.0,13,-10,0,-2,1,down,1983-08-13
23217,New Edition,1983-11-19,New Edition - Candy Girl,22,22,31,14.0,32,Candy Girl,34.0,14,1,-10,0,1,up,1983-08-13
23218,New Edition,1983-11-26,New Edition - Candy Girl,32,22,30,14.0,31,Candy Girl,34.0,15,1,1,-10,1,up,1983-08-13
23219,New Edition,1983-12-03,New Edition - Candy Girl,31,32,38,14.0,30,Candy Girl,34.0,16,-8,1,1,1,down,1983-08-13
23220,New Edition,1983-12-10,New Edition - Candy Girl,30,31,38,14.0,38,Candy Girl,34.0,17,0,-8,1,0,stay,1983-08-13
23221,New Edition,1983-12-17,New Edition - Candy Girl,38,30,37,14.0,38,Candy Girl,34.0,18,1,0,-8,1,up,1983-08-13
23222,New Edition,1983-12-24,New Edition - Candy Girl,38,38,37,14.0,37,Candy Girl,34.0,19,0,1,0,0,stay,1983-08-13
23223,New Edition,1983-12-31,New Edition - Candy Girl,37,38,34,14.0,37,Candy Girl,34.0,20,3,0,1,1,up,1983-08-13
23224,New Edition,1984-01-07,New Edition - Candy Girl,37,37,31,14.0,34,Candy Girl,34.0,21,3,3,0,1,up,1983-08-13
23225,New Edition,1984-01-14,New Edition - Candy Girl,34,37,29,14.0,31,Candy Girl,34.0,22,2,3,3,1,up,1983-08-13
23226,New Edition,1984-01-21,New Edition - Candy Girl,31,34,25,14.0,29,Candy Girl,34.0,23,4,2,3,1,up,1983-08-13
23227,New Edition,1984-01-28,New Edition - Candy Girl,29,31,25,14.0,25,Candy Girl,34.0,24,0,4,2,0,stay,1983-08-13
23228,New Edition,1984-02-04,New Edition - Candy Girl,25,29,28,14.0,25,Candy Girl,34.0,25,-3,0,4,1,down,1983-08-13
23229,New Edition,1984-02-11,New Edition - Candy Girl,25,25,29,14.0,28,Candy Girl,34.0,26,-1,-3,0,1,down,1983-08-13
23230,New Edition,1984-02-18,New Edition - Candy Girl,28,25,39,14.0,29,Candy Girl,34.0,27,-10,-1,-3,1,down,1983-08-13
23231,New Edition,1984-02-25,New Edition - Candy Girl,29,28,38,14.0,39,Candy Girl,34.0,28,1,-10,-1,1,up,1983-08-13
23232,New Edition,1984-03-03,New Edition - Candy Girl,39,29,37,14.0,38,Candy Girl,34.0,29,1,1,-10,1,up,1983-08-13
23233,New Edition,1984-03-10,New Edition - Candy Girl,38,39,37,14.0,37,Candy Girl,34.0,30,0,1,1,0,stay,1983-08-13
23234,New Edition,1984-03-17,New Edition - Candy Girl,37,38,40,14.0,37,Candy Girl,34.0,31,-3,0,1,1,down,1983-08-13
23235,New Edition,1984-03-24,New Edition - Candy Girl,37,37,49,14.0,40,Candy Girl,34.0,32,-9,-3,0,1,down,1983-08-13
23236,New Edition,1984-03-31,New Edition - Candy Girl,40,37,48,14.0,49,Candy Girl,34.0,33,1,-9,-3,1,up,1983-08-13
23237,New Edition,1984-04-07,New Edition - Candy Girl,49,40,51,14.0,48,Candy Girl,34.0,34,-3,1,-9,1,down,1983-08-13
23238,Skyy,1983-08-13,Skyy - Skyylight,51,51,45,44.0,45,Skyylight,2.0,0,0,6,0,0,stay,1983-08-13
23239,Skyy,1983-08-20,Skyy - Skyylight,45,51,44,44.0,45,Skyylight,2.0,1,1,0,6,1,up,1983-08-13
23240,Skyy,1983-08-27,Skyy - Skyylight,45,45,51,44.0,44,Skyylight,2.0,2,-7,1,0,1,down,1983-08-13
23241,Ronnie Laws,1983-08-13,Ronnie Laws - Mr. Nice Guy,51,51,35,24.0,46,Mr. Nice Guy,12.0,0,11,5,0,1,up,1983-08-13
23242,Ronnie Laws,1983-08-20,Ronnie Laws - Mr. Nice Guy,46,51,30,24.0,35,Mr. Nice Guy,12.0,1,5,11,5,1,up,1983-08-13
23243,Ronnie Laws,1983-08-27,Ronnie Laws - Mr. Nice Guy,35,46,24,24.0,30,Mr. Nice Guy,12.0,2,6,5,11,1,up,1983-08-13
23244,Ronnie Laws,1983-09-03,Ronnie Laws - Mr. Nice Guy,30,35,24,24.0,24,Mr. Nice Guy,12.0,3,0,6,5,0,stay,1983-08-13
23245,Ronnie Laws,1983-09-10,Ronnie Laws - Mr. Nice Guy,24,30,32,24.0,24,Mr. Nice Guy,12.0,4,-8,0,6,1,down,1983-08-13
23246,Ronnie Laws,1983-09-17,Ronnie Laws - Mr. Nice Guy,24,24,35,24.0,32,Mr. Nice Guy,12.0,5,-3,-8,0,1,down,1983-08-13
23247,Ronnie Laws,1983-09-24,Ronnie Laws - Mr. Nice Guy,32,24,35,24.0,35,Mr. Nice Guy,12.0,6,0,-3,-8,0,stay,1983-08-13
23248,Ronnie Laws,1983-10-01,Ronnie Laws - Mr. Nice Guy,35,32,46,24.0,35,Mr. Nice Guy,12.0,7,-11,0,-3,1,down,1983-08-13
23249,Ronnie Laws,1983-10-08,Ronnie Laws - Mr. Nice Guy,35,35,44,24.0,46,Mr. Nice Guy,12.0,8,2,-11,0,1,up,1983-08-13
23250,Ronnie Laws,1983-10-15,Ronnie Laws - Mr. Nice Guy,46,35,44,24.0,44,Mr. Nice Guy,12.0,9,0,2,-11,0,stay,1983-08-13
23251,Ronnie Laws,1983-10-22,Ronnie Laws - Mr. Nice Guy,44,46,45,24.0,44,Mr. Nice Guy,12.0,10,-1,0,2,1,down,1983-08-13
23252,Ronnie Laws,1983-10-29,Ronnie Laws - Mr. Nice Guy,44,44,49,24.0,45,Mr. Nice Guy,12.0,11,-4,-1,0,1,down,1983-08-13
23253,Ronnie Laws,1983-11-05,Ronnie Laws - Mr. Nice Guy,45,44,51,24.0,49,Mr. Nice Guy,12.0,12,-2,-4,-1,1,down,1983-08-13
23254,Kurtis Blow,1983-08-20,Kurtis Blow - Party Time,51,51,38,36.0,44,Party Time,7.0,0,6,7,0,1,up,1983-08-20
23255,Kurtis Blow,1983-08-27,Kurtis Blow - Party Time,44,51,36,36.0,38,Party Time,7.0,1,2,6,7,1,up,1983-08-20
23256,Kurtis Blow,1983-09-03,Kurtis Blow - Party Time,38,44,36,36.0,36,Party Time,7.0,2,0,2,6,0,stay,1983-08-20
23257,Kurtis Blow,1983-09-10,Kurtis Blow - Party Time,36,38,37,36.0,36,Party Time,7.0,3,-1,0,2,1,down,1983-08-20
23258,Kurtis Blow,1983-09-17,Kurtis Blow - Party Time,36,36,38,36.0,37,Party Time,7.0,4,-1,-1,0,1,down,1983-08-20
23259,Kurtis Blow,1983-09-24,Kurtis Blow - Party Time,37,36,40,36.0,38,Party Time,7.0,5,-2,-1,-1,1,down,1983-08-20
23260,Kurtis Blow,1983-10-01,Kurtis Blow - Party Time,38,37,42,36.0,40,Party Time,7.0,6,-2,-2,-1,1,down,1983-08-20
23261,Kurtis Blow,1983-10-08,Kurtis Blow - Party Time,40,38,51,36.0,42,Party Time,7.0,7,-9,-2,-2,1,down,1983-08-20
23262,Peabo Bryson & Roberta Flack,1983-08-20,Peabo Bryson & Roberta Flack - Born To Love,51,51,24,8.0,48,Born To Love,34.0,0,24,3,0,1,up,1983-08-20
23263,Peabo Bryson & Roberta Flack,1983-08-27,Peabo Bryson & Roberta Flack - Born To Love,48,51,12,8.0,24,Born To Love,34.0,1,12,24,3,1,up,1983-08-20
23264,Peabo Bryson & Roberta Flack,1983-09-03,Peabo Bryson & Roberta Flack - Born To Love,24,48,9,8.0,12,Born To Love,34.0,2,3,12,24,1,up,1983-08-20
23265,Peabo Bryson & Roberta Flack,1983-09-10,Peabo Bryson & Roberta Flack - Born To Love,12,24,8,8.0,9,Born To Love,34.0,3,1,3,12,1,up,1983-08-20
23266,Peabo Bryson & Roberta Flack,1983-09-17,Peabo Bryson & Roberta Flack - Born To Love,9,12,8,8.0,8,Born To Love,34.0,4,0,1,3,0,stay,1983-08-20
23267,Peabo Bryson & Roberta Flack,1983-09-24,Peabo Bryson & Roberta Flack - Born To Love,8,9,8,8.0,8,Born To Love,34.0,5,0,0,1,0,stay,1983-08-20
23268,Peabo Bryson & Roberta Flack,1983-10-01,Peabo Bryson & Roberta Flack - Born To Love,8,8,8,8.0,8,Born To Love,34.0,6,0,0,0,0,stay,1983-08-20
23269,Peabo Bryson & Roberta Flack,1983-10-08,Peabo Bryson & Roberta Flack - Born To Love,8,8,8,8.0,8,Born To Love,34.0,7,0,0,0,0,stay,1983-08-20
23270,Peabo Bryson & Roberta Flack,1983-10-15,Peabo Bryson & Roberta Flack - Born To Love,8,8,8,8.0,8,Born To Love,34.0,8,0,0,0,0,stay,1983-08-20
23271,Peabo Bryson & Roberta Flack,1983-10-22,Peabo Bryson & Roberta Flack - Born To Love,8,8,8,8.0,8,Born To Love,34.0,9,0,0,0,0,stay,1983-08-20
23272,Peabo Bryson & Roberta Flack,1983-10-29,Peabo Bryson & Roberta Flack - Born To Love,8,8,9,8.0,8,Born To Love,34.0,10,-1,0,0,1,down,1983-08-20
23273,Peabo Bryson & Roberta Flack,1983-11-05,Peabo Bryson & Roberta Flack - Born To Love,8,8,14,8.0,9,Born To Love,34.0,11,-5,-1,0,1,down,1983-08-20
23274,Peabo Bryson & Roberta Flack,1983-11-12,Peabo Bryson & Roberta Flack - Born To Love,9,8,14,8.0,14,Born To Love,34.0,12,0,-5,-1,0,stay,1983-08-20
23275,Peabo Bryson & Roberta Flack,1983-11-19,Peabo Bryson & Roberta Flack - Born To Love,14,9,14,8.0,14,Born To Love,34.0,13,0,0,-5,0,stay,1983-08-20
23276,Peabo Bryson & Roberta Flack,1983-11-26,Peabo Bryson & Roberta Flack - Born To Love,14,14,14,8.0,14,Born To Love,34.0,14,0,0,0,0,stay,1983-08-20
23277,Peabo Bryson & Roberta Flack,1983-12-03,Peabo Bryson & Roberta Flack - Born To Love,14,14,14,8.0,14,Born To Love,34.0,15,0,0,0,0,stay,1983-08-20
23278,Peabo Bryson & Roberta Flack,1983-12-10,Peabo Bryson & Roberta Flack - Born To Love,14,14,17,8.0,14,Born To Love,34.0,16,-3,0,0,1,down,1983-08-20
23279,Peabo Bryson & Roberta Flack,1983-12-17,Peabo Bryson & Roberta Flack - Born To Love,14,14,17,8.0,17,Born To Love,34.0,17,0,-3,0,0,stay,1983-08-20
23280,Peabo Bryson & Roberta Flack,1983-12-24,Peabo Bryson & Roberta Flack - Born To Love,17,14,17,8.0,17,Born To Love,34.0,18,0,0,-3,0,stay,1983-08-20
23281,Peabo Bryson & Roberta Flack,1983-12-31,Peabo Bryson & Roberta Flack - Born To Love,17,17,17,8.0,17,Born To Love,34.0,19,0,0,0,0,stay,1983-08-20
23282,Peabo Bryson & Roberta Flack,1984-01-07,Peabo Bryson & Roberta Flack - Born To Love,17,17,22,8.0,17,Born To Love,34.0,20,-5,0,0,1,down,1983-08-20
23283,Peabo Bryson & Roberta Flack,1984-01-14,Peabo Bryson & Roberta Flack - Born To Love,17,17,35,8.0,22,Born To Love,34.0,21,-13,-5,0,1,down,1983-08-20
23284,Peabo Bryson & Roberta Flack,1984-01-21,Peabo Bryson & Roberta Flack - Born To Love,22,17,33,8.0,35,Born To Love,34.0,22,2,-13,-5,1,up,1983-08-20
23285,Peabo Bryson & Roberta Flack,1984-01-28,Peabo Bryson & Roberta Flack - Born To Love,35,22,32,8.0,33,Born To Love,34.0,23,1,2,-13,1,up,1983-08-20
23286,Peabo Bryson & Roberta Flack,1984-02-04,Peabo Bryson & Roberta Flack - Born To Love,33,35,34,8.0,32,Born To Love,34.0,24,-2,1,2,1,down,1983-08-20
23287,Peabo Bryson & Roberta Flack,1984-02-11,Peabo Bryson & Roberta Flack - Born To Love,32,33,31,8.0,34,Born To Love,34.0,25,3,-2,1,1,up,1983-08-20
23288,Peabo Bryson & Roberta Flack,1984-02-18,Peabo Bryson & Roberta Flack - Born To Love,34,32,31,8.0,31,Born To Love,34.0,26,0,3,-2,0,stay,1983-08-20
23289,Peabo Bryson & Roberta Flack,1984-02-25,Peabo Bryson & Roberta Flack - Born To Love,31,34,30,8.0,31,Born To Love,34.0,27,1,0,3,1,up,1983-08-20
23290,Peabo Bryson & Roberta Flack,1984-03-03,Peabo Bryson & Roberta Flack - Born To Love,31,31,30,8.0,30,Born To Love,34.0,28,0,1,0,0,stay,1983-08-20
23291,Peabo Bryson & Roberta Flack,1984-03-10,Peabo Bryson & Roberta Flack - Born To Love,30,31,33,8.0,30,Born To Love,34.0,29,-3,0,1,1,down,1983-08-20
23292,Peabo Bryson & Roberta Flack,1984-03-17,Peabo Bryson & Roberta Flack - Born To Love,30,30,39,8.0,33,Born To Love,34.0,30,-6,-3,0,1,down,1983-08-20
23293,Peabo Bryson & Roberta Flack,1984-03-24,Peabo Bryson & Roberta Flack - Born To Love,33,30,36,8.0,39,Born To Love,34.0,31,3,-6,-3,1,up,1983-08-20
23294,Peabo Bryson & Roberta Flack,1984-03-31,Peabo Bryson & Roberta Flack - Born To Love,39,33,36,8.0,36,Born To Love,34.0,32,0,3,-6,0,stay,1983-08-20
23295,Peabo Bryson & Roberta Flack,1984-04-07,Peabo Bryson & Roberta Flack - Born To Love,36,39,44,8.0,36,Born To Love,34.0,33,-8,0,3,1,down,1983-08-20
23296,Peabo Bryson & Roberta Flack,1984-04-14,Peabo Bryson & Roberta Flack - Born To Love,36,36,51,8.0,44,Born To Love,34.0,34,-7,-8,0,1,down,1983-08-20
23297,Bobby Bland,1983-08-20,Bobby Bland - Tell Mr. Bland,51,51,50,50.0,50,Tell Mr. Bland,1.0,0,0,1,0,0,stay,1983-08-20
23298,Bobby Bland,1983-08-27,Bobby Bland - Tell Mr. Bland,50,51,51,50.0,50,Tell Mr. Bland,1.0,1,-1,0,1,1,down,1983-08-20
23299,Rick James,1983-09-03,Rick James - Cold Blooded,51,51,5,1.0,21,Cold Blooded,28.0,0,16,30,0,1,up,1983-09-03
23300,Rick James,1983-09-10,Rick James - Cold Blooded,21,51,1,1.0,5,Cold Blooded,28.0,1,4,16,30,1,up,1983-09-03
23301,Rick James,1983-09-17,Rick James - Cold Blooded,5,21,1,1.0,1,Cold Blooded,28.0,2,0,4,16,0,stay,1983-09-03
23302,Rick James,1983-09-24,Rick James - Cold Blooded,1,5,1,1.0,1,Cold Blooded,28.0,3,0,0,4,0,stay,1983-09-03
23303,Rick James,1983-10-01,Rick James - Cold Blooded,1,1,1,1.0,1,Cold Blooded,28.0,4,0,0,0,0,stay,1983-09-03
23304,Rick James,1983-10-08,Rick James - Cold Blooded,1,1,1,1.0,1,Cold Blooded,28.0,5,0,0,0,0,stay,1983-09-03
23305,Rick James,1983-10-15,Rick James - Cold Blooded,1,1,1,1.0,1,Cold Blooded,28.0,6,0,0,0,0,stay,1983-09-03
23306,Rick James,1983-10-22,Rick James - Cold Blooded,1,1,1,1.0,1,Cold Blooded,28.0,7,0,0,0,0,stay,1983-09-03
23307,Rick James,1983-10-29,Rick James - Cold Blooded,1,1,1,1.0,1,Cold Blooded,28.0,8,0,0,0,0,stay,1983-09-03
23308,Rick James,1983-11-05,Rick James - Cold Blooded,1,1,1,1.0,1,Cold Blooded,28.0,9,0,0,0,0,stay,1983-09-03
23309,Rick James,1983-11-12,Rick James - Cold Blooded,1,1,1,1.0,1,Cold Blooded,28.0,10,0,0,0,0,stay,1983-09-03
23310,Rick James,1983-11-19,Rick James - Cold Blooded,1,1,2,1.0,1,Cold Blooded,28.0,11,-1,0,0,1,down,1983-09-03
23311,Rick James,1983-11-26,Rick James - Cold Blooded,1,1,2,1.0,2,Cold Blooded,28.0,12,0,-1,0,0,stay,1983-09-03
23312,Rick James,1983-12-03,Rick James - Cold Blooded,2,1,3,1.0,2,Cold Blooded,28.0,13,-1,0,-1,1,down,1983-09-03
23313,Rick James,1983-12-10,Rick James - Cold Blooded,2,2,3,1.0,3,Cold Blooded,28.0,14,0,-1,0,0,stay,1983-09-03
23314,Rick James,1983-12-17,Rick James - Cold Blooded,3,2,4,1.0,3,Cold Blooded,28.0,15,-1,0,-1,1,down,1983-09-03
23315,Rick James,1983-12-24,Rick James - Cold Blooded,3,3,4,1.0,4,Cold Blooded,28.0,16,0,-1,0,0,stay,1983-09-03
23316,Rick James,1983-12-31,Rick James - Cold Blooded,4,3,6,1.0,4,Cold Blooded,28.0,17,-2,0,-1,1,down,1983-09-03
23317,Rick James,1984-01-07,Rick James - Cold Blooded,4,4,8,1.0,6,Cold Blooded,28.0,18,-2,-2,0,1,down,1983-09-03
23318,Rick James,1984-01-14,Rick James - Cold Blooded,6,4,14,1.0,8,Cold Blooded,28.0,19,-6,-2,-2,1,down,1983-09-03
23319,Rick James,1984-01-21,Rick James - Cold Blooded,8,6,14,1.0,14,Cold Blooded,28.0,20,0,-6,-2,0,stay,1983-09-03
23320,Rick James,1984-01-28,Rick James - Cold Blooded,14,8,14,1.0,14,Cold Blooded,28.0,21,0,0,-6,0,stay,1983-09-03
23321,Rick James,1984-02-04,Rick James - Cold Blooded,14,14,27,1.0,14,Cold Blooded,28.0,22,-13,0,0,1,down,1983-09-03
23322,Rick James,1984-02-11,Rick James - Cold Blooded,14,14,30,1.0,27,Cold Blooded,28.0,23,-3,-13,0,1,down,1983-09-03
23323,Rick James,1984-02-18,Rick James - Cold Blooded,27,14,40,1.0,30,Cold Blooded,28.0,24,-10,-3,-13,1,down,1983-09-03
23324,Rick James,1984-02-25,Rick James - Cold Blooded,30,27,46,1.0,40,Cold Blooded,28.0,25,-6,-10,-3,1,down,1983-09-03
23325,Rick James,1984-03-03,Rick James - Cold Blooded,40,30,45,1.0,46,Cold Blooded,28.0,26,1,-6,-10,1,up,1983-09-03
23326,Rick James,1984-03-10,Rick James - Cold Blooded,46,40,45,1.0,45,Cold Blooded,28.0,27,0,1,-6,0,stay,1983-09-03
23327,Rick James,1984-03-17,Rick James - Cold Blooded,45,46,51,1.0,45,Cold Blooded,28.0,28,-6,0,1,1,down,1983-09-03
23328,Rene & Angela,1983-09-03,Rene & Angela - Rise,51,51,44,33.0,44,Rise,17.0,0,0,7,0,0,stay,1983-09-03
23329,Rene & Angela,1983-09-10,Rene & Angela - Rise,44,51,43,33.0,44,Rise,17.0,1,1,0,7,1,up,1983-09-03
23330,Rene & Angela,1983-09-17,Rene & Angela - Rise,44,44,43,33.0,43,Rise,17.0,2,0,1,0,0,stay,1983-09-03
23331,Rene & Angela,1983-09-24,Rene & Angela - Rise,43,44,45,33.0,43,Rise,17.0,3,-2,0,1,1,down,1983-09-03
23332,Rene & Angela,1983-10-15,Rene & Angela - Rise,43,43,37,33.0,45,Rise,17.0,4,8,-2,0,1,up,1983-09-03
23333,Rene & Angela,1983-10-22,Rene & Angela - Rise,45,43,34,33.0,37,Rise,17.0,5,3,8,-2,1,up,1983-09-03
23334,Rene & Angela,1983-10-29,Rene & Angela - Rise,37,45,33,33.0,34,Rise,17.0,6,1,3,8,1,up,1983-09-03
23335,Rene & Angela,1983-11-05,Rene & Angela - Rise,34,37,40,33.0,33,Rise,17.0,7,-7,1,3,1,down,1983-09-03
23336,Rene & Angela,1983-11-12,Rene & Angela - Rise,33,34,34,33.0,40,Rise,17.0,8,6,-7,1,1,up,1983-09-03
23337,Rene & Angela,1983-11-19,Rene & Angela - Rise,40,33,34,33.0,34,Rise,17.0,9,0,6,-7,0,stay,1983-09-03
23338,Rene & Angela,1983-11-26,Rene & Angela - Rise,34,40,50,33.0,34,Rise,17.0,10,-16,0,6,1,down,1983-09-03
23339,Rene & Angela,1983-12-03,Rene & Angela - Rise,34,34,47,33.0,50,Rise,17.0,11,3,-16,0,1,up,1983-09-03
23340,Rene & Angela,1983-12-10,Rene & Angela - Rise,50,34,45,33.0,47,Rise,17.0,12,2,3,-16,1,up,1983-09-03
23341,Rene & Angela,1983-12-17,Rene & Angela - Rise,47,50,43,33.0,45,Rise,17.0,13,2,2,3,1,up,1983-09-03
23342,Rene & Angela,1983-12-24,Rene & Angela - Rise,45,47,43,33.0,43,Rise,17.0,14,0,2,2,0,stay,1983-09-03
23343,Rene & Angela,1983-12-31,Rene & Angela - Rise,43,45,43,33.0,43,Rise,17.0,15,0,0,2,0,stay,1983-09-03
23344,Rene & Angela,1984-01-07,Rene & Angela - Rise,43,43,49,33.0,43,Rise,17.0,16,-6,0,0,1,down,1983-09-03
23345,Rene & Angela,1984-01-14,Rene & Angela - Rise,43,43,51,33.0,49,Rise,17.0,17,-2,-6,0,1,down,1983-09-03
23346,Eurythmics,1983-09-03,Eurythmics - Sweet Dreams (Are Made Of This),51,51,43,36.0,47,Sweet Dreams (Are Made Of This),7.0,0,4,4,0,1,up,1983-09-03
23347,Eurythmics,1983-09-10,Eurythmics - Sweet Dreams (Are Made Of This),47,51,36,36.0,43,Sweet Dreams (Are Made Of This),7.0,1,7,4,4,1,up,1983-09-03
23348,Eurythmics,1983-09-17,Eurythmics - Sweet Dreams (Are Made Of This),43,47,36,36.0,36,Sweet Dreams (Are Made Of This),7.0,2,0,7,4,0,stay,1983-09-03
23349,Eurythmics,1983-09-24,Eurythmics - Sweet Dreams (Are Made Of This),36,43,37,36.0,36,Sweet Dreams (Are Made Of This),7.0,3,-1,0,7,1,down,1983-09-03
23350,Eurythmics,1983-10-01,Eurythmics - Sweet Dreams (Are Made Of This),36,36,37,36.0,37,Sweet Dreams (Are Made Of This),7.0,4,0,-1,0,0,stay,1983-09-03
23351,Eurythmics,1983-10-08,Eurythmics - Sweet Dreams (Are Made Of This),37,36,41,36.0,37,Sweet Dreams (Are Made Of This),7.0,5,-4,0,-1,1,down,1983-09-03
23352,Eurythmics,1983-10-15,Eurythmics - Sweet Dreams (Are Made Of This),37,37,46,36.0,41,Sweet Dreams (Are Made Of This),7.0,6,-5,-4,0,1,down,1983-09-03
23353,Eurythmics,1983-10-22,Eurythmics - Sweet Dreams (Are Made Of This),41,37,51,36.0,46,Sweet Dreams (Are Made Of This),7.0,7,-5,-5,-4,1,down,1983-09-03
23354,Zapp,1983-09-10,Zapp - Zapp Iii,51,51,15,9.0,18,Zapp Iii,22.0,0,3,33,0,1,up,1983-09-10
23355,Zapp,1983-09-17,Zapp - Zapp Iii,18,51,12,9.0,15,Zapp Iii,22.0,1,3,3,33,1,up,1983-09-10
23356,Zapp,1983-09-24,Zapp - Zapp Iii,15,18,9,9.0,12,Zapp Iii,22.0,2,3,3,3,1,up,1983-09-10
23357,Zapp,1983-10-01,Zapp - Zapp Iii,12,15,9,9.0,9,Zapp Iii,22.0,3,0,3,3,0,stay,1983-09-10
23358,Zapp,1983-10-08,Zapp - Zapp Iii,9,12,9,9.0,9,Zapp Iii,22.0,4,0,0,3,0,stay,1983-09-10
23359,Zapp,1983-10-15,Zapp - Zapp Iii,9,9,11,9.0,9,Zapp Iii,22.0,5,-2,0,0,1,down,1983-09-10
23360,Zapp,1983-10-22,Zapp - Zapp Iii,9,9,11,9.0,11,Zapp Iii,22.0,6,0,-2,0,0,stay,1983-09-10
23361,Zapp,1983-10-29,Zapp - Zapp Iii,11,9,14,9.0,11,Zapp Iii,22.0,7,-3,0,-2,1,down,1983-09-10
23362,Zapp,1983-11-05,Zapp - Zapp Iii,11,11,13,9.0,14,Zapp Iii,22.0,8,1,-3,0,1,up,1983-09-10
23363,Zapp,1983-11-12,Zapp - Zapp Iii,14,11,13,9.0,13,Zapp Iii,22.0,9,0,1,-3,0,stay,1983-09-10
23364,Zapp,1983-11-19,Zapp - Zapp Iii,13,14,17,9.0,13,Zapp Iii,22.0,10,-4,0,1,1,down,1983-09-10
23365,Zapp,1983-11-26,Zapp - Zapp Iii,13,13,17,9.0,17,Zapp Iii,22.0,11,0,-4,0,0,stay,1983-09-10
23366,Zapp,1983-12-03,Zapp - Zapp Iii,17,13,21,9.0,17,Zapp Iii,22.0,12,-4,0,-4,1,down,1983-09-10
23367,Zapp,1983-12-10,Zapp - Zapp Iii,17,17,20,9.0,21,Zapp Iii,22.0,13,1,-4,0,1,up,1983-09-10
23368,Zapp,1983-12-17,Zapp - Zapp Iii,21,17,41,9.0,20,Zapp Iii,22.0,14,-21,1,-4,1,down,1983-09-10
23369,Zapp,1983-12-24,Zapp - Zapp Iii,20,21,41,9.0,41,Zapp Iii,22.0,15,0,-21,1,0,stay,1983-09-10
23370,Zapp,1983-12-31,Zapp - Zapp Iii,41,20,41,9.0,41,Zapp Iii,22.0,16,0,0,-21,0,stay,1983-09-10
23371,Zapp,1984-01-07,Zapp - Zapp Iii,41,41,41,9.0,41,Zapp Iii,22.0,17,0,0,0,0,stay,1983-09-10
23372,Zapp,1984-01-14,Zapp - Zapp Iii,41,41,40,9.0,41,Zapp Iii,22.0,18,1,0,0,1,up,1983-09-10
23373,Zapp,1984-01-21,Zapp - Zapp Iii,41,41,39,9.0,40,Zapp Iii,22.0,19,1,1,0,1,up,1983-09-10
23374,Zapp,1984-01-28,Zapp - Zapp Iii,40,41,47,9.0,39,Zapp Iii,22.0,20,-8,1,1,1,down,1983-09-10
23375,Zapp,1984-02-04,Zapp - Zapp Iii,39,40,48,9.0,47,Zapp Iii,22.0,21,-1,-8,1,1,down,1983-09-10
23376,Zapp,1984-02-11,Zapp - Zapp Iii,47,39,51,9.0,48,Zapp Iii,22.0,22,-3,-1,-8,1,down,1983-09-10
23377,Herbie Hancock,1983-09-10,Herbie Hancock - Future Shock,51,51,19,10.0,30,Future Shock,47.0,0,11,21,0,1,up,1983-09-10
23378,Herbie Hancock,1983-09-17,Herbie Hancock - Future Shock,30,51,16,10.0,19,Future Shock,47.0,1,3,11,21,1,up,1983-09-10
23379,Herbie Hancock,1983-09-24,Herbie Hancock - Future Shock,19,30,15,10.0,16,Future Shock,47.0,2,1,3,11,1,up,1983-09-10
23380,Herbie Hancock,1983-10-01,Herbie Hancock - Future Shock,16,19,13,10.0,15,Future Shock,47.0,3,2,1,3,1,up,1983-09-10
23381,Herbie Hancock,1983-10-08,Herbie Hancock - Future Shock,15,16,12,10.0,13,Future Shock,47.0,4,1,2,1,1,up,1983-09-10
23382,Herbie Hancock,1983-10-15,Herbie Hancock - Future Shock,13,15,10,10.0,12,Future Shock,47.0,5,2,1,2,1,up,1983-09-10
23383,Herbie Hancock,1983-10-22,Herbie Hancock - Future Shock,12,13,10,10.0,10,Future Shock,47.0,6,0,2,1,0,stay,1983-09-10
23384,Herbie Hancock,1983-10-29,Herbie Hancock - Future Shock,10,12,13,10.0,10,Future Shock,47.0,7,-3,0,2,1,down,1983-09-10
23385,Herbie Hancock,1983-11-05,Herbie Hancock - Future Shock,10,10,17,10.0,13,Future Shock,47.0,8,-4,-3,0,1,down,1983-09-10
23386,Herbie Hancock,1983-11-12,Herbie Hancock - Future Shock,13,10,17,10.0,17,Future Shock,47.0,9,0,-4,-3,0,stay,1983-09-10
23387,Herbie Hancock,1983-11-19,Herbie Hancock - Future Shock,17,13,19,10.0,17,Future Shock,47.0,10,-2,0,-4,1,down,1983-09-10
23388,Herbie Hancock,1983-11-26,Herbie Hancock - Future Shock,17,17,31,10.0,19,Future Shock,47.0,11,-12,-2,0,1,down,1983-09-10
23389,Herbie Hancock,1983-12-03,Herbie Hancock - Future Shock,19,17,28,10.0,31,Future Shock,47.0,12,3,-12,-2,1,up,1983-09-10
23390,Herbie Hancock,1983-12-10,Herbie Hancock - Future Shock,31,19,28,10.0,28,Future Shock,47.0,13,0,3,-12,0,stay,1983-09-10
23391,Herbie Hancock,1983-12-17,Herbie Hancock - Future Shock,28,31,27,10.0,28,Future Shock,47.0,14,1,0,3,1,up,1983-09-10
23392,Herbie Hancock,1983-12-24,Herbie Hancock - Future Shock,28,28,27,10.0,27,Future Shock,47.0,15,0,1,0,0,stay,1983-09-10
23393,Herbie Hancock,1983-12-31,Herbie Hancock - Future Shock,27,28,27,10.0,27,Future Shock,47.0,16,0,0,1,0,stay,1983-09-10
23394,Herbie Hancock,1984-01-07,Herbie Hancock - Future Shock,27,27,27,10.0,27,Future Shock,47.0,17,0,0,0,0,stay,1983-09-10
23395,Herbie Hancock,1984-01-14,Herbie Hancock - Future Shock,27,27,26,10.0,27,Future Shock,47.0,18,1,0,0,1,up,1983-09-10
23396,Herbie Hancock,1984-01-21,Herbie Hancock - Future Shock,27,27,24,10.0,26,Future Shock,47.0,19,2,1,0,1,up,1983-09-10
23397,Herbie Hancock,1984-01-28,Herbie Hancock - Future Shock,26,27,24,10.0,24,Future Shock,47.0,20,0,2,1,0,stay,1983-09-10
23398,Herbie Hancock,1984-02-04,Herbie Hancock - Future Shock,24,26,36,10.0,24,Future Shock,47.0,21,-12,0,2,1,down,1983-09-10
23399,Herbie Hancock,1984-02-11,Herbie Hancock - Future Shock,24,24,33,10.0,36,Future Shock,47.0,22,3,-12,0,1,up,1983-09-10
23400,Herbie Hancock,1984-02-18,Herbie Hancock - Future Shock,36,24,33,10.0,33,Future Shock,47.0,23,0,3,-12,0,stay,1983-09-10
23401,Herbie Hancock,1984-02-25,Herbie Hancock - Future Shock,33,36,32,10.0,33,Future Shock,47.0,24,1,0,3,1,up,1983-09-10
23402,Herbie Hancock,1984-03-03,Herbie Hancock - Future Shock,33,33,41,10.0,32,Future Shock,47.0,25,-9,1,0,1,down,1983-09-10
23403,Herbie Hancock,1984-03-10,Herbie Hancock - Future Shock,32,33,36,10.0,41,Future Shock,47.0,26,5,-9,1,1,up,1983-09-10
23404,Herbie Hancock,1984-03-17,Herbie Hancock - Future Shock,41,32,26,10.0,36,Future Shock,47.0,27,10,5,-9,1,up,1983-09-10
23405,Herbie Hancock,1984-03-24,Herbie Hancock - Future Shock,36,41,20,10.0,26,Future Shock,47.0,28,6,10,5,1,up,1983-09-10
23406,Herbie Hancock,1984-03-31,Herbie Hancock - Future Shock,26,36,20,10.0,20,Future Shock,47.0,29,0,6,10,0,stay,1983-09-10
23407,Herbie Hancock,1984-04-07,Herbie Hancock - Future Shock,20,26,21,10.0,20,Future Shock,47.0,30,-1,0,6,1,down,1983-09-10
23408,Herbie Hancock,1984-04-14,Herbie Hancock - Future Shock,20,20,20,10.0,21,Future Shock,47.0,31,1,-1,0,1,up,1983-09-10
23409,Herbie Hancock,1984-04-21,Herbie Hancock - Future Shock,21,20,35,10.0,20,Future Shock,47.0,32,-15,1,-1,1,down,1983-09-10
23410,Herbie Hancock,1984-04-28,Herbie Hancock - Future Shock,20,21,33,10.0,35,Future Shock,47.0,33,2,-15,1,1,up,1983-09-10
23411,Herbie Hancock,1984-05-05,Herbie Hancock - Future Shock,35,20,32,10.0,33,Future Shock,47.0,34,1,2,-15,1,up,1983-09-10
23412,Herbie Hancock,1984-05-12,Herbie Hancock - Future Shock,33,35,30,10.0,32,Future Shock,47.0,35,2,1,2,1,up,1983-09-10
23413,Herbie Hancock,1984-05-19,Herbie Hancock - Future Shock,32,33,34,10.0,30,Future Shock,47.0,36,-4,2,1,1,down,1983-09-10
23414,Herbie Hancock,1984-05-26,Herbie Hancock - Future Shock,30,32,35,10.0,34,Future Shock,47.0,37,-1,-4,2,1,down,1983-09-10
23415,Herbie Hancock,1984-06-02,Herbie Hancock - Future Shock,34,30,36,10.0,35,Future Shock,47.0,38,-1,-1,-4,1,down,1983-09-10
23416,Herbie Hancock,1984-06-09,Herbie Hancock - Future Shock,35,34,41,10.0,36,Future Shock,47.0,39,-5,-1,-1,1,down,1983-09-10
23417,Herbie Hancock,1984-06-16,Herbie Hancock - Future Shock,36,35,44,10.0,41,Future Shock,47.0,40,-3,-5,-1,1,down,1983-09-10
23418,Herbie Hancock,1984-06-23,Herbie Hancock - Future Shock,41,36,43,10.0,44,Future Shock,47.0,41,1,-3,-5,1,up,1983-09-10
23419,Herbie Hancock,1984-06-30,Herbie Hancock - Future Shock,44,41,43,10.0,43,Future Shock,47.0,42,0,1,-3,0,stay,1983-09-10
23420,Herbie Hancock,1984-07-07,Herbie Hancock - Future Shock,43,44,42,10.0,43,Future Shock,47.0,43,1,0,1,1,up,1983-09-10
23421,Herbie Hancock,1984-07-14,Herbie Hancock - Future Shock,43,43,44,10.0,42,Future Shock,47.0,44,-2,1,0,1,down,1983-09-10
23422,Herbie Hancock,1984-07-21,Herbie Hancock - Future Shock,42,43,47,10.0,44,Future Shock,47.0,45,-3,-2,1,1,down,1983-09-10
23423,Herbie Hancock,1984-07-28,Herbie Hancock - Future Shock,44,42,47,10.0,47,Future Shock,47.0,46,0,-3,-2,0,stay,1983-09-10
23424,Herbie Hancock,1984-08-04,Herbie Hancock - Future Shock,47,44,51,10.0,47,Future Shock,47.0,47,-4,0,-3,1,down,1983-09-10
23425,Stephanie Mills,1983-09-10,Stephanie Mills - Merciless,51,51,24,12.0,45,Merciless,24.0,0,21,6,0,1,up,1983-09-10
23426,Stephanie Mills,1983-09-17,Stephanie Mills - Merciless,45,51,18,12.0,24,Merciless,24.0,1,6,21,6,1,up,1983-09-10
23427,Stephanie Mills,1983-09-24,Stephanie Mills - Merciless,24,45,17,12.0,18,Merciless,24.0,2,1,6,21,1,up,1983-09-10
23428,Stephanie Mills,1983-10-01,Stephanie Mills - Merciless,18,24,15,12.0,17,Merciless,24.0,3,2,1,6,1,up,1983-09-10
23429,Stephanie Mills,1983-10-08,Stephanie Mills - Merciless,17,18,13,12.0,15,Merciless,24.0,4,2,2,1,1,up,1983-09-10
23430,Stephanie Mills,1983-10-15,Stephanie Mills - Merciless,15,17,12,12.0,13,Merciless,24.0,5,1,2,2,1,up,1983-09-10
23431,Stephanie Mills,1983-10-22,Stephanie Mills - Merciless,13,15,12,12.0,12,Merciless,24.0,6,0,1,2,0,stay,1983-09-10
23432,Stephanie Mills,1983-10-29,Stephanie Mills - Merciless,12,13,17,12.0,12,Merciless,24.0,7,-5,0,1,1,down,1983-09-10
23433,Stephanie Mills,1983-11-05,Stephanie Mills - Merciless,12,12,15,12.0,17,Merciless,24.0,8,2,-5,0,1,up,1983-09-10
23434,Stephanie Mills,1983-11-12,Stephanie Mills - Merciless,17,12,15,12.0,15,Merciless,24.0,9,0,2,-5,0,stay,1983-09-10
23435,Stephanie Mills,1983-11-19,Stephanie Mills - Merciless,15,17,15,12.0,15,Merciless,24.0,10,0,0,2,0,stay,1983-09-10
23436,Stephanie Mills,1983-11-26,Stephanie Mills - Merciless,15,15,20,12.0,15,Merciless,24.0,11,-5,0,0,1,down,1983-09-10
23437,Stephanie Mills,1983-12-03,Stephanie Mills - Merciless,15,15,24,12.0,20,Merciless,24.0,12,-4,-5,0,1,down,1983-09-10
23438,Stephanie Mills,1983-12-10,Stephanie Mills - Merciless,20,15,24,12.0,24,Merciless,24.0,13,0,-4,-5,0,stay,1983-09-10
23439,Stephanie Mills,1983-12-17,Stephanie Mills - Merciless,24,20,23,12.0,24,Merciless,24.0,14,1,0,-4,1,up,1983-09-10
23440,Stephanie Mills,1983-12-24,Stephanie Mills - Merciless,24,24,23,12.0,23,Merciless,24.0,15,0,1,0,0,stay,1983-09-10
23441,Stephanie Mills,1983-12-31,Stephanie Mills - Merciless,23,24,35,12.0,23,Merciless,24.0,16,-12,0,1,1,down,1983-09-10
23442,Stephanie Mills,1984-01-07,Stephanie Mills - Merciless,23,23,35,12.0,35,Merciless,24.0,17,0,-12,0,0,stay,1983-09-10
23443,Stephanie Mills,1984-01-14,Stephanie Mills - Merciless,35,23,34,12.0,35,Merciless,24.0,18,1,0,-12,1,up,1983-09-10
23444,Stephanie Mills,1984-01-21,Stephanie Mills - Merciless,35,35,42,12.0,34,Merciless,24.0,19,-8,1,0,1,down,1983-09-10
23445,Stephanie Mills,1984-01-28,Stephanie Mills - Merciless,34,35,42,12.0,42,Merciless,24.0,20,0,-8,1,0,stay,1983-09-10
23446,Stephanie Mills,1984-02-04,Stephanie Mills - Merciless,42,34,43,12.0,42,Merciless,24.0,21,-1,0,-8,1,down,1983-09-10
23447,Stephanie Mills,1984-02-11,Stephanie Mills - Merciless,42,42,41,12.0,43,Merciless,24.0,22,2,-1,0,1,up,1983-09-10
23448,Stephanie Mills,1984-02-18,Stephanie Mills - Merciless,43,42,49,12.0,41,Merciless,24.0,23,-8,2,-1,1,down,1983-09-10
23449,Stephanie Mills,1984-02-25,Stephanie Mills - Merciless,41,43,51,12.0,49,Merciless,24.0,24,-2,-8,2,1,down,1983-09-10
23450,Smokey Robinson,1983-09-10,Smokey Robinson - Blame It On Love And All The Great Hits,51,51,38,28.0,47,Blame It On Love And All The Great Hits,8.0,0,9,4,0,1,up,1983-09-10
23451,Smokey Robinson,1983-09-17,Smokey Robinson - Blame It On Love And All The Great Hits,47,51,33,28.0,38,Blame It On Love And All The Great Hits,8.0,1,5,9,4,1,up,1983-09-10
23452,Smokey Robinson,1983-09-24,Smokey Robinson - Blame It On Love And All The Great Hits,38,47,31,28.0,33,Blame It On Love And All The Great Hits,8.0,2,2,5,9,1,up,1983-09-10
23453,Smokey Robinson,1983-10-01,Smokey Robinson - Blame It On Love And All The Great Hits,33,38,29,28.0,31,Blame It On Love And All The Great Hits,8.0,3,2,2,5,1,up,1983-09-10
23454,Smokey Robinson,1983-10-08,Smokey Robinson - Blame It On Love And All The Great Hits,31,33,29,28.0,29,Blame It On Love And All The Great Hits,8.0,4,0,2,2,0,stay,1983-09-10
23455,Smokey Robinson,1983-10-15,Smokey Robinson - Blame It On Love And All The Great Hits,29,31,28,28.0,29,Blame It On Love And All The Great Hits,8.0,5,1,0,2,1,up,1983-09-10
23456,Smokey Robinson,1983-10-22,Smokey Robinson - Blame It On Love And All The Great Hits,29,29,41,28.0,28,Blame It On Love And All The Great Hits,8.0,6,-13,1,0,1,down,1983-09-10
23457,Smokey Robinson,1983-10-29,Smokey Robinson - Blame It On Love And All The Great Hits,28,29,47,28.0,41,Blame It On Love And All The Great Hits,8.0,7,-6,-13,1,1,down,1983-09-10
23458,Smokey Robinson,1983-11-05,Smokey Robinson - Blame It On Love And All The Great Hits,41,28,51,28.0,47,Blame It On Love And All The Great Hits,8.0,8,-4,-6,-13,1,down,1983-09-10
23459,Tom Tom Club,1983-09-10,Tom Tom Club - Close To The Bone,51,51,49,49.0,49,Close To The Bone,1.0,0,0,2,0,0,stay,1983-09-10
23460,Tom Tom Club,1983-09-17,Tom Tom Club - Close To The Bone,49,51,51,49.0,49,Close To The Bone,1.0,1,-2,0,2,1,down,1983-09-10
23461,The Reddings,1983-09-10,The Reddings - Back To Basics,51,51,51,50.0,50,Back To Basics,0.0,0,-1,1,0,1,down,1983-09-10
23462,Rufus And Chaka Khan,1983-09-17,Rufus And Chaka Khan - Live-stompin' At The Savoy,51,51,13,4.0,20,Live-stompin' At The Savoy,26.0,0,7,31,0,1,up,1983-09-17
23463,Rufus And Chaka Khan,1983-09-24,Rufus And Chaka Khan - Live-stompin' At The Savoy,20,51,10,4.0,13,Live-stompin' At The Savoy,26.0,1,3,7,31,1,up,1983-09-17
23464,Rufus And Chaka Khan,1983-10-01,Rufus And Chaka Khan - Live-stompin' At The Savoy,13,20,7,4.0,10,Live-stompin' At The Savoy,26.0,2,3,3,7,1,up,1983-09-17
23465,Rufus And Chaka Khan,1983-10-08,Rufus And Chaka Khan - Live-stompin' At The Savoy,10,13,6,4.0,7,Live-stompin' At The Savoy,26.0,3,1,3,3,1,up,1983-09-17
23466,Rufus And Chaka Khan,1983-10-15,Rufus And Chaka Khan - Live-stompin' At The Savoy,7,10,4,4.0,6,Live-stompin' At The Savoy,26.0,4,2,1,3,1,up,1983-09-17
23467,Rufus And Chaka Khan,1983-10-22,Rufus And Chaka Khan - Live-stompin' At The Savoy,6,7,4,4.0,4,Live-stompin' At The Savoy,26.0,5,0,2,1,0,stay,1983-09-17
23468,Rufus And Chaka Khan,1983-10-29,Rufus And Chaka Khan - Live-stompin' At The Savoy,4,6,4,4.0,4,Live-stompin' At The Savoy,26.0,6,0,0,2,0,stay,1983-09-17
23469,Rufus And Chaka Khan,1983-11-05,Rufus And Chaka Khan - Live-stompin' At The Savoy,4,4,4,4.0,4,Live-stompin' At The Savoy,26.0,7,0,0,0,0,stay,1983-09-17
23470,Rufus And Chaka Khan,1983-11-12,Rufus And Chaka Khan - Live-stompin' At The Savoy,4,4,7,4.0,4,Live-stompin' At The Savoy,26.0,8,-3,0,0,1,down,1983-09-17
23471,Rufus And Chaka Khan,1983-11-19,Rufus And Chaka Khan - Live-stompin' At The Savoy,4,4,10,4.0,7,Live-stompin' At The Savoy,26.0,9,-3,-3,0,1,down,1983-09-17
23472,Rufus And Chaka Khan,1983-11-26,Rufus And Chaka Khan - Live-stompin' At The Savoy,7,4,10,4.0,10,Live-stompin' At The Savoy,26.0,10,0,-3,-3,0,stay,1983-09-17
23473,Rufus And Chaka Khan,1983-12-03,Rufus And Chaka Khan - Live-stompin' At The Savoy,10,7,12,4.0,10,Live-stompin' At The Savoy,26.0,11,-2,0,-3,1,down,1983-09-17
23474,Rufus And Chaka Khan,1983-12-10,Rufus And Chaka Khan - Live-stompin' At The Savoy,10,10,12,4.0,12,Live-stompin' At The Savoy,26.0,12,0,-2,0,0,stay,1983-09-17
23475,Rufus And Chaka Khan,1983-12-17,Rufus And Chaka Khan - Live-stompin' At The Savoy,12,10,20,4.0,12,Live-stompin' At The Savoy,26.0,13,-8,0,-2,1,down,1983-09-17
23476,Rufus And Chaka Khan,1983-12-24,Rufus And Chaka Khan - Live-stompin' At The Savoy,12,12,20,4.0,20,Live-stompin' At The Savoy,26.0,14,0,-8,0,0,stay,1983-09-17
23477,Rufus And Chaka Khan,1983-12-31,Rufus And Chaka Khan - Live-stompin' At The Savoy,20,12,20,4.0,20,Live-stompin' At The Savoy,26.0,15,0,0,-8,0,stay,1983-09-17
23478,Rufus And Chaka Khan,1984-01-07,Rufus And Chaka Khan - Live-stompin' At The Savoy,20,20,20,4.0,20,Live-stompin' At The Savoy,26.0,16,0,0,0,0,stay,1983-09-17
23479,Rufus And Chaka Khan,1984-01-14,Rufus And Chaka Khan - Live-stompin' At The Savoy,20,20,20,4.0,20,Live-stompin' At The Savoy,26.0,17,0,0,0,0,stay,1983-09-17
23480,Rufus And Chaka Khan,1984-01-21,Rufus And Chaka Khan - Live-stompin' At The Savoy,20,20,35,4.0,20,Live-stompin' At The Savoy,26.0,18,-15,0,0,1,down,1983-09-17
23481,Rufus And Chaka Khan,1984-01-28,Rufus And Chaka Khan - Live-stompin' At The Savoy,20,20,46,4.0,35,Live-stompin' At The Savoy,26.0,19,-11,-15,0,1,down,1983-09-17
23482,Rufus And Chaka Khan,1984-02-04,Rufus And Chaka Khan - Live-stompin' At The Savoy,35,20,46,4.0,46,Live-stompin' At The Savoy,26.0,20,0,-11,-15,0,stay,1983-09-17
23483,Rufus And Chaka Khan,1984-02-11,Rufus And Chaka Khan - Live-stompin' At The Savoy,46,35,46,4.0,46,Live-stompin' At The Savoy,26.0,21,0,0,-11,0,stay,1983-09-17
23484,Rufus And Chaka Khan,1984-02-18,Rufus And Chaka Khan - Live-stompin' At The Savoy,46,46,48,4.0,46,Live-stompin' At The Savoy,26.0,22,-2,0,0,1,down,1983-09-17
23485,Rufus And Chaka Khan,1984-02-25,Rufus And Chaka Khan - Live-stompin' At The Savoy,46,46,48,4.0,48,Live-stompin' At The Savoy,26.0,23,0,-2,0,0,stay,1983-09-17
23486,Rufus And Chaka Khan,1984-03-03,Rufus And Chaka Khan - Live-stompin' At The Savoy,48,46,49,4.0,48,Live-stompin' At The Savoy,26.0,24,-1,0,-2,1,down,1983-09-17
23487,Rufus And Chaka Khan,1984-03-10,Rufus And Chaka Khan - Live-stompin' At The Savoy,48,48,47,4.0,49,Live-stompin' At The Savoy,26.0,25,2,-1,0,1,up,1983-09-17
23488,Rufus And Chaka Khan,1984-03-17,Rufus And Chaka Khan - Live-stompin' At The Savoy,49,48,51,4.0,47,Live-stompin' At The Savoy,26.0,26,-4,2,-1,1,down,1983-09-17
23489,The Gap Band,1983-09-17,The Gap Band - Gap Band V-jammin',51,51,15,2.0,29,Gap Band V-jammin',30.0,0,14,22,0,1,up,1983-09-17
23490,The Gap Band,1983-09-24,The Gap Band - Gap Band V-jammin',29,51,6,2.0,15,Gap Band V-jammin',30.0,1,9,14,22,1,up,1983-09-17
23491,The Gap Band,1983-10-01,The Gap Band - Gap Band V-jammin',15,29,4,2.0,6,Gap Band V-jammin',30.0,2,2,9,14,1,up,1983-09-17
23492,The Gap Band,1983-10-08,The Gap Band - Gap Band V-jammin',6,15,2,2.0,4,Gap Band V-jammin',30.0,3,2,2,9,1,up,1983-09-17
23493,The Gap Band,1983-10-15,The Gap Band - Gap Band V-jammin',4,6,2,2.0,2,Gap Band V-jammin',30.0,4,0,2,2,0,stay,1983-09-17
23494,The Gap Band,1983-10-22,The Gap Band - Gap Band V-jammin',2,4,2,2.0,2,Gap Band V-jammin',30.0,5,0,0,2,0,stay,1983-09-17
23495,The Gap Band,1983-10-29,The Gap Band - Gap Band V-jammin',2,2,2,2.0,2,Gap Band V-jammin',30.0,6,0,0,0,0,stay,1983-09-17
23496,The Gap Band,1983-11-05,The Gap Band - Gap Band V-jammin',2,2,3,2.0,2,Gap Band V-jammin',30.0,7,-1,0,0,1,down,1983-09-17
23497,The Gap Band,1983-11-12,The Gap Band - Gap Band V-jammin',2,2,4,2.0,3,Gap Band V-jammin',30.0,8,-1,-1,0,1,down,1983-09-17
23498,The Gap Band,1983-11-19,The Gap Band - Gap Band V-jammin',3,2,5,2.0,4,Gap Band V-jammin',30.0,9,-1,-1,-1,1,down,1983-09-17
23499,The Gap Band,1983-11-26,The Gap Band - Gap Band V-jammin',4,3,5,2.0,5,Gap Band V-jammin',30.0,10,0,-1,-1,0,stay,1983-09-17
23500,The Gap Band,1983-12-03,The Gap Band - Gap Band V-jammin',5,4,5,2.0,5,Gap Band V-jammin',30.0,11,0,0,-1,0,stay,1983-09-17
23501,The Gap Band,1983-12-10,The Gap Band - Gap Band V-jammin',5,5,5,2.0,5,Gap Band V-jammin',30.0,12,0,0,0,0,stay,1983-09-17
23502,The Gap Band,1983-12-17,The Gap Band - Gap Band V-jammin',5,5,7,2.0,5,Gap Band V-jammin',30.0,13,-2,0,0,1,down,1983-09-17
23503,The Gap Band,1983-12-24,The Gap Band - Gap Band V-jammin',5,5,7,2.0,7,Gap Band V-jammin',30.0,14,0,-2,0,0,stay,1983-09-17
23504,The Gap Band,1983-12-31,The Gap Band - Gap Band V-jammin',7,5,7,2.0,7,Gap Band V-jammin',30.0,15,0,0,-2,0,stay,1983-09-17
23505,The Gap Band,1984-01-07,The Gap Band - Gap Band V-jammin',7,7,6,2.0,7,Gap Band V-jammin',30.0,16,1,0,0,1,up,1983-09-17
23506,The Gap Band,1984-01-14,The Gap Band - Gap Band V-jammin',7,7,6,2.0,6,Gap Band V-jammin',30.0,17,0,1,0,0,stay,1983-09-17
23507,The Gap Band,1984-01-21,The Gap Band - Gap Band V-jammin',6,7,6,2.0,6,Gap Band V-jammin',30.0,18,0,0,1,0,stay,1983-09-17
23508,The Gap Band,1984-01-28,The Gap Band - Gap Band V-jammin',6,6,8,2.0,6,Gap Band V-jammin',30.0,19,-2,0,0,1,down,1983-09-17
23509,The Gap Band,1984-02-04,The Gap Band - Gap Band V-jammin',6,6,9,2.0,8,Gap Band V-jammin',30.0,20,-1,-2,0,1,down,1983-09-17
23510,The Gap Band,1984-02-11,The Gap Band - Gap Band V-jammin',8,6,11,2.0,9,Gap Band V-jammin',30.0,21,-2,-1,-2,1,down,1983-09-17
23511,The Gap Band,1984-02-18,The Gap Band - Gap Band V-jammin',9,8,14,2.0,11,Gap Band V-jammin',30.0,22,-3,-2,-1,1,down,1983-09-17
23512,The Gap Band,1984-02-25,The Gap Band - Gap Band V-jammin',11,9,25,2.0,14,Gap Band V-jammin',30.0,23,-11,-3,-2,1,down,1983-09-17
23513,The Gap Band,1984-03-03,The Gap Band - Gap Band V-jammin',14,11,26,2.0,25,Gap Band V-jammin',30.0,24,-1,-11,-3,1,down,1983-09-17
23514,The Gap Band,1984-03-10,The Gap Band - Gap Band V-jammin',25,14,29,2.0,26,Gap Band V-jammin',30.0,25,-3,-1,-11,1,down,1983-09-17
23515,The Gap Band,1984-03-17,The Gap Band - Gap Band V-jammin',26,25,41,2.0,29,Gap Band V-jammin',30.0,26,-12,-3,-1,1,down,1983-09-17
23516,The Gap Band,1984-03-24,The Gap Band - Gap Band V-jammin',29,26,47,2.0,41,Gap Band V-jammin',30.0,27,-6,-12,-3,1,down,1983-09-17
23517,The Gap Band,1984-03-31,The Gap Band - Gap Band V-jammin',41,29,43,2.0,47,Gap Band V-jammin',30.0,28,4,-6,-12,1,up,1983-09-17
23518,The Gap Band,1984-04-07,The Gap Band - Gap Band V-jammin',47,41,43,2.0,43,Gap Band V-jammin',30.0,29,0,4,-6,0,stay,1983-09-17
23519,The Gap Band,1984-04-14,The Gap Band - Gap Band V-jammin',43,47,51,2.0,43,Gap Band V-jammin',30.0,30,-8,0,4,1,down,1983-09-17
23520,Philip Bailey,1983-09-17,Philip Bailey - Continuation,51,51,24,19.0,35,Continuation,15.0,0,11,16,0,1,up,1983-09-17
23521,Philip Bailey,1983-09-24,Philip Bailey - Continuation,35,51,20,19.0,24,Continuation,15.0,1,4,11,16,1,up,1983-09-17
23522,Philip Bailey,1983-10-01,Philip Bailey - Continuation,24,35,20,19.0,20,Continuation,15.0,2,0,4,11,0,stay,1983-09-17
23523,Philip Bailey,1983-10-08,Philip Bailey - Continuation,20,24,20,19.0,20,Continuation,15.0,3,0,0,4,0,stay,1983-09-17
23524,Philip Bailey,1983-10-15,Philip Bailey - Continuation,20,20,19,19.0,20,Continuation,15.0,4,1,0,0,1,up,1983-09-17
23525,Philip Bailey,1983-10-22,Philip Bailey - Continuation,20,20,19,19.0,19,Continuation,15.0,5,0,1,0,0,stay,1983-09-17
23526,Philip Bailey,1983-10-29,Philip Bailey - Continuation,19,20,20,19.0,19,Continuation,15.0,6,-1,0,1,1,down,1983-09-17
23527,Philip Bailey,1983-11-05,Philip Bailey - Continuation,19,19,20,19.0,20,Continuation,15.0,7,0,-1,0,0,stay,1983-09-17
23528,Philip Bailey,1983-11-12,Philip Bailey - Continuation,20,19,21,19.0,20,Continuation,15.0,8,-1,0,-1,1,down,1983-09-17
23529,Philip Bailey,1983-11-19,Philip Bailey - Continuation,20,20,32,19.0,21,Continuation,15.0,9,-11,-1,0,1,down,1983-09-17
23530,Philip Bailey,1983-11-26,Philip Bailey - Continuation,21,20,29,19.0,32,Continuation,15.0,10,3,-11,-1,1,up,1983-09-17
23531,Philip Bailey,1983-12-03,Philip Bailey - Continuation,32,21,29,19.0,29,Continuation,15.0,11,0,3,-11,0,stay,1983-09-17
23532,Philip Bailey,1983-12-10,Philip Bailey - Continuation,29,32,35,19.0,29,Continuation,15.0,12,-6,0,3,1,down,1983-09-17
23533,Philip Bailey,1983-12-17,Philip Bailey - Continuation,29,29,50,19.0,35,Continuation,15.0,13,-15,-6,0,1,down,1983-09-17
23534,Philip Bailey,1983-12-24,Philip Bailey - Continuation,35,29,50,19.0,50,Continuation,15.0,14,0,-15,-6,0,stay,1983-09-17
23535,Philip Bailey,1983-12-31,Philip Bailey - Continuation,50,35,51,19.0,50,Continuation,15.0,15,-1,0,-15,1,down,1983-09-17
23536,Ashford & Simpson,1983-09-24,Ashford & Simpson - Highrise,51,51,22,14.0,30,Highrise,12.0,0,8,21,0,1,up,1983-09-24
23537,Ashford & Simpson,1983-10-01,Ashford & Simpson - Highrise,30,51,18,14.0,22,Highrise,12.0,1,4,8,21,1,up,1983-09-24
23538,Ashford & Simpson,1983-10-08,Ashford & Simpson - Highrise,22,30,15,14.0,18,Highrise,12.0,2,3,4,8,1,up,1983-09-24
23539,Ashford & Simpson,1983-10-15,Ashford & Simpson - Highrise,18,22,14,14.0,15,Highrise,12.0,3,1,3,4,1,up,1983-09-24
23540,Ashford & Simpson,1983-10-22,Ashford & Simpson - Highrise,15,18,14,14.0,14,Highrise,12.0,4,0,1,3,0,stay,1983-09-24
23541,Ashford & Simpson,1983-10-29,Ashford & Simpson - Highrise,14,15,19,14.0,14,Highrise,12.0,5,-5,0,1,1,down,1983-09-24
23542,Ashford & Simpson,1983-11-05,Ashford & Simpson - Highrise,14,14,21,14.0,19,Highrise,12.0,6,-2,-5,0,1,down,1983-09-24
23543,Ashford & Simpson,1983-11-12,Ashford & Simpson - Highrise,19,14,25,14.0,21,Highrise,12.0,7,-4,-2,-5,1,down,1983-09-24
23544,Ashford & Simpson,1983-11-19,Ashford & Simpson - Highrise,21,19,24,14.0,25,Highrise,12.0,8,1,-4,-2,1,up,1983-09-24
23545,Ashford & Simpson,1983-11-26,Ashford & Simpson - Highrise,25,21,33,14.0,24,Highrise,12.0,9,-9,1,-4,1,down,1983-09-24
23546,Ashford & Simpson,1983-12-03,Ashford & Simpson - Highrise,24,25,39,14.0,33,Highrise,12.0,10,-6,-9,1,1,down,1983-09-24
23547,Ashford & Simpson,1983-12-10,Ashford & Simpson - Highrise,33,24,39,14.0,39,Highrise,12.0,11,0,-6,-9,0,stay,1983-09-24
23548,Ashford & Simpson,1983-12-17,Ashford & Simpson - Highrise,39,33,51,14.0,39,Highrise,12.0,12,-12,0,-6,1,down,1983-09-24
23549,Lillo,1983-09-24,Lillo - Let Me Be Yours,51,51,41,23.0,48,Let Me Be Yours,12.0,0,7,3,0,1,up,1983-09-24
23550,Lillo,1983-10-01,Lillo - Let Me Be Yours,48,51,31,23.0,41,Let Me Be Yours,12.0,1,10,7,3,1,up,1983-09-24
23551,Lillo,1983-10-08,Lillo - Let Me Be Yours,41,48,28,23.0,31,Let Me Be Yours,12.0,2,3,10,7,1,up,1983-09-24
23552,Lillo,1983-10-15,Lillo - Let Me Be Yours,31,41,25,23.0,28,Let Me Be Yours,12.0,3,3,3,10,1,up,1983-09-24
23553,Lillo,1983-10-22,Lillo - Let Me Be Yours,28,31,23,23.0,25,Let Me Be Yours,12.0,4,2,3,3,1,up,1983-09-24
23554,Lillo,1983-10-29,Lillo - Let Me Be Yours,25,28,23,23.0,23,Let Me Be Yours,12.0,5,0,2,3,0,stay,1983-09-24
23555,Lillo,1983-11-05,Lillo - Let Me Be Yours,23,25,35,23.0,23,Let Me Be Yours,12.0,6,-12,0,2,1,down,1983-09-24
23556,Lillo,1983-11-12,Lillo - Let Me Be Yours,23,23,35,23.0,35,Let Me Be Yours,12.0,7,0,-12,0,0,stay,1983-09-24
23557,Lillo,1983-11-19,Lillo - Let Me Be Yours,35,23,36,23.0,35,Let Me Be Yours,12.0,8,-1,0,-12,1,down,1983-09-24
23558,Lillo,1983-11-26,Lillo - Let Me Be Yours,35,35,38,23.0,36,Let Me Be Yours,12.0,9,-2,-1,0,1,down,1983-09-24
23559,Lillo,1983-12-03,Lillo - Let Me Be Yours,36,35,49,23.0,38,Let Me Be Yours,12.0,10,-11,-2,-1,1,down,1983-09-24
23560,Lillo,1983-12-10,Lillo - Let Me Be Yours,38,36,49,23.0,49,Let Me Be Yours,12.0,11,0,-11,-2,0,stay,1983-09-24
23561,Lillo,1983-12-17,Lillo - Let Me Be Yours,49,38,51,23.0,49,Let Me Be Yours,12.0,12,-2,0,-11,1,down,1983-09-24
23562,Klique,1983-10-01,Klique - Try It Out,51,51,25,11.0,32,Try It Out,14.0,0,7,19,0,1,up,1983-10-01
23563,Klique,1983-10-08,Klique - Try It Out,32,51,23,11.0,25,Try It Out,14.0,1,2,7,19,1,up,1983-10-01
23564,Klique,1983-10-15,Klique - Try It Out,25,32,21,11.0,23,Try It Out,14.0,2,2,2,7,1,up,1983-10-01
23565,Klique,1983-10-22,Klique - Try It Out,23,25,17,11.0,21,Try It Out,14.0,3,4,2,2,1,up,1983-10-01
23566,Klique,1983-10-29,Klique - Try It Out,21,23,11,11.0,17,Try It Out,14.0,4,6,4,2,1,up,1983-10-01
23567,Klique,1983-11-05,Klique - Try It Out,17,21,11,11.0,11,Try It Out,14.0,5,0,6,4,0,stay,1983-10-01
23568,Klique,1983-11-12,Klique - Try It Out,11,17,18,11.0,11,Try It Out,14.0,6,-7,0,6,1,down,1983-10-01
23569,Klique,1983-11-19,Klique - Try It Out,11,11,18,11.0,18,Try It Out,14.0,7,0,-7,0,0,stay,1983-10-01
23570,Klique,1983-11-26,Klique - Try It Out,18,11,21,11.0,18,Try It Out,14.0,8,-3,0,-7,1,down,1983-10-01
23571,Klique,1983-12-03,Klique - Try It Out,18,18,26,11.0,21,Try It Out,14.0,9,-5,-3,0,1,down,1983-10-01
23572,Klique,1983-12-10,Klique - Try It Out,21,18,34,11.0,26,Try It Out,14.0,10,-8,-5,-3,1,down,1983-10-01
23573,Klique,1983-12-17,Klique - Try It Out,26,21,33,11.0,34,Try It Out,14.0,11,1,-8,-5,1,up,1983-10-01
23574,Klique,1983-12-24,Klique - Try It Out,34,26,33,11.0,33,Try It Out,14.0,12,0,1,-8,0,stay,1983-10-01
23575,Klique,1983-12-31,Klique - Try It Out,33,34,42,11.0,33,Try It Out,14.0,13,-9,0,1,1,down,1983-10-01
23576,Klique,1984-01-07,Klique - Try It Out,33,33,51,11.0,42,Try It Out,14.0,14,-9,-9,0,1,down,1983-10-01
23577,Hiroshima,1983-10-01,Hiroshima - Third Generation,51,51,51,50.0,50,Third Generation,0.0,0,-1,1,0,1,down,1983-10-01
23578,Commodores,1983-10-08,Commodores - Commodores 13,51,51,30,26.0,35,Commodores 13,6.0,0,5,16,0,1,up,1983-10-08
23579,Commodores,1983-10-15,Commodores - Commodores 13,35,51,29,26.0,30,Commodores 13,6.0,1,1,5,16,1,up,1983-10-08
23580,Commodores,1983-10-22,Commodores - Commodores 13,30,35,26,26.0,29,Commodores 13,6.0,2,3,1,5,1,up,1983-10-08
23581,Commodores,1983-10-29,Commodores - Commodores 13,29,30,26,26.0,26,Commodores 13,6.0,3,0,3,1,0,stay,1983-10-08
23582,Commodores,1983-11-05,Commodores - Commodores 13,26,29,41,26.0,26,Commodores 13,6.0,4,-15,0,3,1,down,1983-10-08
23583,Commodores,1983-11-12,Commodores - Commodores 13,26,26,40,26.0,41,Commodores 13,6.0,5,1,-15,0,1,up,1983-10-08
23584,Commodores,1983-11-19,Commodores - Commodores 13,41,26,51,26.0,40,Commodores 13,6.0,6,-11,1,-15,1,down,1983-10-08
23585,Slave,1983-10-08,Slave - Bad Enuff,51,51,36,30.0,43,Bad Enuff,6.0,0,7,8,0,1,up,1983-10-08
23586,Slave,1983-10-15,Slave - Bad Enuff,43,51,32,30.0,36,Bad Enuff,6.0,1,4,7,8,1,up,1983-10-08
23587,Slave,1983-10-22,Slave - Bad Enuff,36,43,30,30.0,32,Bad Enuff,6.0,2,2,4,7,1,up,1983-10-08
23588,Slave,1983-10-29,Slave - Bad Enuff,32,36,30,30.0,30,Bad Enuff,6.0,3,0,2,4,0,stay,1983-10-08
23589,Slave,1983-11-05,Slave - Bad Enuff,30,32,36,30.0,30,Bad Enuff,6.0,4,-6,0,2,1,down,1983-10-08
23590,Slave,1983-11-12,Slave - Bad Enuff,30,30,44,30.0,36,Bad Enuff,6.0,5,-8,-6,0,1,down,1983-10-08
23591,Slave,1983-11-19,Slave - Bad Enuff,36,30,51,30.0,44,Bad Enuff,6.0,6,-7,-8,-6,1,down,1983-10-08
23592,Bobby Nunn,1983-10-08,Bobby Nunn - Private Party,51,51,43,41.0,48,Private Party,5.0,0,5,3,0,1,up,1983-10-08
23593,Bobby Nunn,1983-10-15,Bobby Nunn - Private Party,48,51,43,41.0,43,Private Party,5.0,1,0,5,3,0,stay,1983-10-08
23594,Bobby Nunn,1983-10-22,Bobby Nunn - Private Party,43,48,42,41.0,43,Private Party,5.0,2,1,0,5,1,up,1983-10-08
23595,Bobby Nunn,1983-10-29,Bobby Nunn - Private Party,43,43,41,41.0,42,Private Party,5.0,3,1,1,0,1,up,1983-10-08
23596,Bobby Nunn,1983-11-05,Bobby Nunn - Private Party,42,43,46,41.0,41,Private Party,5.0,4,-5,1,1,1,down,1983-10-08
23597,Bobby Nunn,1983-11-12,Bobby Nunn - Private Party,41,42,51,41.0,46,Private Party,5.0,5,-5,-5,1,1,down,1983-10-08
23598,Andre Cymone,1983-10-15,Andre Cymone - Survivin' In The 80's,51,51,33,31.0,48,Survivin' In The 80's,3.0,0,15,3,0,1,up,1983-10-15
23599,Andre Cymone,1983-10-22,Andre Cymone - Survivin' In The 80's,48,51,31,31.0,33,Survivin' In The 80's,3.0,1,2,15,3,1,up,1983-10-15
23600,Andre Cymone,1983-10-29,Andre Cymone - Survivin' In The 80's,33,48,31,31.0,31,Survivin' In The 80's,3.0,2,0,2,15,0,stay,1983-10-15
23601,Andre Cymone,1983-11-05,Andre Cymone - Survivin' In The 80's,31,33,51,31.0,31,Survivin' In The 80's,3.0,3,-20,0,2,1,down,1983-10-15
23602,Tavares,1983-10-15,Tavares - Words And Music,51,51,50,48.0,50,Words And Music,3.0,0,0,1,0,0,stay,1983-10-15
23603,Tavares,1983-10-22,Tavares - Words And Music,50,51,50,48.0,50,Words And Music,3.0,1,0,0,1,0,stay,1983-10-15
23604,Tavares,1983-10-29,Tavares - Words And Music,50,50,48,48.0,50,Words And Music,3.0,2,2,0,0,1,up,1983-10-15
23605,Tavares,1983-11-05,Tavares - Words And Music,50,50,51,48.0,48,Words And Music,3.0,3,-3,2,0,1,down,1983-10-15
23606,Jennifer Holliday,1983-10-22,Jennifer Holliday - Feel My Soul,51,51,18,6.0,35,Feel My Soul,22.0,0,17,16,0,1,up,1983-10-22
23607,Jennifer Holliday,1983-10-29,Jennifer Holliday - Feel My Soul,35,51,10,6.0,18,Feel My Soul,22.0,1,8,17,16,1,up,1983-10-22
23608,Jennifer Holliday,1983-11-05,Jennifer Holliday - Feel My Soul,18,35,9,6.0,10,Feel My Soul,22.0,2,1,8,17,1,up,1983-10-22
23609,Jennifer Holliday,1983-11-12,Jennifer Holliday - Feel My Soul,10,18,9,6.0,9,Feel My Soul,22.0,3,0,1,8,0,stay,1983-10-22
23610,Jennifer Holliday,1983-11-19,Jennifer Holliday - Feel My Soul,9,10,6,6.0,9,Feel My Soul,22.0,4,3,0,1,1,up,1983-10-22
23611,Jennifer Holliday,1983-11-26,Jennifer Holliday - Feel My Soul,9,9,6,6.0,6,Feel My Soul,22.0,5,0,3,0,0,stay,1983-10-22
23612,Jennifer Holliday,1983-12-03,Jennifer Holliday - Feel My Soul,6,9,8,6.0,6,Feel My Soul,22.0,6,-2,0,3,1,down,1983-10-22
23613,Jennifer Holliday,1983-12-10,Jennifer Holliday - Feel My Soul,6,6,13,6.0,8,Feel My Soul,22.0,7,-5,-2,0,1,down,1983-10-22
23614,Jennifer Holliday,1983-12-17,Jennifer Holliday - Feel My Soul,8,6,12,6.0,13,Feel My Soul,22.0,8,1,-5,-2,1,up,1983-10-22
23615,Jennifer Holliday,1983-12-24,Jennifer Holliday - Feel My Soul,13,8,12,6.0,12,Feel My Soul,22.0,9,0,1,-5,0,stay,1983-10-22
23616,Jennifer Holliday,1983-12-31,Jennifer Holliday - Feel My Soul,12,13,12,6.0,12,Feel My Soul,22.0,10,0,0,1,0,stay,1983-10-22
23617,Jennifer Holliday,1984-01-07,Jennifer Holliday - Feel My Soul,12,12,11,6.0,12,Feel My Soul,22.0,11,1,0,0,1,up,1983-10-22
23618,Jennifer Holliday,1984-01-14,Jennifer Holliday - Feel My Soul,12,12,11,6.0,11,Feel My Soul,22.0,12,0,1,0,0,stay,1983-10-22
23619,Jennifer Holliday,1984-01-21,Jennifer Holliday - Feel My Soul,11,12,12,6.0,11,Feel My Soul,22.0,13,-1,0,1,1,down,1983-10-22
23620,Jennifer Holliday,1984-01-28,Jennifer Holliday - Feel My Soul,11,11,29,6.0,12,Feel My Soul,22.0,14,-17,-1,0,1,down,1983-10-22
23621,Jennifer Holliday,1984-02-04,Jennifer Holliday - Feel My Soul,12,11,29,6.0,29,Feel My Soul,22.0,15,0,-17,-1,0,stay,1983-10-22
23622,Jennifer Holliday,1984-02-11,Jennifer Holliday - Feel My Soul,29,12,35,6.0,29,Feel My Soul,22.0,16,-6,0,-17,1,down,1983-10-22
23623,Jennifer Holliday,1984-02-18,Jennifer Holliday - Feel My Soul,29,29,35,6.0,35,Feel My Soul,22.0,17,0,-6,0,0,stay,1983-10-22
23624,Jennifer Holliday,1984-02-25,Jennifer Holliday - Feel My Soul,35,29,44,6.0,35,Feel My Soul,22.0,18,-9,0,-6,1,down,1983-10-22
23625,Jennifer Holliday,1984-03-03,Jennifer Holliday - Feel My Soul,35,35,44,6.0,44,Feel My Soul,22.0,19,0,-9,0,0,stay,1983-10-22
23626,Jennifer Holliday,1984-03-10,Jennifer Holliday - Feel My Soul,44,35,49,6.0,44,Feel My Soul,22.0,20,-5,0,-9,1,down,1983-10-22
23627,Jennifer Holliday,1984-03-17,Jennifer Holliday - Feel My Soul,44,44,47,6.0,49,Feel My Soul,22.0,21,2,-5,0,1,up,1983-10-22
23628,Jennifer Holliday,1984-03-24,Jennifer Holliday - Feel My Soul,49,44,51,6.0,47,Feel My Soul,22.0,22,-4,2,-5,1,down,1983-10-22
23629,The Manhattan Transfer,1983-10-22,The Manhattan Transfer - Bodies And Souls,51,51,38,38.0,42,Bodies And Souls,4.0,0,4,9,0,1,up,1983-10-22
23630,The Manhattan Transfer,1983-10-29,The Manhattan Transfer - Bodies And Souls,42,51,38,38.0,38,Bodies And Souls,4.0,1,0,4,9,0,stay,1983-10-22
23631,The Manhattan Transfer,1983-11-05,The Manhattan Transfer - Bodies And Souls,38,42,42,38.0,38,Bodies And Souls,4.0,2,-4,0,4,1,down,1983-10-22
23632,The Manhattan Transfer,1983-11-12,The Manhattan Transfer - Bodies And Souls,38,38,42,38.0,42,Bodies And Souls,4.0,3,0,-4,0,0,stay,1983-10-22
23633,The Manhattan Transfer,1983-11-19,The Manhattan Transfer - Bodies And Souls,42,38,51,38.0,42,Bodies And Souls,4.0,4,-9,0,-4,1,down,1983-10-22
23634,Millie Jackson,1983-10-22,Millie Jackson - E.S.P. (Extra Sexual Persuasion),51,51,40,40.0,45,E.S.P. (Extra Sexual Persuasion),12.0,0,5,6,0,1,up,1983-10-22
23635,Millie Jackson,1983-10-29,Millie Jackson - E.S.P. (Extra Sexual Persuasion),45,51,40,40.0,40,E.S.P. (Extra Sexual Persuasion),12.0,1,0,5,6,0,stay,1983-10-22
23636,Millie Jackson,1983-11-05,Millie Jackson - E.S.P. (Extra Sexual Persuasion),40,45,48,40.0,40,E.S.P. (Extra Sexual Persuasion),12.0,2,-8,0,5,1,down,1983-10-22
23637,Millie Jackson,1983-11-12,Millie Jackson - E.S.P. (Extra Sexual Persuasion),40,40,47,40.0,48,E.S.P. (Extra Sexual Persuasion),12.0,3,1,-8,0,1,up,1983-10-22
23638,Millie Jackson,1983-11-19,Millie Jackson - E.S.P. (Extra Sexual Persuasion),48,40,44,40.0,47,E.S.P. (Extra Sexual Persuasion),12.0,4,3,1,-8,1,up,1983-10-22
23639,Millie Jackson,1983-11-26,Millie Jackson - E.S.P. (Extra Sexual Persuasion),47,48,44,40.0,44,E.S.P. (Extra Sexual Persuasion),12.0,5,0,3,1,0,stay,1983-10-22
23640,Millie Jackson,1983-12-03,Millie Jackson - E.S.P. (Extra Sexual Persuasion),44,47,48,40.0,44,E.S.P. (Extra Sexual Persuasion),12.0,6,-4,0,3,1,down,1983-10-22
23641,Millie Jackson,1983-12-10,Millie Jackson - E.S.P. (Extra Sexual Persuasion),44,44,48,40.0,48,E.S.P. (Extra Sexual Persuasion),12.0,7,0,-4,0,0,stay,1983-10-22
23642,Millie Jackson,1983-12-17,Millie Jackson - E.S.P. (Extra Sexual Persuasion),48,44,48,40.0,48,E.S.P. (Extra Sexual Persuasion),12.0,8,0,0,-4,0,stay,1983-10-22
23643,Millie Jackson,1983-12-24,Millie Jackson - E.S.P. (Extra Sexual Persuasion),48,48,48,40.0,48,E.S.P. (Extra Sexual Persuasion),12.0,9,0,0,0,0,stay,1983-10-22
23644,Millie Jackson,1983-12-31,Millie Jackson - E.S.P. (Extra Sexual Persuasion),48,48,46,40.0,48,E.S.P. (Extra Sexual Persuasion),12.0,10,2,0,0,1,up,1983-10-22
23645,Millie Jackson,1984-01-07,Millie Jackson - E.S.P. (Extra Sexual Persuasion),48,48,50,40.0,46,E.S.P. (Extra Sexual Persuasion),12.0,11,-4,2,0,1,down,1983-10-22
23646,Millie Jackson,1984-01-21,Millie Jackson - E.S.P. (Extra Sexual Persuasion),46,48,51,40.0,50,E.S.P. (Extra Sexual Persuasion),12.0,12,-1,-4,2,1,down,1983-10-22
23647,Herb Alpert,1983-10-22,Herb Alpert - Blow Your Own Horn,51,51,49,49.0,49,Blow Your Own Horn,1.0,0,0,2,0,0,stay,1983-10-22
23648,Herb Alpert,1983-10-29,Herb Alpert - Blow Your Own Horn,49,51,51,49.0,49,Blow Your Own Horn,1.0,1,-2,0,2,1,down,1983-10-22
23649,Debarge,1983-10-29,Debarge - In A Special Way,51,51,18,4.0,35,In A Special Way,36.0,0,17,16,0,1,up,1983-10-29
23650,Debarge,1983-11-05,Debarge - In A Special Way,35,51,8,4.0,18,In A Special Way,36.0,1,10,17,16,1,up,1983-10-29
23651,Debarge,1983-11-12,Debarge - In A Special Way,18,35,8,4.0,8,In A Special Way,36.0,2,0,10,17,0,stay,1983-10-29
23652,Debarge,1983-11-19,Debarge - In A Special Way,8,18,8,4.0,8,In A Special Way,36.0,3,0,0,10,0,stay,1983-10-29
23653,Debarge,1983-11-26,Debarge - In A Special Way,8,8,8,4.0,8,In A Special Way,36.0,4,0,0,0,0,stay,1983-10-29
23654,Debarge,1983-12-03,Debarge - In A Special Way,8,8,7,4.0,8,In A Special Way,36.0,5,1,0,0,1,up,1983-10-29
23655,Debarge,1983-12-10,Debarge - In A Special Way,8,8,7,4.0,7,In A Special Way,36.0,6,0,1,0,0,stay,1983-10-29
23656,Debarge,1983-12-17,Debarge - In A Special Way,7,8,5,4.0,7,In A Special Way,36.0,7,2,0,1,1,up,1983-10-29
23657,Debarge,1983-12-24,Debarge - In A Special Way,7,7,5,4.0,5,In A Special Way,36.0,8,0,2,0,0,stay,1983-10-29
23658,Debarge,1983-12-31,Debarge - In A Special Way,5,7,5,4.0,5,In A Special Way,36.0,9,0,0,2,0,stay,1983-10-29
23659,Debarge,1984-01-07,Debarge - In A Special Way,5,5,5,4.0,5,In A Special Way,36.0,10,0,0,0,0,stay,1983-10-29
23660,Debarge,1984-01-14,Debarge - In A Special Way,5,5,4,4.0,5,In A Special Way,36.0,11,1,0,0,1,up,1983-10-29
23661,Debarge,1984-01-21,Debarge - In A Special Way,5,5,4,4.0,4,In A Special Way,36.0,12,0,1,0,0,stay,1983-10-29
23662,Debarge,1984-01-28,Debarge - In A Special Way,4,5,7,4.0,4,In A Special Way,36.0,13,-3,0,1,1,down,1983-10-29
23663,Debarge,1984-02-04,Debarge - In A Special Way,4,4,7,4.0,7,In A Special Way,36.0,14,0,-3,0,0,stay,1983-10-29
23664,Debarge,1984-02-11,Debarge - In A Special Way,7,4,7,4.0,7,In A Special Way,36.0,15,0,0,-3,0,stay,1983-10-29
23665,Debarge,1984-02-18,Debarge - In A Special Way,7,7,6,4.0,7,In A Special Way,36.0,16,1,0,0,1,up,1983-10-29
23666,Debarge,1984-02-25,Debarge - In A Special Way,7,7,8,4.0,6,In A Special Way,36.0,17,-2,1,0,1,down,1983-10-29
23667,Debarge,1984-03-03,Debarge - In A Special Way,6,7,8,4.0,8,In A Special Way,36.0,18,0,-2,1,0,stay,1983-10-29
23668,Debarge,1984-03-10,Debarge - In A Special Way,8,6,10,4.0,8,In A Special Way,36.0,19,-2,0,-2,1,down,1983-10-29
23669,Debarge,1984-03-17,Debarge - In A Special Way,8,8,10,4.0,10,In A Special Way,36.0,20,0,-2,0,0,stay,1983-10-29
23670,Debarge,1984-03-24,Debarge - In A Special Way,10,8,17,4.0,10,In A Special Way,36.0,21,-7,0,-2,1,down,1983-10-29
23671,Debarge,1984-03-31,Debarge - In A Special Way,10,10,15,4.0,17,In A Special Way,36.0,22,2,-7,0,1,up,1983-10-29
23672,Debarge,1984-04-07,Debarge - In A Special Way,17,10,15,4.0,15,In A Special Way,36.0,23,0,2,-7,0,stay,1983-10-29
23673,Debarge,1984-04-14,Debarge - In A Special Way,15,17,15,4.0,15,In A Special Way,36.0,24,0,0,2,0,stay,1983-10-29
23674,Debarge,1984-04-21,Debarge - In A Special Way,15,15,16,4.0,15,In A Special Way,36.0,25,-1,0,0,1,down,1983-10-29
23675,Debarge,1984-04-28,Debarge - In A Special Way,15,15,15,4.0,16,In A Special Way,36.0,26,1,-1,0,1,up,1983-10-29
23676,Debarge,1984-05-05,Debarge - In A Special Way,16,15,15,4.0,15,In A Special Way,36.0,27,0,1,-1,0,stay,1983-10-29
23677,Debarge,1984-05-12,Debarge - In A Special Way,15,16,21,4.0,15,In A Special Way,36.0,28,-6,0,1,1,down,1983-10-29
23678,Debarge,1984-05-19,Debarge - In A Special Way,15,15,21,4.0,21,In A Special Way,36.0,29,0,-6,0,0,stay,1983-10-29
23679,Debarge,1984-05-26,Debarge - In A Special Way,21,15,27,4.0,21,In A Special Way,36.0,30,-6,0,-6,1,down,1983-10-29
23680,Debarge,1984-06-02,Debarge - In A Special Way,21,21,27,4.0,27,In A Special Way,36.0,31,0,-6,0,0,stay,1983-10-29
23681,Debarge,1984-06-09,Debarge - In A Special Way,27,21,44,4.0,27,In A Special Way,36.0,32,-17,0,-6,1,down,1983-10-29
23682,Debarge,1984-06-16,Debarge - In A Special Way,27,27,45,4.0,44,In A Special Way,36.0,33,-1,-17,0,1,down,1983-10-29
23683,Debarge,1984-06-23,Debarge - In A Special Way,44,27,44,4.0,45,In A Special Way,36.0,34,1,-1,-17,1,up,1983-10-29
23684,Debarge,1984-06-30,Debarge - In A Special Way,45,44,50,4.0,44,In A Special Way,36.0,35,-6,1,-1,1,down,1983-10-29
23685,Debarge,1984-07-07,Debarge - In A Special Way,44,45,51,4.0,50,In A Special Way,36.0,36,-1,-6,1,1,down,1983-10-29
23686,Bob James,1983-10-29,Bob James - Foxie,51,51,45,45.0,48,Foxie,3.0,0,3,3,0,1,up,1983-10-29
23687,Bob James,1983-11-05,Bob James - Foxie,48,51,45,45.0,45,Foxie,3.0,1,0,3,3,0,stay,1983-10-29
23688,Bob James,1983-11-12,Bob James - Foxie,45,48,45,45.0,45,Foxie,3.0,2,0,0,3,0,stay,1983-10-29
23689,Bob James,1983-11-19,Bob James - Foxie,45,45,51,45.0,45,Foxie,3.0,3,-6,0,0,1,down,1983-10-29
23690,Dionne Warwick,1983-11-05,Dionne Warwick - How Many Times Can We Say Goodbye,51,51,28,19.0,36,How Many Times Can We Say Goodbye,11.0,0,8,15,0,1,up,1983-11-05
23691,Dionne Warwick,1983-11-12,Dionne Warwick - How Many Times Can We Say Goodbye,36,51,22,19.0,28,How Many Times Can We Say Goodbye,11.0,1,6,8,15,1,up,1983-11-05
23692,Dionne Warwick,1983-11-19,Dionne Warwick - How Many Times Can We Say Goodbye,28,36,20,19.0,22,How Many Times Can We Say Goodbye,11.0,2,2,6,8,1,up,1983-11-05
23693,Dionne Warwick,1983-11-26,Dionne Warwick - How Many Times Can We Say Goodbye,22,28,19,19.0,20,How Many Times Can We Say Goodbye,11.0,3,1,2,6,1,up,1983-11-05
23694,Dionne Warwick,1983-12-03,Dionne Warwick - How Many Times Can We Say Goodbye,20,22,19,19.0,19,How Many Times Can We Say Goodbye,11.0,4,0,1,2,0,stay,1983-11-05
23695,Dionne Warwick,1983-12-10,Dionne Warwick - How Many Times Can We Say Goodbye,19,20,26,19.0,19,How Many Times Can We Say Goodbye,11.0,5,-7,0,1,1,down,1983-11-05
23696,Dionne Warwick,1983-12-17,Dionne Warwick - How Many Times Can We Say Goodbye,19,19,26,19.0,26,How Many Times Can We Say Goodbye,11.0,6,0,-7,0,0,stay,1983-11-05
23697,Dionne Warwick,1983-12-24,Dionne Warwick - How Many Times Can We Say Goodbye,26,19,26,19.0,26,How Many Times Can We Say Goodbye,11.0,7,0,0,-7,0,stay,1983-11-05
23698,Dionne Warwick,1983-12-31,Dionne Warwick - How Many Times Can We Say Goodbye,26,26,38,19.0,26,How Many Times Can We Say Goodbye,11.0,8,-12,0,0,1,down,1983-11-05
23699,Dionne Warwick,1984-01-07,Dionne Warwick - How Many Times Can We Say Goodbye,26,26,39,19.0,38,How Many Times Can We Say Goodbye,11.0,9,-1,-12,0,1,down,1983-11-05
23700,Dionne Warwick,1984-01-14,Dionne Warwick - How Many Times Can We Say Goodbye,38,26,43,19.0,39,How Many Times Can We Say Goodbye,11.0,10,-4,-1,-12,1,down,1983-11-05
23701,Dionne Warwick,1984-01-21,Dionne Warwick - How Many Times Can We Say Goodbye,39,38,51,19.0,43,How Many Times Can We Say Goodbye,11.0,11,-8,-4,-1,1,down,1983-11-05
23702,Third World,1983-11-05,Third World - All The Way Strong,51,51,51,50.0,50,All The Way Strong,0.0,0,-1,1,0,1,down,1983-11-05
23703,Lionel Richie,1983-11-12,Lionel Richie - Can't Slow Down,51,51,2,1.0,18,Can't Slow Down,81.0,0,16,33,0,1,up,1983-11-12
23704,Lionel Richie,1983-11-19,Lionel Richie - Can't Slow Down,18,51,1,1.0,2,Can't Slow Down,81.0,1,1,16,33,1,up,1983-11-12
23705,Lionel Richie,1983-11-26,Lionel Richie - Can't Slow Down,2,18,1,1.0,1,Can't Slow Down,81.0,2,0,1,16,0,stay,1983-11-12
23706,Lionel Richie,1983-12-03,Lionel Richie - Can't Slow Down,1,2,1,1.0,1,Can't Slow Down,81.0,3,0,0,1,0,stay,1983-11-12
23707,Lionel Richie,1983-12-10,Lionel Richie - Can't Slow Down,1,1,1,1.0,1,Can't Slow Down,81.0,4,0,0,0,0,stay,1983-11-12
23708,Lionel Richie,1983-12-17,Lionel Richie - Can't Slow Down,1,1,1,1.0,1,Can't Slow Down,81.0,5,0,0,0,0,stay,1983-11-12
23709,Lionel Richie,1983-12-24,Lionel Richie - Can't Slow Down,1,1,1,1.0,1,Can't Slow Down,81.0,6,0,0,0,0,stay,1983-11-12
23710,Lionel Richie,1983-12-31,Lionel Richie - Can't Slow Down,1,1,1,1.0,1,Can't Slow Down,81.0,7,0,0,0,0,stay,1983-11-12
23711,Lionel Richie,1984-01-07,Lionel Richie - Can't Slow Down,1,1,1,1.0,1,Can't Slow Down,81.0,8,0,0,0,0,stay,1983-11-12
23712,Lionel Richie,1984-01-14,Lionel Richie - Can't Slow Down,1,1,1,1.0,1,Can't Slow Down,81.0,9,0,0,0,0,stay,1983-11-12
23713,Lionel Richie,1984-01-21,Lionel Richie - Can't Slow Down,1,1,1,1.0,1,Can't Slow Down,81.0,10,0,0,0,0,stay,1983-11-12
23714,Lionel Richie,1984-01-28,Lionel Richie - Can't Slow Down,1,1,1,1.0,1,Can't Slow Down,81.0,11,0,0,0,0,stay,1983-11-12
23715,Lionel Richie,1984-02-04,Lionel Richie - Can't Slow Down,1,1,1,1.0,1,Can't Slow Down,81.0,12,0,0,0,0,stay,1983-11-12
23716,Lionel Richie,1984-02-11,Lionel Richie - Can't Slow Down,1,1,1,1.0,1,Can't Slow Down,81.0,13,0,0,0,0,stay,1983-11-12
23717,Lionel Richie,1984-02-18,Lionel Richie - Can't Slow Down,1,1,1,1.0,1,Can't Slow Down,81.0,14,0,0,0,0,stay,1983-11-12
23718,Lionel Richie,1984-02-25,Lionel Richie - Can't Slow Down,1,1,1,1.0,1,Can't Slow Down,81.0,15,0,0,0,0,stay,1983-11-12
23719,Lionel Richie,1984-03-03,Lionel Richie - Can't Slow Down,1,1,2,1.0,1,Can't Slow Down,81.0,16,-1,0,0,1,down,1983-11-12
23720,Lionel Richie,1984-03-10,Lionel Richie - Can't Slow Down,1,1,3,1.0,2,Can't Slow Down,81.0,17,-1,-1,0,1,down,1983-11-12
23721,Lionel Richie,1984-03-17,Lionel Richie - Can't Slow Down,2,1,3,1.0,3,Can't Slow Down,81.0,18,0,-1,-1,0,stay,1983-11-12
23722,Lionel Richie,1984-03-24,Lionel Richie - Can't Slow Down,3,2,3,1.0,3,Can't Slow Down,81.0,19,0,0,-1,0,stay,1983-11-12
23723,Lionel Richie,1984-03-31,Lionel Richie - Can't Slow Down,3,3,2,1.0,3,Can't Slow Down,81.0,20,1,0,0,1,up,1983-11-12
23724,Lionel Richie,1984-04-07,Lionel Richie - Can't Slow Down,3,3,3,1.0,2,Can't Slow Down,81.0,21,-1,1,0,1,down,1983-11-12
23725,Lionel Richie,1984-04-14,Lionel Richie - Can't Slow Down,2,3,2,1.0,3,Can't Slow Down,81.0,22,1,-1,1,1,up,1983-11-12
23726,Lionel Richie,1984-04-21,Lionel Richie - Can't Slow Down,3,2,3,1.0,2,Can't Slow Down,81.0,23,-1,1,-1,1,down,1983-11-12
23727,Lionel Richie,1984-04-28,Lionel Richie - Can't Slow Down,2,3,2,1.0,3,Can't Slow Down,81.0,24,1,-1,1,1,up,1983-11-12
23728,Lionel Richie,1984-05-05,Lionel Richie - Can't Slow Down,3,2,1,1.0,2,Can't Slow Down,81.0,25,1,1,-1,1,up,1983-11-12
23729,Lionel Richie,1984-05-12,Lionel Richie - Can't Slow Down,2,3,1,1.0,1,Can't Slow Down,81.0,26,0,1,1,0,stay,1983-11-12
23730,Lionel Richie,1984-05-19,Lionel Richie - Can't Slow Down,1,2,1,1.0,1,Can't Slow Down,81.0,27,0,0,1,0,stay,1983-11-12
23731,Lionel Richie,1984-05-26,Lionel Richie - Can't Slow Down,1,1,1,1.0,1,Can't Slow Down,81.0,28,0,0,0,0,stay,1983-11-12
23732,Lionel Richie,1984-06-02,Lionel Richie - Can't Slow Down,1,1,1,1.0,1,Can't Slow Down,81.0,29,0,0,0,0,stay,1983-11-12
23733,Lionel Richie,1984-06-09,Lionel Richie - Can't Slow Down,1,1,1,1.0,1,Can't Slow Down,81.0,30,0,0,0,0,stay,1983-11-12
23734,Lionel Richie,1984-06-16,Lionel Richie - Can't Slow Down,1,1,1,1.0,1,Can't Slow Down,81.0,31,0,0,0,0,stay,1983-11-12
23735,Lionel Richie,1984-06-23,Lionel Richie - Can't Slow Down,1,1,1,1.0,1,Can't Slow Down,81.0,32,0,0,0,0,stay,1983-11-12
23736,Lionel Richie,1984-06-30,Lionel Richie - Can't Slow Down,1,1,2,1.0,1,Can't Slow Down,81.0,33,-1,0,0,1,down,1983-11-12
23737,Lionel Richie,1984-07-07,Lionel Richie - Can't Slow Down,1,1,2,1.0,2,Can't Slow Down,81.0,34,0,-1,0,0,stay,1983-11-12
23738,Lionel Richie,1984-07-14,Lionel Richie - Can't Slow Down,2,1,4,1.0,2,Can't Slow Down,81.0,35,-2,0,-1,1,down,1983-11-12
23739,Lionel Richie,1984-07-21,Lionel Richie - Can't Slow Down,2,2,5,1.0,4,Can't Slow Down,81.0,36,-1,-2,0,1,down,1983-11-12
23740,Lionel Richie,1984-07-28,Lionel Richie - Can't Slow Down,4,2,7,1.0,5,Can't Slow Down,81.0,37,-2,-1,-2,1,down,1983-11-12
23741,Lionel Richie,1984-08-04,Lionel Richie - Can't Slow Down,5,4,6,1.0,7,Can't Slow Down,81.0,38,1,-2,-1,1,up,1983-11-12
23742,Lionel Richie,1984-08-11,Lionel Richie - Can't Slow Down,7,5,6,1.0,6,Can't Slow Down,81.0,39,0,1,-2,0,stay,1983-11-12
23743,Lionel Richie,1984-08-18,Lionel Richie - Can't Slow Down,6,7,6,1.0,6,Can't Slow Down,81.0,40,0,0,1,0,stay,1983-11-12
23744,Lionel Richie,1984-08-25,Lionel Richie - Can't Slow Down,6,6,7,1.0,6,Can't Slow Down,81.0,41,-1,0,0,1,down,1983-11-12
23745,Lionel Richie,1984-09-01,Lionel Richie - Can't Slow Down,6,6,7,1.0,7,Can't Slow Down,81.0,42,0,-1,0,0,stay,1983-11-12
23746,Lionel Richie,1984-09-08,Lionel Richie - Can't Slow Down,7,6,11,1.0,7,Can't Slow Down,81.0,43,-4,0,-1,1,down,1983-11-12
23747,Lionel Richie,1984-09-15,Lionel Richie - Can't Slow Down,7,7,9,1.0,11,Can't Slow Down,81.0,44,2,-4,0,1,up,1983-11-12
23748,Lionel Richie,1984-09-22,Lionel Richie - Can't Slow Down,11,7,9,1.0,9,Can't Slow Down,81.0,45,0,2,-4,0,stay,1983-11-12
23749,Lionel Richie,1984-09-29,Lionel Richie - Can't Slow Down,9,11,8,1.0,9,Can't Slow Down,81.0,46,1,0,2,1,up,1983-11-12
23750,Lionel Richie,1984-10-06,Lionel Richie - Can't Slow Down,9,9,8,1.0,8,Can't Slow Down,81.0,47,0,1,0,0,stay,1983-11-12
23751,Lionel Richie,1984-10-13,Lionel Richie - Can't Slow Down,8,9,7,1.0,8,Can't Slow Down,81.0,48,1,0,1,1,up,1983-11-12
23752,Lionel Richie,1984-10-20,Lionel Richie - Can't Slow Down,8,8,6,1.0,7,Can't Slow Down,81.0,49,1,1,0,1,up,1983-11-12
23753,Lionel Richie,1984-10-27,Lionel Richie - Can't Slow Down,7,8,6,1.0,6,Can't Slow Down,81.0,50,0,1,1,0,stay,1983-11-12
23754,Lionel Richie,1984-11-03,Lionel Richie - Can't Slow Down,6,7,9,1.0,6,Can't Slow Down,81.0,51,-3,0,1,1,down,1983-11-12
23755,Lionel Richie,1984-11-10,Lionel Richie - Can't Slow Down,6,6,9,1.0,9,Can't Slow Down,81.0,52,0,-3,0,0,stay,1983-11-12
23756,Lionel Richie,1984-11-17,Lionel Richie - Can't Slow Down,9,6,9,1.0,9,Can't Slow Down,81.0,53,0,0,-3,0,stay,1983-11-12
23757,Lionel Richie,1984-11-24,Lionel Richie - Can't Slow Down,9,9,8,1.0,9,Can't Slow Down,81.0,54,1,0,0,1,up,1983-11-12
23758,Lionel Richie,1984-12-01,Lionel Richie - Can't Slow Down,9,9,9,1.0,8,Can't Slow Down,81.0,55,-1,1,0,1,down,1983-11-12
23759,Lionel Richie,1984-12-08,Lionel Richie - Can't Slow Down,8,9,10,1.0,9,Can't Slow Down,81.0,56,-1,-1,1,1,down,1983-11-12
23760,Lionel Richie,1984-12-15,Lionel Richie - Can't Slow Down,9,8,10,1.0,10,Can't Slow Down,81.0,57,0,-1,-1,0,stay,1983-11-12
23761,Lionel Richie,1984-12-22,Lionel Richie - Can't Slow Down,10,9,10,1.0,10,Can't Slow Down,81.0,58,0,0,-1,0,stay,1983-11-12
23762,Lionel Richie,1984-12-29,Lionel Richie - Can't Slow Down,10,10,14,1.0,10,Can't Slow Down,81.0,59,-4,0,0,1,down,1983-11-12
23763,Lionel Richie,1985-01-05,Lionel Richie - Can't Slow Down,10,10,14,1.0,14,Can't Slow Down,81.0,60,0,-4,0,0,stay,1983-11-12
23764,Lionel Richie,1985-01-12,Lionel Richie - Can't Slow Down,14,10,19,1.0,14,Can't Slow Down,81.0,61,-5,0,-4,1,down,1983-11-12
23765,Lionel Richie,1985-01-19,Lionel Richie - Can't Slow Down,14,14,16,1.0,19,Can't Slow Down,81.0,62,3,-5,0,1,up,1983-11-12
23766,Lionel Richie,1985-01-26,Lionel Richie - Can't Slow Down,19,14,16,1.0,16,Can't Slow Down,81.0,63,0,3,-5,0,stay,1983-11-12
23767,Lionel Richie,1985-02-02,Lionel Richie - Can't Slow Down,16,19,21,1.0,16,Can't Slow Down,81.0,64,-5,0,3,1,down,1983-11-12
23768,Lionel Richie,1985-02-09,Lionel Richie - Can't Slow Down,16,16,20,1.0,21,Can't Slow Down,81.0,65,1,-5,0,1,up,1983-11-12
23769,Lionel Richie,1985-02-16,Lionel Richie - Can't Slow Down,21,16,19,1.0,20,Can't Slow Down,81.0,66,1,1,-5,1,up,1983-11-12
23770,Lionel Richie,1985-02-23,Lionel Richie - Can't Slow Down,20,21,18,1.0,19,Can't Slow Down,81.0,67,1,1,1,1,up,1983-11-12
23771,Lionel Richie,1985-03-02,Lionel Richie - Can't Slow Down,19,20,20,1.0,18,Can't Slow Down,81.0,68,-2,1,1,1,down,1983-11-12
23772,Lionel Richie,1985-03-09,Lionel Richie - Can't Slow Down,18,19,23,1.0,20,Can't Slow Down,81.0,69,-3,-2,1,1,down,1983-11-12
23773,Lionel Richie,1985-03-16,Lionel Richie - Can't Slow Down,20,18,17,1.0,23,Can't Slow Down,81.0,70,6,-3,-2,1,up,1983-11-12
23774,Lionel Richie,1985-03-23,Lionel Richie - Can't Slow Down,23,20,17,1.0,17,Can't Slow Down,81.0,71,0,6,-3,0,stay,1983-11-12
23775,Lionel Richie,1985-03-30,Lionel Richie - Can't Slow Down,17,23,24,1.0,17,Can't Slow Down,81.0,72,-7,0,6,1,down,1983-11-12
23776,Lionel Richie,1985-04-06,Lionel Richie - Can't Slow Down,17,17,24,1.0,24,Can't Slow Down,81.0,73,0,-7,0,0,stay,1983-11-12
23777,Lionel Richie,1985-04-13,Lionel Richie - Can't Slow Down,24,17,26,1.0,24,Can't Slow Down,81.0,74,-2,0,-7,1,down,1983-11-12
23778,Lionel Richie,1985-04-20,Lionel Richie - Can't Slow Down,24,24,28,1.0,26,Can't Slow Down,81.0,75,-2,-2,0,1,down,1983-11-12
23779,Lionel Richie,1985-04-27,Lionel Richie - Can't Slow Down,26,24,29,1.0,28,Can't Slow Down,81.0,76,-1,-2,-2,1,down,1983-11-12
23780,Lionel Richie,1985-05-04,Lionel Richie - Can't Slow Down,28,26,39,1.0,29,Can't Slow Down,81.0,77,-10,-1,-2,1,down,1983-11-12
23781,Lionel Richie,1985-05-11,Lionel Richie - Can't Slow Down,29,28,41,1.0,39,Can't Slow Down,81.0,78,-2,-10,-1,1,down,1983-11-12
23782,Lionel Richie,1985-05-18,Lionel Richie - Can't Slow Down,39,29,46,1.0,41,Can't Slow Down,81.0,79,-5,-2,-10,1,down,1983-11-12
23783,Lionel Richie,1985-05-25,Lionel Richie - Can't Slow Down,41,39,45,1.0,46,Can't Slow Down,81.0,80,1,-5,-2,1,up,1983-11-12
23784,Lionel Richie,1985-06-01,Lionel Richie - Can't Slow Down,46,41,51,1.0,45,Can't Slow Down,81.0,81,-6,1,-5,1,down,1983-11-12
23785,Atlantic Starr,1983-11-12,Atlantic Starr - Yours Forever,51,51,20,10.0,27,Yours Forever,30.0,0,7,24,0,1,up,1983-11-12
23786,Atlantic Starr,1983-11-19,Atlantic Starr - Yours Forever,27,51,12,10.0,20,Yours Forever,30.0,1,8,7,24,1,up,1983-11-12
23787,Atlantic Starr,1983-11-26,Atlantic Starr - Yours Forever,20,27,11,10.0,12,Yours Forever,30.0,2,1,8,7,1,up,1983-11-12
23788,Atlantic Starr,1983-12-03,Atlantic Starr - Yours Forever,12,20,11,10.0,11,Yours Forever,30.0,3,0,1,8,0,stay,1983-11-12
23789,Atlantic Starr,1983-12-10,Atlantic Starr - Yours Forever,11,12,10,10.0,11,Yours Forever,30.0,4,1,0,1,1,up,1983-11-12
23790,Atlantic Starr,1983-12-17,Atlantic Starr - Yours Forever,11,11,10,10.0,10,Yours Forever,30.0,5,0,1,0,0,stay,1983-11-12
23791,Atlantic Starr,1983-12-24,Atlantic Starr - Yours Forever,10,11,10,10.0,10,Yours Forever,30.0,6,0,0,1,0,stay,1983-11-12
23792,Atlantic Starr,1983-12-31,Atlantic Starr - Yours Forever,10,10,10,10.0,10,Yours Forever,30.0,7,0,0,0,0,stay,1983-11-12
23793,Atlantic Starr,1984-01-07,Atlantic Starr - Yours Forever,10,10,17,10.0,10,Yours Forever,30.0,8,-7,0,0,1,down,1983-11-12
23794,Atlantic Starr,1984-01-14,Atlantic Starr - Yours Forever,10,10,16,10.0,17,Yours Forever,30.0,9,1,-7,0,1,up,1983-11-12
23795,Atlantic Starr,1984-01-21,Atlantic Starr - Yours Forever,17,10,27,10.0,16,Yours Forever,30.0,10,-11,1,-7,1,down,1983-11-12
23796,Atlantic Starr,1984-01-28,Atlantic Starr - Yours Forever,16,17,21,10.0,27,Yours Forever,30.0,11,6,-11,1,1,up,1983-11-12
23797,Atlantic Starr,1984-02-04,Atlantic Starr - Yours Forever,27,16,19,10.0,21,Yours Forever,30.0,12,2,6,-11,1,up,1983-11-12
23798,Atlantic Starr,1984-02-11,Atlantic Starr - Yours Forever,21,27,25,10.0,19,Yours Forever,30.0,13,-6,2,6,1,down,1983-11-12
23799,Atlantic Starr,1984-02-18,Atlantic Starr - Yours Forever,19,21,24,10.0,25,Yours Forever,30.0,14,1,-6,2,1,up,1983-11-12
23800,Atlantic Starr,1984-02-25,Atlantic Starr - Yours Forever,25,19,27,10.0,24,Yours Forever,30.0,15,-3,1,-6,1,down,1983-11-12
23801,Atlantic Starr,1984-03-03,Atlantic Starr - Yours Forever,24,25,25,10.0,27,Yours Forever,30.0,16,2,-3,1,1,up,1983-11-12
23802,Atlantic Starr,1984-03-10,Atlantic Starr - Yours Forever,27,24,25,10.0,25,Yours Forever,30.0,17,0,2,-3,0,stay,1983-11-12
23803,Atlantic Starr,1984-03-17,Atlantic Starr - Yours Forever,25,27,23,10.0,25,Yours Forever,30.0,18,2,0,2,1,up,1983-11-12
23804,Atlantic Starr,1984-03-24,Atlantic Starr - Yours Forever,25,25,22,10.0,23,Yours Forever,30.0,19,1,2,0,1,up,1983-11-12
23805,Atlantic Starr,1984-03-31,Atlantic Starr - Yours Forever,23,25,23,10.0,22,Yours Forever,30.0,20,-1,1,2,1,down,1983-11-12
23806,Atlantic Starr,1984-04-07,Atlantic Starr - Yours Forever,22,23,24,10.0,23,Yours Forever,30.0,21,-1,-1,1,1,down,1983-11-12
23807,Atlantic Starr,1984-04-14,Atlantic Starr - Yours Forever,23,22,31,10.0,24,Yours Forever,30.0,22,-7,-1,-1,1,down,1983-11-12
23808,Atlantic Starr,1984-04-21,Atlantic Starr - Yours Forever,24,23,31,10.0,31,Yours Forever,30.0,23,0,-7,-1,0,stay,1983-11-12
23809,Atlantic Starr,1984-04-28,Atlantic Starr - Yours Forever,31,24,34,10.0,31,Yours Forever,30.0,24,-3,0,-7,1,down,1983-11-12
23810,Atlantic Starr,1984-05-05,Atlantic Starr - Yours Forever,31,31,34,10.0,34,Yours Forever,30.0,25,0,-3,0,0,stay,1983-11-12
23811,Atlantic Starr,1984-05-12,Atlantic Starr - Yours Forever,34,31,36,10.0,34,Yours Forever,30.0,26,-2,0,-3,1,down,1983-11-12
23812,Atlantic Starr,1984-05-19,Atlantic Starr - Yours Forever,34,34,46,10.0,36,Yours Forever,30.0,27,-10,-2,0,1,down,1983-11-12
23813,Atlantic Starr,1984-05-26,Atlantic Starr - Yours Forever,36,34,46,10.0,46,Yours Forever,30.0,28,0,-10,-2,0,stay,1983-11-12
23814,Atlantic Starr,1984-06-02,Atlantic Starr - Yours Forever,46,36,45,10.0,46,Yours Forever,30.0,29,1,0,-10,1,up,1983-11-12
23815,Atlantic Starr,1984-06-09,Atlantic Starr - Yours Forever,46,46,51,10.0,45,Yours Forever,30.0,30,-6,1,0,1,down,1983-11-12
23816,Teena Marie,1983-11-12,Teena Marie - Robbery,51,51,29,13.0,33,Robbery,26.0,0,4,18,0,1,up,1983-11-12
23817,Teena Marie,1983-11-19,Teena Marie - Robbery,33,51,27,13.0,29,Robbery,26.0,1,2,4,18,1,up,1983-11-12
23818,Teena Marie,1983-11-26,Teena Marie - Robbery,29,33,27,13.0,27,Robbery,26.0,2,0,2,4,0,stay,1983-11-12
23819,Teena Marie,1983-12-03,Teena Marie - Robbery,27,29,25,13.0,27,Robbery,26.0,3,2,0,2,1,up,1983-11-12
23820,Teena Marie,1983-12-10,Teena Marie - Robbery,27,27,23,13.0,25,Robbery,26.0,4,2,2,0,1,up,1983-11-12
23821,Teena Marie,1983-12-17,Teena Marie - Robbery,25,27,22,13.0,23,Robbery,26.0,5,1,2,2,1,up,1983-11-12
23822,Teena Marie,1983-12-24,Teena Marie - Robbery,23,25,22,13.0,22,Robbery,26.0,6,0,1,2,0,stay,1983-11-12
23823,Teena Marie,1983-12-31,Teena Marie - Robbery,22,23,36,13.0,22,Robbery,26.0,7,-14,0,1,1,down,1983-11-12
23824,Teena Marie,1984-01-07,Teena Marie - Robbery,22,22,30,13.0,36,Robbery,26.0,8,6,-14,0,1,up,1983-11-12
23825,Teena Marie,1984-01-14,Teena Marie - Robbery,36,22,25,13.0,30,Robbery,26.0,9,5,6,-14,1,up,1983-11-12
23826,Teena Marie,1984-01-21,Teena Marie - Robbery,30,36,17,13.0,25,Robbery,26.0,10,8,5,6,1,up,1983-11-12
23827,Teena Marie,1984-01-28,Teena Marie - Robbery,25,30,15,13.0,17,Robbery,26.0,11,2,8,5,1,up,1983-11-12
23828,Teena Marie,1984-02-04,Teena Marie - Robbery,17,25,14,13.0,15,Robbery,26.0,12,1,2,8,1,up,1983-11-12
23829,Teena Marie,1984-02-11,Teena Marie - Robbery,15,17,14,13.0,14,Robbery,26.0,13,0,1,2,0,stay,1983-11-12
23830,Teena Marie,1984-02-18,Teena Marie - Robbery,14,15,13,13.0,14,Robbery,26.0,14,1,0,1,1,up,1983-11-12
23831,Teena Marie,1984-02-25,Teena Marie - Robbery,14,14,19,13.0,13,Robbery,26.0,15,-6,1,0,1,down,1983-11-12
23832,Teena Marie,1984-03-03,Teena Marie - Robbery,13,14,19,13.0,19,Robbery,26.0,16,0,-6,1,0,stay,1983-11-12
23833,Teena Marie,1984-03-10,Teena Marie - Robbery,19,13,19,13.0,19,Robbery,26.0,17,0,0,-6,0,stay,1983-11-12
23834,Teena Marie,1984-03-17,Teena Marie - Robbery,19,19,22,13.0,19,Robbery,26.0,18,-3,0,0,1,down,1983-11-12
23835,Teena Marie,1984-03-24,Teena Marie - Robbery,19,19,21,13.0,22,Robbery,26.0,19,1,-3,0,1,up,1983-11-12
23836,Teena Marie,1984-03-31,Teena Marie - Robbery,22,19,28,13.0,21,Robbery,26.0,20,-7,1,-3,1,down,1983-11-12
23837,Teena Marie,1984-04-07,Teena Marie - Robbery,21,22,31,13.0,28,Robbery,26.0,21,-3,-7,1,1,down,1983-11-12
23838,Teena Marie,1984-04-14,Teena Marie - Robbery,28,21,34,13.0,31,Robbery,26.0,22,-3,-3,-7,1,down,1983-11-12
23839,Teena Marie,1984-04-21,Teena Marie - Robbery,31,28,36,13.0,34,Robbery,26.0,23,-2,-3,-3,1,down,1983-11-12
23840,Teena Marie,1984-04-28,Teena Marie - Robbery,34,31,48,13.0,36,Robbery,26.0,24,-12,-2,-3,1,down,1983-11-12
23841,Teena Marie,1984-05-26,Teena Marie - Robbery,36,34,47,13.0,48,Robbery,26.0,25,1,-12,-2,1,up,1983-11-12
23842,Teena Marie,1984-06-02,Teena Marie - Robbery,48,36,51,13.0,47,Robbery,26.0,26,-4,1,-12,1,down,1983-11-12
23843,Richard Pryor,1983-11-12,Richard Pryor - Richard Pryor: Here And Now,51,51,28,22.0,38,Richard Pryor: Here And Now,10.0,0,10,13,0,1,up,1983-11-12
23844,Richard Pryor,1983-11-19,Richard Pryor - Richard Pryor: Here And Now,38,51,26,22.0,28,Richard Pryor: Here And Now,10.0,1,2,10,13,1,up,1983-11-12
23845,Richard Pryor,1983-11-26,Richard Pryor - Richard Pryor: Here And Now,28,38,22,22.0,26,Richard Pryor: Here And Now,10.0,2,4,2,10,1,up,1983-11-12
23846,Richard Pryor,1983-12-03,Richard Pryor - Richard Pryor: Here And Now,26,28,22,22.0,22,Richard Pryor: Here And Now,10.0,3,0,4,2,0,stay,1983-11-12
23847,Richard Pryor,1983-12-10,Richard Pryor - Richard Pryor: Here And Now,22,26,32,22.0,22,Richard Pryor: Here And Now,10.0,4,-10,0,4,1,down,1983-11-12
23848,Richard Pryor,1983-12-17,Richard Pryor - Richard Pryor: Here And Now,22,22,31,22.0,32,Richard Pryor: Here And Now,10.0,5,1,-10,0,1,up,1983-11-12
23849,Richard Pryor,1983-12-24,Richard Pryor - Richard Pryor: Here And Now,32,22,31,22.0,31,Richard Pryor: Here And Now,10.0,6,0,1,-10,0,stay,1983-11-12
23850,Richard Pryor,1983-12-31,Richard Pryor - Richard Pryor: Here And Now,31,32,31,22.0,31,Richard Pryor: Here And Now,10.0,7,0,0,1,0,stay,1983-11-12
23851,Richard Pryor,1984-01-07,Richard Pryor - Richard Pryor: Here And Now,31,31,38,22.0,31,Richard Pryor: Here And Now,10.0,8,-7,0,0,1,down,1983-11-12
23852,Richard Pryor,1984-01-14,Richard Pryor - Richard Pryor: Here And Now,31,31,48,22.0,38,Richard Pryor: Here And Now,10.0,9,-10,-7,0,1,down,1983-11-12
23853,Richard Pryor,1984-01-21,Richard Pryor - Richard Pryor: Here And Now,38,31,51,22.0,48,Richard Pryor: Here And Now,10.0,10,-3,-10,-7,1,down,1983-11-12
23854,Randy Crawford,1983-11-12,Randy Crawford - Nightline,51,51,41,41.0,44,Nightline,2.0,0,3,7,0,1,up,1983-11-12
23855,Randy Crawford,1983-11-19,Randy Crawford - Nightline,44,51,41,41.0,41,Nightline,2.0,1,0,3,7,0,stay,1983-11-12
23856,Randy Crawford,1983-11-26,Randy Crawford - Nightline,41,44,51,41.0,41,Nightline,2.0,2,-10,0,3,1,down,1983-11-12
23857,Madonna,1983-11-12,Madonna - Madonna,51,51,46,20.0,49,Madonna,53.0,0,3,2,0,1,up,1983-11-12
23858,Madonna,1983-11-19,Madonna - Madonna,49,51,46,20.0,46,Madonna,53.0,1,0,3,2,0,stay,1983-11-12
23859,Madonna,1983-11-26,Madonna - Madonna,46,49,42,20.0,46,Madonna,53.0,2,4,0,3,1,up,1983-11-12
23860,Madonna,1983-12-03,Madonna - Madonna,46,46,42,20.0,42,Madonna,53.0,3,0,4,0,0,stay,1983-11-12
23861,Madonna,1983-12-10,Madonna - Madonna,42,46,46,20.0,42,Madonna,53.0,4,-4,0,4,1,down,1983-11-12
23862,Madonna,1983-12-17,Madonna - Madonna,42,42,46,20.0,46,Madonna,53.0,5,0,-4,0,0,stay,1983-11-12
23863,Madonna,1983-12-24,Madonna - Madonna,46,42,46,20.0,46,Madonna,53.0,6,0,0,-4,0,stay,1983-11-12
23864,Madonna,1983-12-31,Madonna - Madonna,46,46,48,20.0,46,Madonna,53.0,7,-2,0,0,1,down,1983-11-12
23865,Madonna,1984-01-07,Madonna - Madonna,46,46,42,20.0,48,Madonna,53.0,8,6,-2,0,1,up,1983-11-12
23866,Madonna,1984-01-14,Madonna - Madonna,48,46,38,20.0,42,Madonna,53.0,9,4,6,-2,1,up,1983-11-12
23867,Madonna,1984-01-21,Madonna - Madonna,42,48,36,20.0,38,Madonna,53.0,10,2,4,6,1,up,1983-11-12
23868,Madonna,1984-01-28,Madonna - Madonna,38,42,33,20.0,36,Madonna,53.0,11,3,2,4,1,up,1983-11-12
23869,Madonna,1984-02-04,Madonna - Madonna,36,38,33,20.0,33,Madonna,53.0,12,0,3,2,0,stay,1983-11-12
23870,Madonna,1984-02-11,Madonna - Madonna,33,36,39,20.0,33,Madonna,53.0,13,-6,0,3,1,down,1983-11-12
23871,Madonna,1984-02-18,Madonna - Madonna,33,33,37,20.0,39,Madonna,53.0,14,2,-6,0,1,up,1983-11-12
23872,Madonna,1984-02-25,Madonna - Madonna,39,33,35,20.0,37,Madonna,53.0,15,2,2,-6,1,up,1983-11-12
23873,Madonna,1984-03-03,Madonna - Madonna,37,39,40,20.0,35,Madonna,53.0,16,-5,2,2,1,down,1983-11-12
23874,Madonna,1984-03-10,Madonna - Madonna,35,37,40,20.0,40,Madonna,53.0,17,0,-5,2,0,stay,1983-11-12
23875,Madonna,1984-03-17,Madonna - Madonna,40,35,38,20.0,40,Madonna,53.0,18,2,0,-5,1,up,1983-11-12
23876,Madonna,1984-03-24,Madonna - Madonna,40,40,39,20.0,38,Madonna,53.0,19,-1,2,0,1,down,1983-11-12
23877,Madonna,1984-03-31,Madonna - Madonna,38,40,46,20.0,39,Madonna,53.0,20,-7,-1,2,1,down,1983-11-12
23878,Madonna,1984-04-07,Madonna - Madonna,39,38,45,20.0,46,Madonna,53.0,21,1,-7,-1,1,up,1983-11-12
23879,Madonna,1984-04-21,Madonna - Madonna,46,39,45,20.0,45,Madonna,53.0,22,0,1,-7,0,stay,1983-11-12
23880,Madonna,1984-04-28,Madonna - Madonna,45,46,44,20.0,45,Madonna,53.0,23,1,0,1,1,up,1983-11-12
23881,Madonna,1984-05-26,Madonna - Madonna,45,45,37,20.0,44,Madonna,53.0,24,7,1,0,1,up,1983-11-12
23882,Madonna,1984-06-02,Madonna - Madonna,44,45,35,20.0,37,Madonna,53.0,25,2,7,1,1,up,1983-11-12
23883,Madonna,1984-06-09,Madonna - Madonna,37,44,31,20.0,35,Madonna,53.0,26,4,2,7,1,up,1983-11-12
23884,Madonna,1984-06-16,Madonna - Madonna,35,37,30,20.0,31,Madonna,53.0,27,1,4,2,1,up,1983-11-12
23885,Madonna,1984-06-23,Madonna - Madonna,31,35,31,20.0,30,Madonna,53.0,28,-1,1,4,1,down,1983-11-12
23886,Madonna,1984-06-30,Madonna - Madonna,30,31,26,20.0,31,Madonna,53.0,29,5,-1,1,1,up,1983-11-12
23887,Madonna,1984-07-07,Madonna - Madonna,31,30,23,20.0,26,Madonna,53.0,30,3,5,-1,1,up,1983-11-12
23888,Madonna,1984-07-14,Madonna - Madonna,26,31,20,20.0,23,Madonna,53.0,31,3,3,5,1,up,1983-11-12
23889,Madonna,1984-07-21,Madonna - Madonna,23,26,20,20.0,20,Madonna,53.0,32,0,3,3,0,stay,1983-11-12
23890,Madonna,1984-07-28,Madonna - Madonna,20,23,27,20.0,20,Madonna,53.0,33,-7,0,3,1,down,1983-11-12
23891,Madonna,1984-08-04,Madonna - Madonna,20,20,27,20.0,27,Madonna,53.0,34,0,-7,0,0,stay,1983-11-12
23892,Madonna,1984-08-11,Madonna - Madonna,27,20,26,20.0,27,Madonna,53.0,35,1,0,-7,1,up,1983-11-12
23893,Madonna,1984-08-18,Madonna - Madonna,27,27,28,20.0,26,Madonna,53.0,36,-2,1,0,1,down,1983-11-12
23894,Madonna,1984-08-25,Madonna - Madonna,26,27,28,20.0,28,Madonna,53.0,37,0,-2,1,0,stay,1983-11-12
23895,Madonna,1984-09-01,Madonna - Madonna,28,26,26,20.0,28,Madonna,53.0,38,2,0,-2,1,up,1983-11-12
23896,Madonna,1984-09-08,Madonna - Madonna,28,28,23,20.0,26,Madonna,53.0,39,3,2,0,1,up,1983-11-12
23897,Madonna,1984-09-15,Madonna - Madonna,26,28,23,20.0,23,Madonna,53.0,40,0,3,2,0,stay,1983-11-12
23898,Madonna,1984-09-22,Madonna - Madonna,23,26,22,20.0,23,Madonna,53.0,41,1,0,3,1,up,1983-11-12
23899,Madonna,1984-09-29,Madonna - Madonna,23,23,20,20.0,22,Madonna,53.0,42,2,1,0,1,up,1983-11-12
23900,Madonna,1984-10-06,Madonna - Madonna,22,23,20,20.0,20,Madonna,53.0,43,0,2,1,0,stay,1983-11-12
23901,Madonna,1984-10-13,Madonna - Madonna,20,22,22,20.0,20,Madonna,53.0,44,-2,0,2,1,down,1983-11-12
23902,Madonna,1984-10-20,Madonna - Madonna,20,20,22,20.0,22,Madonna,53.0,45,0,-2,0,0,stay,1983-11-12
23903,Madonna,1984-10-27,Madonna - Madonna,22,20,21,20.0,22,Madonna,53.0,46,1,0,-2,1,up,1983-11-12
23904,Madonna,1984-11-03,Madonna - Madonna,22,22,23,20.0,21,Madonna,53.0,47,-2,1,0,1,down,1983-11-12
23905,Madonna,1984-11-10,Madonna - Madonna,21,22,25,20.0,23,Madonna,53.0,48,-2,-2,1,1,down,1983-11-12
23906,Madonna,1984-11-17,Madonna - Madonna,23,21,31,20.0,25,Madonna,53.0,49,-6,-2,-2,1,down,1983-11-12
23907,Madonna,1984-11-24,Madonna - Madonna,25,23,29,20.0,31,Madonna,53.0,50,2,-6,-2,1,up,1983-11-12
23908,Madonna,1984-12-01,Madonna - Madonna,31,25,29,20.0,29,Madonna,53.0,51,0,2,-6,0,stay,1983-11-12
23909,Madonna,1984-12-08,Madonna - Madonna,29,31,48,20.0,29,Madonna,53.0,52,-19,0,2,1,down,1983-11-12
23910,Madonna,1984-12-15,Madonna - Madonna,29,29,51,20.0,48,Madonna,53.0,53,-3,-19,0,1,down,1983-11-12
23911,James Ingram,1983-11-19,James Ingram - It's Your Night,51,51,21,10.0,27,It's Your Night,36.0,0,6,24,0,1,up,1983-11-19
23912,James Ingram,1983-11-26,James Ingram - It's Your Night,27,51,15,10.0,21,It's Your Night,36.0,1,6,6,24,1,up,1983-11-19
23913,James Ingram,1983-12-03,James Ingram - It's Your Night,21,27,15,10.0,15,It's Your Night,36.0,2,0,6,6,0,stay,1983-11-19
23914,James Ingram,1983-12-10,James Ingram - It's Your Night,15,21,14,10.0,15,It's Your Night,36.0,3,1,0,6,1,up,1983-11-19
23915,James Ingram,1983-12-17,James Ingram - It's Your Night,15,15,14,10.0,14,It's Your Night,36.0,4,0,1,0,0,stay,1983-11-19
23916,James Ingram,1983-12-24,James Ingram - It's Your Night,14,15,14,10.0,14,It's Your Night,36.0,5,0,0,1,0,stay,1983-11-19
23917,James Ingram,1983-12-31,James Ingram - It's Your Night,14,14,14,10.0,14,It's Your Night,36.0,6,0,0,0,0,stay,1983-11-19
23918,James Ingram,1984-01-07,James Ingram - It's Your Night,14,14,14,10.0,14,It's Your Night,36.0,7,0,0,0,0,stay,1983-11-19
23919,James Ingram,1984-01-14,James Ingram - It's Your Night,14,14,13,10.0,14,It's Your Night,36.0,8,1,0,0,1,up,1983-11-19
23920,James Ingram,1984-01-21,James Ingram - It's Your Night,14,14,13,10.0,13,It's Your Night,36.0,9,0,1,0,0,stay,1983-11-19
23921,James Ingram,1984-01-28,James Ingram - It's Your Night,13,14,13,10.0,13,It's Your Night,36.0,10,0,0,1,0,stay,1983-11-19
23922,James Ingram,1984-02-04,James Ingram - It's Your Night,13,13,10,10.0,13,It's Your Night,36.0,11,3,0,0,1,up,1983-11-19
23923,James Ingram,1984-02-11,James Ingram - It's Your Night,13,13,10,10.0,10,It's Your Night,36.0,12,0,3,0,0,stay,1983-11-19
23924,James Ingram,1984-02-18,James Ingram - It's Your Night,10,13,10,10.0,10,It's Your Night,36.0,13,0,0,3,0,stay,1983-11-19
23925,James Ingram,1984-02-25,James Ingram - It's Your Night,10,10,10,10.0,10,It's Your Night,36.0,14,0,0,0,0,stay,1983-11-19
23926,James Ingram,1984-03-03,James Ingram - It's Your Night,10,10,11,10.0,10,It's Your Night,36.0,15,-1,0,0,1,down,1983-11-19
23927,James Ingram,1984-03-10,James Ingram - It's Your Night,10,10,14,10.0,11,It's Your Night,36.0,16,-3,-1,0,1,down,1983-11-19
23928,James Ingram,1984-03-17,James Ingram - It's Your Night,11,10,16,10.0,14,It's Your Night,36.0,17,-2,-3,-1,1,down,1983-11-19
23929,James Ingram,1984-03-24,James Ingram - It's Your Night,14,11,16,10.0,16,It's Your Night,36.0,18,0,-2,-3,0,stay,1983-11-19
23930,James Ingram,1984-03-31,James Ingram - It's Your Night,16,14,18,10.0,16,It's Your Night,36.0,19,-2,0,-2,1,down,1983-11-19
23931,James Ingram,1984-04-07,James Ingram - It's Your Night,16,16,20,10.0,18,It's Your Night,36.0,20,-2,-2,0,1,down,1983-11-19
23932,James Ingram,1984-04-14,James Ingram - It's Your Night,18,16,22,10.0,20,It's Your Night,36.0,21,-2,-2,-2,1,down,1983-11-19
23933,James Ingram,1984-04-21,James Ingram - It's Your Night,20,18,32,10.0,22,It's Your Night,36.0,22,-10,-2,-2,1,down,1983-11-19
23934,James Ingram,1984-04-28,James Ingram - It's Your Night,22,20,30,10.0,32,It's Your Night,36.0,23,2,-10,-2,1,up,1983-11-19
23935,James Ingram,1984-05-05,James Ingram - It's Your Night,32,22,30,10.0,30,It's Your Night,36.0,24,0,2,-10,0,stay,1983-11-19
23936,James Ingram,1984-05-12,James Ingram - It's Your Night,30,32,31,10.0,30,It's Your Night,36.0,25,-1,0,2,1,down,1983-11-19
23937,James Ingram,1984-05-19,James Ingram - It's Your Night,30,30,31,10.0,31,It's Your Night,36.0,26,0,-1,0,0,stay,1983-11-19
23938,James Ingram,1984-05-26,James Ingram - It's Your Night,31,30,28,10.0,31,It's Your Night,36.0,27,3,0,-1,1,up,1983-11-19
23939,James Ingram,1984-06-02,James Ingram - It's Your Night,31,31,28,10.0,28,It's Your Night,36.0,28,0,3,0,0,stay,1983-11-19
23940,James Ingram,1984-06-09,James Ingram - It's Your Night,28,31,27,10.0,28,It's Your Night,36.0,29,1,0,3,1,up,1983-11-19
23941,James Ingram,1984-06-16,James Ingram - It's Your Night,28,28,37,10.0,27,It's Your Night,36.0,30,-10,1,0,1,down,1983-11-19
23942,James Ingram,1984-06-23,James Ingram - It's Your Night,27,28,37,10.0,37,It's Your Night,36.0,31,0,-10,1,0,stay,1983-11-19
23943,James Ingram,1984-06-30,James Ingram - It's Your Night,37,27,47,10.0,37,It's Your Night,36.0,32,-10,0,-10,1,down,1983-11-19
23944,James Ingram,1984-07-07,James Ingram - It's Your Night,37,37,50,10.0,47,It's Your Night,36.0,33,-3,-10,0,1,down,1983-11-19
23945,James Ingram,1984-07-14,James Ingram - It's Your Night,47,37,50,10.0,50,It's Your Night,36.0,34,0,-3,-10,0,stay,1983-11-19
23946,James Ingram,1984-07-21,James Ingram - It's Your Night,50,47,50,10.0,50,It's Your Night,36.0,35,0,0,-3,0,stay,1983-11-19
23947,James Ingram,1984-07-28,James Ingram - It's Your Night,50,50,51,10.0,50,It's Your Night,36.0,36,-1,0,0,1,down,1983-11-19
23948,Four Tops,1983-11-19,Four Tops - Back Where I Belong,51,51,49,47.0,49,Back Where I Belong,3.0,0,0,2,0,0,stay,1983-11-19
23949,Four Tops,1983-11-26,Four Tops - Back Where I Belong,49,51,47,47.0,49,Back Where I Belong,3.0,1,2,0,2,1,up,1983-11-19
23950,Four Tops,1983-12-03,Four Tops - Back Where I Belong,49,49,50,47.0,47,Back Where I Belong,3.0,2,-3,2,0,1,down,1983-11-19
23951,Four Tops,1983-12-10,Four Tops - Back Where I Belong,47,49,51,47.0,50,Back Where I Belong,3.0,3,-1,-3,2,1,down,1983-11-19
23952,Teddy Pendergrass,1983-11-26,Teddy Pendergrass - Heaven Only Knows,51,51,18,9.0,29,Heaven Only Knows,20.0,0,11,22,0,1,up,1983-11-26
23953,Teddy Pendergrass,1983-12-03,Teddy Pendergrass - Heaven Only Knows,29,51,10,9.0,18,Heaven Only Knows,20.0,1,8,11,22,1,up,1983-11-26
23954,Teddy Pendergrass,1983-12-10,Teddy Pendergrass - Heaven Only Knows,18,29,9,9.0,10,Heaven Only Knows,20.0,2,1,8,11,1,up,1983-11-26
23955,Teddy Pendergrass,1983-12-17,Teddy Pendergrass - Heaven Only Knows,10,18,9,9.0,9,Heaven Only Knows,20.0,3,0,1,8,0,stay,1983-11-26
23956,Teddy Pendergrass,1983-12-24,Teddy Pendergrass - Heaven Only Knows,9,10,9,9.0,9,Heaven Only Knows,20.0,4,0,0,1,0,stay,1983-11-26
23957,Teddy Pendergrass,1983-12-31,Teddy Pendergrass - Heaven Only Knows,9,9,9,9.0,9,Heaven Only Knows,20.0,5,0,0,0,0,stay,1983-11-26
23958,Teddy Pendergrass,1984-01-07,Teddy Pendergrass - Heaven Only Knows,9,9,9,9.0,9,Heaven Only Knows,20.0,6,0,0,0,0,stay,1983-11-26
23959,Teddy Pendergrass,1984-01-14,Teddy Pendergrass - Heaven Only Knows,9,9,9,9.0,9,Heaven Only Knows,20.0,7,0,0,0,0,stay,1983-11-26
23960,Teddy Pendergrass,1984-01-21,Teddy Pendergrass - Heaven Only Knows,9,9,11,9.0,9,Heaven Only Knows,20.0,8,-2,0,0,1,down,1983-11-26
23961,Teddy Pendergrass,1984-01-28,Teddy Pendergrass - Heaven Only Knows,9,9,11,9.0,11,Heaven Only Knows,20.0,9,0,-2,0,0,stay,1983-11-26
23962,Teddy Pendergrass,1984-02-04,Teddy Pendergrass - Heaven Only Knows,11,9,25,9.0,11,Heaven Only Knows,20.0,10,-14,0,-2,1,down,1983-11-26
23963,Teddy Pendergrass,1984-02-11,Teddy Pendergrass - Heaven Only Knows,11,11,22,9.0,25,Heaven Only Knows,20.0,11,3,-14,0,1,up,1983-11-26
23964,Teddy Pendergrass,1984-02-18,Teddy Pendergrass - Heaven Only Knows,25,11,22,9.0,22,Heaven Only Knows,20.0,12,0,3,-14,0,stay,1983-11-26
23965,Teddy Pendergrass,1984-02-25,Teddy Pendergrass - Heaven Only Knows,22,25,21,9.0,22,Heaven Only Knows,20.0,13,1,0,3,1,up,1983-11-26
23966,Teddy Pendergrass,1984-03-03,Teddy Pendergrass - Heaven Only Knows,22,22,27,9.0,21,Heaven Only Knows,20.0,14,-6,1,0,1,down,1983-11-26
23967,Teddy Pendergrass,1984-03-10,Teddy Pendergrass - Heaven Only Knows,21,22,26,9.0,27,Heaven Only Knows,20.0,15,1,-6,1,1,up,1983-11-26
23968,Teddy Pendergrass,1984-03-17,Teddy Pendergrass - Heaven Only Knows,27,21,33,9.0,26,Heaven Only Knows,20.0,16,-7,1,-6,1,down,1983-11-26
23969,Teddy Pendergrass,1984-03-24,Teddy Pendergrass - Heaven Only Knows,26,27,38,9.0,33,Heaven Only Knows,20.0,17,-5,-7,1,1,down,1983-11-26
23970,Teddy Pendergrass,1984-03-31,Teddy Pendergrass - Heaven Only Knows,33,26,38,9.0,38,Heaven Only Knows,20.0,18,0,-5,-7,0,stay,1983-11-26
23971,Teddy Pendergrass,1984-04-07,Teddy Pendergrass - Heaven Only Knows,38,33,48,9.0,38,Heaven Only Knows,20.0,19,-10,0,-5,1,down,1983-11-26
23972,Teddy Pendergrass,1984-04-14,Teddy Pendergrass - Heaven Only Knows,38,38,51,9.0,48,Heaven Only Knows,20.0,20,-3,-10,0,1,down,1983-11-26
23973,ConFunkShun,1983-11-26,ConFunkShun - Fever,51,51,26,12.0,38,Fever,21.0,0,12,13,0,1,up,1983-11-26
23974,ConFunkShun,1983-12-03,ConFunkShun - Fever,38,51,23,12.0,26,Fever,21.0,1,3,12,13,1,up,1983-11-26
23975,ConFunkShun,1983-12-10,ConFunkShun - Fever,26,38,15,12.0,23,Fever,21.0,2,8,3,12,1,up,1983-11-26
23976,ConFunkShun,1983-12-17,ConFunkShun - Fever,23,26,15,12.0,15,Fever,21.0,3,0,8,3,0,stay,1983-11-26
23977,ConFunkShun,1983-12-24,ConFunkShun - Fever,15,23,15,12.0,15,Fever,21.0,4,0,0,8,0,stay,1983-11-26
23978,ConFunkShun,1983-12-31,ConFunkShun - Fever,15,15,15,12.0,15,Fever,21.0,5,0,0,0,0,stay,1983-11-26
23979,ConFunkShun,1984-01-07,ConFunkShun - Fever,15,15,15,12.0,15,Fever,21.0,6,0,0,0,0,stay,1983-11-26
23980,ConFunkShun,1984-01-14,ConFunkShun - Fever,15,15,15,12.0,15,Fever,21.0,7,0,0,0,0,stay,1983-11-26
23981,ConFunkShun,1984-01-21,ConFunkShun - Fever,15,15,15,12.0,15,Fever,21.0,8,0,0,0,0,stay,1983-11-26
23982,ConFunkShun,1984-01-28,ConFunkShun - Fever,15,15,12,12.0,15,Fever,21.0,9,3,0,0,1,up,1983-11-26
23983,ConFunkShun,1984-02-04,ConFunkShun - Fever,15,15,12,12.0,12,Fever,21.0,10,0,3,0,0,stay,1983-11-26
23984,ConFunkShun,1984-02-11,ConFunkShun - Fever,12,15,21,12.0,12,Fever,21.0,11,-9,0,3,1,down,1983-11-26
23985,ConFunkShun,1984-02-18,ConFunkShun - Fever,12,12,21,12.0,21,Fever,21.0,12,0,-9,0,0,stay,1983-11-26
23986,ConFunkShun,1984-02-25,ConFunkShun - Fever,21,12,29,12.0,21,Fever,21.0,13,-8,0,-9,1,down,1983-11-26
23987,ConFunkShun,1984-03-03,ConFunkShun - Fever,21,21,29,12.0,29,Fever,21.0,14,0,-8,0,0,stay,1983-11-26
23988,ConFunkShun,1984-03-10,ConFunkShun - Fever,29,21,30,12.0,29,Fever,21.0,15,-1,0,-8,1,down,1983-11-26
23989,ConFunkShun,1984-03-17,ConFunkShun - Fever,29,29,31,12.0,30,Fever,21.0,16,-1,-1,0,1,down,1983-11-26
23990,ConFunkShun,1984-03-24,ConFunkShun - Fever,30,29,30,12.0,31,Fever,21.0,17,1,-1,-1,1,up,1983-11-26
23991,ConFunkShun,1984-03-31,ConFunkShun - Fever,31,30,34,12.0,30,Fever,21.0,18,-4,1,-1,1,down,1983-11-26
23992,ConFunkShun,1984-04-07,ConFunkShun - Fever,30,31,38,12.0,34,Fever,21.0,19,-4,-4,1,1,down,1983-11-26
23993,ConFunkShun,1984-04-14,ConFunkShun - Fever,34,30,36,12.0,38,Fever,21.0,20,2,-4,-4,1,up,1983-11-26
23994,ConFunkShun,1984-04-21,ConFunkShun - Fever,38,34,51,12.0,36,Fever,21.0,21,-15,2,-4,1,down,1983-11-26
23995,Tom Browne,1983-11-26,Tom Browne - Rockin' Radio,51,51,32,24.0,39,Rockin' Radio,16.0,0,7,12,0,1,up,1983-11-26
23996,Tom Browne,1983-12-03,Tom Browne - Rockin' Radio,39,51,30,24.0,32,Rockin' Radio,16.0,1,2,7,12,1,up,1983-11-26
23997,Tom Browne,1983-12-10,Tom Browne - Rockin' Radio,32,39,27,24.0,30,Rockin' Radio,16.0,2,3,2,7,1,up,1983-11-26
23998,Tom Browne,1983-12-17,Tom Browne - Rockin' Radio,30,32,24,24.0,27,Rockin' Radio,16.0,3,3,3,2,1,up,1983-11-26
23999,Tom Browne,1983-12-24,Tom Browne - Rockin' Radio,27,30,24,24.0,24,Rockin' Radio,16.0,4,0,3,3,0,stay,1983-11-26
24000,Tom Browne,1983-12-31,Tom Browne - Rockin' Radio,24,27,24,24.0,24,Rockin' Radio,16.0,5,0,0,3,0,stay,1983-11-26
24001,Tom Browne,1984-01-07,Tom Browne - Rockin' Radio,24,24,37,24.0,24,Rockin' Radio,16.0,6,-13,0,0,1,down,1983-11-26
24002,Tom Browne,1984-01-14,Tom Browne - Rockin' Radio,24,24,44,24.0,37,Rockin' Radio,16.0,7,-7,-13,0,1,down,1983-11-26
24003,Tom Browne,1984-01-21,Tom Browne - Rockin' Radio,37,24,44,24.0,44,Rockin' Radio,16.0,8,0,-7,-13,0,stay,1983-11-26
24004,Tom Browne,1984-01-28,Tom Browne - Rockin' Radio,44,37,43,24.0,44,Rockin' Radio,16.0,9,1,0,-7,1,up,1983-11-26
24005,Tom Browne,1984-02-04,Tom Browne - Rockin' Radio,44,44,45,24.0,43,Rockin' Radio,16.0,10,-2,1,0,1,down,1983-11-26
24006,Tom Browne,1984-02-11,Tom Browne - Rockin' Radio,43,44,45,24.0,45,Rockin' Radio,16.0,11,0,-2,1,0,stay,1983-11-26
24007,Tom Browne,1984-02-18,Tom Browne - Rockin' Radio,45,43,44,24.0,45,Rockin' Radio,16.0,12,1,0,-2,1,up,1983-11-26
24008,Tom Browne,1984-02-25,Tom Browne - Rockin' Radio,45,45,47,24.0,44,Rockin' Radio,16.0,13,-3,1,0,1,down,1983-11-26
24009,Tom Browne,1984-03-03,Tom Browne - Rockin' Radio,44,45,46,24.0,47,Rockin' Radio,16.0,14,1,-3,1,1,up,1983-11-26
24010,Tom Browne,1984-03-10,Tom Browne - Rockin' Radio,47,44,46,24.0,46,Rockin' Radio,16.0,15,0,1,-3,0,stay,1983-11-26
24011,Tom Browne,1984-03-17,Tom Browne - Rockin' Radio,46,47,51,24.0,46,Rockin' Radio,16.0,16,-5,0,1,1,down,1983-11-26
24012,David Sanborn,1983-11-26,David Sanborn - Backstreet,51,51,37,21.0,43,Backstreet,21.0,0,6,8,0,1,up,1983-11-26
24013,David Sanborn,1983-12-03,David Sanborn - Backstreet,43,51,27,21.0,37,Backstreet,21.0,1,10,6,8,1,up,1983-11-26
24014,David Sanborn,1983-12-10,David Sanborn - Backstreet,37,43,25,21.0,27,Backstreet,21.0,2,2,10,6,1,up,1983-11-26
24015,David Sanborn,1983-12-17,David Sanborn - Backstreet,27,37,25,21.0,25,Backstreet,21.0,3,0,2,10,0,stay,1983-11-26
24016,David Sanborn,1983-12-24,David Sanborn - Backstreet,25,27,25,21.0,25,Backstreet,21.0,4,0,0,2,0,stay,1983-11-26
24017,David Sanborn,1983-12-31,David Sanborn - Backstreet,25,25,25,21.0,25,Backstreet,21.0,5,0,0,0,0,stay,1983-11-26
24018,David Sanborn,1984-01-07,David Sanborn - Backstreet,25,25,25,21.0,25,Backstreet,21.0,6,0,0,0,0,stay,1983-11-26
24019,David Sanborn,1984-01-14,David Sanborn - Backstreet,25,25,24,21.0,25,Backstreet,21.0,7,1,0,0,1,up,1983-11-26
24020,David Sanborn,1984-01-21,David Sanborn - Backstreet,25,25,22,21.0,24,Backstreet,21.0,8,2,1,0,1,up,1983-11-26
24021,David Sanborn,1984-01-28,David Sanborn - Backstreet,24,25,22,21.0,22,Backstreet,21.0,9,0,2,1,0,stay,1983-11-26
24022,David Sanborn,1984-02-04,David Sanborn - Backstreet,22,24,21,21.0,22,Backstreet,21.0,10,1,0,2,1,up,1983-11-26
24023,David Sanborn,1984-02-11,David Sanborn - Backstreet,22,22,28,21.0,21,Backstreet,21.0,11,-7,1,0,1,down,1983-11-26
24024,David Sanborn,1984-02-18,David Sanborn - Backstreet,21,22,36,21.0,28,Backstreet,21.0,12,-8,-7,1,1,down,1983-11-26
24025,David Sanborn,1984-02-25,David Sanborn - Backstreet,28,21,36,21.0,36,Backstreet,21.0,13,0,-8,-7,0,stay,1983-11-26
24026,David Sanborn,1984-03-03,David Sanborn - Backstreet,36,28,34,21.0,36,Backstreet,21.0,14,2,0,-8,1,up,1983-11-26
24027,David Sanborn,1984-03-10,David Sanborn - Backstreet,36,36,34,21.0,34,Backstreet,21.0,15,0,2,0,0,stay,1983-11-26
24028,David Sanborn,1984-03-17,David Sanborn - Backstreet,34,36,42,21.0,34,Backstreet,21.0,16,-8,0,2,1,down,1983-11-26
24029,David Sanborn,1984-03-24,David Sanborn - Backstreet,34,34,42,21.0,42,Backstreet,21.0,17,0,-8,0,0,stay,1983-11-26
24030,David Sanborn,1984-03-31,David Sanborn - Backstreet,42,34,40,21.0,42,Backstreet,21.0,18,2,0,-8,1,up,1983-11-26
24031,David Sanborn,1984-04-07,David Sanborn - Backstreet,42,42,42,21.0,40,Backstreet,21.0,19,-2,2,0,1,down,1983-11-26
24032,David Sanborn,1984-04-14,David Sanborn - Backstreet,40,42,40,21.0,42,Backstreet,21.0,20,2,-2,2,1,up,1983-11-26
24033,David Sanborn,1984-04-21,David Sanborn - Backstreet,42,40,51,21.0,40,Backstreet,21.0,21,-11,2,-2,1,down,1983-11-26
24034,The Pointer Sisters,1983-11-26,The Pointer Sisters - Break Out,51,51,40,6.0,45,Break Out,86.0,0,5,6,0,1,up,1983-11-26
24035,The Pointer Sisters,1983-12-03,The Pointer Sisters - Break Out,45,51,32,6.0,40,Break Out,86.0,1,8,5,6,1,up,1983-11-26
24036,The Pointer Sisters,1983-12-10,The Pointer Sisters - Break Out,40,45,30,6.0,32,Break Out,86.0,2,2,8,5,1,up,1983-11-26
24037,The Pointer Sisters,1983-12-17,The Pointer Sisters - Break Out,32,40,29,6.0,30,Break Out,86.0,3,1,2,8,1,up,1983-11-26
24038,The Pointer Sisters,1983-12-24,The Pointer Sisters - Break Out,30,32,29,6.0,29,Break Out,86.0,4,0,1,2,0,stay,1983-11-26
24039,The Pointer Sisters,1983-12-31,The Pointer Sisters - Break Out,29,30,29,6.0,29,Break Out,86.0,5,0,0,1,0,stay,1983-11-26
24040,The Pointer Sisters,1984-01-07,The Pointer Sisters - Break Out,29,29,29,6.0,29,Break Out,86.0,6,0,0,0,0,stay,1983-11-26
24041,The Pointer Sisters,1984-01-14,The Pointer Sisters - Break Out,29,29,28,6.0,29,Break Out,86.0,7,1,0,0,1,up,1983-11-26
24042,The Pointer Sisters,1984-01-21,The Pointer Sisters - Break Out,29,29,41,6.0,28,Break Out,86.0,8,-13,1,0,1,down,1983-11-26
24043,The Pointer Sisters,1984-01-28,The Pointer Sisters - Break Out,28,29,38,6.0,41,Break Out,86.0,9,3,-13,1,1,up,1983-11-26
24044,The Pointer Sisters,1984-02-04,The Pointer Sisters - Break Out,41,28,30,6.0,38,Break Out,86.0,10,8,3,-13,1,up,1983-11-26
24045,The Pointer Sisters,1984-02-11,The Pointer Sisters - Break Out,38,41,27,6.0,30,Break Out,86.0,11,3,8,3,1,up,1983-11-26
24046,The Pointer Sisters,1984-02-18,The Pointer Sisters - Break Out,30,38,19,6.0,27,Break Out,86.0,12,8,3,8,1,up,1983-11-26
24047,The Pointer Sisters,1984-02-25,The Pointer Sisters - Break Out,27,30,18,6.0,19,Break Out,86.0,13,1,8,3,1,up,1983-11-26
24048,The Pointer Sisters,1984-03-03,The Pointer Sisters - Break Out,19,27,16,6.0,18,Break Out,86.0,14,2,1,8,1,up,1983-11-26
24049,The Pointer Sisters,1984-03-10,The Pointer Sisters - Break Out,18,19,15,6.0,16,Break Out,86.0,15,1,2,1,1,up,1983-11-26
24050,The Pointer Sisters,1984-03-17,The Pointer Sisters - Break Out,16,18,13,6.0,15,Break Out,86.0,16,2,1,2,1,up,1983-11-26
24051,The Pointer Sisters,1984-03-24,The Pointer Sisters - Break Out,15,16,12,6.0,13,Break Out,86.0,17,1,2,1,1,up,1983-11-26
24052,The Pointer Sisters,1984-03-31,The Pointer Sisters - Break Out,13,15,12,6.0,12,Break Out,86.0,18,0,1,2,0,stay,1983-11-26
24053,The Pointer Sisters,1984-04-07,The Pointer Sisters - Break Out,12,13,12,6.0,12,Break Out,86.0,19,0,0,1,0,stay,1983-11-26
24054,The Pointer Sisters,1984-04-14,The Pointer Sisters - Break Out,12,12,12,6.0,12,Break Out,86.0,20,0,0,0,0,stay,1983-11-26
24055,The Pointer Sisters,1984-04-21,The Pointer Sisters - Break Out,12,12,10,6.0,12,Break Out,86.0,21,2,0,0,1,up,1983-11-26
24056,The Pointer Sisters,1984-04-28,The Pointer Sisters - Break Out,12,12,9,6.0,10,Break Out,86.0,22,1,2,0,1,up,1983-11-26
24057,The Pointer Sisters,1984-05-05,The Pointer Sisters - Break Out,10,12,9,6.0,9,Break Out,86.0,23,0,1,2,0,stay,1983-11-26
24058,The Pointer Sisters,1984-05-12,The Pointer Sisters - Break Out,9,10,10,6.0,9,Break Out,86.0,24,-1,0,1,1,down,1983-11-26
24059,The Pointer Sisters,1984-05-19,The Pointer Sisters - Break Out,9,9,12,6.0,10,Break Out,86.0,25,-2,-1,0,1,down,1983-11-26
24060,The Pointer Sisters,1984-05-26,The Pointer Sisters - Break Out,10,9,12,6.0,12,Break Out,86.0,26,0,-2,-1,0,stay,1983-11-26
24061,The Pointer Sisters,1984-06-02,The Pointer Sisters - Break Out,12,10,11,6.0,12,Break Out,86.0,27,1,0,-2,1,up,1983-11-26
24062,The Pointer Sisters,1984-06-09,The Pointer Sisters - Break Out,12,12,11,6.0,11,Break Out,86.0,28,0,1,0,0,stay,1983-11-26
24063,The Pointer Sisters,1984-06-16,The Pointer Sisters - Break Out,11,12,9,6.0,11,Break Out,86.0,29,2,0,1,1,up,1983-11-26
24064,The Pointer Sisters,1984-06-23,The Pointer Sisters - Break Out,11,11,9,6.0,9,Break Out,86.0,30,0,2,0,0,stay,1983-11-26
24065,The Pointer Sisters,1984-06-30,The Pointer Sisters - Break Out,9,11,6,6.0,9,Break Out,86.0,31,3,0,2,1,up,1983-11-26
24066,The Pointer Sisters,1984-07-07,The Pointer Sisters - Break Out,9,9,8,6.0,6,Break Out,86.0,32,-2,3,0,1,down,1983-11-26
24067,The Pointer Sisters,1984-07-14,The Pointer Sisters - Break Out,6,9,11,6.0,8,Break Out,86.0,33,-3,-2,3,1,down,1983-11-26
24068,The Pointer Sisters,1984-07-21,The Pointer Sisters - Break Out,8,6,11,6.0,11,Break Out,86.0,34,0,-3,-2,0,stay,1983-11-26
24069,The Pointer Sisters,1984-07-28,The Pointer Sisters - Break Out,11,8,10,6.0,11,Break Out,86.0,35,1,0,-3,1,up,1983-11-26
24070,The Pointer Sisters,1984-08-04,The Pointer Sisters - Break Out,11,11,17,6.0,10,Break Out,86.0,36,-7,1,0,1,down,1983-11-26
24071,The Pointer Sisters,1984-08-11,The Pointer Sisters - Break Out,10,11,16,6.0,17,Break Out,86.0,37,1,-7,1,1,up,1983-11-26
24072,The Pointer Sisters,1984-08-18,The Pointer Sisters - Break Out,17,10,15,6.0,16,Break Out,86.0,38,1,1,-7,1,up,1983-11-26
24073,The Pointer Sisters,1984-08-25,The Pointer Sisters - Break Out,16,17,15,6.0,15,Break Out,86.0,39,0,1,1,0,stay,1983-11-26
24074,The Pointer Sisters,1984-09-01,The Pointer Sisters - Break Out,15,16,14,6.0,15,Break Out,86.0,40,1,0,1,1,up,1983-11-26
24075,The Pointer Sisters,1984-09-08,The Pointer Sisters - Break Out,15,15,12,6.0,14,Break Out,86.0,41,2,1,0,1,up,1983-11-26
24076,The Pointer Sisters,1984-09-15,The Pointer Sisters - Break Out,14,15,12,6.0,12,Break Out,86.0,42,0,2,1,0,stay,1983-11-26
24077,The Pointer Sisters,1984-09-22,The Pointer Sisters - Break Out,12,14,16,6.0,12,Break Out,86.0,43,-4,0,2,1,down,1983-11-26
24078,The Pointer Sisters,1984-09-29,The Pointer Sisters - Break Out,12,12,17,6.0,16,Break Out,86.0,44,-1,-4,0,1,down,1983-11-26
24079,The Pointer Sisters,1984-10-06,The Pointer Sisters - Break Out,16,12,16,6.0,17,Break Out,86.0,45,1,-1,-4,1,up,1983-11-26
24080,The Pointer Sisters,1984-10-13,The Pointer Sisters - Break Out,17,16,16,6.0,16,Break Out,86.0,46,0,1,-1,0,stay,1983-11-26
24081,The Pointer Sisters,1984-10-20,The Pointer Sisters - Break Out,16,17,20,6.0,16,Break Out,86.0,47,-4,0,1,1,down,1983-11-26
24082,The Pointer Sisters,1984-10-27,The Pointer Sisters - Break Out,16,16,17,6.0,20,Break Out,86.0,48,3,-4,0,1,up,1983-11-26
24083,The Pointer Sisters,1984-11-03,The Pointer Sisters - Break Out,20,16,17,6.0,17,Break Out,86.0,49,0,3,-4,0,stay,1983-11-26
24084,The Pointer Sisters,1984-11-10,The Pointer Sisters - Break Out,17,20,17,6.0,17,Break Out,86.0,50,0,0,3,0,stay,1983-11-26
24085,The Pointer Sisters,1984-11-17,The Pointer Sisters - Break Out,17,17,19,6.0,17,Break Out,86.0,51,-2,0,0,1,down,1983-11-26
24086,The Pointer Sisters,1984-11-24,The Pointer Sisters - Break Out,17,17,19,6.0,19,Break Out,86.0,52,0,-2,0,0,stay,1983-11-26
24087,The Pointer Sisters,1984-12-01,The Pointer Sisters - Break Out,19,17,24,6.0,19,Break Out,86.0,53,-5,0,-2,1,down,1983-11-26
24088,The Pointer Sisters,1984-12-08,The Pointer Sisters - Break Out,19,19,31,6.0,24,Break Out,86.0,54,-7,-5,0,1,down,1983-11-26
24089,The Pointer Sisters,1984-12-15,The Pointer Sisters - Break Out,24,19,29,6.0,31,Break Out,86.0,55,2,-7,-5,1,up,1983-11-26
24090,The Pointer Sisters,1984-12-22,The Pointer Sisters - Break Out,31,24,29,6.0,29,Break Out,86.0,56,0,2,-7,0,stay,1983-11-26
24091,The Pointer Sisters,1984-12-29,The Pointer Sisters - Break Out,29,31,29,6.0,29,Break Out,86.0,57,0,0,2,0,stay,1983-11-26
24092,The Pointer Sisters,1985-01-05,The Pointer Sisters - Break Out,29,29,26,6.0,29,Break Out,86.0,58,3,0,0,1,up,1983-11-26
24093,The Pointer Sisters,1985-01-12,The Pointer Sisters - Break Out,29,29,24,6.0,26,Break Out,86.0,59,2,3,0,1,up,1983-11-26
24094,The Pointer Sisters,1985-01-19,The Pointer Sisters - Break Out,26,29,24,6.0,24,Break Out,86.0,60,0,2,3,0,stay,1983-11-26
24095,The Pointer Sisters,1985-01-26,The Pointer Sisters - Break Out,24,26,26,6.0,24,Break Out,86.0,61,-2,0,2,1,down,1983-11-26
24096,The Pointer Sisters,1985-02-02,The Pointer Sisters - Break Out,24,24,27,6.0,26,Break Out,86.0,62,-1,-2,0,1,down,1983-11-26
24097,The Pointer Sisters,1985-02-09,The Pointer Sisters - Break Out,26,24,26,6.0,27,Break Out,86.0,63,1,-1,-2,1,up,1983-11-26
24098,The Pointer Sisters,1985-02-16,The Pointer Sisters - Break Out,27,26,32,6.0,26,Break Out,86.0,64,-6,1,-1,1,down,1983-11-26
24099,The Pointer Sisters,1985-02-23,The Pointer Sisters - Break Out,26,27,32,6.0,32,Break Out,86.0,65,0,-6,1,0,stay,1983-11-26
24100,The Pointer Sisters,1985-03-02,The Pointer Sisters - Break Out,32,26,27,6.0,32,Break Out,86.0,66,5,0,-6,1,up,1983-11-26
24101,The Pointer Sisters,1985-03-09,The Pointer Sisters - Break Out,32,32,20,6.0,27,Break Out,86.0,67,7,5,0,1,up,1983-11-26
24102,The Pointer Sisters,1985-03-16,The Pointer Sisters - Break Out,27,32,20,6.0,20,Break Out,86.0,68,0,7,5,0,stay,1983-11-26
24103,The Pointer Sisters,1985-03-23,The Pointer Sisters - Break Out,20,27,15,6.0,20,Break Out,86.0,69,5,0,7,1,up,1983-11-26
24104,The Pointer Sisters,1985-03-30,The Pointer Sisters - Break Out,20,20,15,6.0,15,Break Out,86.0,70,0,5,0,0,stay,1983-11-26
24105,The Pointer Sisters,1985-04-06,The Pointer Sisters - Break Out,15,20,22,6.0,15,Break Out,86.0,71,-7,0,5,1,down,1983-11-26
24106,The Pointer Sisters,1985-04-13,The Pointer Sisters - Break Out,15,15,22,6.0,22,Break Out,86.0,72,0,-7,0,0,stay,1983-11-26
24107,The Pointer Sisters,1985-04-20,The Pointer Sisters - Break Out,22,15,22,6.0,22,Break Out,86.0,73,0,0,-7,0,stay,1983-11-26
24108,The Pointer Sisters,1985-04-27,The Pointer Sisters - Break Out,22,22,24,6.0,22,Break Out,86.0,74,-2,0,0,1,down,1983-11-26
24109,The Pointer Sisters,1985-05-04,The Pointer Sisters - Break Out,22,22,28,6.0,24,Break Out,86.0,75,-4,-2,0,1,down,1983-11-26
24110,The Pointer Sisters,1985-05-11,The Pointer Sisters - Break Out,24,22,36,6.0,28,Break Out,86.0,76,-8,-4,-2,1,down,1983-11-26
24111,The Pointer Sisters,1985-05-18,The Pointer Sisters - Break Out,28,24,36,6.0,36,Break Out,86.0,77,0,-8,-4,0,stay,1983-11-26
24112,The Pointer Sisters,1985-05-25,The Pointer Sisters - Break Out,36,28,36,6.0,36,Break Out,86.0,78,0,0,-8,0,stay,1983-11-26
24113,The Pointer Sisters,1985-06-01,The Pointer Sisters - Break Out,36,36,36,6.0,36,Break Out,86.0,79,0,0,0,0,stay,1983-11-26
24114,The Pointer Sisters,1985-06-08,The Pointer Sisters - Break Out,36,36,34,6.0,36,Break Out,86.0,80,2,0,0,1,up,1983-11-26
24115,The Pointer Sisters,1985-06-15,The Pointer Sisters - Break Out,36,36,34,6.0,34,Break Out,86.0,81,0,2,0,0,stay,1983-11-26
24116,The Pointer Sisters,1985-06-22,The Pointer Sisters - Break Out,34,36,33,6.0,34,Break Out,86.0,82,1,0,2,1,up,1983-11-26
24117,The Pointer Sisters,1985-06-29,The Pointer Sisters - Break Out,34,34,43,6.0,33,Break Out,86.0,83,-10,1,0,1,down,1983-11-26
24118,The Pointer Sisters,1985-07-06,The Pointer Sisters - Break Out,33,34,42,6.0,43,Break Out,86.0,84,1,-10,1,1,up,1983-11-26
24119,The Pointer Sisters,1985-07-13,The Pointer Sisters - Break Out,43,33,42,6.0,42,Break Out,86.0,85,0,1,-10,0,stay,1983-11-26
24120,The Pointer Sisters,1985-07-20,The Pointer Sisters - Break Out,42,43,51,6.0,42,Break Out,86.0,86,-9,0,1,1,down,1983-11-26
24121,Tyrone Davis,1983-11-26,Tyrone Davis - Something Good,51,51,46,46.0,47,Something Good,1.0,0,1,4,0,1,up,1983-11-26
24122,Tyrone Davis,1983-12-03,Tyrone Davis - Something Good,47,51,51,46.0,46,Something Good,1.0,1,-5,1,4,1,down,1983-11-26
24123,Eddie Murphy,1983-11-26,Eddie Murphy - Eddie Murphy: Comedian,51,51,24,10.0,50,Eddie Murphy: Comedian,21.0,0,26,1,0,1,up,1983-11-26
24124,Eddie Murphy,1983-12-03,Eddie Murphy - Eddie Murphy: Comedian,50,51,18,10.0,24,Eddie Murphy: Comedian,21.0,1,6,26,1,1,up,1983-11-26
24125,Eddie Murphy,1983-12-10,Eddie Murphy - Eddie Murphy: Comedian,24,50,16,10.0,18,Eddie Murphy: Comedian,21.0,2,2,6,26,1,up,1983-11-26
24126,Eddie Murphy,1983-12-17,Eddie Murphy - Eddie Murphy: Comedian,18,24,16,10.0,16,Eddie Murphy: Comedian,21.0,3,0,2,6,0,stay,1983-11-26
24127,Eddie Murphy,1983-12-24,Eddie Murphy - Eddie Murphy: Comedian,16,18,16,10.0,16,Eddie Murphy: Comedian,21.0,4,0,0,2,0,stay,1983-11-26
24128,Eddie Murphy,1983-12-31,Eddie Murphy - Eddie Murphy: Comedian,16,16,16,10.0,16,Eddie Murphy: Comedian,21.0,5,0,0,0,0,stay,1983-11-26
24129,Eddie Murphy,1984-01-07,Eddie Murphy - Eddie Murphy: Comedian,16,16,12,10.0,16,Eddie Murphy: Comedian,21.0,6,4,0,0,1,up,1983-11-26
24130,Eddie Murphy,1984-01-14,Eddie Murphy - Eddie Murphy: Comedian,16,16,12,10.0,12,Eddie Murphy: Comedian,21.0,7,0,4,0,0,stay,1983-11-26
24131,Eddie Murphy,1984-01-21,Eddie Murphy - Eddie Murphy: Comedian,12,16,10,10.0,12,Eddie Murphy: Comedian,21.0,8,2,0,4,1,up,1983-11-26
24132,Eddie Murphy,1984-01-28,Eddie Murphy - Eddie Murphy: Comedian,12,12,10,10.0,10,Eddie Murphy: Comedian,21.0,9,0,2,0,0,stay,1983-11-26
24133,Eddie Murphy,1984-02-04,Eddie Murphy - Eddie Murphy: Comedian,10,12,11,10.0,10,Eddie Murphy: Comedian,21.0,10,-1,0,2,1,down,1983-11-26
24134,Eddie Murphy,1984-02-11,Eddie Murphy - Eddie Murphy: Comedian,10,10,12,10.0,11,Eddie Murphy: Comedian,21.0,11,-1,-1,0,1,down,1983-11-26
24135,Eddie Murphy,1984-02-18,Eddie Murphy - Eddie Murphy: Comedian,11,10,29,10.0,12,Eddie Murphy: Comedian,21.0,12,-17,-1,-1,1,down,1983-11-26
24136,Eddie Murphy,1984-02-25,Eddie Murphy - Eddie Murphy: Comedian,12,11,31,10.0,29,Eddie Murphy: Comedian,21.0,13,-2,-17,-1,1,down,1983-11-26
24137,Eddie Murphy,1984-03-03,Eddie Murphy - Eddie Murphy: Comedian,29,12,28,10.0,31,Eddie Murphy: Comedian,21.0,14,3,-2,-17,1,up,1983-11-26
24138,Eddie Murphy,1984-03-10,Eddie Murphy - Eddie Murphy: Comedian,31,29,22,10.0,28,Eddie Murphy: Comedian,21.0,15,6,3,-2,1,up,1983-11-26
24139,Eddie Murphy,1984-03-17,Eddie Murphy - Eddie Murphy: Comedian,28,31,20,10.0,22,Eddie Murphy: Comedian,21.0,16,2,6,3,1,up,1983-11-26
24140,Eddie Murphy,1984-03-24,Eddie Murphy - Eddie Murphy: Comedian,22,28,19,10.0,20,Eddie Murphy: Comedian,21.0,17,1,2,6,1,up,1983-11-26
24141,Eddie Murphy,1984-03-31,Eddie Murphy - Eddie Murphy: Comedian,20,22,19,10.0,19,Eddie Murphy: Comedian,21.0,18,0,1,2,0,stay,1983-11-26
24142,Eddie Murphy,1984-04-07,Eddie Murphy - Eddie Murphy: Comedian,19,20,22,10.0,19,Eddie Murphy: Comedian,21.0,19,-3,0,1,1,down,1983-11-26
24143,Eddie Murphy,1984-04-14,Eddie Murphy - Eddie Murphy: Comedian,19,19,30,10.0,22,Eddie Murphy: Comedian,21.0,20,-8,-3,0,1,down,1983-11-26
24144,Eddie Murphy,1984-04-21,Eddie Murphy - Eddie Murphy: Comedian,22,19,51,10.0,30,Eddie Murphy: Comedian,21.0,21,-21,-8,-3,1,down,1983-11-26
24145,Ray Parker Jr.,1983-12-03,Ray Parker Jr. - Woman Out Of Control,51,51,31,18.0,35,Woman Out Of Control,19.0,0,4,16,0,1,up,1983-12-03
24146,Ray Parker Jr.,1983-12-10,Ray Parker Jr. - Woman Out Of Control,35,51,19,18.0,31,Woman Out Of Control,19.0,1,12,4,16,1,up,1983-12-03
24147,Ray Parker Jr.,1983-12-17,Ray Parker Jr. - Woman Out Of Control,31,35,18,18.0,19,Woman Out Of Control,19.0,2,1,12,4,1,up,1983-12-03
24148,Ray Parker Jr.,1983-12-24,Ray Parker Jr. - Woman Out Of Control,19,31,18,18.0,18,Woman Out Of Control,19.0,3,0,1,12,0,stay,1983-12-03
24149,Ray Parker Jr.,1983-12-31,Ray Parker Jr. - Woman Out Of Control,18,19,18,18.0,18,Woman Out Of Control,19.0,4,0,0,1,0,stay,1983-12-03
24150,Ray Parker Jr.,1984-01-07,Ray Parker Jr. - Woman Out Of Control,18,18,18,18.0,18,Woman Out Of Control,19.0,5,0,0,0,0,stay,1983-12-03
24151,Ray Parker Jr.,1984-01-14,Ray Parker Jr. - Woman Out Of Control,18,18,18,18.0,18,Woman Out Of Control,19.0,6,0,0,0,0,stay,1983-12-03
24152,Ray Parker Jr.,1984-01-21,Ray Parker Jr. - Woman Out Of Control,18,18,29,18.0,18,Woman Out Of Control,19.0,7,-11,0,0,1,down,1983-12-03
24153,Ray Parker Jr.,1984-01-28,Ray Parker Jr. - Woman Out Of Control,18,18,27,18.0,29,Woman Out Of Control,19.0,8,2,-11,0,1,up,1983-12-03
24154,Ray Parker Jr.,1984-02-04,Ray Parker Jr. - Woman Out Of Control,29,18,23,18.0,27,Woman Out Of Control,19.0,9,4,2,-11,1,up,1983-12-03
24155,Ray Parker Jr.,1984-02-11,Ray Parker Jr. - Woman Out Of Control,27,29,23,18.0,23,Woman Out Of Control,19.0,10,0,4,2,0,stay,1983-12-03
24156,Ray Parker Jr.,1984-02-18,Ray Parker Jr. - Woman Out Of Control,23,27,34,18.0,23,Woman Out Of Control,19.0,11,-11,0,4,1,down,1983-12-03
24157,Ray Parker Jr.,1984-02-25,Ray Parker Jr. - Woman Out Of Control,23,23,34,18.0,34,Woman Out Of Control,19.0,12,0,-11,0,0,stay,1983-12-03
24158,Ray Parker Jr.,1984-03-03,Ray Parker Jr. - Woman Out Of Control,34,23,31,18.0,34,Woman Out Of Control,19.0,13,3,0,-11,1,up,1983-12-03
24159,Ray Parker Jr.,1984-03-10,Ray Parker Jr. - Woman Out Of Control,34,34,31,18.0,31,Woman Out Of Control,19.0,14,0,3,0,0,stay,1983-12-03
24160,Ray Parker Jr.,1984-03-17,Ray Parker Jr. - Woman Out Of Control,31,34,35,18.0,31,Woman Out Of Control,19.0,15,-4,0,3,1,down,1983-12-03
24161,Ray Parker Jr.,1984-03-24,Ray Parker Jr. - Woman Out Of Control,31,31,40,18.0,35,Woman Out Of Control,19.0,16,-5,-4,0,1,down,1983-12-03
24162,Ray Parker Jr.,1984-03-31,Ray Parker Jr. - Woman Out Of Control,35,31,44,18.0,40,Woman Out Of Control,19.0,17,-4,-5,-4,1,down,1983-12-03
24163,Ray Parker Jr.,1984-04-07,Ray Parker Jr. - Woman Out Of Control,40,35,50,18.0,44,Woman Out Of Control,19.0,18,-6,-4,-5,1,down,1983-12-03
24164,Ray Parker Jr.,1984-04-14,Ray Parker Jr. - Woman Out Of Control,44,40,51,18.0,50,Woman Out Of Control,19.0,19,-1,-6,-4,1,down,1983-12-03
24165,Angela Bofill,1983-12-03,Angela Bofill - Teaser,51,51,34,20.0,39,Teaser,19.0,0,5,12,0,1,up,1983-12-03
24166,Angela Bofill,1983-12-10,Angela Bofill - Teaser,39,51,29,20.0,34,Teaser,19.0,1,5,5,12,1,up,1983-12-03
24167,Angela Bofill,1983-12-17,Angela Bofill - Teaser,34,39,28,20.0,29,Teaser,19.0,2,1,5,5,1,up,1983-12-03
24168,Angela Bofill,1983-12-24,Angela Bofill - Teaser,29,34,28,20.0,28,Teaser,19.0,3,0,1,5,0,stay,1983-12-03
24169,Angela Bofill,1983-12-31,Angela Bofill - Teaser,28,29,28,20.0,28,Teaser,19.0,4,0,0,1,0,stay,1983-12-03
24170,Angela Bofill,1984-01-07,Angela Bofill - Teaser,28,28,28,20.0,28,Teaser,19.0,5,0,0,0,0,stay,1983-12-03
24171,Angela Bofill,1984-01-14,Angela Bofill - Teaser,28,28,27,20.0,28,Teaser,19.0,6,1,0,0,1,up,1983-12-03
24172,Angela Bofill,1984-01-21,Angela Bofill - Teaser,28,28,26,20.0,27,Teaser,19.0,7,1,1,0,1,up,1983-12-03
24173,Angela Bofill,1984-01-28,Angela Bofill - Teaser,27,28,26,20.0,26,Teaser,19.0,8,0,1,1,0,stay,1983-12-03
24174,Angela Bofill,1984-02-04,Angela Bofill - Teaser,26,27,22,20.0,26,Teaser,19.0,9,4,0,1,1,up,1983-12-03
24175,Angela Bofill,1984-02-11,Angela Bofill - Teaser,26,26,20,20.0,22,Teaser,19.0,10,2,4,0,1,up,1983-12-03
24176,Angela Bofill,1984-02-18,Angela Bofill - Teaser,22,26,20,20.0,20,Teaser,19.0,11,0,2,4,0,stay,1983-12-03
24177,Angela Bofill,1984-02-25,Angela Bofill - Teaser,20,22,28,20.0,20,Teaser,19.0,12,-8,0,2,1,down,1983-12-03
24178,Angela Bofill,1984-03-03,Angela Bofill - Teaser,20,20,39,20.0,28,Teaser,19.0,13,-11,-8,0,1,down,1983-12-03
24179,Angela Bofill,1984-03-10,Angela Bofill - Teaser,28,20,38,20.0,39,Teaser,19.0,14,1,-11,-8,1,up,1983-12-03
24180,Angela Bofill,1984-03-17,Angela Bofill - Teaser,39,28,34,20.0,38,Teaser,19.0,15,4,1,-11,1,up,1983-12-03
24181,Angela Bofill,1984-03-24,Angela Bofill - Teaser,38,39,34,20.0,34,Teaser,19.0,16,0,4,1,0,stay,1983-12-03
24182,Angela Bofill,1984-03-31,Angela Bofill - Teaser,34,38,42,20.0,34,Teaser,19.0,17,-8,0,4,1,down,1983-12-03
24183,Angela Bofill,1984-04-07,Angela Bofill - Teaser,34,34,41,20.0,42,Teaser,19.0,18,1,-8,0,1,up,1983-12-03
24184,Angela Bofill,1984-04-14,Angela Bofill - Teaser,42,34,51,20.0,41,Teaser,19.0,19,-10,1,-8,1,down,1983-12-03
24185,"Earth, Wind & Fire",1983-12-03,"Earth, Wind & Fire - Electric Universe",51,51,17,8.0,41,Electric Universe,17.0,0,24,10,0,1,up,1983-12-03
24186,"Earth, Wind & Fire",1983-12-10,"Earth, Wind & Fire - Electric Universe",41,51,8,8.0,17,Electric Universe,17.0,1,9,24,10,1,up,1983-12-03
24187,"Earth, Wind & Fire",1983-12-17,"Earth, Wind & Fire - Electric Universe",17,41,8,8.0,8,Electric Universe,17.0,2,0,9,24,0,stay,1983-12-03
24188,"Earth, Wind & Fire",1983-12-24,"Earth, Wind & Fire - Electric Universe",8,17,8,8.0,8,Electric Universe,17.0,3,0,0,9,0,stay,1983-12-03
24189,"Earth, Wind & Fire",1983-12-31,"Earth, Wind & Fire - Electric Universe",8,8,8,8.0,8,Electric Universe,17.0,4,0,0,0,0,stay,1983-12-03
24190,"Earth, Wind & Fire",1984-01-07,"Earth, Wind & Fire - Electric Universe",8,8,16,8.0,8,Electric Universe,17.0,5,-8,0,0,1,down,1983-12-03
24191,"Earth, Wind & Fire",1984-01-14,"Earth, Wind & Fire - Electric Universe",8,8,17,8.0,16,Electric Universe,17.0,6,-1,-8,0,1,down,1983-12-03
24192,"Earth, Wind & Fire",1984-01-21,"Earth, Wind & Fire - Electric Universe",16,8,23,8.0,17,Electric Universe,17.0,7,-6,-1,-8,1,down,1983-12-03
24193,"Earth, Wind & Fire",1984-01-28,"Earth, Wind & Fire - Electric Universe",17,16,35,8.0,23,Electric Universe,17.0,8,-12,-6,-1,1,down,1983-12-03
24194,"Earth, Wind & Fire",1984-02-04,"Earth, Wind & Fire - Electric Universe",23,17,35,8.0,35,Electric Universe,17.0,9,0,-12,-6,0,stay,1983-12-03
24195,"Earth, Wind & Fire",1984-02-11,"Earth, Wind & Fire - Electric Universe",35,23,32,8.0,35,Electric Universe,17.0,10,3,0,-12,1,up,1983-12-03
24196,"Earth, Wind & Fire",1984-02-18,"Earth, Wind & Fire - Electric Universe",35,35,32,8.0,32,Electric Universe,17.0,11,0,3,0,0,stay,1983-12-03
24197,"Earth, Wind & Fire",1984-02-25,"Earth, Wind & Fire - Electric Universe",32,35,42,8.0,32,Electric Universe,17.0,12,-10,0,3,1,down,1983-12-03
24198,"Earth, Wind & Fire",1984-03-03,"Earth, Wind & Fire - Electric Universe",32,32,42,8.0,42,Electric Universe,17.0,13,0,-10,0,0,stay,1983-12-03
24199,"Earth, Wind & Fire",1984-03-10,"Earth, Wind & Fire - Electric Universe",42,32,41,8.0,42,Electric Universe,17.0,14,1,0,-10,1,up,1983-12-03
24200,"Earth, Wind & Fire",1984-03-17,"Earth, Wind & Fire - Electric Universe",42,42,45,8.0,41,Electric Universe,17.0,15,-4,1,0,1,down,1983-12-03
24201,"Earth, Wind & Fire",1984-03-24,"Earth, Wind & Fire - Electric Universe",41,42,43,8.0,45,Electric Universe,17.0,16,2,-4,1,1,up,1983-12-03
24202,"Earth, Wind & Fire",1984-03-31,"Earth, Wind & Fire - Electric Universe",45,41,51,8.0,43,Electric Universe,17.0,17,-8,2,-4,1,down,1983-12-03
24203,Daryl Hall John Oates,1983-12-03,"Daryl Hall John Oates - Rock 'N Soul, Part 1",51,51,35,26.0,45,"Rock 'N Soul, Part 1",25.0,0,10,6,0,1,up,1983-12-03
24204,Daryl Hall John Oates,1983-12-10,"Daryl Hall John Oates - Rock 'N Soul, Part 1",45,51,33,26.0,35,"Rock 'N Soul, Part 1",25.0,1,2,10,6,1,up,1983-12-03
24205,Daryl Hall John Oates,1983-12-17,"Daryl Hall John Oates - Rock 'N Soul, Part 1",35,45,30,26.0,33,"Rock 'N Soul, Part 1",25.0,2,3,2,10,1,up,1983-12-03
24206,Daryl Hall John Oates,1983-12-24,"Daryl Hall John Oates - Rock 'N Soul, Part 1",33,35,30,26.0,30,"Rock 'N Soul, Part 1",25.0,3,0,3,2,0,stay,1983-12-03
24207,Daryl Hall John Oates,1983-12-31,"Daryl Hall John Oates - Rock 'N Soul, Part 1",30,33,26,26.0,30,"Rock 'N Soul, Part 1",25.0,4,4,0,3,1,up,1983-12-03
24208,Daryl Hall John Oates,1984-01-07,"Daryl Hall John Oates - Rock 'N Soul, Part 1",30,30,26,26.0,26,"Rock 'N Soul, Part 1",25.0,5,0,4,0,0,stay,1983-12-03
24209,Daryl Hall John Oates,1984-01-14,"Daryl Hall John Oates - Rock 'N Soul, Part 1",26,30,36,26.0,26,"Rock 'N Soul, Part 1",25.0,6,-10,0,4,1,down,1983-12-03
24210,Daryl Hall John Oates,1984-01-21,"Daryl Hall John Oates - Rock 'N Soul, Part 1",26,26,32,26.0,36,"Rock 'N Soul, Part 1",25.0,7,4,-10,0,1,up,1983-12-03
24211,Daryl Hall John Oates,1984-01-28,"Daryl Hall John Oates - Rock 'N Soul, Part 1",36,26,31,26.0,32,"Rock 'N Soul, Part 1",25.0,8,1,4,-10,1,up,1983-12-03
24212,Daryl Hall John Oates,1984-02-04,"Daryl Hall John Oates - Rock 'N Soul, Part 1",32,36,31,26.0,31,"Rock 'N Soul, Part 1",25.0,9,0,1,4,0,stay,1983-12-03
24213,Daryl Hall John Oates,1984-02-11,"Daryl Hall John Oates - Rock 'N Soul, Part 1",31,32,36,26.0,31,"Rock 'N Soul, Part 1",25.0,10,-5,0,1,1,down,1983-12-03
24214,Daryl Hall John Oates,1984-02-18,"Daryl Hall John Oates - Rock 'N Soul, Part 1",31,31,41,26.0,36,"Rock 'N Soul, Part 1",25.0,11,-5,-5,0,1,down,1983-12-03
24215,Daryl Hall John Oates,1984-02-25,"Daryl Hall John Oates - Rock 'N Soul, Part 1",36,31,39,26.0,41,"Rock 'N Soul, Part 1",25.0,12,2,-5,-5,1,up,1983-12-03
24216,Daryl Hall John Oates,1984-03-03,"Daryl Hall John Oates - Rock 'N Soul, Part 1",41,36,38,26.0,39,"Rock 'N Soul, Part 1",25.0,13,1,2,-5,1,up,1983-12-03
24217,Daryl Hall John Oates,1984-03-10,"Daryl Hall John Oates - Rock 'N Soul, Part 1",39,41,39,26.0,38,"Rock 'N Soul, Part 1",25.0,14,-1,1,2,1,down,1983-12-03
24218,Daryl Hall John Oates,1984-03-17,"Daryl Hall John Oates - Rock 'N Soul, Part 1",38,39,36,26.0,39,"Rock 'N Soul, Part 1",25.0,15,3,-1,1,1,up,1983-12-03
24219,Daryl Hall John Oates,1984-03-24,"Daryl Hall John Oates - Rock 'N Soul, Part 1",39,38,35,26.0,36,"Rock 'N Soul, Part 1",25.0,16,1,3,-1,1,up,1983-12-03
24220,Daryl Hall John Oates,1984-03-31,"Daryl Hall John Oates - Rock 'N Soul, Part 1",36,39,33,26.0,35,"Rock 'N Soul, Part 1",25.0,17,2,1,3,1,up,1983-12-03
24221,Daryl Hall John Oates,1984-04-07,"Daryl Hall John Oates - Rock 'N Soul, Part 1",35,36,37,26.0,33,"Rock 'N Soul, Part 1",25.0,18,-4,2,1,1,down,1983-12-03
24222,Daryl Hall John Oates,1984-04-14,"Daryl Hall John Oates - Rock 'N Soul, Part 1",33,35,37,26.0,37,"Rock 'N Soul, Part 1",25.0,19,0,-4,2,0,stay,1983-12-03
24223,Daryl Hall John Oates,1984-04-21,"Daryl Hall John Oates - Rock 'N Soul, Part 1",37,33,47,26.0,37,"Rock 'N Soul, Part 1",25.0,20,-10,0,-4,1,down,1983-12-03
24224,Daryl Hall John Oates,1984-05-05,"Daryl Hall John Oates - Rock 'N Soul, Part 1",37,37,45,26.0,47,"Rock 'N Soul, Part 1",25.0,21,2,-10,0,1,up,1983-12-03
24225,Daryl Hall John Oates,1984-05-12,"Daryl Hall John Oates - Rock 'N Soul, Part 1",47,37,45,26.0,45,"Rock 'N Soul, Part 1",25.0,22,0,2,-10,0,stay,1983-12-03
24226,Daryl Hall John Oates,1984-05-19,"Daryl Hall John Oates - Rock 'N Soul, Part 1",45,47,47,26.0,45,"Rock 'N Soul, Part 1",25.0,23,-2,0,2,1,down,1983-12-03
24227,Daryl Hall John Oates,1984-05-26,"Daryl Hall John Oates - Rock 'N Soul, Part 1",45,45,48,26.0,47,"Rock 'N Soul, Part 1",25.0,24,-1,-2,0,1,down,1983-12-03
24228,Daryl Hall John Oates,1984-06-02,"Daryl Hall John Oates - Rock 'N Soul, Part 1",47,45,51,26.0,48,"Rock 'N Soul, Part 1",25.0,25,-3,-1,-2,1,down,1983-12-03
24229,Stanley Clarke/George Duke,1983-12-03,Stanley Clarke/George Duke - The Clarke/Duke Project II,51,51,46,44.0,48,The Clarke/Duke Project II,4.0,0,2,3,0,1,up,1983-12-03
24230,Stanley Clarke/George Duke,1983-12-10,Stanley Clarke/George Duke - The Clarke/Duke Project II,48,51,44,44.0,46,The Clarke/Duke Project II,4.0,1,2,2,3,1,up,1983-12-03
24231,Stanley Clarke/George Duke,1983-12-17,Stanley Clarke/George Duke - The Clarke/Duke Project II,46,48,44,44.0,44,The Clarke/Duke Project II,4.0,2,0,2,2,0,stay,1983-12-03
24232,Stanley Clarke/George Duke,1983-12-24,Stanley Clarke/George Duke - The Clarke/Duke Project II,44,46,44,44.0,44,The Clarke/Duke Project II,4.0,3,0,0,2,0,stay,1983-12-03
24233,Stanley Clarke/George Duke,1983-12-31,Stanley Clarke/George Duke - The Clarke/Duke Project II,44,44,51,44.0,44,The Clarke/Duke Project II,4.0,4,-7,0,0,1,down,1983-12-03
24234,Soundtrack,1983-12-03,Soundtrack - The Big Chill,51,51,45,40.0,49,The Big Chill,8.0,0,4,2,0,1,up,1983-12-03
24235,Soundtrack,1983-12-10,Soundtrack - The Big Chill,49,51,43,40.0,45,The Big Chill,8.0,1,2,4,2,1,up,1983-12-03
24236,Soundtrack,1983-12-17,Soundtrack - The Big Chill,45,49,40,40.0,43,The Big Chill,8.0,2,3,2,4,1,up,1983-12-03
24237,Soundtrack,1983-12-24,Soundtrack - The Big Chill,43,45,40,40.0,40,The Big Chill,8.0,3,0,3,2,0,stay,1983-12-03
24238,Soundtrack,1983-12-31,Soundtrack - The Big Chill,40,43,40,40.0,40,The Big Chill,8.0,4,0,0,3,0,stay,1983-12-03
24239,Soundtrack,1984-01-07,Soundtrack - The Big Chill,40,40,40,40.0,40,The Big Chill,8.0,5,0,0,0,0,stay,1983-12-03
24240,Soundtrack,1984-01-14,Soundtrack - The Big Chill,40,40,47,40.0,40,The Big Chill,8.0,6,-7,0,0,1,down,1983-12-03
24241,Soundtrack,1984-01-21,Soundtrack - The Big Chill,40,40,47,40.0,47,The Big Chill,8.0,7,0,-7,0,0,stay,1983-12-03
24242,Soundtrack,1984-01-28,Soundtrack - The Big Chill,47,40,51,40.0,47,The Big Chill,8.0,8,-4,0,-7,1,down,1983-12-03
24243,Kool & The Gang,1983-12-10,Kool & The Gang - In The Heart,51,51,21,5.0,33,In The Heart,33.0,0,12,18,0,1,up,1983-12-10
24244,Kool & The Gang,1983-12-17,Kool & The Gang - In The Heart,33,51,13,5.0,21,In The Heart,33.0,1,8,12,18,1,up,1983-12-10
24245,Kool & The Gang,1983-12-24,Kool & The Gang - In The Heart,21,33,13,5.0,13,In The Heart,33.0,2,0,8,12,0,stay,1983-12-10
24246,Kool & The Gang,1983-12-31,Kool & The Gang - In The Heart,13,21,13,5.0,13,In The Heart,33.0,3,0,0,8,0,stay,1983-12-10
24247,Kool & The Gang,1984-01-07,Kool & The Gang - In The Heart,13,13,7,5.0,13,In The Heart,33.0,4,6,0,0,1,up,1983-12-10
24248,Kool & The Gang,1984-01-14,Kool & The Gang - In The Heart,13,13,5,5.0,7,In The Heart,33.0,5,2,6,0,1,up,1983-12-10
24249,Kool & The Gang,1984-01-21,Kool & The Gang - In The Heart,7,13,5,5.0,5,In The Heart,33.0,6,0,2,6,0,stay,1983-12-10
24250,Kool & The Gang,1984-01-28,Kool & The Gang - In The Heart,5,7,5,5.0,5,In The Heart,33.0,7,0,0,2,0,stay,1983-12-10
24251,Kool & The Gang,1984-02-04,Kool & The Gang - In The Heart,5,5,5,5.0,5,In The Heart,33.0,8,0,0,0,0,stay,1983-12-10
24252,Kool & The Gang,1984-02-11,Kool & The Gang - In The Heart,5,5,6,5.0,5,In The Heart,33.0,9,-1,0,0,1,down,1983-12-10
24253,Kool & The Gang,1984-02-18,Kool & The Gang - In The Heart,5,5,7,5.0,6,In The Heart,33.0,10,-1,-1,0,1,down,1983-12-10
24254,Kool & The Gang,1984-02-25,Kool & The Gang - In The Heart,6,5,7,5.0,7,In The Heart,33.0,11,0,-1,-1,0,stay,1983-12-10
24255,Kool & The Gang,1984-03-03,Kool & The Gang - In The Heart,7,6,7,5.0,7,In The Heart,33.0,12,0,0,-1,0,stay,1983-12-10
24256,Kool & The Gang,1984-03-10,Kool & The Gang - In The Heart,7,7,9,5.0,7,In The Heart,33.0,13,-2,0,0,1,down,1983-12-10
24257,Kool & The Gang,1984-03-17,Kool & The Gang - In The Heart,7,7,15,5.0,9,In The Heart,33.0,14,-6,-2,0,1,down,1983-12-10
24258,Kool & The Gang,1984-03-24,Kool & The Gang - In The Heart,9,7,15,5.0,15,In The Heart,33.0,15,0,-6,-2,0,stay,1983-12-10
24259,Kool & The Gang,1984-03-31,Kool & The Gang - In The Heart,15,9,17,5.0,15,In The Heart,33.0,16,-2,0,-6,1,down,1983-12-10
24260,Kool & The Gang,1984-04-07,Kool & The Gang - In The Heart,15,15,17,5.0,17,In The Heart,33.0,17,0,-2,0,0,stay,1983-12-10
24261,Kool & The Gang,1984-04-14,Kool & The Gang - In The Heart,17,15,16,5.0,17,In The Heart,33.0,18,1,0,-2,1,up,1983-12-10
24262,Kool & The Gang,1984-04-21,Kool & The Gang - In The Heart,17,17,14,5.0,16,In The Heart,33.0,19,2,1,0,1,up,1983-12-10
24263,Kool & The Gang,1984-04-28,Kool & The Gang - In The Heart,16,17,13,5.0,14,In The Heart,33.0,20,1,2,1,1,up,1983-12-10
24264,Kool & The Gang,1984-05-05,Kool & The Gang - In The Heart,14,16,13,5.0,13,In The Heart,33.0,21,0,1,2,0,stay,1983-12-10
24265,Kool & The Gang,1984-05-12,Kool & The Gang - In The Heart,13,14,11,5.0,13,In The Heart,33.0,22,2,0,1,1,up,1983-12-10
24266,Kool & The Gang,1984-05-19,Kool & The Gang - In The Heart,13,13,11,5.0,11,In The Heart,33.0,23,0,2,0,0,stay,1983-12-10
24267,Kool & The Gang,1984-05-26,Kool & The Gang - In The Heart,11,13,15,5.0,11,In The Heart,33.0,24,-4,0,2,1,down,1983-12-10
24268,Kool & The Gang,1984-06-02,Kool & The Gang - In The Heart,11,11,19,5.0,15,In The Heart,33.0,25,-4,-4,0,1,down,1983-12-10
24269,Kool & The Gang,1984-06-09,Kool & The Gang - In The Heart,15,11,28,5.0,19,In The Heart,33.0,26,-9,-4,-4,1,down,1983-12-10
24270,Kool & The Gang,1984-06-16,Kool & The Gang - In The Heart,19,15,39,5.0,28,In The Heart,33.0,27,-11,-9,-4,1,down,1983-12-10
24271,Kool & The Gang,1984-06-23,Kool & The Gang - In The Heart,28,19,39,5.0,39,In The Heart,33.0,28,0,-11,-9,0,stay,1983-12-10
24272,Kool & The Gang,1984-06-30,Kool & The Gang - In The Heart,39,28,37,5.0,39,In The Heart,33.0,29,2,0,-11,1,up,1983-12-10
24273,Kool & The Gang,1984-07-07,Kool & The Gang - In The Heart,39,39,41,5.0,37,In The Heart,33.0,30,-4,2,0,1,down,1983-12-10
24274,Kool & The Gang,1984-07-14,Kool & The Gang - In The Heart,37,39,41,5.0,41,In The Heart,33.0,31,0,-4,2,0,stay,1983-12-10
24275,Kool & The Gang,1984-07-21,Kool & The Gang - In The Heart,41,37,46,5.0,41,In The Heart,33.0,32,-5,0,-4,1,down,1983-12-10
24276,Kool & The Gang,1984-07-28,Kool & The Gang - In The Heart,41,41,51,5.0,46,In The Heart,33.0,33,-5,-5,0,1,down,1983-12-10
24277,Z.Z. Hill,1983-12-17,Z.Z. Hill - I'm A Blues Man,51,51,32,15.0,40,I'm A Blues Man,37.0,0,8,11,0,1,up,1983-12-17
24278,Z.Z. Hill,1983-12-24,Z.Z. Hill - I'm A Blues Man,40,51,32,15.0,32,I'm A Blues Man,37.0,1,0,8,11,0,stay,1983-12-17
24279,Z.Z. Hill,1983-12-31,Z.Z. Hill - I'm A Blues Man,32,40,30,15.0,32,I'm A Blues Man,37.0,2,2,0,8,1,up,1983-12-17
24280,Z.Z. Hill,1984-01-07,Z.Z. Hill - I'm A Blues Man,32,32,23,15.0,30,I'm A Blues Man,37.0,3,7,2,0,1,up,1983-12-17
24281,Z.Z. Hill,1984-01-14,Z.Z. Hill - I'm A Blues Man,30,32,23,15.0,23,I'm A Blues Man,37.0,4,0,7,2,0,stay,1983-12-17
24282,Z.Z. Hill,1984-01-21,Z.Z. Hill - I'm A Blues Man,23,30,21,15.0,23,I'm A Blues Man,37.0,5,2,0,7,1,up,1983-12-17
24283,Z.Z. Hill,1984-01-28,Z.Z. Hill - I'm A Blues Man,23,23,20,15.0,21,I'm A Blues Man,37.0,6,1,2,0,1,up,1983-12-17
24284,Z.Z. Hill,1984-02-04,Z.Z. Hill - I'm A Blues Man,21,23,20,15.0,20,I'm A Blues Man,37.0,7,0,1,2,0,stay,1983-12-17
24285,Z.Z. Hill,1984-02-11,Z.Z. Hill - I'm A Blues Man,20,21,17,15.0,20,I'm A Blues Man,37.0,8,3,0,1,1,up,1983-12-17
24286,Z.Z. Hill,1984-02-18,Z.Z. Hill - I'm A Blues Man,20,20,17,15.0,17,I'm A Blues Man,37.0,9,0,3,0,0,stay,1983-12-17
24287,Z.Z. Hill,1984-02-25,Z.Z. Hill - I'm A Blues Man,17,20,15,15.0,17,I'm A Blues Man,37.0,10,2,0,3,1,up,1983-12-17
24288,Z.Z. Hill,1984-03-03,Z.Z. Hill - I'm A Blues Man,17,17,15,15.0,15,I'm A Blues Man,37.0,11,0,2,0,0,stay,1983-12-17
24289,Z.Z. Hill,1984-03-10,Z.Z. Hill - I'm A Blues Man,15,17,27,15.0,15,I'm A Blues Man,37.0,12,-12,0,2,1,down,1983-12-17
24290,Z.Z. Hill,1984-03-17,Z.Z. Hill - I'm A Blues Man,15,15,27,15.0,27,I'm A Blues Man,37.0,13,0,-12,0,0,stay,1983-12-17
24291,Z.Z. Hill,1984-03-24,Z.Z. Hill - I'm A Blues Man,27,15,26,15.0,27,I'm A Blues Man,37.0,14,1,0,-12,1,up,1983-12-17
24292,Z.Z. Hill,1984-03-31,Z.Z. Hill - I'm A Blues Man,27,27,31,15.0,26,I'm A Blues Man,37.0,15,-5,1,0,1,down,1983-12-17
24293,Z.Z. Hill,1984-04-07,Z.Z. Hill - I'm A Blues Man,26,27,30,15.0,31,I'm A Blues Man,37.0,16,1,-5,1,1,up,1983-12-17
24294,Z.Z. Hill,1984-04-14,Z.Z. Hill - I'm A Blues Man,31,26,29,15.0,30,I'm A Blues Man,37.0,17,1,1,-5,1,up,1983-12-17
24295,Z.Z. Hill,1984-04-21,Z.Z. Hill - I'm A Blues Man,30,31,29,15.0,29,I'm A Blues Man,37.0,18,0,1,1,0,stay,1983-12-17
24296,Z.Z. Hill,1984-04-28,Z.Z. Hill - I'm A Blues Man,29,30,32,15.0,29,I'm A Blues Man,37.0,19,-3,0,1,1,down,1983-12-17
24297,Z.Z. Hill,1984-05-05,Z.Z. Hill - I'm A Blues Man,29,29,39,15.0,32,I'm A Blues Man,37.0,20,-7,-3,0,1,down,1983-12-17
24298,Z.Z. Hill,1984-05-12,Z.Z. Hill - I'm A Blues Man,32,29,35,15.0,39,I'm A Blues Man,37.0,21,4,-7,-3,1,up,1983-12-17
24299,Z.Z. Hill,1984-05-19,Z.Z. Hill - I'm A Blues Man,39,32,33,15.0,35,I'm A Blues Man,37.0,22,2,4,-7,1,up,1983-12-17
24300,Z.Z. Hill,1984-05-26,Z.Z. Hill - I'm A Blues Man,35,39,33,15.0,33,I'm A Blues Man,37.0,23,0,2,4,0,stay,1983-12-17
24301,Z.Z. Hill,1984-06-02,Z.Z. Hill - I'm A Blues Man,33,35,32,15.0,33,I'm A Blues Man,37.0,24,1,0,2,1,up,1983-12-17
24302,Z.Z. Hill,1984-06-09,Z.Z. Hill - I'm A Blues Man,33,33,39,15.0,32,I'm A Blues Man,37.0,25,-7,1,0,1,down,1983-12-17
24303,Z.Z. Hill,1984-06-16,Z.Z. Hill - I'm A Blues Man,32,33,38,15.0,39,I'm A Blues Man,37.0,26,1,-7,1,1,up,1983-12-17
24304,Z.Z. Hill,1984-06-23,Z.Z. Hill - I'm A Blues Man,39,32,38,15.0,38,I'm A Blues Man,37.0,27,0,1,-7,0,stay,1983-12-17
24305,Z.Z. Hill,1984-06-30,Z.Z. Hill - I'm A Blues Man,38,39,48,15.0,38,I'm A Blues Man,37.0,28,-10,0,1,1,down,1983-12-17
24306,Z.Z. Hill,1984-07-07,Z.Z. Hill - I'm A Blues Man,38,38,48,15.0,48,I'm A Blues Man,37.0,29,0,-10,0,0,stay,1983-12-17
24307,Z.Z. Hill,1984-07-14,Z.Z. Hill - I'm A Blues Man,48,38,49,15.0,48,I'm A Blues Man,37.0,30,-1,0,-10,1,down,1983-12-17
24308,Z.Z. Hill,1984-07-21,Z.Z. Hill - I'm A Blues Man,48,48,49,15.0,49,I'm A Blues Man,37.0,31,0,-1,0,0,stay,1983-12-17
24309,Z.Z. Hill,1984-07-28,Z.Z. Hill - I'm A Blues Man,49,48,46,15.0,49,I'm A Blues Man,37.0,32,3,0,-1,1,up,1983-12-17
24310,Z.Z. Hill,1984-08-04,Z.Z. Hill - I'm A Blues Man,49,49,41,15.0,46,I'm A Blues Man,37.0,33,5,3,0,1,up,1983-12-17
24311,Z.Z. Hill,1984-08-11,Z.Z. Hill - I'm A Blues Man,46,49,41,15.0,41,I'm A Blues Man,37.0,34,0,5,3,0,stay,1983-12-17
24312,Z.Z. Hill,1984-08-18,Z.Z. Hill - I'm A Blues Man,41,46,45,15.0,41,I'm A Blues Man,37.0,35,-4,0,5,1,down,1983-12-17
24313,Z.Z. Hill,1984-08-25,Z.Z. Hill - I'm A Blues Man,41,41,46,15.0,45,I'm A Blues Man,37.0,36,-1,-4,0,1,down,1983-12-17
24314,Z.Z. Hill,1984-09-01,Z.Z. Hill - I'm A Blues Man,45,41,51,15.0,46,I'm A Blues Man,37.0,37,-5,-1,-4,1,down,1983-12-17
24315,Pieces Of A Dream,1983-12-17,Pieces Of A Dream - Imagine This,51,51,39,16.0,50,Imagine This,20.0,0,11,1,0,1,up,1983-12-17
24316,Pieces Of A Dream,1983-12-24,Pieces Of A Dream - Imagine This,50,51,39,16.0,39,Imagine This,20.0,1,0,11,1,0,stay,1983-12-17
24317,Pieces Of A Dream,1983-12-31,Pieces Of A Dream - Imagine This,39,50,37,16.0,39,Imagine This,20.0,2,2,0,11,1,up,1983-12-17
24318,Pieces Of A Dream,1984-01-07,Pieces Of A Dream - Imagine This,39,39,34,16.0,37,Imagine This,20.0,3,3,2,0,1,up,1983-12-17
24319,Pieces Of A Dream,1984-01-14,Pieces Of A Dream - Imagine This,37,39,22,16.0,34,Imagine This,20.0,4,12,3,2,1,up,1983-12-17
24320,Pieces Of A Dream,1984-01-21,Pieces Of A Dream - Imagine This,34,37,16,16.0,22,Imagine This,20.0,5,6,12,3,1,up,1983-12-17
24321,Pieces Of A Dream,1984-01-28,Pieces Of A Dream - Imagine This,22,34,16,16.0,16,Imagine This,20.0,6,0,6,12,0,stay,1983-12-17
24322,Pieces Of A Dream,1984-02-04,Pieces Of A Dream - Imagine This,16,22,16,16.0,16,Imagine This,20.0,7,0,0,6,0,stay,1983-12-17
24323,Pieces Of A Dream,1984-02-11,Pieces Of A Dream - Imagine This,16,16,24,16.0,16,Imagine This,20.0,8,-8,0,0,1,down,1983-12-17
24324,Pieces Of A Dream,1984-02-18,Pieces Of A Dream - Imagine This,16,16,23,16.0,24,Imagine This,20.0,9,1,-8,0,1,up,1983-12-17
24325,Pieces Of A Dream,1984-02-25,Pieces Of A Dream - Imagine This,24,16,23,16.0,23,Imagine This,20.0,10,0,1,-8,0,stay,1983-12-17
24326,Pieces Of A Dream,1984-03-03,Pieces Of A Dream - Imagine This,23,24,22,16.0,23,Imagine This,20.0,11,1,0,1,1,up,1983-12-17
24327,Pieces Of A Dream,1984-03-10,Pieces Of A Dream - Imagine This,23,23,28,16.0,22,Imagine This,20.0,12,-6,1,0,1,down,1983-12-17
24328,Pieces Of A Dream,1984-03-17,Pieces Of A Dream - Imagine This,22,23,29,16.0,28,Imagine This,20.0,13,-1,-6,1,1,down,1983-12-17
24329,Pieces Of A Dream,1984-03-24,Pieces Of A Dream - Imagine This,28,22,29,16.0,29,Imagine This,20.0,14,0,-1,-6,0,stay,1983-12-17
24330,Pieces Of A Dream,1984-03-31,Pieces Of A Dream - Imagine This,29,28,35,16.0,29,Imagine This,20.0,15,-6,0,-1,1,down,1983-12-17
24331,Pieces Of A Dream,1984-04-07,Pieces Of A Dream - Imagine This,29,29,34,16.0,35,Imagine This,20.0,16,1,-6,0,1,up,1983-12-17
24332,Pieces Of A Dream,1984-04-14,Pieces Of A Dream - Imagine This,35,29,35,16.0,34,Imagine This,20.0,17,-1,1,-6,1,down,1983-12-17
24333,Pieces Of A Dream,1984-04-21,Pieces Of A Dream - Imagine This,34,35,34,16.0,35,Imagine This,20.0,18,1,-1,1,1,up,1983-12-17
24334,Pieces Of A Dream,1984-04-28,Pieces Of A Dream - Imagine This,35,34,44,16.0,34,Imagine This,20.0,19,-10,1,-1,1,down,1983-12-17
24335,Pieces Of A Dream,1984-05-05,Pieces Of A Dream - Imagine This,34,35,51,16.0,44,Imagine This,20.0,20,-7,-10,1,1,down,1983-12-17
24336,Melba Moore,1983-12-24,Melba Moore - Never Say Never,51,51,34,9.0,34,Never Say Never,30.0,0,0,17,0,0,stay,1983-12-24
24337,Melba Moore,1983-12-31,Melba Moore - Never Say Never,34,51,32,9.0,34,Never Say Never,30.0,1,2,0,17,1,up,1983-12-24
24338,Melba Moore,1984-01-07,Melba Moore - Never Say Never,34,34,32,9.0,32,Never Say Never,30.0,2,0,2,0,0,stay,1983-12-24
24339,Melba Moore,1984-01-14,Melba Moore - Never Say Never,32,34,32,9.0,32,Never Say Never,30.0,3,0,0,2,0,stay,1983-12-24
24340,Melba Moore,1984-01-21,Melba Moore - Never Say Never,32,32,30,9.0,32,Never Say Never,30.0,4,2,0,0,1,up,1983-12-24
24341,Melba Moore,1984-01-28,Melba Moore - Never Say Never,32,32,28,9.0,30,Never Say Never,30.0,5,2,2,0,1,up,1983-12-24
24342,Melba Moore,1984-02-04,Melba Moore - Never Say Never,30,32,26,9.0,28,Never Say Never,30.0,6,2,2,2,1,up,1983-12-24
24343,Melba Moore,1984-02-11,Melba Moore - Never Say Never,28,30,19,9.0,26,Never Say Never,30.0,7,7,2,2,1,up,1983-12-24
24344,Melba Moore,1984-02-18,Melba Moore - Never Say Never,26,28,18,9.0,19,Never Say Never,30.0,8,1,7,2,1,up,1983-12-24
24345,Melba Moore,1984-02-25,Melba Moore - Never Say Never,19,26,16,9.0,18,Never Say Never,30.0,9,2,1,7,1,up,1983-12-24
24346,Melba Moore,1984-03-03,Melba Moore - Never Say Never,18,19,14,9.0,16,Never Say Never,30.0,10,2,2,1,1,up,1983-12-24
24347,Melba Moore,1984-03-10,Melba Moore - Never Say Never,16,18,11,9.0,14,Never Say Never,30.0,11,3,2,2,1,up,1983-12-24
24348,Melba Moore,1984-03-17,Melba Moore - Never Say Never,14,16,11,9.0,11,Never Say Never,30.0,12,0,3,2,0,stay,1983-12-24
24349,Melba Moore,1984-03-24,Melba Moore - Never Say Never,11,14,9,9.0,11,Never Say Never,30.0,13,2,0,3,1,up,1983-12-24
24350,Melba Moore,1984-03-31,Melba Moore - Never Say Never,11,11,9,9.0,9,Never Say Never,30.0,14,0,2,0,0,stay,1983-12-24
24351,Melba Moore,1984-04-07,Melba Moore - Never Say Never,9,11,9,9.0,9,Never Say Never,30.0,15,0,0,2,0,stay,1983-12-24
24352,Melba Moore,1984-04-14,Melba Moore - Never Say Never,9,9,9,9.0,9,Never Say Never,30.0,16,0,0,0,0,stay,1983-12-24
24353,Melba Moore,1984-04-21,Melba Moore - Never Say Never,9,9,12,9.0,9,Never Say Never,30.0,17,-3,0,0,1,down,1983-12-24
24354,Melba Moore,1984-04-28,Melba Moore - Never Say Never,9,9,24,9.0,12,Never Say Never,30.0,18,-12,-3,0,1,down,1983-12-24
24355,Melba Moore,1984-05-05,Melba Moore - Never Say Never,12,9,21,9.0,24,Never Say Never,30.0,19,3,-12,-3,1,up,1983-12-24
24356,Melba Moore,1984-05-12,Melba Moore - Never Say Never,24,12,19,9.0,21,Never Say Never,30.0,20,2,3,-12,1,up,1983-12-24
24357,Melba Moore,1984-05-19,Melba Moore - Never Say Never,21,24,17,9.0,19,Never Say Never,30.0,21,2,2,3,1,up,1983-12-24
24358,Melba Moore,1984-05-26,Melba Moore - Never Say Never,19,21,17,9.0,17,Never Say Never,30.0,22,0,2,2,0,stay,1983-12-24
24359,Melba Moore,1984-06-02,Melba Moore - Never Say Never,17,19,14,9.0,17,Never Say Never,30.0,23,3,0,2,1,up,1983-12-24
24360,Melba Moore,1984-06-09,Melba Moore - Never Say Never,17,17,14,9.0,14,Never Say Never,30.0,24,0,3,0,0,stay,1983-12-24
24361,Melba Moore,1984-06-16,Melba Moore - Never Say Never,14,17,21,9.0,14,Never Say Never,30.0,25,-7,0,3,1,down,1983-12-24
24362,Melba Moore,1984-06-23,Melba Moore - Never Say Never,14,14,25,9.0,21,Never Say Never,30.0,26,-4,-7,0,1,down,1983-12-24
24363,Melba Moore,1984-06-30,Melba Moore - Never Say Never,21,14,25,9.0,25,Never Say Never,30.0,27,0,-4,-7,0,stay,1983-12-24
24364,Melba Moore,1984-07-07,Melba Moore - Never Say Never,25,21,36,9.0,25,Never Say Never,30.0,28,-11,0,-4,1,down,1983-12-24
24365,Melba Moore,1984-07-14,Melba Moore - Never Say Never,25,25,47,9.0,36,Never Say Never,30.0,29,-11,-11,0,1,down,1983-12-24
24366,Melba Moore,1984-07-21,Melba Moore - Never Say Never,36,25,51,9.0,47,Never Say Never,30.0,30,-4,-11,-11,1,down,1983-12-24
24367,Dazz Band,1983-12-24,Dazz Band - Joystick,51,51,38,12.0,38,Joystick,30.0,0,0,13,0,0,stay,1983-12-24
24368,Dazz Band,1983-12-31,Dazz Band - Joystick,38,51,33,12.0,38,Joystick,30.0,1,5,0,13,1,up,1983-12-24
24369,Dazz Band,1984-01-07,Dazz Band - Joystick,38,38,33,12.0,33,Joystick,30.0,2,0,5,0,0,stay,1983-12-24
24370,Dazz Band,1984-01-14,Dazz Band - Joystick,33,38,30,12.0,33,Joystick,30.0,3,3,0,5,1,up,1983-12-24
24371,Dazz Band,1984-01-21,Dazz Band - Joystick,33,33,20,12.0,30,Joystick,30.0,4,10,3,0,1,up,1983-12-24
24372,Dazz Band,1984-01-28,Dazz Band - Joystick,30,33,19,12.0,20,Joystick,30.0,5,1,10,3,1,up,1983-12-24
24373,Dazz Band,1984-02-04,Dazz Band - Joystick,20,30,15,12.0,19,Joystick,30.0,6,4,1,10,1,up,1983-12-24
24374,Dazz Band,1984-02-11,Dazz Band - Joystick,19,20,13,12.0,15,Joystick,30.0,7,2,4,1,1,up,1983-12-24
24375,Dazz Band,1984-02-18,Dazz Band - Joystick,15,19,12,12.0,13,Joystick,30.0,8,1,2,4,1,up,1983-12-24
24376,Dazz Band,1984-02-25,Dazz Band - Joystick,13,15,12,12.0,12,Joystick,30.0,9,0,1,2,0,stay,1983-12-24
24377,Dazz Band,1984-03-03,Dazz Band - Joystick,12,13,12,12.0,12,Joystick,30.0,10,0,0,1,0,stay,1983-12-24
24378,Dazz Band,1984-03-10,Dazz Band - Joystick,12,12,16,12.0,12,Joystick,30.0,11,-4,0,0,1,down,1983-12-24
24379,Dazz Band,1984-03-17,Dazz Band - Joystick,12,12,17,12.0,16,Joystick,30.0,12,-1,-4,0,1,down,1983-12-24
24380,Dazz Band,1984-03-24,Dazz Band - Joystick,16,12,28,12.0,17,Joystick,30.0,13,-11,-1,-4,1,down,1983-12-24
24381,Dazz Band,1984-03-31,Dazz Band - Joystick,17,16,26,12.0,28,Joystick,30.0,14,2,-11,-1,1,up,1983-12-24
24382,Dazz Band,1984-04-07,Dazz Band - Joystick,28,17,25,12.0,26,Joystick,30.0,15,1,2,-11,1,up,1983-12-24
24383,Dazz Band,1984-04-14,Dazz Band - Joystick,26,28,24,12.0,25,Joystick,30.0,16,1,1,2,1,up,1983-12-24
24384,Dazz Band,1984-04-21,Dazz Band - Joystick,25,26,24,12.0,24,Joystick,30.0,17,0,1,1,0,stay,1983-12-24
24385,Dazz Band,1984-04-28,Dazz Band - Joystick,24,25,22,12.0,24,Joystick,30.0,18,2,0,1,1,up,1983-12-24
24386,Dazz Band,1984-05-05,Dazz Band - Joystick,24,24,20,12.0,22,Joystick,30.0,19,2,2,0,1,up,1983-12-24
24387,Dazz Band,1984-05-12,Dazz Band - Joystick,22,24,20,12.0,20,Joystick,30.0,20,0,2,2,0,stay,1983-12-24
24388,Dazz Band,1984-05-19,Dazz Band - Joystick,20,22,24,12.0,20,Joystick,30.0,21,-4,0,2,1,down,1983-12-24
24389,Dazz Band,1984-05-26,Dazz Band - Joystick,20,20,26,12.0,24,Joystick,30.0,22,-2,-4,0,1,down,1983-12-24
24390,Dazz Band,1984-06-02,Dazz Band - Joystick,24,20,26,12.0,26,Joystick,30.0,23,0,-2,-4,0,stay,1983-12-24
24391,Dazz Band,1984-06-09,Dazz Band - Joystick,26,24,25,12.0,26,Joystick,30.0,24,1,0,-2,1,up,1983-12-24
24392,Dazz Band,1984-06-16,Dazz Band - Joystick,26,26,31,12.0,25,Joystick,30.0,25,-6,1,0,1,down,1983-12-24
24393,Dazz Band,1984-06-23,Dazz Band - Joystick,25,26,30,12.0,31,Joystick,30.0,26,1,-6,1,1,up,1983-12-24
24394,Dazz Band,1984-06-30,Dazz Band - Joystick,31,25,30,12.0,30,Joystick,30.0,27,0,1,-6,0,stay,1983-12-24
24395,Dazz Band,1984-07-07,Dazz Band - Joystick,30,31,35,12.0,30,Joystick,30.0,28,-5,0,1,1,down,1983-12-24
24396,Dazz Band,1984-07-14,Dazz Band - Joystick,30,30,39,12.0,35,Joystick,30.0,29,-4,-5,0,1,down,1983-12-24
24397,Dazz Band,1984-07-21,Dazz Band - Joystick,35,30,51,12.0,39,Joystick,30.0,30,-12,-4,-5,1,down,1983-12-24
24398,The Deele,1983-12-24,The Deele - Street Beat,51,51,42,9.0,42,Street Beat,24.0,0,0,9,0,0,stay,1983-12-24
24399,The Deele,1983-12-31,The Deele - Street Beat,42,51,39,9.0,42,Street Beat,24.0,1,3,0,9,1,up,1983-12-24
24400,The Deele,1984-01-07,The Deele - Street Beat,42,42,36,9.0,39,Street Beat,24.0,2,3,3,0,1,up,1983-12-24
24401,The Deele,1984-01-14,The Deele - Street Beat,39,42,31,9.0,36,Street Beat,24.0,3,5,3,3,1,up,1983-12-24
24402,The Deele,1984-01-21,The Deele - Street Beat,36,39,19,9.0,31,Street Beat,24.0,4,12,5,3,1,up,1983-12-24
24403,The Deele,1984-01-28,The Deele - Street Beat,31,36,18,9.0,19,Street Beat,24.0,5,1,12,5,1,up,1983-12-24
24404,The Deele,1984-02-04,The Deele - Street Beat,19,31,13,9.0,18,Street Beat,24.0,6,5,1,12,1,up,1983-12-24
24405,The Deele,1984-02-11,The Deele - Street Beat,18,19,9,9.0,13,Street Beat,24.0,7,4,5,1,1,up,1983-12-24
24406,The Deele,1984-02-18,The Deele - Street Beat,13,18,9,9.0,9,Street Beat,24.0,8,0,4,5,0,stay,1983-12-24
24407,The Deele,1984-02-25,The Deele - Street Beat,9,13,13,9.0,9,Street Beat,24.0,9,-4,0,4,1,down,1983-12-24
24408,The Deele,1984-03-03,The Deele - Street Beat,9,9,18,9.0,13,Street Beat,24.0,10,-5,-4,0,1,down,1983-12-24
24409,The Deele,1984-03-10,The Deele - Street Beat,13,9,17,9.0,18,Street Beat,24.0,11,1,-5,-4,1,up,1983-12-24
24410,The Deele,1984-03-17,The Deele - Street Beat,18,13,19,9.0,17,Street Beat,24.0,12,-2,1,-5,1,down,1983-12-24
24411,The Deele,1984-03-24,The Deele - Street Beat,17,18,25,9.0,19,Street Beat,24.0,13,-6,-2,1,1,down,1983-12-24
24412,The Deele,1984-03-31,The Deele - Street Beat,19,17,25,9.0,25,Street Beat,24.0,14,0,-6,-2,0,stay,1983-12-24
24413,The Deele,1984-04-07,The Deele - Street Beat,25,19,29,9.0,25,Street Beat,24.0,15,-4,0,-6,1,down,1983-12-24
24414,The Deele,1984-04-14,The Deele - Street Beat,25,25,25,9.0,29,Street Beat,24.0,16,4,-4,0,1,up,1983-12-24
24415,The Deele,1984-04-21,The Deele - Street Beat,29,25,25,9.0,25,Street Beat,24.0,17,0,4,-4,0,stay,1983-12-24
24416,The Deele,1984-04-28,The Deele - Street Beat,25,29,31,9.0,25,Street Beat,24.0,18,-6,0,4,1,down,1983-12-24
24417,The Deele,1984-05-05,The Deele - Street Beat,25,25,37,9.0,31,Street Beat,24.0,19,-6,-6,0,1,down,1983-12-24
24418,The Deele,1984-05-12,The Deele - Street Beat,31,25,42,9.0,37,Street Beat,24.0,20,-5,-6,-6,1,down,1983-12-24
24419,The Deele,1984-05-19,The Deele - Street Beat,37,31,40,9.0,42,Street Beat,24.0,21,2,-5,-6,1,up,1983-12-24
24420,The Deele,1984-05-26,The Deele - Street Beat,42,37,39,9.0,40,Street Beat,24.0,22,1,2,-5,1,up,1983-12-24
24421,The Deele,1984-06-02,The Deele - Street Beat,40,42,43,9.0,39,Street Beat,24.0,23,-4,1,2,1,down,1983-12-24
24422,The Deele,1984-06-09,The Deele - Street Beat,39,40,51,9.0,43,Street Beat,24.0,24,-8,-4,1,1,down,1983-12-24
24423,Irene Cara,1983-12-24,Irene Cara - What A Feelin',51,51,49,45.0,49,What A Feelin',7.0,0,0,2,0,0,stay,1983-12-24
24424,Irene Cara,1983-12-31,Irene Cara - What A Feelin',49,51,45,45.0,49,What A Feelin',7.0,1,4,0,2,1,up,1983-12-24
24425,Irene Cara,1984-01-07,Irene Cara - What A Feelin',49,49,45,45.0,45,What A Feelin',7.0,2,0,4,0,0,stay,1983-12-24
24426,Irene Cara,1984-01-14,Irene Cara - What A Feelin',45,49,49,45.0,45,What A Feelin',7.0,3,-4,0,4,1,down,1983-12-24
24427,Irene Cara,1984-01-21,Irene Cara - What A Feelin',45,45,49,45.0,49,What A Feelin',7.0,4,0,-4,0,0,stay,1983-12-24
24428,Irene Cara,1984-01-28,Irene Cara - What A Feelin',49,45,48,45.0,49,What A Feelin',7.0,5,1,0,-4,1,up,1983-12-24
24429,Irene Cara,1984-02-04,Irene Cara - What A Feelin',49,49,47,45.0,48,What A Feelin',7.0,6,1,1,0,1,up,1983-12-24
24430,Irene Cara,1984-02-11,Irene Cara - What A Feelin',48,49,51,45.0,47,What A Feelin',7.0,7,-4,1,1,1,down,1983-12-24
24431,Patti LaBelle,1984-01-07,Patti LaBelle - I'm In Love Again,51,51,10,4.0,21,I'm In Love Again,36.0,0,11,30,0,1,up,1984-01-07
24432,Patti LaBelle,1984-01-14,Patti LaBelle - I'm In Love Again,21,51,8,4.0,10,I'm In Love Again,36.0,1,2,11,30,1,up,1984-01-07
24433,Patti LaBelle,1984-01-21,Patti LaBelle - I'm In Love Again,10,21,7,4.0,8,I'm In Love Again,36.0,2,1,2,11,1,up,1984-01-07
24434,Patti LaBelle,1984-01-28,Patti LaBelle - I'm In Love Again,8,10,6,4.0,7,I'm In Love Again,36.0,3,1,1,2,1,up,1984-01-07
24435,Patti LaBelle,1984-02-04,Patti LaBelle - I'm In Love Again,7,8,4,4.0,6,I'm In Love Again,36.0,4,2,1,1,1,up,1984-01-07
24436,Patti LaBelle,1984-02-11,Patti LaBelle - I'm In Love Again,6,7,4,4.0,4,I'm In Love Again,36.0,5,0,2,1,0,stay,1984-01-07
24437,Patti LaBelle,1984-02-18,Patti LaBelle - I'm In Love Again,4,6,4,4.0,4,I'm In Love Again,36.0,6,0,0,2,0,stay,1984-01-07
24438,Patti LaBelle,1984-02-25,Patti LaBelle - I'm In Love Again,4,4,4,4.0,4,I'm In Love Again,36.0,7,0,0,0,0,stay,1984-01-07
24439,Patti LaBelle,1984-03-03,Patti LaBelle - I'm In Love Again,4,4,4,4.0,4,I'm In Love Again,36.0,8,0,0,0,0,stay,1984-01-07
24440,Patti LaBelle,1984-03-10,Patti LaBelle - I'm In Love Again,4,4,4,4.0,4,I'm In Love Again,36.0,9,0,0,0,0,stay,1984-01-07
24441,Patti LaBelle,1984-03-17,Patti LaBelle - I'm In Love Again,4,4,4,4.0,4,I'm In Love Again,36.0,10,0,0,0,0,stay,1984-01-07
24442,Patti LaBelle,1984-03-24,Patti LaBelle - I'm In Love Again,4,4,4,4.0,4,I'm In Love Again,36.0,11,0,0,0,0,stay,1984-01-07
24443,Patti LaBelle,1984-03-31,Patti LaBelle - I'm In Love Again,4,4,4,4.0,4,I'm In Love Again,36.0,12,0,0,0,0,stay,1984-01-07
24444,Patti LaBelle,1984-04-07,Patti LaBelle - I'm In Love Again,4,4,5,4.0,4,I'm In Love Again,36.0,13,-1,0,0,1,down,1984-01-07
24445,Patti LaBelle,1984-04-14,Patti LaBelle - I'm In Love Again,4,4,7,4.0,5,I'm In Love Again,36.0,14,-2,-1,0,1,down,1984-01-07
24446,Patti LaBelle,1984-04-21,Patti LaBelle - I'm In Love Again,5,4,7,4.0,7,I'm In Love Again,36.0,15,0,-2,-1,0,stay,1984-01-07
24447,Patti LaBelle,1984-04-28,Patti LaBelle - I'm In Love Again,7,5,7,4.0,7,I'm In Love Again,36.0,16,0,0,-2,0,stay,1984-01-07
24448,Patti LaBelle,1984-05-05,Patti LaBelle - I'm In Love Again,7,7,8,4.0,7,I'm In Love Again,36.0,17,-1,0,0,1,down,1984-01-07
24449,Patti LaBelle,1984-05-12,Patti LaBelle - I'm In Love Again,7,7,8,4.0,8,I'm In Love Again,36.0,18,0,-1,0,0,stay,1984-01-07
24450,Patti LaBelle,1984-05-19,Patti LaBelle - I'm In Love Again,8,7,10,4.0,8,I'm In Love Again,36.0,19,-2,0,-1,1,down,1984-01-07
24451,Patti LaBelle,1984-05-26,Patti LaBelle - I'm In Love Again,8,8,11,4.0,10,I'm In Love Again,36.0,20,-1,-2,0,1,down,1984-01-07
24452,Patti LaBelle,1984-06-02,Patti LaBelle - I'm In Love Again,10,8,10,4.0,11,I'm In Love Again,36.0,21,1,-1,-2,1,up,1984-01-07
24453,Patti LaBelle,1984-06-09,Patti LaBelle - I'm In Love Again,11,10,12,4.0,10,I'm In Love Again,36.0,22,-2,1,-1,1,down,1984-01-07
24454,Patti LaBelle,1984-06-16,Patti LaBelle - I'm In Love Again,10,11,13,4.0,12,I'm In Love Again,36.0,23,-1,-2,1,1,down,1984-01-07
24455,Patti LaBelle,1984-06-23,Patti LaBelle - I'm In Love Again,12,10,17,4.0,13,I'm In Love Again,36.0,24,-4,-1,-2,1,down,1984-01-07
24456,Patti LaBelle,1984-06-30,Patti LaBelle - I'm In Love Again,13,12,20,4.0,17,I'm In Love Again,36.0,25,-3,-4,-1,1,down,1984-01-07
24457,Patti LaBelle,1984-07-07,Patti LaBelle - I'm In Love Again,17,13,20,4.0,20,I'm In Love Again,36.0,26,0,-3,-4,0,stay,1984-01-07
24458,Patti LaBelle,1984-07-14,Patti LaBelle - I'm In Love Again,20,17,21,4.0,20,I'm In Love Again,36.0,27,-1,0,-3,1,down,1984-01-07
24459,Patti LaBelle,1984-07-21,Patti LaBelle - I'm In Love Again,20,20,21,4.0,21,I'm In Love Again,36.0,28,0,-1,0,0,stay,1984-01-07
24460,Patti LaBelle,1984-07-28,Patti LaBelle - I'm In Love Again,21,20,31,4.0,21,I'm In Love Again,36.0,29,-10,0,-1,1,down,1984-01-07
24461,Patti LaBelle,1984-08-04,Patti LaBelle - I'm In Love Again,21,21,28,4.0,31,I'm In Love Again,36.0,30,3,-10,0,1,up,1984-01-07
24462,Patti LaBelle,1984-08-11,Patti LaBelle - I'm In Love Again,31,21,28,4.0,28,I'm In Love Again,36.0,31,0,3,-10,0,stay,1984-01-07
24463,Patti LaBelle,1984-08-18,Patti LaBelle - I'm In Love Again,28,31,29,4.0,28,I'm In Love Again,36.0,32,-1,0,3,1,down,1984-01-07
24464,Patti LaBelle,1984-08-25,Patti LaBelle - I'm In Love Again,28,28,30,4.0,29,I'm In Love Again,36.0,33,-1,-1,0,1,down,1984-01-07
24465,Patti LaBelle,1984-09-01,Patti LaBelle - I'm In Love Again,29,28,45,4.0,30,I'm In Love Again,36.0,34,-15,-1,-1,1,down,1984-01-07
24466,Patti LaBelle,1984-09-08,Patti LaBelle - I'm In Love Again,30,29,43,4.0,45,I'm In Love Again,36.0,35,2,-15,-1,1,up,1984-01-07
24467,Patti LaBelle,1984-09-15,Patti LaBelle - I'm In Love Again,45,30,51,4.0,43,I'm In Love Again,36.0,36,-8,2,-15,1,down,1984-01-07
24468,Luther Vandross,1984-01-07,Luther Vandross - Busy Body,51,51,13,1.0,22,Busy Body,40.0,0,9,29,0,1,up,1984-01-07
24469,Luther Vandross,1984-01-14,Luther Vandross - Busy Body,22,51,10,1.0,13,Busy Body,40.0,1,3,9,29,1,up,1984-01-07
24470,Luther Vandross,1984-01-21,Luther Vandross - Busy Body,13,22,8,1.0,10,Busy Body,40.0,2,2,3,9,1,up,1984-01-07
24471,Luther Vandross,1984-01-28,Luther Vandross - Busy Body,10,13,4,1.0,8,Busy Body,40.0,3,4,2,3,1,up,1984-01-07
24472,Luther Vandross,1984-02-04,Luther Vandross - Busy Body,8,10,3,1.0,4,Busy Body,40.0,4,1,4,2,1,up,1984-01-07
24473,Luther Vandross,1984-02-11,Luther Vandross - Busy Body,4,8,3,1.0,3,Busy Body,40.0,5,0,1,4,0,stay,1984-01-07
24474,Luther Vandross,1984-02-18,Luther Vandross - Busy Body,3,4,3,1.0,3,Busy Body,40.0,6,0,0,1,0,stay,1984-01-07
24475,Luther Vandross,1984-02-25,Luther Vandross - Busy Body,3,3,3,1.0,3,Busy Body,40.0,7,0,0,0,0,stay,1984-01-07
24476,Luther Vandross,1984-03-03,Luther Vandross - Busy Body,3,3,3,1.0,3,Busy Body,40.0,8,0,0,0,0,stay,1984-01-07
24477,Luther Vandross,1984-03-10,Luther Vandross - Busy Body,3,3,2,1.0,3,Busy Body,40.0,9,1,0,0,1,up,1984-01-07
24478,Luther Vandross,1984-03-17,Luther Vandross - Busy Body,3,3,2,1.0,2,Busy Body,40.0,10,0,1,0,0,stay,1984-01-07
24479,Luther Vandross,1984-03-24,Luther Vandross - Busy Body,2,3,2,1.0,2,Busy Body,40.0,11,0,0,1,0,stay,1984-01-07
24480,Luther Vandross,1984-03-31,Luther Vandross - Busy Body,2,2,3,1.0,2,Busy Body,40.0,12,-1,0,0,1,down,1984-01-07
24481,Luther Vandross,1984-04-07,Luther Vandross - Busy Body,2,2,1,1.0,3,Busy Body,40.0,13,2,-1,0,1,up,1984-01-07
24482,Luther Vandross,1984-04-14,Luther Vandross - Busy Body,3,2,1,1.0,1,Busy Body,40.0,14,0,2,-1,0,stay,1984-01-07
24483,Luther Vandross,1984-04-21,Luther Vandross - Busy Body,1,3,2,1.0,1,Busy Body,40.0,15,-1,0,2,1,down,1984-01-07
24484,Luther Vandross,1984-04-28,Luther Vandross - Busy Body,1,1,3,1.0,2,Busy Body,40.0,16,-1,-1,0,1,down,1984-01-07
24485,Luther Vandross,1984-05-05,Luther Vandross - Busy Body,2,1,2,1.0,3,Busy Body,40.0,17,1,-1,-1,1,up,1984-01-07
24486,Luther Vandross,1984-05-12,Luther Vandross - Busy Body,3,2,3,1.0,2,Busy Body,40.0,18,-1,1,-1,1,down,1984-01-07
24487,Luther Vandross,1984-05-19,Luther Vandross - Busy Body,2,3,4,1.0,3,Busy Body,40.0,19,-1,-1,1,1,down,1984-01-07
24488,Luther Vandross,1984-05-26,Luther Vandross - Busy Body,3,2,3,1.0,4,Busy Body,40.0,20,1,-1,-1,1,up,1984-01-07
24489,Luther Vandross,1984-06-02,Luther Vandross - Busy Body,4,3,9,1.0,3,Busy Body,40.0,21,-6,1,-1,1,down,1984-01-07
24490,Luther Vandross,1984-06-09,Luther Vandross - Busy Body,3,4,9,1.0,9,Busy Body,40.0,22,0,-6,1,0,stay,1984-01-07
24491,Luther Vandross,1984-06-16,Luther Vandross - Busy Body,9,3,8,1.0,9,Busy Body,40.0,23,1,0,-6,1,up,1984-01-07
24492,Luther Vandross,1984-06-23,Luther Vandross - Busy Body,9,9,8,1.0,8,Busy Body,40.0,24,0,1,0,0,stay,1984-01-07
24493,Luther Vandross,1984-06-30,Luther Vandross - Busy Body,8,9,16,1.0,8,Busy Body,40.0,25,-8,0,1,1,down,1984-01-07
24494,Luther Vandross,1984-07-07,Luther Vandross - Busy Body,8,8,16,1.0,16,Busy Body,40.0,26,0,-8,0,0,stay,1984-01-07
24495,Luther Vandross,1984-07-14,Luther Vandross - Busy Body,16,8,17,1.0,16,Busy Body,40.0,27,-1,0,-8,1,down,1984-01-07
24496,Luther Vandross,1984-07-21,Luther Vandross - Busy Body,16,16,16,1.0,17,Busy Body,40.0,28,1,-1,0,1,up,1984-01-07
24497,Luther Vandross,1984-07-28,Luther Vandross - Busy Body,17,16,28,1.0,16,Busy Body,40.0,29,-12,1,-1,1,down,1984-01-07
24498,Luther Vandross,1984-08-04,Luther Vandross - Busy Body,16,17,29,1.0,28,Busy Body,40.0,30,-1,-12,1,1,down,1984-01-07
24499,Luther Vandross,1984-08-11,Luther Vandross - Busy Body,28,16,32,1.0,29,Busy Body,40.0,31,-3,-1,-12,1,down,1984-01-07
24500,Luther Vandross,1984-08-18,Luther Vandross - Busy Body,29,28,31,1.0,32,Busy Body,40.0,32,1,-3,-1,1,up,1984-01-07
24501,Luther Vandross,1984-08-25,Luther Vandross - Busy Body,32,29,32,1.0,31,Busy Body,40.0,33,-1,1,-3,1,down,1984-01-07
24502,Luther Vandross,1984-09-01,Luther Vandross - Busy Body,31,32,42,1.0,32,Busy Body,40.0,34,-10,-1,1,1,down,1984-01-07
24503,Luther Vandross,1984-09-08,Luther Vandross - Busy Body,32,31,41,1.0,42,Busy Body,40.0,35,1,-10,-1,1,up,1984-01-07
24504,Luther Vandross,1984-09-15,Luther Vandross - Busy Body,42,32,43,1.0,41,Busy Body,40.0,36,-2,1,-10,1,down,1984-01-07
24505,Luther Vandross,1984-09-22,Luther Vandross - Busy Body,41,42,49,1.0,43,Busy Body,40.0,37,-6,-2,1,1,down,1984-01-07
24506,Luther Vandross,1984-09-29,Luther Vandross - Busy Body,43,41,49,1.0,49,Busy Body,40.0,38,0,-6,-2,0,stay,1984-01-07
24507,Luther Vandross,1984-10-06,Luther Vandross - Busy Body,49,43,49,1.0,49,Busy Body,40.0,39,0,0,-6,0,stay,1984-01-07
24508,Luther Vandross,1984-10-13,Luther Vandross - Busy Body,49,49,51,1.0,49,Busy Body,40.0,40,-2,0,0,1,down,1984-01-07
24509,"Evelyn ""Champagne"" King",1984-01-14,"Evelyn ""Champagne"" King - Face To Face",51,51,41,24.0,46,Face To Face,22.0,0,5,5,0,1,up,1984-01-14
24510,"Evelyn ""Champagne"" King",1984-01-21,"Evelyn ""Champagne"" King - Face To Face",46,51,38,24.0,41,Face To Face,22.0,1,3,5,5,1,up,1984-01-14
24511,"Evelyn ""Champagne"" King",1984-01-28,"Evelyn ""Champagne"" King - Face To Face",41,46,36,24.0,38,Face To Face,22.0,2,2,3,5,1,up,1984-01-14
24512,"Evelyn ""Champagne"" King",1984-02-04,"Evelyn ""Champagne"" King - Face To Face",38,41,32,24.0,36,Face To Face,22.0,3,4,2,3,1,up,1984-01-14
24513,"Evelyn ""Champagne"" King",1984-02-11,"Evelyn ""Champagne"" King - Face To Face",36,38,26,24.0,32,Face To Face,22.0,4,6,4,2,1,up,1984-01-14
24514,"Evelyn ""Champagne"" King",1984-02-18,"Evelyn ""Champagne"" King - Face To Face",32,36,26,24.0,26,Face To Face,22.0,5,0,6,4,0,stay,1984-01-14
24515,"Evelyn ""Champagne"" King",1984-02-25,"Evelyn ""Champagne"" King - Face To Face",26,32,24,24.0,26,Face To Face,22.0,6,2,0,6,1,up,1984-01-14
24516,"Evelyn ""Champagne"" King",1984-03-03,"Evelyn ""Champagne"" King - Face To Face",26,26,24,24.0,24,Face To Face,22.0,7,0,2,0,0,stay,1984-01-14
24517,"Evelyn ""Champagne"" King",1984-03-10,"Evelyn ""Champagne"" King - Face To Face",24,26,24,24.0,24,Face To Face,22.0,8,0,0,2,0,stay,1984-01-14
24518,"Evelyn ""Champagne"" King",1984-03-17,"Evelyn ""Champagne"" King - Face To Face",24,24,25,24.0,24,Face To Face,22.0,9,-1,0,0,1,down,1984-01-14
24519,"Evelyn ""Champagne"" King",1984-03-24,"Evelyn ""Champagne"" King - Face To Face",24,24,24,24.0,25,Face To Face,22.0,10,1,-1,0,1,up,1984-01-14
24520,"Evelyn ""Champagne"" King",1984-03-31,"Evelyn ""Champagne"" King - Face To Face",25,24,29,24.0,24,Face To Face,22.0,11,-5,1,-1,1,down,1984-01-14
24521,"Evelyn ""Champagne"" King",1984-04-07,"Evelyn ""Champagne"" King - Face To Face",24,25,28,24.0,29,Face To Face,22.0,12,1,-5,1,1,up,1984-01-14
24522,"Evelyn ""Champagne"" King",1984-04-14,"Evelyn ""Champagne"" King - Face To Face",29,24,33,24.0,28,Face To Face,22.0,13,-5,1,-5,1,down,1984-01-14
24523,"Evelyn ""Champagne"" King",1984-04-21,"Evelyn ""Champagne"" King - Face To Face",28,29,33,24.0,33,Face To Face,22.0,14,0,-5,1,0,stay,1984-01-14
24524,"Evelyn ""Champagne"" King",1984-04-28,"Evelyn ""Champagne"" King - Face To Face",33,28,29,24.0,33,Face To Face,22.0,15,4,0,-5,1,up,1984-01-14
24525,"Evelyn ""Champagne"" King",1984-05-05,"Evelyn ""Champagne"" King - Face To Face",33,33,29,24.0,29,Face To Face,22.0,16,0,4,0,0,stay,1984-01-14
24526,"Evelyn ""Champagne"" King",1984-05-12,"Evelyn ""Champagne"" King - Face To Face",29,33,33,24.0,29,Face To Face,22.0,17,-4,0,4,1,down,1984-01-14
24527,"Evelyn ""Champagne"" King",1984-05-19,"Evelyn ""Champagne"" King - Face To Face",29,29,37,24.0,33,Face To Face,22.0,18,-4,-4,0,1,down,1984-01-14
24528,"Evelyn ""Champagne"" King",1984-05-26,"Evelyn ""Champagne"" King - Face To Face",33,29,40,24.0,37,Face To Face,22.0,19,-3,-4,-4,1,down,1984-01-14
24529,"Evelyn ""Champagne"" King",1984-06-02,"Evelyn ""Champagne"" King - Face To Face",37,33,39,24.0,40,Face To Face,22.0,20,1,-3,-4,1,up,1984-01-14
24530,"Evelyn ""Champagne"" King",1984-06-09,"Evelyn ""Champagne"" King - Face To Face",40,37,45,24.0,39,Face To Face,22.0,21,-6,1,-3,1,down,1984-01-14
24531,"Evelyn ""Champagne"" King",1984-06-16,"Evelyn ""Champagne"" King - Face To Face",39,40,51,24.0,45,Face To Face,22.0,22,-6,-6,1,1,down,1984-01-14
24532,George Clinton,1984-01-14,George Clinton - You Shouldn't-nuf Bit Fish,51,51,33,18.0,48,You Shouldn't-nuf Bit Fish,24.0,0,15,3,0,1,up,1984-01-14
24533,George Clinton,1984-01-21,George Clinton - You Shouldn't-nuf Bit Fish,48,51,28,18.0,33,You Shouldn't-nuf Bit Fish,24.0,1,5,15,3,1,up,1984-01-14
24534,George Clinton,1984-01-28,George Clinton - You Shouldn't-nuf Bit Fish,33,48,23,18.0,28,You Shouldn't-nuf Bit Fish,24.0,2,5,5,15,1,up,1984-01-14
24535,George Clinton,1984-02-04,George Clinton - You Shouldn't-nuf Bit Fish,28,33,18,18.0,23,You Shouldn't-nuf Bit Fish,24.0,3,5,5,5,1,up,1984-01-14
24536,George Clinton,1984-02-11,George Clinton - You Shouldn't-nuf Bit Fish,23,28,18,18.0,18,You Shouldn't-nuf Bit Fish,24.0,4,0,5,5,0,stay,1984-01-14
24537,George Clinton,1984-02-18,George Clinton - You Shouldn't-nuf Bit Fish,18,23,27,18.0,18,You Shouldn't-nuf Bit Fish,24.0,5,-9,0,5,1,down,1984-01-14
24538,George Clinton,1984-02-25,George Clinton - You Shouldn't-nuf Bit Fish,18,18,26,18.0,27,You Shouldn't-nuf Bit Fish,24.0,6,1,-9,0,1,up,1984-01-14
24539,George Clinton,1984-03-03,George Clinton - You Shouldn't-nuf Bit Fish,27,18,23,18.0,26,You Shouldn't-nuf Bit Fish,24.0,7,3,1,-9,1,up,1984-01-14
24540,George Clinton,1984-03-10,George Clinton - You Shouldn't-nuf Bit Fish,26,27,23,18.0,23,You Shouldn't-nuf Bit Fish,24.0,8,0,3,1,0,stay,1984-01-14
24541,George Clinton,1984-03-17,George Clinton - You Shouldn't-nuf Bit Fish,23,26,24,18.0,23,You Shouldn't-nuf Bit Fish,24.0,9,-1,0,3,1,down,1984-01-14
24542,George Clinton,1984-03-24,George Clinton - You Shouldn't-nuf Bit Fish,23,23,23,18.0,24,You Shouldn't-nuf Bit Fish,24.0,10,1,-1,0,1,up,1984-01-14
24543,George Clinton,1984-03-31,George Clinton - You Shouldn't-nuf Bit Fish,24,23,24,18.0,23,You Shouldn't-nuf Bit Fish,24.0,11,-1,1,-1,1,down,1984-01-14
24544,George Clinton,1984-04-07,George Clinton - You Shouldn't-nuf Bit Fish,23,24,23,18.0,24,You Shouldn't-nuf Bit Fish,24.0,12,1,-1,1,1,up,1984-01-14
24545,George Clinton,1984-04-14,George Clinton - You Shouldn't-nuf Bit Fish,24,23,21,18.0,23,You Shouldn't-nuf Bit Fish,24.0,13,2,1,-1,1,up,1984-01-14
24546,George Clinton,1984-04-21,George Clinton - You Shouldn't-nuf Bit Fish,23,24,21,18.0,21,You Shouldn't-nuf Bit Fish,24.0,14,0,2,1,0,stay,1984-01-14
24547,George Clinton,1984-04-28,George Clinton - You Shouldn't-nuf Bit Fish,21,23,20,18.0,21,You Shouldn't-nuf Bit Fish,24.0,15,1,0,2,1,up,1984-01-14
24548,George Clinton,1984-05-05,George Clinton - You Shouldn't-nuf Bit Fish,21,21,27,18.0,20,You Shouldn't-nuf Bit Fish,24.0,16,-7,1,0,1,down,1984-01-14
24549,George Clinton,1984-05-12,George Clinton - You Shouldn't-nuf Bit Fish,20,21,28,18.0,27,You Shouldn't-nuf Bit Fish,24.0,17,-1,-7,1,1,down,1984-01-14
24550,George Clinton,1984-05-19,George Clinton - You Shouldn't-nuf Bit Fish,27,20,27,18.0,28,You Shouldn't-nuf Bit Fish,24.0,18,1,-1,-7,1,up,1984-01-14
24551,George Clinton,1984-05-26,George Clinton - You Shouldn't-nuf Bit Fish,28,27,30,18.0,27,You Shouldn't-nuf Bit Fish,24.0,19,-3,1,-1,1,down,1984-01-14
24552,George Clinton,1984-06-02,George Clinton - You Shouldn't-nuf Bit Fish,27,28,30,18.0,30,You Shouldn't-nuf Bit Fish,24.0,20,0,-3,1,0,stay,1984-01-14
24553,George Clinton,1984-06-09,George Clinton - You Shouldn't-nuf Bit Fish,30,27,35,18.0,30,You Shouldn't-nuf Bit Fish,24.0,21,-5,0,-3,1,down,1984-01-14
24554,George Clinton,1984-06-16,George Clinton - You Shouldn't-nuf Bit Fish,30,30,48,18.0,35,You Shouldn't-nuf Bit Fish,24.0,22,-13,-5,0,1,down,1984-01-14
24555,George Clinton,1984-06-23,George Clinton - You Shouldn't-nuf Bit Fish,35,30,48,18.0,48,You Shouldn't-nuf Bit Fish,24.0,23,0,-13,-5,0,stay,1984-01-14
24556,George Clinton,1984-06-30,George Clinton - You Shouldn't-nuf Bit Fish,48,35,51,18.0,48,You Shouldn't-nuf Bit Fish,24.0,24,-3,0,-13,1,down,1984-01-14
24557,Cheryl Lynn,1984-01-21,Cheryl Lynn - Preppie,51,51,37,8.0,39,Preppie,17.0,0,2,12,0,1,up,1984-01-21
24558,Cheryl Lynn,1984-01-28,Cheryl Lynn - Preppie,39,51,30,8.0,37,Preppie,17.0,1,7,2,12,1,up,1984-01-21
24559,Cheryl Lynn,1984-02-04,Cheryl Lynn - Preppie,37,39,24,8.0,30,Preppie,17.0,2,6,7,2,1,up,1984-01-21
24560,Cheryl Lynn,1984-02-11,Cheryl Lynn - Preppie,30,37,15,8.0,24,Preppie,17.0,3,9,6,7,1,up,1984-01-21
24561,Cheryl Lynn,1984-02-18,Cheryl Lynn - Preppie,24,30,11,8.0,15,Preppie,17.0,4,4,9,6,1,up,1984-01-21
24562,Cheryl Lynn,1984-02-25,Cheryl Lynn - Preppie,15,24,11,8.0,11,Preppie,17.0,5,0,4,9,0,stay,1984-01-21
24563,Cheryl Lynn,1984-03-03,Cheryl Lynn - Preppie,11,15,10,8.0,11,Preppie,17.0,6,1,0,4,1,up,1984-01-21
24564,Cheryl Lynn,1984-03-10,Cheryl Lynn - Preppie,11,11,8,8.0,10,Preppie,17.0,7,2,1,0,1,up,1984-01-21
24565,Cheryl Lynn,1984-03-17,Cheryl Lynn - Preppie,10,11,8,8.0,8,Preppie,17.0,8,0,2,1,0,stay,1984-01-21
24566,Cheryl Lynn,1984-03-24,Cheryl Lynn - Preppie,8,10,14,8.0,8,Preppie,17.0,9,-6,0,2,1,down,1984-01-21
24567,Cheryl Lynn,1984-03-31,Cheryl Lynn - Preppie,8,8,14,8.0,14,Preppie,17.0,10,0,-6,0,0,stay,1984-01-21
24568,Cheryl Lynn,1984-04-07,Cheryl Lynn - Preppie,14,8,14,8.0,14,Preppie,17.0,11,0,0,-6,0,stay,1984-01-21
24569,Cheryl Lynn,1984-04-14,Cheryl Lynn - Preppie,14,14,14,8.0,14,Preppie,17.0,12,0,0,0,0,stay,1984-01-21
24570,Cheryl Lynn,1984-04-21,Cheryl Lynn - Preppie,14,14,19,8.0,14,Preppie,17.0,13,-5,0,0,1,down,1984-01-21
24571,Cheryl Lynn,1984-04-28,Cheryl Lynn - Preppie,14,14,42,8.0,19,Preppie,17.0,14,-23,-5,0,1,down,1984-01-21
24572,Cheryl Lynn,1984-05-05,Cheryl Lynn - Preppie,19,14,44,8.0,42,Preppie,17.0,15,-2,-23,-5,1,down,1984-01-21
24573,Cheryl Lynn,1984-05-12,Cheryl Lynn - Preppie,42,19,44,8.0,44,Preppie,17.0,16,0,-2,-23,0,stay,1984-01-21
24574,Cheryl Lynn,1984-05-19,Cheryl Lynn - Preppie,44,42,51,8.0,44,Preppie,17.0,17,-7,0,-2,1,down,1984-01-21
24575,J. Blackfoot,1984-01-28,J. Blackfoot - City Slicker,51,51,37,16.0,45,City Slicker,14.0,0,8,6,0,1,up,1984-01-28
24576,J. Blackfoot,1984-02-04,J. Blackfoot - City Slicker,45,51,37,16.0,37,City Slicker,14.0,1,0,8,6,0,stay,1984-01-28
24577,J. Blackfoot,1984-02-11,J. Blackfoot - City Slicker,37,45,34,16.0,37,City Slicker,14.0,2,3,0,8,1,up,1984-01-28
24578,J. Blackfoot,1984-02-18,J. Blackfoot - City Slicker,37,37,30,16.0,34,City Slicker,14.0,3,4,3,0,1,up,1984-01-28
24579,J. Blackfoot,1984-02-25,J. Blackfoot - City Slicker,34,37,22,16.0,30,City Slicker,14.0,4,8,4,3,1,up,1984-01-28
24580,J. Blackfoot,1984-03-03,J. Blackfoot - City Slicker,30,34,21,16.0,22,City Slicker,14.0,5,1,8,4,1,up,1984-01-28
24581,J. Blackfoot,1984-03-10,J. Blackfoot - City Slicker,22,30,21,16.0,21,City Slicker,14.0,6,0,1,8,0,stay,1984-01-28
24582,J. Blackfoot,1984-03-17,J. Blackfoot - City Slicker,21,22,18,16.0,21,City Slicker,14.0,7,3,0,1,1,up,1984-01-28
24583,J. Blackfoot,1984-03-24,J. Blackfoot - City Slicker,21,21,18,16.0,18,City Slicker,14.0,8,0,3,0,0,stay,1984-01-28
24584,J. Blackfoot,1984-03-31,J. Blackfoot - City Slicker,18,21,16,16.0,18,City Slicker,14.0,9,2,0,3,1,up,1984-01-28
24585,J. Blackfoot,1984-04-07,J. Blackfoot - City Slicker,18,18,16,16.0,16,City Slicker,14.0,10,0,2,0,0,stay,1984-01-28
24586,J. Blackfoot,1984-04-14,J. Blackfoot - City Slicker,16,18,17,16.0,16,City Slicker,14.0,11,-1,0,2,1,down,1984-01-28
24587,J. Blackfoot,1984-04-21,J. Blackfoot - City Slicker,16,16,37,16.0,17,City Slicker,14.0,12,-20,-1,0,1,down,1984-01-28
24588,J. Blackfoot,1984-04-28,J. Blackfoot - City Slicker,17,16,43,16.0,37,City Slicker,14.0,13,-6,-20,-1,1,down,1984-01-28
24589,J. Blackfoot,1984-05-05,J. Blackfoot - City Slicker,37,17,51,16.0,43,City Slicker,14.0,14,-8,-6,-20,1,down,1984-01-28
24590,Dreamboy,1984-01-28,Dreamboy - Dreamboy,51,51,45,32.0,48,Dreamboy,13.0,0,3,3,0,1,up,1984-01-28
24591,Dreamboy,1984-02-04,Dreamboy - Dreamboy,48,51,42,32.0,45,Dreamboy,13.0,1,3,3,3,1,up,1984-01-28
24592,Dreamboy,1984-02-11,Dreamboy - Dreamboy,45,48,38,32.0,42,Dreamboy,13.0,2,4,3,3,1,up,1984-01-28
24593,Dreamboy,1984-02-18,Dreamboy - Dreamboy,42,45,38,32.0,38,Dreamboy,13.0,3,0,4,3,0,stay,1984-01-28
24594,Dreamboy,1984-02-25,Dreamboy - Dreamboy,38,42,33,32.0,38,Dreamboy,13.0,4,5,0,4,1,up,1984-01-28
24595,Dreamboy,1984-03-03,Dreamboy - Dreamboy,38,38,33,32.0,33,Dreamboy,13.0,5,0,5,0,0,stay,1984-01-28
24596,Dreamboy,1984-03-10,Dreamboy - Dreamboy,33,38,32,32.0,33,Dreamboy,13.0,6,1,0,5,1,up,1984-01-28
24597,Dreamboy,1984-03-17,Dreamboy - Dreamboy,33,33,32,32.0,32,Dreamboy,13.0,7,0,1,0,0,stay,1984-01-28
24598,Dreamboy,1984-03-24,Dreamboy - Dreamboy,32,33,37,32.0,32,Dreamboy,13.0,8,-5,0,1,1,down,1984-01-28
24599,Dreamboy,1984-03-31,Dreamboy - Dreamboy,32,32,32,32.0,37,Dreamboy,13.0,9,5,-5,0,1,up,1984-01-28
24600,Dreamboy,1984-04-07,Dreamboy - Dreamboy,37,32,32,32.0,32,Dreamboy,13.0,10,0,5,-5,0,stay,1984-01-28
24601,Dreamboy,1984-04-14,Dreamboy - Dreamboy,32,37,39,32.0,32,Dreamboy,13.0,11,-7,0,5,1,down,1984-01-28
24602,Dreamboy,1984-04-21,Dreamboy - Dreamboy,32,32,39,32.0,39,Dreamboy,13.0,12,0,-7,0,0,stay,1984-01-28
24603,Dreamboy,1984-04-28,Dreamboy - Dreamboy,39,32,51,32.0,39,Dreamboy,13.0,13,-12,0,-7,1,down,1984-01-28
24604,Paul McCartney,1984-02-04,Paul McCartney - Pipes Of Peace,51,51,49,49.0,49,Pipes Of Peace,2.0,0,0,2,0,0,stay,1984-02-04
24605,Paul McCartney,1984-02-11,Paul McCartney - Pipes Of Peace,49,51,49,49.0,49,Pipes Of Peace,2.0,1,0,0,2,0,stay,1984-02-04
24606,Paul McCartney,1984-02-18,Paul McCartney - Pipes Of Peace,49,49,51,49.0,49,Pipes Of Peace,2.0,2,-2,0,0,1,down,1984-02-04
24607,P-Funk All Stars,1984-02-04,P-Funk All Stars - Urban Dance Floor Guerillas,51,51,50,48.0,50,Urban Dance Floor Guerillas,2.0,0,0,1,0,0,stay,1984-02-04
24608,P-Funk All Stars,1984-02-11,P-Funk All Stars - Urban Dance Floor Guerillas,50,51,48,48.0,50,Urban Dance Floor Guerillas,2.0,1,2,0,1,1,up,1984-02-04
24609,P-Funk All Stars,1984-02-18,P-Funk All Stars - Urban Dance Floor Guerillas,50,50,51,48.0,48,Urban Dance Floor Guerillas,2.0,2,-3,2,0,1,down,1984-02-04
24610,Culture Club,1984-02-18,Culture Club - Colour By Numbers,51,51,28,7.0,40,Colour By Numbers,24.0,0,12,11,0,1,up,1984-02-18
24611,Culture Club,1984-02-25,Culture Club - Colour By Numbers,40,51,20,7.0,28,Colour By Numbers,24.0,1,8,12,11,1,up,1984-02-18
24612,Culture Club,1984-03-03,Culture Club - Colour By Numbers,28,40,17,7.0,20,Colour By Numbers,24.0,2,3,8,12,1,up,1984-02-18
24613,Culture Club,1984-03-10,Culture Club - Colour By Numbers,20,28,13,7.0,17,Colour By Numbers,24.0,3,4,3,8,1,up,1984-02-18
24614,Culture Club,1984-03-17,Culture Club - Colour By Numbers,17,20,9,7.0,13,Colour By Numbers,24.0,4,4,4,3,1,up,1984-02-18
24615,Culture Club,1984-03-24,Culture Club - Colour By Numbers,13,17,8,7.0,9,Colour By Numbers,24.0,5,1,4,4,1,up,1984-02-18
24616,Culture Club,1984-03-31,Culture Club - Colour By Numbers,9,13,8,7.0,8,Colour By Numbers,24.0,6,0,1,4,0,stay,1984-02-18
24617,Culture Club,1984-04-07,Culture Club - Colour By Numbers,8,9,11,7.0,8,Colour By Numbers,24.0,7,-3,0,1,1,down,1984-02-18
24618,Culture Club,1984-04-14,Culture Club - Colour By Numbers,8,8,11,7.0,11,Colour By Numbers,24.0,8,0,-3,0,0,stay,1984-02-18
24619,Culture Club,1984-04-21,Culture Club - Colour By Numbers,11,8,8,7.0,11,Colour By Numbers,24.0,9,3,0,-3,1,up,1984-02-18
24620,Culture Club,1984-04-28,Culture Club - Colour By Numbers,11,11,8,7.0,8,Colour By Numbers,24.0,10,0,3,0,0,stay,1984-02-18
24621,Culture Club,1984-05-05,Culture Club - Colour By Numbers,8,11,7,7.0,8,Colour By Numbers,24.0,11,1,0,3,1,up,1984-02-18
24622,Culture Club,1984-05-12,Culture Club - Colour By Numbers,8,8,15,7.0,7,Colour By Numbers,24.0,12,-8,1,0,1,down,1984-02-18
24623,Culture Club,1984-05-19,Culture Club - Colour By Numbers,7,8,15,7.0,15,Colour By Numbers,24.0,13,0,-8,1,0,stay,1984-02-18
24624,Culture Club,1984-05-26,Culture Club - Colour By Numbers,15,7,14,7.0,15,Colour By Numbers,24.0,14,1,0,-8,1,up,1984-02-18
24625,Culture Club,1984-06-02,Culture Club - Colour By Numbers,15,15,17,7.0,14,Colour By Numbers,24.0,15,-3,1,0,1,down,1984-02-18
24626,Culture Club,1984-06-09,Culture Club - Colour By Numbers,14,15,26,7.0,17,Colour By Numbers,24.0,16,-9,-3,1,1,down,1984-02-18
24627,Culture Club,1984-06-16,Culture Club - Colour By Numbers,17,14,25,7.0,26,Colour By Numbers,24.0,17,1,-9,-3,1,up,1984-02-18
24628,Culture Club,1984-06-23,Culture Club - Colour By Numbers,26,17,27,7.0,25,Colour By Numbers,24.0,18,-2,1,-9,1,down,1984-02-18
24629,Culture Club,1984-06-30,Culture Club - Colour By Numbers,25,26,27,7.0,27,Colour By Numbers,24.0,19,0,-2,1,0,stay,1984-02-18
24630,Culture Club,1984-07-07,Culture Club - Colour By Numbers,27,25,29,7.0,27,Colour By Numbers,24.0,20,-2,0,-2,1,down,1984-02-18
24631,Culture Club,1984-07-14,Culture Club - Colour By Numbers,27,27,37,7.0,29,Colour By Numbers,24.0,21,-8,-2,0,1,down,1984-02-18
24632,Culture Club,1984-07-21,Culture Club - Colour By Numbers,29,27,44,7.0,37,Colour By Numbers,24.0,22,-7,-8,-2,1,down,1984-02-18
24633,Culture Club,1984-07-28,Culture Club - Colour By Numbers,37,29,50,7.0,44,Colour By Numbers,24.0,23,-6,-7,-8,1,down,1984-02-18
24634,Culture Club,1984-08-04,Culture Club - Colour By Numbers,44,37,51,7.0,50,Colour By Numbers,24.0,24,-1,-6,-7,1,down,1984-02-18
24635,Rockwell,1984-02-18,Rockwell - Somebody's Watching Me,51,51,15,5.0,42,Somebody's Watching Me,27.0,0,27,9,0,1,up,1984-02-18
24636,Rockwell,1984-02-25,Rockwell - Somebody's Watching Me,42,51,9,5.0,15,Somebody's Watching Me,27.0,1,6,27,9,1,up,1984-02-18
24637,Rockwell,1984-03-03,Rockwell - Somebody's Watching Me,15,42,9,5.0,9,Somebody's Watching Me,27.0,2,0,6,27,0,stay,1984-02-18
24638,Rockwell,1984-03-10,Rockwell - Somebody's Watching Me,9,15,6,5.0,9,Somebody's Watching Me,27.0,3,3,0,6,1,up,1984-02-18
24639,Rockwell,1984-03-17,Rockwell - Somebody's Watching Me,9,9,5,5.0,6,Somebody's Watching Me,27.0,4,1,3,0,1,up,1984-02-18
24640,Rockwell,1984-03-24,Rockwell - Somebody's Watching Me,6,9,5,5.0,5,Somebody's Watching Me,27.0,5,0,1,3,0,stay,1984-02-18
24641,Rockwell,1984-03-31,Rockwell - Somebody's Watching Me,5,6,6,5.0,5,Somebody's Watching Me,27.0,6,-1,0,1,1,down,1984-02-18
24642,Rockwell,1984-04-07,Rockwell - Somebody's Watching Me,5,5,6,5.0,6,Somebody's Watching Me,27.0,7,0,-1,0,0,stay,1984-02-18
24643,Rockwell,1984-04-14,Rockwell - Somebody's Watching Me,6,5,8,5.0,6,Somebody's Watching Me,27.0,8,-2,0,-1,1,down,1984-02-18
24644,Rockwell,1984-04-21,Rockwell - Somebody's Watching Me,6,6,9,5.0,8,Somebody's Watching Me,27.0,9,-1,-2,0,1,down,1984-02-18
24645,Rockwell,1984-04-28,Rockwell - Somebody's Watching Me,8,6,10,5.0,9,Somebody's Watching Me,27.0,10,-1,-1,-2,1,down,1984-02-18
24646,Rockwell,1984-05-05,Rockwell - Somebody's Watching Me,9,8,18,5.0,10,Somebody's Watching Me,27.0,11,-8,-1,-1,1,down,1984-02-18
24647,Rockwell,1984-05-12,Rockwell - Somebody's Watching Me,10,9,18,5.0,18,Somebody's Watching Me,27.0,12,0,-8,-1,0,stay,1984-02-18
24648,Rockwell,1984-05-19,Rockwell - Somebody's Watching Me,18,10,25,5.0,18,Somebody's Watching Me,27.0,13,-7,0,-8,1,down,1984-02-18
24649,Rockwell,1984-05-26,Rockwell - Somebody's Watching Me,18,18,23,5.0,25,Somebody's Watching Me,27.0,14,2,-7,0,1,up,1984-02-18
24650,Rockwell,1984-06-02,Rockwell - Somebody's Watching Me,25,18,21,5.0,23,Somebody's Watching Me,27.0,15,2,2,-7,1,up,1984-02-18
24651,Rockwell,1984-06-09,Rockwell - Somebody's Watching Me,23,25,21,5.0,21,Somebody's Watching Me,27.0,16,0,2,2,0,stay,1984-02-18
24652,Rockwell,1984-06-16,Rockwell - Somebody's Watching Me,21,23,29,5.0,21,Somebody's Watching Me,27.0,17,-8,0,2,1,down,1984-02-18
24653,Rockwell,1984-06-23,Rockwell - Somebody's Watching Me,21,21,28,5.0,29,Somebody's Watching Me,27.0,18,1,-8,0,1,up,1984-02-18
24654,Rockwell,1984-06-30,Rockwell - Somebody's Watching Me,29,21,29,5.0,28,Somebody's Watching Me,27.0,19,-1,1,-8,1,down,1984-02-18
24655,Rockwell,1984-07-07,Rockwell - Somebody's Watching Me,28,29,28,5.0,29,Somebody's Watching Me,27.0,20,1,-1,1,1,up,1984-02-18
24656,Rockwell,1984-07-14,Rockwell - Somebody's Watching Me,29,28,36,5.0,28,Somebody's Watching Me,27.0,21,-8,1,-1,1,down,1984-02-18
24657,Rockwell,1984-07-21,Rockwell - Somebody's Watching Me,28,29,37,5.0,36,Somebody's Watching Me,27.0,22,-1,-8,1,1,down,1984-02-18
24658,Rockwell,1984-07-28,Rockwell - Somebody's Watching Me,36,28,38,5.0,37,Somebody's Watching Me,27.0,23,-1,-1,-8,1,down,1984-02-18
24659,Rockwell,1984-08-04,Rockwell - Somebody's Watching Me,37,36,46,5.0,38,Somebody's Watching Me,27.0,24,-8,-1,-1,1,down,1984-02-18
24660,Rockwell,1984-08-11,Rockwell - Somebody's Watching Me,38,37,46,5.0,46,Somebody's Watching Me,27.0,25,0,-8,-1,0,stay,1984-02-18
24661,Rockwell,1984-08-18,Rockwell - Somebody's Watching Me,46,38,49,5.0,46,Somebody's Watching Me,27.0,26,-3,0,-8,1,down,1984-02-18
24662,Rockwell,1984-08-25,Rockwell - Somebody's Watching Me,46,46,51,5.0,49,Somebody's Watching Me,27.0,27,-2,-3,0,1,down,1984-02-18
24663,Steve Arrington's Hall Of Fame,1984-02-18,Steve Arrington's Hall Of Fame - Positive Power,51,51,42,36.0,47,Positive Power,5.0,0,5,4,0,1,up,1984-02-18
24664,Steve Arrington's Hall Of Fame,1984-02-25,Steve Arrington's Hall Of Fame - Positive Power,47,51,37,36.0,42,Positive Power,5.0,1,5,5,4,1,up,1984-02-18
24665,Steve Arrington's Hall Of Fame,1984-03-03,Steve Arrington's Hall Of Fame - Positive Power,42,47,36,36.0,37,Positive Power,5.0,2,1,5,5,1,up,1984-02-18
24666,Steve Arrington's Hall Of Fame,1984-03-10,Steve Arrington's Hall Of Fame - Positive Power,37,42,42,36.0,36,Positive Power,5.0,3,-6,1,5,1,down,1984-02-18
24667,Steve Arrington's Hall Of Fame,1984-03-17,Steve Arrington's Hall Of Fame - Positive Power,36,37,43,36.0,42,Positive Power,5.0,4,-1,-6,1,1,down,1984-02-18
24668,Steve Arrington's Hall Of Fame,1984-03-24,Steve Arrington's Hall Of Fame - Positive Power,42,36,51,36.0,43,Positive Power,5.0,5,-8,-1,-6,1,down,1984-02-18
24669,Malcolm McLaren,1984-02-18,Malcolm McLaren - D'ya Like Scratchin',51,51,47,43.0,50,D'ya Like Scratchin',7.0,0,3,1,0,1,up,1984-02-18
24670,Malcolm McLaren,1984-02-25,Malcolm McLaren - D'ya Like Scratchin',50,51,43,43.0,47,D'ya Like Scratchin',7.0,1,4,3,1,1,up,1984-02-18
24671,Malcolm McLaren,1984-03-03,Malcolm McLaren - D'ya Like Scratchin',47,50,43,43.0,43,D'ya Like Scratchin',7.0,2,0,4,3,0,stay,1984-02-18
24672,Malcolm McLaren,1984-03-10,Malcolm McLaren - D'ya Like Scratchin',43,47,43,43.0,43,D'ya Like Scratchin',7.0,3,0,0,4,0,stay,1984-02-18
24673,Malcolm McLaren,1984-03-17,Malcolm McLaren - D'ya Like Scratchin',43,43,46,43.0,43,D'ya Like Scratchin',7.0,4,-3,0,0,1,down,1984-02-18
24674,Malcolm McLaren,1984-03-24,Malcolm McLaren - D'ya Like Scratchin',43,43,45,43.0,46,D'ya Like Scratchin',7.0,5,1,-3,0,1,up,1984-02-18
24675,Malcolm McLaren,1984-03-31,Malcolm McLaren - D'ya Like Scratchin',46,43,45,43.0,45,D'ya Like Scratchin',7.0,6,0,1,-3,0,stay,1984-02-18
24676,Malcolm McLaren,1984-04-07,Malcolm McLaren - D'ya Like Scratchin',45,46,51,43.0,45,D'ya Like Scratchin',7.0,7,-6,0,1,1,down,1984-02-18
24677,Shannon,1984-02-25,Shannon - Let The Music Play,51,51,14,11.0,25,Let The Music Play,27.0,0,11,26,0,1,up,1984-02-25
24678,Shannon,1984-03-03,Shannon - Let The Music Play,25,51,13,11.0,14,Let The Music Play,27.0,1,1,11,26,1,up,1984-02-25
24679,Shannon,1984-03-10,Shannon - Let The Music Play,14,25,12,11.0,13,Let The Music Play,27.0,2,1,1,11,1,up,1984-02-25
24680,Shannon,1984-03-17,Shannon - Let The Music Play,13,14,12,11.0,12,Let The Music Play,27.0,3,0,1,1,0,stay,1984-02-25
24681,Shannon,1984-03-24,Shannon - Let The Music Play,12,13,11,11.0,12,Let The Music Play,27.0,4,1,0,1,1,up,1984-02-25
24682,Shannon,1984-03-31,Shannon - Let The Music Play,12,12,11,11.0,11,Let The Music Play,27.0,5,0,1,0,0,stay,1984-02-25
24683,Shannon,1984-04-07,Shannon - Let The Music Play,11,12,18,11.0,11,Let The Music Play,27.0,6,-7,0,1,1,down,1984-02-25
24684,Shannon,1984-04-14,Shannon - Let The Music Play,11,11,18,11.0,18,Let The Music Play,27.0,7,0,-7,0,0,stay,1984-02-25
24685,Shannon,1984-04-21,Shannon - Let The Music Play,18,11,18,11.0,18,Let The Music Play,27.0,8,0,0,-7,0,stay,1984-02-25
24686,Shannon,1984-04-28,Shannon - Let The Music Play,18,18,16,11.0,18,Let The Music Play,27.0,9,2,0,0,1,up,1984-02-25
24687,Shannon,1984-05-05,Shannon - Let The Music Play,18,18,14,11.0,16,Let The Music Play,27.0,10,2,2,0,1,up,1984-02-25
24688,Shannon,1984-05-12,Shannon - Let The Music Play,16,18,14,11.0,14,Let The Music Play,27.0,11,0,2,2,0,stay,1984-02-25
24689,Shannon,1984-05-19,Shannon - Let The Music Play,14,16,14,11.0,14,Let The Music Play,27.0,12,0,0,2,0,stay,1984-02-25
24690,Shannon,1984-05-26,Shannon - Let The Music Play,14,14,22,11.0,14,Let The Music Play,27.0,13,-8,0,0,1,down,1984-02-25
24691,Shannon,1984-06-02,Shannon - Let The Music Play,14,14,22,11.0,22,Let The Music Play,27.0,14,0,-8,0,0,stay,1984-02-25
24692,Shannon,1984-06-09,Shannon - Let The Music Play,22,14,22,11.0,22,Let The Music Play,27.0,15,0,0,-8,0,stay,1984-02-25
24693,Shannon,1984-06-16,Shannon - Let The Music Play,22,22,23,11.0,22,Let The Music Play,27.0,16,-1,0,0,1,down,1984-02-25
24694,Shannon,1984-06-23,Shannon - Let The Music Play,22,22,26,11.0,23,Let The Music Play,27.0,17,-3,-1,0,1,down,1984-02-25
24695,Shannon,1984-06-30,Shannon - Let The Music Play,23,22,28,11.0,26,Let The Music Play,27.0,18,-2,-3,-1,1,down,1984-02-25
24696,Shannon,1984-07-07,Shannon - Let The Music Play,26,23,34,11.0,28,Let The Music Play,27.0,19,-6,-2,-3,1,down,1984-02-25
24697,Shannon,1984-07-14,Shannon - Let The Music Play,28,26,34,11.0,34,Let The Music Play,27.0,20,0,-6,-2,0,stay,1984-02-25
24698,Shannon,1984-07-21,Shannon - Let The Music Play,34,28,36,11.0,34,Let The Music Play,27.0,21,-2,0,-6,1,down,1984-02-25
24699,Shannon,1984-07-28,Shannon - Let The Music Play,34,34,35,11.0,36,Let The Music Play,27.0,22,1,-2,0,1,up,1984-02-25
24700,Shannon,1984-08-04,Shannon - Let The Music Play,36,34,35,11.0,35,Let The Music Play,27.0,23,0,1,-2,0,stay,1984-02-25
24701,Shannon,1984-08-11,Shannon - Let The Music Play,35,36,35,11.0,35,Let The Music Play,27.0,24,0,0,1,0,stay,1984-02-25
24702,Shannon,1984-08-18,Shannon - Let The Music Play,35,35,37,11.0,35,Let The Music Play,27.0,25,-2,0,0,1,down,1984-02-25
24703,Shannon,1984-08-25,Shannon - Let The Music Play,35,35,48,11.0,37,Let The Music Play,27.0,26,-11,-2,0,1,down,1984-02-25
24704,Shannon,1984-09-01,Shannon - Let The Music Play,37,35,51,11.0,48,Let The Music Play,27.0,27,-3,-11,-2,1,down,1984-02-25
24705,Kenny G,1984-02-25,Kenny G - G Force,51,51,40,17.0,43,G Force,19.0,0,3,8,0,1,up,1984-02-25
24706,Kenny G,1984-03-03,Kenny G - G Force,43,51,35,17.0,40,G Force,19.0,1,5,3,8,1,up,1984-02-25
24707,Kenny G,1984-03-10,Kenny G - G Force,40,43,35,17.0,35,G Force,19.0,2,0,5,3,0,stay,1984-02-25
24708,Kenny G,1984-03-17,Kenny G - G Force,35,40,30,17.0,35,G Force,19.0,3,5,0,5,1,up,1984-02-25
24709,Kenny G,1984-03-24,Kenny G - G Force,35,35,27,17.0,30,G Force,19.0,4,3,5,0,1,up,1984-02-25
24710,Kenny G,1984-03-31,Kenny G - G Force,30,35,21,17.0,27,G Force,19.0,5,6,3,5,1,up,1984-02-25
24711,Kenny G,1984-04-07,Kenny G - G Force,27,30,19,17.0,21,G Force,19.0,6,2,6,3,1,up,1984-02-25
24712,Kenny G,1984-04-14,Kenny G - G Force,21,27,19,17.0,19,G Force,19.0,7,0,2,6,0,stay,1984-02-25
24713,Kenny G,1984-04-21,Kenny G - G Force,19,21,17,17.0,19,G Force,19.0,8,2,0,2,1,up,1984-02-25
24714,Kenny G,1984-04-28,Kenny G - G Force,19,19,17,17.0,17,G Force,19.0,9,0,2,0,0,stay,1984-02-25
24715,Kenny G,1984-05-05,Kenny G - G Force,17,19,19,17.0,17,G Force,19.0,10,-2,0,2,1,down,1984-02-25
24716,Kenny G,1984-05-12,Kenny G - G Force,17,17,22,17.0,19,G Force,19.0,11,-3,-2,0,1,down,1984-02-25
24717,Kenny G,1984-05-19,Kenny G - G Force,19,17,26,17.0,22,G Force,19.0,12,-4,-3,-2,1,down,1984-02-25
24718,Kenny G,1984-05-26,Kenny G - G Force,22,19,29,17.0,26,G Force,19.0,13,-3,-4,-3,1,down,1984-02-25
24719,Kenny G,1984-06-02,Kenny G - G Force,26,22,42,17.0,29,G Force,19.0,14,-13,-3,-4,1,down,1984-02-25
24720,Kenny G,1984-06-09,Kenny G - G Force,29,26,42,17.0,42,G Force,19.0,15,0,-13,-3,0,stay,1984-02-25
24721,Kenny G,1984-06-16,Kenny G - G Force,42,29,49,17.0,42,G Force,19.0,16,-7,0,-13,1,down,1984-02-25
24722,Kenny G,1984-06-30,Kenny G - G Force,42,42,49,17.0,49,G Force,19.0,17,0,-7,0,0,stay,1984-02-25
24723,Kenny G,1984-07-07,Kenny G - G Force,49,42,47,17.0,49,G Force,19.0,18,2,0,-7,1,up,1984-02-25
24724,Kenny G,1984-07-14,Kenny G - G Force,49,49,51,17.0,47,G Force,19.0,19,-4,2,0,1,down,1984-02-25
24725,Dennis Edwards,1984-03-03,Dennis Edwards - Don't Look Any Further,51,51,32,2.0,41,Don't Look Any Further,30.0,0,9,10,0,1,up,1984-03-03
24726,Dennis Edwards,1984-03-10,Dennis Edwards - Don't Look Any Further,41,51,18,2.0,32,Don't Look Any Further,30.0,1,14,9,10,1,up,1984-03-03
24727,Dennis Edwards,1984-03-17,Dennis Edwards - Don't Look Any Further,32,41,14,2.0,18,Don't Look Any Further,30.0,2,4,14,9,1,up,1984-03-03
24728,Dennis Edwards,1984-03-24,Dennis Edwards - Don't Look Any Further,18,32,10,2.0,14,Don't Look Any Further,30.0,3,4,4,14,1,up,1984-03-03
24729,Dennis Edwards,1984-03-31,Dennis Edwards - Don't Look Any Further,14,18,7,2.0,10,Don't Look Any Further,30.0,4,3,4,4,1,up,1984-03-03
24730,Dennis Edwards,1984-04-07,Dennis Edwards - Don't Look Any Further,10,14,7,2.0,7,Don't Look Any Further,30.0,5,0,3,4,0,stay,1984-03-03
24731,Dennis Edwards,1984-04-14,Dennis Edwards - Don't Look Any Further,7,10,5,2.0,7,Don't Look Any Further,30.0,6,2,0,3,1,up,1984-03-03
24732,Dennis Edwards,1984-04-21,Dennis Edwards - Don't Look Any Further,7,7,6,2.0,5,Don't Look Any Further,30.0,7,-1,2,0,1,down,1984-03-03
24733,Dennis Edwards,1984-04-28,Dennis Edwards - Don't Look Any Further,5,7,4,2.0,6,Don't Look Any Further,30.0,8,2,-1,2,1,up,1984-03-03
24734,Dennis Edwards,1984-05-05,Dennis Edwards - Don't Look Any Further,6,5,4,2.0,4,Don't Look Any Further,30.0,9,0,2,-1,0,stay,1984-03-03
24735,Dennis Edwards,1984-05-12,Dennis Edwards - Don't Look Any Further,4,6,4,2.0,4,Don't Look Any Further,30.0,10,0,0,2,0,stay,1984-03-03
24736,Dennis Edwards,1984-05-19,Dennis Edwards - Don't Look Any Further,4,4,3,2.0,4,Don't Look Any Further,30.0,11,1,0,0,1,up,1984-03-03
24737,Dennis Edwards,1984-05-26,Dennis Edwards - Don't Look Any Further,4,4,4,2.0,3,Don't Look Any Further,30.0,12,-1,1,0,1,down,1984-03-03
24738,Dennis Edwards,1984-06-02,Dennis Edwards - Don't Look Any Further,3,4,2,2.0,4,Don't Look Any Further,30.0,13,2,-1,1,1,up,1984-03-03
24739,Dennis Edwards,1984-06-09,Dennis Edwards - Don't Look Any Further,4,3,2,2.0,2,Don't Look Any Further,30.0,14,0,2,-1,0,stay,1984-03-03
24740,Dennis Edwards,1984-06-16,Dennis Edwards - Don't Look Any Further,2,4,4,2.0,2,Don't Look Any Further,30.0,15,-2,0,2,1,down,1984-03-03
24741,Dennis Edwards,1984-06-23,Dennis Edwards - Don't Look Any Further,2,2,7,2.0,4,Don't Look Any Further,30.0,16,-3,-2,0,1,down,1984-03-03
24742,Dennis Edwards,1984-06-30,Dennis Edwards - Don't Look Any Further,4,2,11,2.0,7,Don't Look Any Further,30.0,17,-4,-3,-2,1,down,1984-03-03
24743,Dennis Edwards,1984-07-07,Dennis Edwards - Don't Look Any Further,7,4,12,2.0,11,Don't Look Any Further,30.0,18,-1,-4,-3,1,down,1984-03-03
24744,Dennis Edwards,1984-07-14,Dennis Edwards - Don't Look Any Further,11,7,12,2.0,12,Don't Look Any Further,30.0,19,0,-1,-4,0,stay,1984-03-03
24745,Dennis Edwards,1984-07-21,Dennis Edwards - Don't Look Any Further,12,11,13,2.0,12,Don't Look Any Further,30.0,20,-1,0,-1,1,down,1984-03-03
24746,Dennis Edwards,1984-07-28,Dennis Edwards - Don't Look Any Further,12,12,15,2.0,13,Don't Look Any Further,30.0,21,-2,-1,0,1,down,1984-03-03
24747,Dennis Edwards,1984-08-04,Dennis Edwards - Don't Look Any Further,13,12,20,2.0,15,Don't Look Any Further,30.0,22,-5,-2,-1,1,down,1984-03-03
24748,Dennis Edwards,1984-08-11,Dennis Edwards - Don't Look Any Further,15,13,22,2.0,20,Don't Look Any Further,30.0,23,-2,-5,-2,1,down,1984-03-03
24749,Dennis Edwards,1984-08-18,Dennis Edwards - Don't Look Any Further,20,15,22,2.0,22,Don't Look Any Further,30.0,24,0,-2,-5,0,stay,1984-03-03
24750,Dennis Edwards,1984-08-25,Dennis Edwards - Don't Look Any Further,22,20,23,2.0,22,Don't Look Any Further,30.0,25,-1,0,-2,1,down,1984-03-03
24751,Dennis Edwards,1984-09-01,Dennis Edwards - Don't Look Any Further,22,22,31,2.0,23,Don't Look Any Further,30.0,26,-8,-1,0,1,down,1984-03-03
24752,Dennis Edwards,1984-09-08,Dennis Edwards - Don't Look Any Further,23,22,44,2.0,31,Don't Look Any Further,30.0,27,-13,-8,-1,1,down,1984-03-03
24753,Dennis Edwards,1984-09-15,Dennis Edwards - Don't Look Any Further,31,23,44,2.0,44,Don't Look Any Further,30.0,28,0,-13,-8,0,stay,1984-03-03
24754,Dennis Edwards,1984-09-22,Dennis Edwards - Don't Look Any Further,44,31,43,2.0,44,Don't Look Any Further,30.0,29,1,0,-13,1,up,1984-03-03
24755,Dennis Edwards,1984-09-29,Dennis Edwards - Don't Look Any Further,44,44,51,2.0,43,Don't Look Any Further,30.0,30,-8,1,0,1,down,1984-03-03
24756,Musical Youth,1984-03-03,Musical Youth - Different Style,51,51,51,50.0,50,Different Style,0.0,0,-1,1,0,1,down,1984-03-03
24757,Imagination,1984-03-10,Imagination - New Dimensions,51,51,44,44.0,48,New Dimensions,2.0,0,4,3,0,1,up,1984-03-10
24758,Imagination,1984-03-17,Imagination - New Dimensions,48,51,44,44.0,44,New Dimensions,2.0,1,0,4,3,0,stay,1984-03-10
24759,Imagination,1984-03-24,Imagination - New Dimensions,44,48,51,44.0,44,New Dimensions,2.0,2,-7,0,4,1,down,1984-03-10
24760,Jenny Burton,1984-03-10,Jenny Burton - In Black & White,51,51,50,50.0,50,In Black & White,1.0,0,0,1,0,0,stay,1984-03-10
24761,Jenny Burton,1984-03-17,Jenny Burton - In Black & White,50,51,51,50.0,50,In Black & White,1.0,1,-1,0,1,1,down,1984-03-10
24762,Cameo,1984-03-24,Cameo - She's Strange,51,51,6,1.0,21,She's Strange,27.0,0,15,30,0,1,up,1984-03-24
24763,Cameo,1984-03-31,Cameo - She's Strange,21,51,5,1.0,6,She's Strange,27.0,1,1,15,30,1,up,1984-03-24
24764,Cameo,1984-04-07,Cameo - She's Strange,6,21,4,1.0,5,She's Strange,27.0,2,1,1,15,1,up,1984-03-24
24765,Cameo,1984-04-14,Cameo - She's Strange,5,6,4,1.0,4,She's Strange,27.0,3,0,1,1,0,stay,1984-03-24
24766,Cameo,1984-04-21,Cameo - She's Strange,4,5,1,1.0,4,She's Strange,27.0,4,3,0,1,1,up,1984-03-24
24767,Cameo,1984-04-28,Cameo - She's Strange,4,4,1,1.0,1,She's Strange,27.0,5,0,3,0,0,stay,1984-03-24
24768,Cameo,1984-05-05,Cameo - She's Strange,1,4,3,1.0,1,She's Strange,27.0,6,-2,0,3,1,down,1984-03-24
24769,Cameo,1984-05-12,Cameo - She's Strange,1,1,2,1.0,3,She's Strange,27.0,7,1,-2,0,1,up,1984-03-24
24770,Cameo,1984-05-19,Cameo - She's Strange,3,1,2,1.0,2,She's Strange,27.0,8,0,1,-2,0,stay,1984-03-24
24771,Cameo,1984-05-26,Cameo - She's Strange,2,3,2,1.0,2,She's Strange,27.0,9,0,0,1,0,stay,1984-03-24
24772,Cameo,1984-06-02,Cameo - She's Strange,2,2,3,1.0,2,She's Strange,27.0,10,-1,0,0,1,down,1984-03-24
24773,Cameo,1984-06-09,Cameo - She's Strange,2,2,4,1.0,3,She's Strange,27.0,11,-1,-1,0,1,down,1984-03-24
24774,Cameo,1984-06-16,Cameo - She's Strange,3,2,6,1.0,4,She's Strange,27.0,12,-2,-1,-1,1,down,1984-03-24
24775,Cameo,1984-06-23,Cameo - She's Strange,4,3,5,1.0,6,She's Strange,27.0,13,1,-2,-1,1,up,1984-03-24
24776,Cameo,1984-06-30,Cameo - She's Strange,6,4,7,1.0,5,She's Strange,27.0,14,-2,1,-2,1,down,1984-03-24
24777,Cameo,1984-07-07,Cameo - She's Strange,5,6,10,1.0,7,She's Strange,27.0,15,-3,-2,1,1,down,1984-03-24
24778,Cameo,1984-07-14,Cameo - She's Strange,7,5,14,1.0,10,She's Strange,27.0,16,-4,-3,-2,1,down,1984-03-24
24779,Cameo,1984-07-21,Cameo - She's Strange,10,7,14,1.0,14,She's Strange,27.0,17,0,-4,-3,0,stay,1984-03-24
24780,Cameo,1984-07-28,Cameo - She's Strange,14,10,21,1.0,14,She's Strange,27.0,18,-7,0,-4,1,down,1984-03-24
24781,Cameo,1984-08-04,Cameo - She's Strange,14,14,22,1.0,21,She's Strange,27.0,19,-1,-7,0,1,down,1984-03-24
24782,Cameo,1984-08-11,Cameo - She's Strange,21,14,23,1.0,22,She's Strange,27.0,20,-1,-1,-7,1,down,1984-03-24
24783,Cameo,1984-08-18,Cameo - She's Strange,22,21,27,1.0,23,She's Strange,27.0,21,-4,-1,-1,1,down,1984-03-24
24784,Cameo,1984-08-25,Cameo - She's Strange,23,22,29,1.0,27,She's Strange,27.0,22,-2,-4,-1,1,down,1984-03-24
24785,Cameo,1984-09-01,Cameo - She's Strange,27,23,32,1.0,29,She's Strange,27.0,23,-3,-2,-4,1,down,1984-03-24
24786,Cameo,1984-09-08,Cameo - She's Strange,29,27,31,1.0,32,She's Strange,27.0,24,1,-3,-2,1,up,1984-03-24
24787,Cameo,1984-09-15,Cameo - She's Strange,32,29,34,1.0,31,She's Strange,27.0,25,-3,1,-3,1,down,1984-03-24
24788,Cameo,1984-09-22,Cameo - She's Strange,31,32,46,1.0,34,She's Strange,27.0,26,-12,-3,1,1,down,1984-03-24
24789,Cameo,1984-09-29,Cameo - She's Strange,34,31,51,1.0,46,She's Strange,27.0,27,-5,-12,-3,1,down,1984-03-24
24790,Stacy Lattisaw & Johnny Gill,1984-03-24,Stacy Lattisaw & Johnny Gill - Perfect Combination,51,51,33,27.0,37,Perfect Combination,10.0,0,4,14,0,1,up,1984-03-24
24791,Stacy Lattisaw & Johnny Gill,1984-03-31,Stacy Lattisaw & Johnny Gill - Perfect Combination,37,51,30,27.0,33,Perfect Combination,10.0,1,3,4,14,1,up,1984-03-24
24792,Stacy Lattisaw & Johnny Gill,1984-04-07,Stacy Lattisaw & Johnny Gill - Perfect Combination,33,37,27,27.0,30,Perfect Combination,10.0,2,3,3,4,1,up,1984-03-24
24793,Stacy Lattisaw & Johnny Gill,1984-04-14,Stacy Lattisaw & Johnny Gill - Perfect Combination,30,33,27,27.0,27,Perfect Combination,10.0,3,0,3,3,0,stay,1984-03-24
24794,Stacy Lattisaw & Johnny Gill,1984-04-21,Stacy Lattisaw & Johnny Gill - Perfect Combination,27,30,27,27.0,27,Perfect Combination,10.0,4,0,0,3,0,stay,1984-03-24
24795,Stacy Lattisaw & Johnny Gill,1984-04-28,Stacy Lattisaw & Johnny Gill - Perfect Combination,27,27,27,27.0,27,Perfect Combination,10.0,5,0,0,0,0,stay,1984-03-24
24796,Stacy Lattisaw & Johnny Gill,1984-05-05,Stacy Lattisaw & Johnny Gill - Perfect Combination,27,27,38,27.0,27,Perfect Combination,10.0,6,-11,0,0,1,down,1984-03-24
24797,Stacy Lattisaw & Johnny Gill,1984-05-12,Stacy Lattisaw & Johnny Gill - Perfect Combination,27,27,41,27.0,38,Perfect Combination,10.0,7,-3,-11,0,1,down,1984-03-24
24798,Stacy Lattisaw & Johnny Gill,1984-05-19,Stacy Lattisaw & Johnny Gill - Perfect Combination,38,27,43,27.0,41,Perfect Combination,10.0,8,-2,-3,-11,1,down,1984-03-24
24799,Stacy Lattisaw & Johnny Gill,1984-05-26,Stacy Lattisaw & Johnny Gill - Perfect Combination,41,38,44,27.0,43,Perfect Combination,10.0,9,-1,-2,-3,1,down,1984-03-24
24800,Stacy Lattisaw & Johnny Gill,1984-06-02,Stacy Lattisaw & Johnny Gill - Perfect Combination,43,41,51,27.0,44,Perfect Combination,10.0,10,-7,-1,-2,1,down,1984-03-24
24801,Eurythmics,1984-03-24,Eurythmics - Touch,51,51,41,35.0,50,Touch,14.0,0,9,1,0,1,up,1984-03-24
24802,Eurythmics,1984-03-31,Eurythmics - Touch,50,51,41,35.0,41,Touch,14.0,1,0,9,1,0,stay,1984-03-24
24803,Eurythmics,1984-04-07,Eurythmics - Touch,41,50,40,35.0,41,Touch,14.0,2,1,0,9,1,up,1984-03-24
24804,Eurythmics,1984-04-14,Eurythmics - Touch,41,41,41,35.0,40,Touch,14.0,3,-1,1,0,1,down,1984-03-24
24805,Eurythmics,1984-04-21,Eurythmics - Touch,40,41,38,35.0,41,Touch,14.0,4,3,-1,1,1,up,1984-03-24
24806,Eurythmics,1984-04-28,Eurythmics - Touch,41,40,35,35.0,38,Touch,14.0,5,3,3,-1,1,up,1984-03-24
24807,Eurythmics,1984-05-05,Eurythmics - Touch,38,41,35,35.0,35,Touch,14.0,6,0,3,3,0,stay,1984-03-24
24808,Eurythmics,1984-05-12,Eurythmics - Touch,35,38,38,35.0,35,Touch,14.0,7,-3,0,3,1,down,1984-03-24
24809,Eurythmics,1984-05-19,Eurythmics - Touch,35,35,45,35.0,38,Touch,14.0,8,-7,-3,0,1,down,1984-03-24
24810,Eurythmics,1984-05-26,Eurythmics - Touch,38,35,45,35.0,45,Touch,14.0,9,0,-7,-3,0,stay,1984-03-24
24811,Eurythmics,1984-06-02,Eurythmics - Touch,45,38,44,35.0,45,Touch,14.0,10,1,0,-7,1,up,1984-03-24
24812,Eurythmics,1984-06-09,Eurythmics - Touch,45,45,46,35.0,44,Touch,14.0,11,-2,1,0,1,down,1984-03-24
24813,Eurythmics,1984-06-16,Eurythmics - Touch,44,45,49,35.0,46,Touch,14.0,12,-3,-2,1,1,down,1984-03-24
24814,Eurythmics,1984-06-23,Eurythmics - Touch,46,44,50,35.0,49,Touch,14.0,13,-1,-3,-2,1,down,1984-03-24
24815,Eurythmics,1984-06-30,Eurythmics - Touch,49,46,51,35.0,50,Touch,14.0,14,-1,-1,-3,1,down,1984-03-24
24816,Patti Austin,1984-03-31,Patti Austin - Patti Austin,51,51,27,25.0,32,Patti Austin,9.0,0,5,19,0,1,up,1984-03-31
24817,Patti Austin,1984-04-07,Patti Austin - Patti Austin,32,51,26,25.0,27,Patti Austin,9.0,1,1,5,19,1,up,1984-03-31
24818,Patti Austin,1984-04-14,Patti Austin - Patti Austin,27,32,26,25.0,26,Patti Austin,9.0,2,0,1,5,0,stay,1984-03-31
24819,Patti Austin,1984-04-21,Patti Austin - Patti Austin,26,27,26,25.0,26,Patti Austin,9.0,3,0,0,1,0,stay,1984-03-31
24820,Patti Austin,1984-04-28,Patti Austin - Patti Austin,26,26,25,25.0,26,Patti Austin,9.0,4,1,0,0,1,up,1984-03-31
24821,Patti Austin,1984-05-05,Patti Austin - Patti Austin,26,26,36,25.0,25,Patti Austin,9.0,5,-11,1,0,1,down,1984-03-31
24822,Patti Austin,1984-05-12,Patti Austin - Patti Austin,25,26,37,25.0,36,Patti Austin,9.0,6,-1,-11,1,1,down,1984-03-31
24823,Patti Austin,1984-05-19,Patti Austin - Patti Austin,36,25,39,25.0,37,Patti Austin,9.0,7,-2,-1,-11,1,down,1984-03-31
24824,Patti Austin,1984-05-26,Patti Austin - Patti Austin,37,36,43,25.0,39,Patti Austin,9.0,8,-4,-2,-1,1,down,1984-03-31
24825,Patti Austin,1984-06-02,Patti Austin - Patti Austin,39,37,51,25.0,43,Patti Austin,9.0,9,-8,-4,-2,1,down,1984-03-31
24826,The Art Of Noise,1984-03-31,The Art Of Noise - Into Battle With The Art Of Noise,51,51,39,21.0,44,Into Battle With The Art Of Noise,17.0,0,5,7,0,1,up,1984-03-31
24827,The Art Of Noise,1984-04-07,The Art Of Noise - Into Battle With The Art Of Noise,44,51,36,21.0,39,Into Battle With The Art Of Noise,17.0,1,3,5,7,1,up,1984-03-31
24828,The Art Of Noise,1984-04-14,The Art Of Noise - Into Battle With The Art Of Noise,39,44,28,21.0,36,Into Battle With The Art Of Noise,17.0,2,8,3,5,1,up,1984-03-31
24829,The Art Of Noise,1984-04-21,The Art Of Noise - Into Battle With The Art Of Noise,36,39,22,21.0,28,Into Battle With The Art Of Noise,17.0,3,6,8,3,1,up,1984-03-31
24830,The Art Of Noise,1984-04-28,The Art Of Noise - Into Battle With The Art Of Noise,28,36,21,21.0,22,Into Battle With The Art Of Noise,17.0,4,1,6,8,1,up,1984-03-31
24831,The Art Of Noise,1984-05-05,The Art Of Noise - Into Battle With The Art Of Noise,22,28,23,21.0,21,Into Battle With The Art Of Noise,17.0,5,-2,1,6,1,down,1984-03-31
24832,The Art Of Noise,1984-05-12,The Art Of Noise - Into Battle With The Art Of Noise,21,22,29,21.0,23,Into Battle With The Art Of Noise,17.0,6,-6,-2,1,1,down,1984-03-31
24833,The Art Of Noise,1984-05-19,The Art Of Noise - Into Battle With The Art Of Noise,23,21,29,21.0,29,Into Battle With The Art Of Noise,17.0,7,0,-6,-2,0,stay,1984-03-31
24834,The Art Of Noise,1984-05-26,The Art Of Noise - Into Battle With The Art Of Noise,29,23,32,21.0,29,Into Battle With The Art Of Noise,17.0,8,-3,0,-6,1,down,1984-03-31
24835,The Art Of Noise,1984-06-02,The Art Of Noise - Into Battle With The Art Of Noise,29,29,29,21.0,32,Into Battle With The Art Of Noise,17.0,9,3,-3,0,1,up,1984-03-31
24836,The Art Of Noise,1984-06-09,The Art Of Noise - Into Battle With The Art Of Noise,32,29,29,21.0,29,Into Battle With The Art Of Noise,17.0,10,0,3,-3,0,stay,1984-03-31
24837,The Art Of Noise,1984-06-16,The Art Of Noise - Into Battle With The Art Of Noise,29,32,42,21.0,29,Into Battle With The Art Of Noise,17.0,11,-13,0,3,1,down,1984-03-31
24838,The Art Of Noise,1984-06-23,The Art Of Noise - Into Battle With The Art Of Noise,29,29,41,21.0,42,Into Battle With The Art Of Noise,17.0,12,1,-13,0,1,up,1984-03-31
24839,The Art Of Noise,1984-06-30,The Art Of Noise - Into Battle With The Art Of Noise,42,29,39,21.0,41,Into Battle With The Art Of Noise,17.0,13,2,1,-13,1,up,1984-03-31
24840,The Art Of Noise,1984-07-07,The Art Of Noise - Into Battle With The Art Of Noise,41,42,39,21.0,39,Into Battle With The Art Of Noise,17.0,14,0,2,1,0,stay,1984-03-31
24841,The Art Of Noise,1984-07-14,The Art Of Noise - Into Battle With The Art Of Noise,39,41,40,21.0,39,Into Battle With The Art Of Noise,17.0,15,-1,0,2,1,down,1984-03-31
24842,The Art Of Noise,1984-07-21,The Art Of Noise - Into Battle With The Art Of Noise,39,39,45,21.0,40,Into Battle With The Art Of Noise,17.0,16,-5,-1,0,1,down,1984-03-31
24843,The Art Of Noise,1984-07-28,The Art Of Noise - Into Battle With The Art Of Noise,40,39,51,21.0,45,Into Battle With The Art Of Noise,17.0,17,-6,-5,-1,1,down,1984-03-31
24844,Bobby Womack,1984-03-31,Bobby Womack - The Poet II,51,51,22,5.0,46,The Poet II,21.0,0,24,5,0,1,up,1984-03-31
24845,Bobby Womack,1984-04-07,Bobby Womack - The Poet II,46,51,8,5.0,22,The Poet II,21.0,1,14,24,5,1,up,1984-03-31
24846,Bobby Womack,1984-04-14,Bobby Womack - The Poet II,22,46,6,5.0,8,The Poet II,21.0,2,2,14,24,1,up,1984-03-31
24847,Bobby Womack,1984-04-21,Bobby Womack - The Poet II,8,22,5,5.0,6,The Poet II,21.0,3,1,2,14,1,up,1984-03-31
24848,Bobby Womack,1984-04-28,Bobby Womack - The Poet II,6,8,6,5.0,5,The Poet II,21.0,4,-1,1,2,1,down,1984-03-31
24849,Bobby Womack,1984-05-05,Bobby Womack - The Poet II,5,6,6,5.0,6,The Poet II,21.0,5,0,-1,1,0,stay,1984-03-31
24850,Bobby Womack,1984-05-12,Bobby Womack - The Poet II,6,5,6,5.0,6,The Poet II,21.0,6,0,0,-1,0,stay,1984-03-31
24851,Bobby Womack,1984-05-19,Bobby Womack - The Poet II,6,6,9,5.0,6,The Poet II,21.0,7,-3,0,0,1,down,1984-03-31
24852,Bobby Womack,1984-05-26,Bobby Womack - The Poet II,6,6,9,5.0,9,The Poet II,21.0,8,0,-3,0,0,stay,1984-03-31
24853,Bobby Womack,1984-06-02,Bobby Womack - The Poet II,9,6,12,5.0,9,The Poet II,21.0,9,-3,0,-3,1,down,1984-03-31
24854,Bobby Womack,1984-06-09,Bobby Womack - The Poet II,9,9,13,5.0,12,The Poet II,21.0,10,-1,-3,0,1,down,1984-03-31
24855,Bobby Womack,1984-06-16,Bobby Womack - The Poet II,12,9,18,5.0,13,The Poet II,21.0,11,-5,-1,-3,1,down,1984-03-31
24856,Bobby Womack,1984-06-23,Bobby Womack - The Poet II,13,12,23,5.0,18,The Poet II,21.0,12,-5,-5,-1,1,down,1984-03-31
24857,Bobby Womack,1984-06-30,Bobby Womack - The Poet II,18,13,22,5.0,23,The Poet II,21.0,13,1,-5,-5,1,up,1984-03-31
24858,Bobby Womack,1984-07-07,Bobby Womack - The Poet II,23,18,24,5.0,22,The Poet II,21.0,14,-2,1,-5,1,down,1984-03-31
24859,Bobby Womack,1984-07-14,Bobby Womack - The Poet II,22,23,25,5.0,24,The Poet II,21.0,15,-1,-2,1,1,down,1984-03-31
24860,Bobby Womack,1984-07-21,Bobby Womack - The Poet II,24,22,30,5.0,25,The Poet II,21.0,16,-5,-1,-2,1,down,1984-03-31
24861,Bobby Womack,1984-07-28,Bobby Womack - The Poet II,25,24,30,5.0,30,The Poet II,21.0,17,0,-5,-1,0,stay,1984-03-31
24862,Bobby Womack,1984-08-04,Bobby Womack - The Poet II,30,25,33,5.0,30,The Poet II,21.0,18,-3,0,-5,1,down,1984-03-31
24863,Bobby Womack,1984-08-11,Bobby Womack - The Poet II,30,30,37,5.0,33,The Poet II,21.0,19,-4,-3,0,1,down,1984-03-31
24864,Bobby Womack,1984-08-18,Bobby Womack - The Poet II,33,30,39,5.0,37,The Poet II,21.0,20,-2,-4,-3,1,down,1984-03-31
24865,Bobby Womack,1984-08-25,Bobby Womack - The Poet II,37,33,51,5.0,39,The Poet II,21.0,21,-12,-2,-4,1,down,1984-03-31
24866,Earl Klugh,1984-04-07,Earl Klugh - Wishful Thinking,51,51,35,18.0,47,Wishful Thinking,20.0,0,12,4,0,1,up,1984-04-07
24867,Earl Klugh,1984-04-14,Earl Klugh - Wishful Thinking,47,51,32,18.0,35,Wishful Thinking,20.0,1,3,12,4,1,up,1984-04-07
24868,Earl Klugh,1984-04-21,Earl Klugh - Wishful Thinking,35,47,30,18.0,32,Wishful Thinking,20.0,2,2,3,12,1,up,1984-04-07
24869,Earl Klugh,1984-04-28,Earl Klugh - Wishful Thinking,32,35,28,18.0,30,Wishful Thinking,20.0,3,2,2,3,1,up,1984-04-07
24870,Earl Klugh,1984-05-05,Earl Klugh - Wishful Thinking,30,32,28,18.0,28,Wishful Thinking,20.0,4,0,2,2,0,stay,1984-04-07
24871,Earl Klugh,1984-05-12,Earl Klugh - Wishful Thinking,28,30,25,18.0,28,Wishful Thinking,20.0,5,3,0,2,1,up,1984-04-07
24872,Earl Klugh,1984-05-19,Earl Klugh - Wishful Thinking,28,28,23,18.0,25,Wishful Thinking,20.0,6,2,3,0,1,up,1984-04-07
24873,Earl Klugh,1984-05-26,Earl Klugh - Wishful Thinking,25,28,21,18.0,23,Wishful Thinking,20.0,7,2,2,3,1,up,1984-04-07
24874,Earl Klugh,1984-06-02,Earl Klugh - Wishful Thinking,23,25,18,18.0,21,Wishful Thinking,20.0,8,3,2,2,1,up,1984-04-07
24875,Earl Klugh,1984-06-09,Earl Klugh - Wishful Thinking,21,23,18,18.0,18,Wishful Thinking,20.0,9,0,3,2,0,stay,1984-04-07
24876,Earl Klugh,1984-06-16,Earl Klugh - Wishful Thinking,18,21,28,18.0,18,Wishful Thinking,20.0,10,-10,0,3,1,down,1984-04-07
24877,Earl Klugh,1984-06-23,Earl Klugh - Wishful Thinking,18,18,29,18.0,28,Wishful Thinking,20.0,11,-1,-10,0,1,down,1984-04-07
24878,Earl Klugh,1984-06-30,Earl Klugh - Wishful Thinking,28,18,31,18.0,29,Wishful Thinking,20.0,12,-2,-1,-10,1,down,1984-04-07
24879,Earl Klugh,1984-07-07,Earl Klugh - Wishful Thinking,29,28,30,18.0,31,Wishful Thinking,20.0,13,1,-2,-1,1,up,1984-04-07
24880,Earl Klugh,1984-07-14,Earl Klugh - Wishful Thinking,31,29,33,18.0,30,Wishful Thinking,20.0,14,-3,1,-2,1,down,1984-04-07
24881,Earl Klugh,1984-07-21,Earl Klugh - Wishful Thinking,30,31,33,18.0,33,Wishful Thinking,20.0,15,0,-3,1,0,stay,1984-04-07
24882,Earl Klugh,1984-07-28,Earl Klugh - Wishful Thinking,33,30,36,18.0,33,Wishful Thinking,20.0,16,-3,0,-3,1,down,1984-04-07
24883,Earl Klugh,1984-08-04,Earl Klugh - Wishful Thinking,33,33,43,18.0,36,Wishful Thinking,20.0,17,-7,-3,0,1,down,1984-04-07
24884,Earl Klugh,1984-08-11,Earl Klugh - Wishful Thinking,36,33,43,18.0,43,Wishful Thinking,20.0,18,0,-7,-3,0,stay,1984-04-07
24885,Earl Klugh,1984-08-18,Earl Klugh - Wishful Thinking,43,36,42,18.0,43,Wishful Thinking,20.0,19,1,0,-7,1,up,1984-04-07
24886,Earl Klugh,1984-08-25,Earl Klugh - Wishful Thinking,43,43,51,18.0,42,Wishful Thinking,20.0,20,-9,1,0,1,down,1984-04-07
24887,Laid Back,1984-04-07,Laid Back - Keep Smiling,51,51,33,22.0,49,Keep Smiling,10.0,0,16,2,0,1,up,1984-04-07
24888,Laid Back,1984-04-14,Laid Back - Keep Smiling,49,51,23,22.0,33,Keep Smiling,10.0,1,10,16,2,1,up,1984-04-07
24889,Laid Back,1984-04-21,Laid Back - Keep Smiling,33,49,23,22.0,23,Keep Smiling,10.0,2,0,10,16,0,stay,1984-04-07
24890,Laid Back,1984-04-28,Laid Back - Keep Smiling,23,33,23,22.0,23,Keep Smiling,10.0,3,0,0,10,0,stay,1984-04-07
24891,Laid Back,1984-05-05,Laid Back - Keep Smiling,23,23,22,22.0,23,Keep Smiling,10.0,4,1,0,0,1,up,1984-04-07
24892,Laid Back,1984-05-12,Laid Back - Keep Smiling,23,23,24,22.0,22,Keep Smiling,10.0,5,-2,1,0,1,down,1984-04-07
24893,Laid Back,1984-05-19,Laid Back - Keep Smiling,22,23,36,22.0,24,Keep Smiling,10.0,6,-12,-2,1,1,down,1984-04-07
24894,Laid Back,1984-05-26,Laid Back - Keep Smiling,24,22,34,22.0,36,Keep Smiling,10.0,7,2,-12,-2,1,up,1984-04-07
24895,Laid Back,1984-06-02,Laid Back - Keep Smiling,36,24,34,22.0,34,Keep Smiling,10.0,8,0,2,-12,0,stay,1984-04-07
24896,Laid Back,1984-06-09,Laid Back - Keep Smiling,34,36,47,22.0,34,Keep Smiling,10.0,9,-13,0,2,1,down,1984-04-07
24897,Laid Back,1984-06-16,Laid Back - Keep Smiling,34,34,51,22.0,47,Keep Smiling,10.0,10,-4,-13,0,1,down,1984-04-07
24898,Jeff Lorber,1984-04-07,Jeff Lorber - In The Heat Of The Night,51,51,47,44.0,50,In The Heat Of The Night,3.0,0,3,1,0,1,up,1984-04-07
24899,Jeff Lorber,1984-04-14,Jeff Lorber - In The Heat Of The Night,50,51,44,44.0,47,In The Heat Of The Night,3.0,1,3,3,1,1,up,1984-04-07
24900,Jeff Lorber,1984-04-21,Jeff Lorber - In The Heat Of The Night,47,50,44,44.0,44,In The Heat Of The Night,3.0,2,0,3,3,0,stay,1984-04-07
24901,Jeff Lorber,1984-04-28,Jeff Lorber - In The Heat Of The Night,44,47,51,44.0,44,In The Heat Of The Night,3.0,3,-7,0,3,1,down,1984-04-07
24902,The Temptations,1984-04-14,The Temptations - Back To Basics,51,51,43,30.0,45,Back To Basics,12.0,0,2,6,0,1,up,1984-04-14
24903,The Temptations,1984-04-21,The Temptations - Back To Basics,45,51,41,30.0,43,Back To Basics,12.0,1,2,2,6,1,up,1984-04-14
24904,The Temptations,1984-04-28,The Temptations - Back To Basics,43,45,39,30.0,41,Back To Basics,12.0,2,2,2,2,1,up,1984-04-14
24905,The Temptations,1984-05-05,The Temptations - Back To Basics,41,43,33,30.0,39,Back To Basics,12.0,3,6,2,2,1,up,1984-04-14
24906,The Temptations,1984-05-12,The Temptations - Back To Basics,39,41,32,30.0,33,Back To Basics,12.0,4,1,6,2,1,up,1984-04-14
24907,The Temptations,1984-05-19,The Temptations - Back To Basics,33,39,32,30.0,32,Back To Basics,12.0,5,0,1,6,0,stay,1984-04-14
24908,The Temptations,1984-05-26,The Temptations - Back To Basics,32,33,31,30.0,32,Back To Basics,12.0,6,1,0,1,1,up,1984-04-14
24909,The Temptations,1984-06-02,The Temptations - Back To Basics,32,32,31,30.0,31,Back To Basics,12.0,7,0,1,0,0,stay,1984-04-14
24910,The Temptations,1984-06-09,The Temptations - Back To Basics,31,32,30,30.0,31,Back To Basics,12.0,8,1,0,1,1,up,1984-04-14
24911,The Temptations,1984-06-16,The Temptations - Back To Basics,31,31,41,30.0,30,Back To Basics,12.0,9,-11,1,0,1,down,1984-04-14
24912,The Temptations,1984-06-23,The Temptations - Back To Basics,30,31,46,30.0,41,Back To Basics,12.0,10,-5,-11,1,1,down,1984-04-14
24913,The Temptations,1984-06-30,The Temptations - Back To Basics,41,30,46,30.0,46,Back To Basics,12.0,11,0,-5,-11,0,stay,1984-04-14
24914,The Temptations,1984-07-07,The Temptations - Back To Basics,46,41,51,30.0,46,Back To Basics,12.0,12,-5,0,-5,1,down,1984-04-14
24915,Starpoint,1984-04-14,Starpoint - It's All Yours,51,51,42,40.0,46,It's All Yours,4.0,0,4,5,0,1,up,1984-04-14
24916,Starpoint,1984-04-21,Starpoint - It's All Yours,46,51,40,40.0,42,It's All Yours,4.0,1,2,4,5,1,up,1984-04-14
24917,Starpoint,1984-04-28,Starpoint - It's All Yours,42,46,40,40.0,40,It's All Yours,4.0,2,0,2,4,0,stay,1984-04-14
24918,Starpoint,1984-05-05,Starpoint - It's All Yours,40,42,48,40.0,40,It's All Yours,4.0,3,-8,0,2,1,down,1984-04-14
24919,Starpoint,1984-05-12,Starpoint - It's All Yours,40,40,51,40.0,48,It's All Yours,4.0,4,-3,-8,0,1,down,1984-04-14
24920,"""Weird Al"" Yankovic",1984-04-14,"""Weird Al"" Yankovic - ""Weird Al"" Yankovic In 3-D",51,51,46,46.0,49,"""Weird Al"" Yankovic In 3-D",2.0,0,3,2,0,1,up,1984-04-14
24921,"""Weird Al"" Yankovic",1984-04-21,"""Weird Al"" Yankovic - ""Weird Al"" Yankovic In 3-D",49,51,46,46.0,46,"""Weird Al"" Yankovic In 3-D",2.0,1,0,3,2,0,stay,1984-04-14
24922,"""Weird Al"" Yankovic",1984-04-28,"""Weird Al"" Yankovic - ""Weird Al"" Yankovic In 3-D",46,49,51,46.0,46,"""Weird Al"" Yankovic In 3-D",2.0,2,-5,0,3,1,down,1984-04-14
24923,Soundtrack,1984-04-21,Soundtrack - Footloose,51,51,20,16.0,38,Footloose,12.0,0,18,13,0,1,up,1984-04-21
24924,Soundtrack,1984-04-28,Soundtrack - Footloose,38,51,18,16.0,20,Footloose,12.0,1,2,18,13,1,up,1984-04-21
24925,Soundtrack,1984-05-05,Soundtrack - Footloose,20,38,16,16.0,18,Footloose,12.0,2,2,2,18,1,up,1984-04-21
24926,Soundtrack,1984-05-12,Soundtrack - Footloose,18,20,16,16.0,16,Footloose,12.0,3,0,2,2,0,stay,1984-04-21
24927,Soundtrack,1984-05-19,Soundtrack - Footloose,16,18,19,16.0,16,Footloose,12.0,4,-3,0,2,1,down,1984-04-21
24928,Soundtrack,1984-05-26,Soundtrack - Footloose,16,16,25,16.0,19,Footloose,12.0,5,-6,-3,0,1,down,1984-04-21
24929,Soundtrack,1984-06-02,Soundtrack - Footloose,19,16,25,16.0,25,Footloose,12.0,6,0,-6,-3,0,stay,1984-04-21
24930,Soundtrack,1984-06-09,Soundtrack - Footloose,25,19,34,16.0,25,Footloose,12.0,7,-9,0,-6,1,down,1984-04-21
24931,Soundtrack,1984-06-16,Soundtrack - Footloose,25,25,34,16.0,34,Footloose,12.0,8,0,-9,0,0,stay,1984-04-21
24932,Soundtrack,1984-06-23,Soundtrack - Footloose,34,25,34,16.0,34,Footloose,12.0,9,0,0,-9,0,stay,1984-04-21
24933,Soundtrack,1984-06-30,Soundtrack - Footloose,34,34,35,16.0,34,Footloose,12.0,10,-1,0,0,1,down,1984-04-21
24934,Soundtrack,1984-07-07,Soundtrack - Footloose,34,34,49,16.0,35,Footloose,12.0,11,-14,-1,0,1,down,1984-04-21
24935,Soundtrack,1984-07-14,Soundtrack - Footloose,35,34,51,16.0,49,Footloose,12.0,12,-2,-14,-1,1,down,1984-04-21
24936,Yarbrough & Peoples,1984-04-21,Yarbrough & Peoples - Be A Winner,51,51,43,6.0,47,Be A Winner,25.0,0,4,4,0,1,up,1984-04-21
24937,Yarbrough & Peoples,1984-04-28,Yarbrough & Peoples - Be A Winner,47,51,26,6.0,43,Be A Winner,25.0,1,17,4,4,1,up,1984-04-21
24938,Yarbrough & Peoples,1984-05-05,Yarbrough & Peoples - Be A Winner,43,47,24,6.0,26,Be A Winner,25.0,2,2,17,4,1,up,1984-04-21
24939,Yarbrough & Peoples,1984-05-12,Yarbrough & Peoples - Be A Winner,26,43,13,6.0,24,Be A Winner,25.0,3,11,2,17,1,up,1984-04-21
24940,Yarbrough & Peoples,1984-05-19,Yarbrough & Peoples - Be A Winner,24,26,6,6.0,13,Be A Winner,25.0,4,7,11,2,1,up,1984-04-21
24941,Yarbrough & Peoples,1984-05-26,Yarbrough & Peoples - Be A Winner,13,24,6,6.0,6,Be A Winner,25.0,5,0,7,11,0,stay,1984-04-21
24942,Yarbrough & Peoples,1984-06-02,Yarbrough & Peoples - Be A Winner,6,13,6,6.0,6,Be A Winner,25.0,6,0,0,7,0,stay,1984-04-21
24943,Yarbrough & Peoples,1984-06-09,Yarbrough & Peoples - Be A Winner,6,6,6,6.0,6,Be A Winner,25.0,7,0,0,0,0,stay,1984-04-21
24944,Yarbrough & Peoples,1984-06-16,Yarbrough & Peoples - Be A Winner,6,6,7,6.0,6,Be A Winner,25.0,8,-1,0,0,1,down,1984-04-21
24945,Yarbrough & Peoples,1984-06-23,Yarbrough & Peoples - Be A Winner,6,6,19,6.0,7,Be A Winner,25.0,9,-12,-1,0,1,down,1984-04-21
24946,Yarbrough & Peoples,1984-06-30,Yarbrough & Peoples - Be A Winner,7,6,19,6.0,19,Be A Winner,25.0,10,0,-12,-1,0,stay,1984-04-21
24947,Yarbrough & Peoples,1984-07-07,Yarbrough & Peoples - Be A Winner,19,7,22,6.0,19,Be A Winner,25.0,11,-3,0,-12,1,down,1984-04-21
24948,Yarbrough & Peoples,1984-07-14,Yarbrough & Peoples - Be A Winner,19,19,24,6.0,22,Be A Winner,25.0,12,-2,-3,0,1,down,1984-04-21
24949,Yarbrough & Peoples,1984-07-21,Yarbrough & Peoples - Be A Winner,22,19,29,6.0,24,Be A Winner,25.0,13,-5,-2,-3,1,down,1984-04-21
24950,Yarbrough & Peoples,1984-07-28,Yarbrough & Peoples - Be A Winner,24,22,29,6.0,29,Be A Winner,25.0,14,0,-5,-2,0,stay,1984-04-21
24951,Yarbrough & Peoples,1984-08-04,Yarbrough & Peoples - Be A Winner,29,24,31,6.0,29,Be A Winner,25.0,15,-2,0,-5,1,down,1984-04-21
24952,Yarbrough & Peoples,1984-08-11,Yarbrough & Peoples - Be A Winner,29,29,38,6.0,31,Be A Winner,25.0,16,-7,-2,0,1,down,1984-04-21
24953,Yarbrough & Peoples,1984-08-18,Yarbrough & Peoples - Be A Winner,31,29,38,6.0,38,Be A Winner,25.0,17,0,-7,-2,0,stay,1984-04-21
24954,Yarbrough & Peoples,1984-08-25,Yarbrough & Peoples - Be A Winner,38,31,36,6.0,38,Be A Winner,25.0,18,2,0,-7,1,up,1984-04-21
24955,Yarbrough & Peoples,1984-09-01,Yarbrough & Peoples - Be A Winner,38,38,36,6.0,36,Be A Winner,25.0,19,0,2,0,0,stay,1984-04-21
24956,Yarbrough & Peoples,1984-09-08,Yarbrough & Peoples - Be A Winner,36,38,34,6.0,36,Be A Winner,25.0,20,2,0,2,1,up,1984-04-21
24957,Yarbrough & Peoples,1984-09-15,Yarbrough & Peoples - Be A Winner,36,36,36,6.0,34,Be A Winner,25.0,21,-2,2,0,1,down,1984-04-21
24958,Yarbrough & Peoples,1984-09-22,Yarbrough & Peoples - Be A Winner,34,36,47,6.0,36,Be A Winner,25.0,22,-11,-2,2,1,down,1984-04-21
24959,Yarbrough & Peoples,1984-09-29,Yarbrough & Peoples - Be A Winner,36,34,48,6.0,47,Be A Winner,25.0,23,-1,-11,-2,1,down,1984-04-21
24960,Yarbrough & Peoples,1984-10-06,Yarbrough & Peoples - Be A Winner,47,36,47,6.0,48,Be A Winner,25.0,24,1,-1,-11,1,up,1984-04-21
24961,Yarbrough & Peoples,1984-10-13,Yarbrough & Peoples - Be A Winner,48,47,51,6.0,47,Be A Winner,25.0,25,-4,1,-1,1,down,1984-04-21
24962,Denise LaSalle,1984-04-21,"Denise LaSalle - Right Place, Right Time",51,51,42,38.0,48,"Right Place, Right Time",8.0,0,6,3,0,1,up,1984-04-21
24963,Denise LaSalle,1984-04-28,"Denise LaSalle - Right Place, Right Time",48,51,41,38.0,42,"Right Place, Right Time",8.0,1,1,6,3,1,up,1984-04-21
24964,Denise LaSalle,1984-05-05,"Denise LaSalle - Right Place, Right Time",42,48,41,38.0,41,"Right Place, Right Time",8.0,2,0,1,6,0,stay,1984-04-21
24965,Denise LaSalle,1984-05-12,"Denise LaSalle - Right Place, Right Time",41,42,43,38.0,41,"Right Place, Right Time",8.0,3,-2,0,1,1,down,1984-04-21
24966,Denise LaSalle,1984-05-19,"Denise LaSalle - Right Place, Right Time",41,41,41,38.0,43,"Right Place, Right Time",8.0,4,2,-2,0,1,up,1984-04-21
24967,Denise LaSalle,1984-05-26,"Denise LaSalle - Right Place, Right Time",43,41,38,38.0,41,"Right Place, Right Time",8.0,5,3,2,-2,1,up,1984-04-21
24968,Denise LaSalle,1984-06-02,"Denise LaSalle - Right Place, Right Time",41,43,38,38.0,38,"Right Place, Right Time",8.0,6,0,3,2,0,stay,1984-04-21
24969,Denise LaSalle,1984-06-09,"Denise LaSalle - Right Place, Right Time",38,41,48,38.0,38,"Right Place, Right Time",8.0,7,-10,0,3,1,down,1984-04-21
24970,Denise LaSalle,1984-06-16,"Denise LaSalle - Right Place, Right Time",38,38,51,38.0,48,"Right Place, Right Time",8.0,8,-3,-10,0,1,down,1984-04-21
24971,Kleeer,1984-04-21,Kleeer - Intimate Connection,51,51,49,49.0,49,Intimate Connection,3.0,0,0,2,0,0,stay,1984-04-21
24972,Kleeer,1984-04-28,Kleeer - Intimate Connection,49,51,50,49.0,49,Intimate Connection,3.0,1,-1,0,2,1,down,1984-04-21
24973,Kleeer,1984-08-18,Kleeer - Intimate Connection,49,49,50,49.0,50,Intimate Connection,3.0,2,0,-1,0,0,stay,1984-04-21
24974,Kleeer,1984-08-25,Kleeer - Intimate Connection,50,49,51,49.0,50,Intimate Connection,3.0,3,-1,0,-1,1,down,1984-04-21
24975,Barkays,1984-04-21,Barkays - Dangerous,51,51,15,7.0,50,Dangerous,38.0,0,35,1,0,1,up,1984-04-21
24976,Barkays,1984-04-28,Barkays - Dangerous,50,51,12,7.0,15,Dangerous,38.0,1,3,35,1,1,up,1984-04-21
24977,Barkays,1984-05-05,Barkays - Dangerous,15,50,10,7.0,12,Dangerous,38.0,2,2,3,35,1,up,1984-04-21
24978,Barkays,1984-05-12,Barkays - Dangerous,12,15,7,7.0,10,Dangerous,38.0,3,3,2,3,1,up,1984-04-21
24979,Barkays,1984-05-19,Barkays - Dangerous,10,12,7,7.0,7,Dangerous,38.0,4,0,3,2,0,stay,1984-04-21
24980,Barkays,1984-05-26,Barkays - Dangerous,7,10,7,7.0,7,Dangerous,38.0,5,0,0,3,0,stay,1984-04-21
24981,Barkays,1984-06-02,Barkays - Dangerous,7,7,7,7.0,7,Dangerous,38.0,6,0,0,0,0,stay,1984-04-21
24982,Barkays,1984-06-09,Barkays - Dangerous,7,7,7,7.0,7,Dangerous,38.0,7,0,0,0,0,stay,1984-04-21
24983,Barkays,1984-06-16,Barkays - Dangerous,7,7,12,7.0,7,Dangerous,38.0,8,-5,0,0,1,down,1984-04-21
24984,Barkays,1984-06-23,Barkays - Dangerous,7,7,12,7.0,12,Dangerous,38.0,9,0,-5,0,0,stay,1984-04-21
24985,Barkays,1984-06-30,Barkays - Dangerous,12,7,15,7.0,12,Dangerous,38.0,10,-3,0,-5,1,down,1984-04-21
24986,Barkays,1984-07-07,Barkays - Dangerous,12,12,15,7.0,15,Dangerous,38.0,11,0,-3,0,0,stay,1984-04-21
24987,Barkays,1984-07-14,Barkays - Dangerous,15,12,15,7.0,15,Dangerous,38.0,12,0,0,-3,0,stay,1984-04-21
24988,Barkays,1984-07-21,Barkays - Dangerous,15,15,18,7.0,15,Dangerous,38.0,13,-3,0,0,1,down,1984-04-21
24989,Barkays,1984-07-28,Barkays - Dangerous,15,15,26,7.0,18,Dangerous,38.0,14,-8,-3,0,1,down,1984-04-21
24990,Barkays,1984-08-04,Barkays - Dangerous,18,15,26,7.0,26,Dangerous,38.0,15,0,-8,-3,0,stay,1984-04-21
24991,Barkays,1984-08-11,Barkays - Dangerous,26,18,25,7.0,26,Dangerous,38.0,16,1,0,-8,1,up,1984-04-21
24992,Barkays,1984-08-18,Barkays - Dangerous,26,26,25,7.0,25,Dangerous,38.0,17,0,1,0,0,stay,1984-04-21
24993,Barkays,1984-08-25,Barkays - Dangerous,25,26,24,7.0,25,Dangerous,38.0,18,1,0,1,1,up,1984-04-21
24994,Barkays,1984-09-01,Barkays - Dangerous,25,25,28,7.0,24,Dangerous,38.0,19,-4,1,0,1,down,1984-04-21
24995,Barkays,1984-09-08,Barkays - Dangerous,24,25,28,7.0,28,Dangerous,38.0,20,0,-4,1,0,stay,1984-04-21
24996,Barkays,1984-09-15,Barkays - Dangerous,28,24,29,7.0,28,Dangerous,38.0,21,-1,0,-4,1,down,1984-04-21
24997,Barkays,1984-09-22,Barkays - Dangerous,28,28,36,7.0,29,Dangerous,38.0,22,-7,-1,0,1,down,1984-04-21
24998,Barkays,1984-09-29,Barkays - Dangerous,29,28,43,7.0,36,Dangerous,38.0,23,-7,-7,-1,1,down,1984-04-21
24999,Barkays,1984-10-06,Barkays - Dangerous,36,29,43,7.0,43,Dangerous,38.0,24,0,-7,-7,0,stay,1984-04-21
25000,Barkays,1984-10-13,Barkays - Dangerous,43,36,42,7.0,43,Dangerous,38.0,25,1,0,-7,1,up,1984-04-21
25001,Barkays,1984-10-20,Barkays - Dangerous,43,43,39,7.0,42,Dangerous,38.0,26,3,1,0,1,up,1984-04-21
25002,Barkays,1984-10-27,Barkays - Dangerous,42,43,38,7.0,39,Dangerous,38.0,27,1,3,1,1,up,1984-04-21
25003,Barkays,1984-11-03,Barkays - Dangerous,39,42,38,7.0,38,Dangerous,38.0,28,0,1,3,0,stay,1984-04-21
25004,Barkays,1984-11-10,Barkays - Dangerous,38,39,33,7.0,38,Dangerous,38.0,29,5,0,1,1,up,1984-04-21
25005,Barkays,1984-11-17,Barkays - Dangerous,38,38,28,7.0,33,Dangerous,38.0,30,5,5,0,1,up,1984-04-21
25006,Barkays,1984-11-24,Barkays - Dangerous,33,38,28,7.0,28,Dangerous,38.0,31,0,5,5,0,stay,1984-04-21
25007,Barkays,1984-12-01,Barkays - Dangerous,28,33,27,7.0,28,Dangerous,38.0,32,1,0,5,1,up,1984-04-21
25008,Barkays,1984-12-08,Barkays - Dangerous,28,28,27,7.0,27,Dangerous,38.0,33,0,1,0,0,stay,1984-04-21
25009,Barkays,1984-12-15,Barkays - Dangerous,27,28,36,7.0,27,Dangerous,38.0,34,-9,0,1,1,down,1984-04-21
25010,Barkays,1984-12-22,Barkays - Dangerous,27,27,36,7.0,36,Dangerous,38.0,35,0,-9,0,0,stay,1984-04-21
25011,Barkays,1984-12-29,Barkays - Dangerous,36,27,41,7.0,36,Dangerous,38.0,36,-5,0,-9,1,down,1984-04-21
25012,Barkays,1985-01-05,Barkays - Dangerous,36,36,49,7.0,41,Dangerous,38.0,37,-8,-5,0,1,down,1984-04-21
25013,Barkays,1985-01-12,Barkays - Dangerous,41,36,51,7.0,49,Dangerous,38.0,38,-2,-8,-5,1,down,1984-04-21
25014,One Way,1984-04-28,One Way - Lady,51,51,19,1.0,28,Lady,27.0,0,9,23,0,1,up,1984-04-28
25015,One Way,1984-05-05,One Way - Lady,28,51,11,1.0,19,Lady,27.0,1,8,9,23,1,up,1984-04-28
25016,One Way,1984-05-12,One Way - Lady,19,28,9,1.0,11,Lady,27.0,2,2,8,9,1,up,1984-04-28
25017,One Way,1984-05-19,One Way - Lady,11,19,8,1.0,9,Lady,27.0,3,1,2,8,1,up,1984-04-28
25018,One Way,1984-05-26,One Way - Lady,9,11,5,1.0,8,Lady,27.0,4,3,1,2,1,up,1984-04-28
25019,One Way,1984-06-02,One Way - Lady,8,9,5,1.0,5,Lady,27.0,5,0,3,1,0,stay,1984-04-28
25020,One Way,1984-06-09,One Way - Lady,5,8,5,1.0,5,Lady,27.0,6,0,0,3,0,stay,1984-04-28
25021,One Way,1984-06-16,One Way - Lady,5,5,3,1.0,5,Lady,27.0,7,2,0,0,1,up,1984-04-28
25022,One Way,1984-06-23,One Way - Lady,5,5,3,1.0,3,Lady,27.0,8,0,2,0,0,stay,1984-04-28
25023,One Way,1984-06-30,One Way - Lady,3,5,4,1.0,3,Lady,27.0,9,-1,0,2,1,down,1984-04-28
25024,One Way,1984-07-07,One Way - Lady,3,3,1,1.0,4,Lady,27.0,10,3,-1,0,1,up,1984-04-28
25025,One Way,1984-07-14,One Way - Lady,4,3,5,1.0,1,Lady,27.0,11,-4,3,-1,1,down,1984-04-28
25026,One Way,1984-07-21,One Way - Lady,1,4,6,1.0,5,Lady,27.0,12,-1,-4,3,1,down,1984-04-28
25027,One Way,1984-07-28,One Way - Lady,5,1,6,1.0,6,Lady,27.0,13,0,-1,-4,0,stay,1984-04-28
25028,One Way,1984-08-04,One Way - Lady,6,5,7,1.0,6,Lady,27.0,14,-1,0,-1,1,down,1984-04-28
25029,One Way,1984-08-11,One Way - Lady,6,6,8,1.0,7,Lady,27.0,15,-1,-1,0,1,down,1984-04-28
25030,One Way,1984-08-18,One Way - Lady,7,6,9,1.0,8,Lady,27.0,16,-1,-1,-1,1,down,1984-04-28
25031,One Way,1984-08-25,One Way - Lady,8,7,12,1.0,9,Lady,27.0,17,-3,-1,-1,1,down,1984-04-28
25032,One Way,1984-09-01,One Way - Lady,9,8,12,1.0,12,Lady,27.0,18,0,-3,-1,0,stay,1984-04-28
25033,One Way,1984-09-08,One Way - Lady,12,9,14,1.0,12,Lady,27.0,19,-2,0,-3,1,down,1984-04-28
25034,One Way,1984-09-15,One Way - Lady,12,12,21,1.0,14,Lady,27.0,20,-7,-2,0,1,down,1984-04-28
25035,One Way,1984-09-22,One Way - Lady,14,12,26,1.0,21,Lady,27.0,21,-5,-7,-2,1,down,1984-04-28
25036,One Way,1984-09-29,One Way - Lady,21,14,28,1.0,26,Lady,27.0,22,-2,-5,-7,1,down,1984-04-28
25037,One Way,1984-10-06,One Way - Lady,26,21,35,1.0,28,Lady,27.0,23,-7,-2,-5,1,down,1984-04-28
25038,One Way,1984-10-13,One Way - Lady,28,26,39,1.0,35,Lady,27.0,24,-4,-7,-2,1,down,1984-04-28
25039,One Way,1984-10-20,One Way - Lady,35,28,38,1.0,39,Lady,27.0,25,1,-4,-7,1,up,1984-04-28
25040,One Way,1984-10-27,One Way - Lady,39,35,40,1.0,38,Lady,27.0,26,-2,1,-4,1,down,1984-04-28
25041,One Way,1984-11-03,One Way - Lady,38,39,51,1.0,40,Lady,27.0,27,-11,-2,1,1,down,1984-04-28
25042,Change,1984-04-28,Change - Change Of Heart,51,51,37,15.0,47,Change Of Heart,16.0,0,10,4,0,1,up,1984-04-28
25043,Change,1984-05-05,Change - Change Of Heart,47,51,31,15.0,37,Change Of Heart,16.0,1,6,10,4,1,up,1984-04-28
25044,Change,1984-05-12,Change - Change Of Heart,37,47,27,15.0,31,Change Of Heart,16.0,2,4,6,10,1,up,1984-04-28
25045,Change,1984-05-19,Change - Change Of Heart,31,37,22,15.0,27,Change Of Heart,16.0,3,5,4,6,1,up,1984-04-28
25046,Change,1984-05-26,Change - Change Of Heart,27,31,19,15.0,22,Change Of Heart,16.0,4,3,5,4,1,up,1984-04-28
25047,Change,1984-06-02,Change - Change Of Heart,22,27,15,15.0,19,Change Of Heart,16.0,5,4,3,5,1,up,1984-04-28
25048,Change,1984-06-09,Change - Change Of Heart,19,22,15,15.0,15,Change Of Heart,16.0,6,0,4,3,0,stay,1984-04-28
25049,Change,1984-06-16,Change - Change Of Heart,15,19,17,15.0,15,Change Of Heart,16.0,7,-2,0,4,1,down,1984-04-28
25050,Change,1984-06-23,Change - Change Of Heart,15,15,22,15.0,17,Change Of Heart,16.0,8,-5,-2,0,1,down,1984-04-28
25051,Change,1984-06-30,Change - Change Of Heart,17,15,23,15.0,22,Change Of Heart,16.0,9,-1,-5,-2,1,down,1984-04-28
25052,Change,1984-07-07,Change - Change Of Heart,22,17,26,15.0,23,Change Of Heart,16.0,10,-3,-1,-5,1,down,1984-04-28
25053,Change,1984-07-14,Change - Change Of Heart,23,22,27,15.0,26,Change Of Heart,16.0,11,-1,-3,-1,1,down,1984-04-28
25054,Change,1984-07-21,Change - Change Of Heart,26,23,31,15.0,27,Change Of Heart,16.0,12,-4,-1,-3,1,down,1984-04-28
25055,Change,1984-07-28,Change - Change Of Heart,27,26,32,15.0,31,Change Of Heart,16.0,13,-1,-4,-1,1,down,1984-04-28
25056,Change,1984-08-04,Change - Change Of Heart,31,27,44,15.0,32,Change Of Heart,16.0,14,-12,-1,-4,1,down,1984-04-28
25057,Change,1984-08-11,Change - Change Of Heart,32,31,49,15.0,44,Change Of Heart,16.0,15,-5,-12,-1,1,down,1984-04-28
25058,Change,1984-08-18,Change - Change Of Heart,44,32,51,15.0,49,Change Of Heart,16.0,16,-2,-5,-12,1,down,1984-04-28
25059,The Crusaders,1984-04-28,The Crusaders - Ghetto Blaster,51,51,38,20.0,48,Ghetto Blaster,21.0,0,10,3,0,1,up,1984-04-28
25060,The Crusaders,1984-05-05,The Crusaders - Ghetto Blaster,48,51,25,20.0,38,Ghetto Blaster,21.0,1,13,10,3,1,up,1984-04-28
25061,The Crusaders,1984-05-12,The Crusaders - Ghetto Blaster,38,48,23,20.0,25,Ghetto Blaster,21.0,2,2,13,10,1,up,1984-04-28
25062,The Crusaders,1984-05-19,The Crusaders - Ghetto Blaster,25,38,20,20.0,23,Ghetto Blaster,21.0,3,3,2,13,1,up,1984-04-28
25063,The Crusaders,1984-05-26,The Crusaders - Ghetto Blaster,23,25,20,20.0,20,Ghetto Blaster,21.0,4,0,3,2,0,stay,1984-04-28
25064,The Crusaders,1984-06-02,The Crusaders - Ghetto Blaster,20,23,20,20.0,20,Ghetto Blaster,21.0,5,0,0,3,0,stay,1984-04-28
25065,The Crusaders,1984-06-09,The Crusaders - Ghetto Blaster,20,20,32,20.0,20,Ghetto Blaster,21.0,6,-12,0,0,1,down,1984-04-28
25066,The Crusaders,1984-06-16,The Crusaders - Ghetto Blaster,20,20,43,20.0,32,Ghetto Blaster,21.0,7,-11,-12,0,1,down,1984-04-28
25067,The Crusaders,1984-06-23,The Crusaders - Ghetto Blaster,32,20,42,20.0,43,Ghetto Blaster,21.0,8,1,-11,-12,1,up,1984-04-28
25068,The Crusaders,1984-06-30,The Crusaders - Ghetto Blaster,43,32,42,20.0,42,Ghetto Blaster,21.0,9,0,1,-11,0,stay,1984-04-28
25069,The Crusaders,1984-07-07,The Crusaders - Ghetto Blaster,42,43,45,20.0,42,Ghetto Blaster,21.0,10,-3,0,1,1,down,1984-04-28
25070,The Crusaders,1984-07-14,The Crusaders - Ghetto Blaster,42,42,45,20.0,45,Ghetto Blaster,21.0,11,0,-3,0,0,stay,1984-04-28
25071,The Crusaders,1984-07-21,The Crusaders - Ghetto Blaster,45,42,39,20.0,45,Ghetto Blaster,21.0,12,6,0,-3,1,up,1984-04-28
25072,The Crusaders,1984-07-28,The Crusaders - Ghetto Blaster,45,45,39,20.0,39,Ghetto Blaster,21.0,13,0,6,0,0,stay,1984-04-28
25073,The Crusaders,1984-08-04,The Crusaders - Ghetto Blaster,39,45,36,20.0,39,Ghetto Blaster,21.0,14,3,0,6,1,up,1984-04-28
25074,The Crusaders,1984-08-11,The Crusaders - Ghetto Blaster,39,39,36,20.0,36,Ghetto Blaster,21.0,15,0,3,0,0,stay,1984-04-28
25075,The Crusaders,1984-08-18,The Crusaders - Ghetto Blaster,36,39,36,20.0,36,Ghetto Blaster,21.0,16,0,0,3,0,stay,1984-04-28
25076,The Crusaders,1984-08-25,The Crusaders - Ghetto Blaster,36,36,40,20.0,36,Ghetto Blaster,21.0,17,-4,0,0,1,down,1984-04-28
25077,The Crusaders,1984-09-01,The Crusaders - Ghetto Blaster,36,36,47,20.0,40,Ghetto Blaster,21.0,18,-7,-4,0,1,down,1984-04-28
25078,The Crusaders,1984-09-08,The Crusaders - Ghetto Blaster,40,36,50,20.0,47,Ghetto Blaster,21.0,19,-3,-7,-4,1,down,1984-04-28
25079,The Crusaders,1984-09-15,The Crusaders - Ghetto Blaster,47,40,50,20.0,50,Ghetto Blaster,21.0,20,0,-3,-7,0,stay,1984-04-28
25080,The Crusaders,1984-09-22,The Crusaders - Ghetto Blaster,50,47,51,20.0,50,Ghetto Blaster,21.0,21,-1,0,-3,1,down,1984-04-28
25081,Marvin Gaye,1984-05-05,Marvin Gaye - Every Great Hit Of Marvin Gaye,51,51,26,26.0,36,Every Great Hit Of Marvin Gaye,4.0,0,10,15,0,1,up,1984-05-05
25082,Marvin Gaye,1984-05-12,Marvin Gaye - Every Great Hit Of Marvin Gaye,36,51,26,26.0,26,Every Great Hit Of Marvin Gaye,4.0,1,0,10,15,0,stay,1984-05-05
25083,Marvin Gaye,1984-05-19,Marvin Gaye - Every Great Hit Of Marvin Gaye,26,36,28,26.0,26,Every Great Hit Of Marvin Gaye,4.0,2,-2,0,10,1,down,1984-05-05
25084,Marvin Gaye,1984-05-26,Marvin Gaye - Every Great Hit Of Marvin Gaye,26,26,41,26.0,28,Every Great Hit Of Marvin Gaye,4.0,3,-13,-2,0,1,down,1984-05-05
25085,Marvin Gaye,1984-06-02,Marvin Gaye - Every Great Hit Of Marvin Gaye,28,26,51,26.0,41,Every Great Hit Of Marvin Gaye,4.0,4,-10,-13,-2,1,down,1984-05-05
25086,Marvin Gaye,1984-05-05,Marvin Gaye - Marvin Gaye Anthology,51,51,40,40.0,45,Marvin Gaye Anthology,2.0,0,5,6,0,1,up,1984-05-05
25087,Marvin Gaye,1984-05-12,Marvin Gaye - Marvin Gaye Anthology,45,51,40,40.0,40,Marvin Gaye Anthology,2.0,1,0,5,6,0,stay,1984-05-05
25088,Marvin Gaye,1984-05-19,Marvin Gaye - Marvin Gaye Anthology,40,45,51,40.0,40,Marvin Gaye Anthology,2.0,2,-11,0,5,1,down,1984-05-05
25089,The Emotions,1984-05-05,The Emotions - Sincerely,51,51,42,33.0,46,Sincerely,9.0,0,4,5,0,1,up,1984-05-05
25090,The Emotions,1984-05-12,The Emotions - Sincerely,46,51,39,33.0,42,Sincerely,9.0,1,3,4,5,1,up,1984-05-05
25091,The Emotions,1984-05-19,The Emotions - Sincerely,42,46,38,33.0,39,Sincerely,9.0,2,1,3,4,1,up,1984-05-05
25092,The Emotions,1984-05-26,The Emotions - Sincerely,39,42,36,33.0,38,Sincerely,9.0,3,2,1,3,1,up,1984-05-05
25093,The Emotions,1984-06-02,The Emotions - Sincerely,38,39,33,33.0,36,Sincerely,9.0,4,3,2,1,1,up,1984-05-05
25094,The Emotions,1984-06-09,The Emotions - Sincerely,36,38,33,33.0,33,Sincerely,9.0,5,0,3,2,0,stay,1984-05-05
25095,The Emotions,1984-06-16,The Emotions - Sincerely,33,36,33,33.0,33,Sincerely,9.0,6,0,0,3,0,stay,1984-05-05
25096,The Emotions,1984-06-23,The Emotions - Sincerely,33,33,33,33.0,33,Sincerely,9.0,7,0,0,0,0,stay,1984-05-05
25097,The Emotions,1984-06-30,The Emotions - Sincerely,33,33,34,33.0,33,Sincerely,9.0,8,-1,0,0,1,down,1984-05-05
25098,The Emotions,1984-07-07,The Emotions - Sincerely,33,33,51,33.0,34,Sincerely,9.0,9,-17,-1,0,1,down,1984-05-05
25099,The Dells,1984-05-05,The Dells - One Step Closer,51,51,49,49.0,49,One Step Closer,2.0,0,0,2,0,0,stay,1984-05-05
25100,The Dells,1984-05-12,The Dells - One Step Closer,49,51,49,49.0,49,One Step Closer,2.0,1,0,0,2,0,stay,1984-05-05
25101,The Dells,1984-05-19,The Dells - One Step Closer,49,49,51,49.0,49,One Step Closer,2.0,2,-2,0,0,1,down,1984-05-05
25102,Spinners,1984-05-05,Spinners - Cross Fire,51,51,47,47.0,50,Cross Fire,5.0,0,3,1,0,1,up,1984-05-05
25103,Spinners,1984-05-12,Spinners - Cross Fire,50,51,47,47.0,47,Cross Fire,5.0,1,0,3,1,0,stay,1984-05-05
25104,Spinners,1984-05-19,Spinners - Cross Fire,47,50,50,47.0,47,Cross Fire,5.0,2,-3,0,3,1,down,1984-05-05
25105,Spinners,1984-06-02,Spinners - Cross Fire,47,47,50,47.0,50,Cross Fire,5.0,3,0,-3,0,0,stay,1984-05-05
25106,Spinners,1984-06-09,Spinners - Cross Fire,50,47,49,47.0,50,Cross Fire,5.0,4,1,0,-3,1,up,1984-05-05
25107,Spinners,1984-06-16,Spinners - Cross Fire,50,50,51,47.0,49,Cross Fire,5.0,5,-2,1,0,1,down,1984-05-05
25108,Run-D.M.C.,1984-05-12,Run-D.M.C. - Run-D.M.C.,51,51,34,14.0,43,Run-D.M.C.,45.0,0,9,8,0,1,up,1984-05-12
25109,Run-D.M.C.,1984-05-19,Run-D.M.C. - Run-D.M.C.,43,51,30,14.0,34,Run-D.M.C.,45.0,1,4,9,8,1,up,1984-05-12
25110,Run-D.M.C.,1984-05-26,Run-D.M.C. - Run-D.M.C.,34,43,16,14.0,30,Run-D.M.C.,45.0,2,14,4,9,1,up,1984-05-12
25111,Run-D.M.C.,1984-06-02,Run-D.M.C. - Run-D.M.C.,30,34,16,14.0,16,Run-D.M.C.,45.0,3,0,14,4,0,stay,1984-05-12
25112,Run-D.M.C.,1984-06-09,Run-D.M.C. - Run-D.M.C.,16,30,16,14.0,16,Run-D.M.C.,45.0,4,0,0,14,0,stay,1984-05-12
25113,Run-D.M.C.,1984-06-16,Run-D.M.C. - Run-D.M.C.,16,16,14,14.0,16,Run-D.M.C.,45.0,5,2,0,0,1,up,1984-05-12
25114,Run-D.M.C.,1984-06-23,Run-D.M.C. - Run-D.M.C.,16,16,14,14.0,14,Run-D.M.C.,45.0,6,0,2,0,0,stay,1984-05-12
25115,Run-D.M.C.,1984-06-30,Run-D.M.C. - Run-D.M.C.,14,16,17,14.0,14,Run-D.M.C.,45.0,7,-3,0,2,1,down,1984-05-12
25116,Run-D.M.C.,1984-07-07,Run-D.M.C. - Run-D.M.C.,14,14,17,14.0,17,Run-D.M.C.,45.0,8,0,-3,0,0,stay,1984-05-12
25117,Run-D.M.C.,1984-07-14,Run-D.M.C. - Run-D.M.C.,17,14,18,14.0,17,Run-D.M.C.,45.0,9,-1,0,-3,1,down,1984-05-12
25118,Run-D.M.C.,1984-07-21,Run-D.M.C. - Run-D.M.C.,17,17,26,14.0,18,Run-D.M.C.,45.0,10,-8,-1,0,1,down,1984-05-12
25119,Run-D.M.C.,1984-07-28,Run-D.M.C. - Run-D.M.C.,18,17,23,14.0,26,Run-D.M.C.,45.0,11,3,-8,-1,1,up,1984-05-12
25120,Run-D.M.C.,1984-08-04,Run-D.M.C. - Run-D.M.C.,26,18,23,14.0,23,Run-D.M.C.,45.0,12,0,3,-8,0,stay,1984-05-12
25121,Run-D.M.C.,1984-08-11,Run-D.M.C. - Run-D.M.C.,23,26,20,14.0,23,Run-D.M.C.,45.0,13,3,0,3,1,up,1984-05-12
25122,Run-D.M.C.,1984-08-18,Run-D.M.C. - Run-D.M.C.,23,23,19,14.0,20,Run-D.M.C.,45.0,14,1,3,0,1,up,1984-05-12
25123,Run-D.M.C.,1984-08-25,Run-D.M.C. - Run-D.M.C.,20,23,18,14.0,19,Run-D.M.C.,45.0,15,1,1,3,1,up,1984-05-12
25124,Run-D.M.C.,1984-09-01,Run-D.M.C. - Run-D.M.C.,19,20,16,14.0,18,Run-D.M.C.,45.0,16,2,1,1,1,up,1984-05-12
25125,Run-D.M.C.,1984-09-08,Run-D.M.C. - Run-D.M.C.,18,19,15,14.0,16,Run-D.M.C.,45.0,17,1,2,1,1,up,1984-05-12
25126,Run-D.M.C.,1984-09-15,Run-D.M.C. - Run-D.M.C.,16,18,14,14.0,15,Run-D.M.C.,45.0,18,1,1,2,1,up,1984-05-12
25127,Run-D.M.C.,1984-09-22,Run-D.M.C. - Run-D.M.C.,15,16,17,14.0,14,Run-D.M.C.,45.0,19,-3,1,1,1,down,1984-05-12
25128,Run-D.M.C.,1984-09-29,Run-D.M.C. - Run-D.M.C.,14,15,18,14.0,17,Run-D.M.C.,45.0,20,-1,-3,1,1,down,1984-05-12
25129,Run-D.M.C.,1984-10-06,Run-D.M.C. - Run-D.M.C.,17,14,28,14.0,18,Run-D.M.C.,45.0,21,-10,-1,-3,1,down,1984-05-12
25130,Run-D.M.C.,1984-10-13,Run-D.M.C. - Run-D.M.C.,18,17,28,14.0,28,Run-D.M.C.,45.0,22,0,-10,-1,0,stay,1984-05-12
25131,Run-D.M.C.,1984-10-20,Run-D.M.C. - Run-D.M.C.,28,18,28,14.0,28,Run-D.M.C.,45.0,23,0,0,-10,0,stay,1984-05-12
25132,Run-D.M.C.,1984-10-27,Run-D.M.C. - Run-D.M.C.,28,28,39,14.0,28,Run-D.M.C.,45.0,24,-11,0,0,1,down,1984-05-12
25133,Run-D.M.C.,1984-11-03,Run-D.M.C. - Run-D.M.C.,28,28,39,14.0,39,Run-D.M.C.,45.0,25,0,-11,0,0,stay,1984-05-12
25134,Run-D.M.C.,1984-11-10,Run-D.M.C. - Run-D.M.C.,39,28,40,14.0,39,Run-D.M.C.,45.0,26,-1,0,-11,1,down,1984-05-12
25135,Run-D.M.C.,1984-11-17,Run-D.M.C. - Run-D.M.C.,39,39,38,14.0,40,Run-D.M.C.,45.0,27,2,-1,0,1,up,1984-05-12
25136,Run-D.M.C.,1984-11-24,Run-D.M.C. - Run-D.M.C.,40,39,44,14.0,38,Run-D.M.C.,45.0,28,-6,2,-1,1,down,1984-05-12
25137,Run-D.M.C.,1984-12-01,Run-D.M.C. - Run-D.M.C.,38,40,40,14.0,44,Run-D.M.C.,45.0,29,4,-6,2,1,up,1984-05-12
25138,Run-D.M.C.,1984-12-08,Run-D.M.C. - Run-D.M.C.,44,38,40,14.0,40,Run-D.M.C.,45.0,30,0,4,-6,0,stay,1984-05-12
25139,Run-D.M.C.,1984-12-15,Run-D.M.C. - Run-D.M.C.,40,44,48,14.0,40,Run-D.M.C.,45.0,31,-8,0,4,1,down,1984-05-12
25140,Run-D.M.C.,1984-12-22,Run-D.M.C. - Run-D.M.C.,40,40,48,14.0,48,Run-D.M.C.,45.0,32,0,-8,0,0,stay,1984-05-12
25141,Run-D.M.C.,1984-12-29,Run-D.M.C. - Run-D.M.C.,48,40,48,14.0,48,Run-D.M.C.,45.0,33,0,0,-8,0,stay,1984-05-12
25142,Run-D.M.C.,1985-01-05,Run-D.M.C. - Run-D.M.C.,48,48,47,14.0,48,Run-D.M.C.,45.0,34,1,0,0,1,up,1984-05-12
25143,Run-D.M.C.,1985-01-12,Run-D.M.C. - Run-D.M.C.,48,48,47,14.0,47,Run-D.M.C.,45.0,35,0,1,0,0,stay,1984-05-12
25144,Run-D.M.C.,1985-01-19,Run-D.M.C. - Run-D.M.C.,47,48,43,14.0,47,Run-D.M.C.,45.0,36,4,0,1,1,up,1984-05-12
25145,Run-D.M.C.,1985-01-26,Run-D.M.C. - Run-D.M.C.,47,47,42,14.0,43,Run-D.M.C.,45.0,37,1,4,0,1,up,1984-05-12
25146,Run-D.M.C.,1985-02-02,Run-D.M.C. - Run-D.M.C.,43,47,44,14.0,42,Run-D.M.C.,45.0,38,-2,1,4,1,down,1984-05-12
25147,Run-D.M.C.,1985-02-09,Run-D.M.C. - Run-D.M.C.,42,43,43,14.0,44,Run-D.M.C.,45.0,39,1,-2,1,1,up,1984-05-12
25148,Run-D.M.C.,1985-02-16,Run-D.M.C. - Run-D.M.C.,44,42,40,14.0,43,Run-D.M.C.,45.0,40,3,1,-2,1,up,1984-05-12
25149,Run-D.M.C.,1985-02-23,Run-D.M.C. - Run-D.M.C.,43,44,40,14.0,40,Run-D.M.C.,45.0,41,0,3,1,0,stay,1984-05-12
25150,Run-D.M.C.,1985-03-02,Run-D.M.C. - Run-D.M.C.,40,43,44,14.0,40,Run-D.M.C.,45.0,42,-4,0,3,1,down,1984-05-12
25151,Run-D.M.C.,1985-03-09,Run-D.M.C. - Run-D.M.C.,40,40,45,14.0,44,Run-D.M.C.,45.0,43,-1,-4,0,1,down,1984-05-12
25152,Run-D.M.C.,1985-03-16,Run-D.M.C. - Run-D.M.C.,44,40,43,14.0,45,Run-D.M.C.,45.0,44,2,-1,-4,1,up,1984-05-12
25153,Run-D.M.C.,1985-03-23,Run-D.M.C. - Run-D.M.C.,45,44,51,14.0,43,Run-D.M.C.,45.0,45,-8,2,-1,1,down,1984-05-12
25154,Nona Hendryx,1984-05-12,Nona Hendryx - The Art Of Defense,51,51,46,40.0,50,The Art Of Defense,7.0,0,4,1,0,1,up,1984-05-12
25155,Nona Hendryx,1984-05-19,Nona Hendryx - The Art Of Defense,50,51,42,40.0,46,The Art Of Defense,7.0,1,4,4,1,1,up,1984-05-12
25156,Nona Hendryx,1984-05-26,Nona Hendryx - The Art Of Defense,46,50,42,40.0,42,The Art Of Defense,7.0,2,0,4,4,0,stay,1984-05-12
25157,Nona Hendryx,1984-06-02,Nona Hendryx - The Art Of Defense,42,46,40,40.0,42,The Art Of Defense,7.0,3,2,0,4,1,up,1984-05-12
25158,Nona Hendryx,1984-06-09,Nona Hendryx - The Art Of Defense,42,42,40,40.0,40,The Art Of Defense,7.0,4,0,2,0,0,stay,1984-05-12
25159,Nona Hendryx,1984-06-16,Nona Hendryx - The Art Of Defense,40,42,46,40.0,40,The Art Of Defense,7.0,5,-6,0,2,1,down,1984-05-12
25160,Nona Hendryx,1984-06-23,Nona Hendryx - The Art Of Defense,40,40,47,40.0,46,The Art Of Defense,7.0,6,-1,-6,0,1,down,1984-05-12
25161,Nona Hendryx,1984-06-30,Nona Hendryx - The Art Of Defense,46,40,51,40.0,47,The Art Of Defense,7.0,7,-4,-1,-6,1,down,1984-05-12
25162,Soundtrack,1984-05-19,Soundtrack - Against All Odds,51,51,50,50.0,50,Against All Odds,1.0,0,0,1,0,0,stay,1984-05-19
25163,Soundtrack,1984-05-26,Soundtrack - Against All Odds,50,51,51,50.0,50,Against All Odds,1.0,1,-1,0,1,1,down,1984-05-19
25164,Jermaine Jackson,1984-05-26,Jermaine Jackson - Jermaine Jackson,51,51,8,1.0,16,Jermaine Jackson,42.0,0,8,35,0,1,up,1984-05-26
25165,Jermaine Jackson,1984-06-02,Jermaine Jackson - Jermaine Jackson,16,51,4,1.0,8,Jermaine Jackson,42.0,1,4,8,35,1,up,1984-05-26
25166,Jermaine Jackson,1984-06-09,Jermaine Jackson - Jermaine Jackson,8,16,3,1.0,4,Jermaine Jackson,42.0,2,1,4,8,1,up,1984-05-26
25167,Jermaine Jackson,1984-06-16,Jermaine Jackson - Jermaine Jackson,4,8,2,1.0,3,Jermaine Jackson,42.0,3,1,1,4,1,up,1984-05-26
25168,Jermaine Jackson,1984-06-23,Jermaine Jackson - Jermaine Jackson,3,4,2,1.0,2,Jermaine Jackson,42.0,4,0,1,1,0,stay,1984-05-26
25169,Jermaine Jackson,1984-06-30,Jermaine Jackson - Jermaine Jackson,2,3,1,1.0,2,Jermaine Jackson,42.0,5,1,0,1,1,up,1984-05-26
25170,Jermaine Jackson,1984-07-07,Jermaine Jackson - Jermaine Jackson,2,2,6,1.0,1,Jermaine Jackson,42.0,6,-5,1,0,1,down,1984-05-26
25171,Jermaine Jackson,1984-07-14,Jermaine Jackson - Jermaine Jackson,1,2,9,1.0,6,Jermaine Jackson,42.0,7,-3,-5,1,1,down,1984-05-26
25172,Jermaine Jackson,1984-07-21,Jermaine Jackson - Jermaine Jackson,6,1,9,1.0,9,Jermaine Jackson,42.0,8,0,-3,-5,0,stay,1984-05-26
25173,Jermaine Jackson,1984-07-28,Jermaine Jackson - Jermaine Jackson,9,6,11,1.0,9,Jermaine Jackson,42.0,9,-2,0,-3,1,down,1984-05-26
25174,Jermaine Jackson,1984-08-04,Jermaine Jackson - Jermaine Jackson,9,9,10,1.0,11,Jermaine Jackson,42.0,10,1,-2,0,1,up,1984-05-26
25175,Jermaine Jackson,1984-08-11,Jermaine Jackson - Jermaine Jackson,11,9,10,1.0,10,Jermaine Jackson,42.0,11,0,1,-2,0,stay,1984-05-26
25176,Jermaine Jackson,1984-08-18,Jermaine Jackson - Jermaine Jackson,10,11,14,1.0,10,Jermaine Jackson,42.0,12,-4,0,1,1,down,1984-05-26
25177,Jermaine Jackson,1984-08-25,Jermaine Jackson - Jermaine Jackson,10,10,13,1.0,14,Jermaine Jackson,42.0,13,1,-4,0,1,up,1984-05-26
25178,Jermaine Jackson,1984-09-01,Jermaine Jackson - Jermaine Jackson,14,10,10,1.0,13,Jermaine Jackson,42.0,14,3,1,-4,1,up,1984-05-26
25179,Jermaine Jackson,1984-09-08,Jermaine Jackson - Jermaine Jackson,13,14,10,1.0,10,Jermaine Jackson,42.0,15,0,3,1,0,stay,1984-05-26
25180,Jermaine Jackson,1984-09-15,Jermaine Jackson - Jermaine Jackson,10,13,13,1.0,10,Jermaine Jackson,42.0,16,-3,0,3,1,down,1984-05-26
25181,Jermaine Jackson,1984-09-22,Jermaine Jackson - Jermaine Jackson,10,10,13,1.0,13,Jermaine Jackson,42.0,17,0,-3,0,0,stay,1984-05-26
25182,Jermaine Jackson,1984-09-29,Jermaine Jackson - Jermaine Jackson,13,10,14,1.0,13,Jermaine Jackson,42.0,18,-1,0,-3,1,down,1984-05-26
25183,Jermaine Jackson,1984-10-06,Jermaine Jackson - Jermaine Jackson,13,13,13,1.0,14,Jermaine Jackson,42.0,19,1,-1,0,1,up,1984-05-26
25184,Jermaine Jackson,1984-10-13,Jermaine Jackson - Jermaine Jackson,14,13,15,1.0,13,Jermaine Jackson,42.0,20,-2,1,-1,1,down,1984-05-26
25185,Jermaine Jackson,1984-10-20,Jermaine Jackson - Jermaine Jackson,13,14,14,1.0,15,Jermaine Jackson,42.0,21,1,-2,1,1,up,1984-05-26
25186,Jermaine Jackson,1984-10-27,Jermaine Jackson - Jermaine Jackson,15,13,18,1.0,14,Jermaine Jackson,42.0,22,-4,1,-2,1,down,1984-05-26
25187,Jermaine Jackson,1984-11-03,Jermaine Jackson - Jermaine Jackson,14,15,25,1.0,18,Jermaine Jackson,42.0,23,-7,-4,1,1,down,1984-05-26
25188,Jermaine Jackson,1984-11-10,Jermaine Jackson - Jermaine Jackson,18,14,29,1.0,25,Jermaine Jackson,42.0,24,-4,-7,-4,1,down,1984-05-26
25189,Jermaine Jackson,1984-11-17,Jermaine Jackson - Jermaine Jackson,25,18,32,1.0,29,Jermaine Jackson,42.0,25,-3,-4,-7,1,down,1984-05-26
25190,Jermaine Jackson,1984-11-24,Jermaine Jackson - Jermaine Jackson,29,25,35,1.0,32,Jermaine Jackson,42.0,26,-3,-3,-4,1,down,1984-05-26
25191,Jermaine Jackson,1984-12-01,Jermaine Jackson - Jermaine Jackson,32,29,33,1.0,35,Jermaine Jackson,42.0,27,2,-3,-3,1,up,1984-05-26
25192,Jermaine Jackson,1984-12-08,Jermaine Jackson - Jermaine Jackson,35,32,33,1.0,33,Jermaine Jackson,42.0,28,0,2,-3,0,stay,1984-05-26
25193,Jermaine Jackson,1984-12-15,Jermaine Jackson - Jermaine Jackson,33,35,37,1.0,33,Jermaine Jackson,42.0,29,-4,0,2,1,down,1984-05-26
25194,Jermaine Jackson,1984-12-22,Jermaine Jackson - Jermaine Jackson,33,33,37,1.0,37,Jermaine Jackson,42.0,30,0,-4,0,0,stay,1984-05-26
25195,Jermaine Jackson,1984-12-29,Jermaine Jackson - Jermaine Jackson,37,33,39,1.0,37,Jermaine Jackson,42.0,31,-2,0,-4,1,down,1984-05-26
25196,Jermaine Jackson,1985-01-05,Jermaine Jackson - Jermaine Jackson,37,37,38,1.0,39,Jermaine Jackson,42.0,32,1,-2,0,1,up,1984-05-26
25197,Jermaine Jackson,1985-01-12,Jermaine Jackson - Jermaine Jackson,39,37,35,1.0,38,Jermaine Jackson,42.0,33,3,1,-2,1,up,1984-05-26
25198,Jermaine Jackson,1985-01-19,Jermaine Jackson - Jermaine Jackson,38,39,35,1.0,35,Jermaine Jackson,42.0,34,0,3,1,0,stay,1984-05-26
25199,Jermaine Jackson,1985-01-26,Jermaine Jackson - Jermaine Jackson,35,38,34,1.0,35,Jermaine Jackson,42.0,35,1,0,3,1,up,1984-05-26
25200,Jermaine Jackson,1985-02-02,Jermaine Jackson - Jermaine Jackson,35,35,33,1.0,34,Jermaine Jackson,42.0,36,1,1,0,1,up,1984-05-26
25201,Jermaine Jackson,1985-02-09,Jermaine Jackson - Jermaine Jackson,34,35,40,1.0,33,Jermaine Jackson,42.0,37,-7,1,1,1,down,1984-05-26
25202,Jermaine Jackson,1985-02-16,Jermaine Jackson - Jermaine Jackson,33,34,38,1.0,40,Jermaine Jackson,42.0,38,2,-7,1,1,up,1984-05-26
25203,Jermaine Jackson,1985-02-23,Jermaine Jackson - Jermaine Jackson,40,33,43,1.0,38,Jermaine Jackson,42.0,39,-5,2,-7,1,down,1984-05-26
25204,Jermaine Jackson,1985-03-02,Jermaine Jackson - Jermaine Jackson,38,40,43,1.0,43,Jermaine Jackson,42.0,40,0,-5,2,0,stay,1984-05-26
25205,Jermaine Jackson,1985-03-09,Jermaine Jackson - Jermaine Jackson,43,38,44,1.0,43,Jermaine Jackson,42.0,41,-1,0,-5,1,down,1984-05-26
25206,Jermaine Jackson,1985-03-16,Jermaine Jackson - Jermaine Jackson,43,43,51,1.0,44,Jermaine Jackson,42.0,42,-7,-1,0,1,down,1984-05-26
25207,O'Bryan,1984-05-26,O'Bryan - Be My Lover,51,51,18,3.0,35,Be My Lover,28.0,0,17,16,0,1,up,1984-05-26
25208,O'Bryan,1984-06-02,O'Bryan - Be My Lover,35,51,13,3.0,18,Be My Lover,28.0,1,5,17,16,1,up,1984-05-26
25209,O'Bryan,1984-06-09,O'Bryan - Be My Lover,18,35,10,3.0,13,Be My Lover,28.0,2,3,5,17,1,up,1984-05-26
25210,O'Bryan,1984-06-16,O'Bryan - Be My Lover,13,18,5,3.0,10,Be My Lover,28.0,3,5,3,5,1,up,1984-05-26
25211,O'Bryan,1984-06-23,O'Bryan - Be My Lover,10,13,4,3.0,5,Be My Lover,28.0,4,1,5,3,1,up,1984-05-26
25212,O'Bryan,1984-06-30,O'Bryan - Be My Lover,5,10,3,3.0,4,Be My Lover,28.0,5,1,1,5,1,up,1984-05-26
25213,O'Bryan,1984-07-07,O'Bryan - Be My Lover,4,5,3,3.0,3,Be My Lover,28.0,6,0,1,1,0,stay,1984-05-26
25214,O'Bryan,1984-07-14,O'Bryan - Be My Lover,3,4,3,3.0,3,Be My Lover,28.0,7,0,0,1,0,stay,1984-05-26
25215,O'Bryan,1984-07-21,O'Bryan - Be My Lover,3,3,4,3.0,3,Be My Lover,28.0,8,-1,0,0,1,down,1984-05-26
25216,O'Bryan,1984-07-28,O'Bryan - Be My Lover,3,3,5,3.0,4,Be My Lover,28.0,9,-1,-1,0,1,down,1984-05-26
25217,O'Bryan,1984-08-04,O'Bryan - Be My Lover,4,3,8,3.0,5,Be My Lover,28.0,10,-3,-1,-1,1,down,1984-05-26
25218,O'Bryan,1984-08-11,O'Bryan - Be My Lover,5,4,13,3.0,8,Be My Lover,28.0,11,-5,-3,-1,1,down,1984-05-26
25219,O'Bryan,1984-08-18,O'Bryan - Be My Lover,8,5,13,3.0,13,Be My Lover,28.0,12,0,-5,-3,0,stay,1984-05-26
25220,O'Bryan,1984-08-25,O'Bryan - Be My Lover,13,8,14,3.0,13,Be My Lover,28.0,13,-1,0,-5,1,down,1984-05-26
25221,O'Bryan,1984-09-01,O'Bryan - Be My Lover,13,13,13,3.0,14,Be My Lover,28.0,14,1,-1,0,1,up,1984-05-26
25222,O'Bryan,1984-09-08,O'Bryan - Be My Lover,14,13,16,3.0,13,Be My Lover,28.0,15,-3,1,-1,1,down,1984-05-26
25223,O'Bryan,1984-09-15,O'Bryan - Be My Lover,13,14,17,3.0,16,Be My Lover,28.0,16,-1,-3,1,1,down,1984-05-26
25224,O'Bryan,1984-09-22,O'Bryan - Be My Lover,16,13,18,3.0,17,Be My Lover,28.0,17,-1,-1,-3,1,down,1984-05-26
25225,O'Bryan,1984-09-29,O'Bryan - Be My Lover,17,16,22,3.0,18,Be My Lover,28.0,18,-4,-1,-1,1,down,1984-05-26
25226,O'Bryan,1984-10-06,O'Bryan - Be My Lover,18,17,22,3.0,22,Be My Lover,28.0,19,0,-4,-1,0,stay,1984-05-26
25227,O'Bryan,1984-10-13,O'Bryan - Be My Lover,22,18,25,3.0,22,Be My Lover,28.0,20,-3,0,-4,1,down,1984-05-26
25228,O'Bryan,1984-10-20,O'Bryan - Be My Lover,22,22,25,3.0,25,Be My Lover,28.0,21,0,-3,0,0,stay,1984-05-26
25229,O'Bryan,1984-10-27,O'Bryan - Be My Lover,25,22,36,3.0,25,Be My Lover,28.0,22,-11,0,-3,1,down,1984-05-26
25230,O'Bryan,1984-11-03,O'Bryan - Be My Lover,25,25,36,3.0,36,Be My Lover,28.0,23,0,-11,0,0,stay,1984-05-26
25231,O'Bryan,1984-11-10,O'Bryan - Be My Lover,36,25,35,3.0,36,Be My Lover,28.0,24,1,0,-11,1,up,1984-05-26
25232,O'Bryan,1984-11-17,O'Bryan - Be My Lover,36,36,35,3.0,35,Be My Lover,28.0,25,0,1,0,0,stay,1984-05-26
25233,O'Bryan,1984-11-24,O'Bryan - Be My Lover,35,36,47,3.0,35,Be My Lover,28.0,26,-12,0,1,1,down,1984-05-26
25234,O'Bryan,1984-12-01,O'Bryan - Be My Lover,35,35,46,3.0,47,Be My Lover,28.0,27,1,-12,0,1,up,1984-05-26
25235,O'Bryan,1984-12-08,O'Bryan - Be My Lover,47,35,51,3.0,46,Be My Lover,28.0,28,-5,1,-12,1,down,1984-05-26
25236,Marvin Gaye,1984-06-02,Marvin Gaye - What's Going On,51,51,49,49.0,49,What's Going On,1.0,0,0,2,0,0,stay,1984-06-02
25237,Marvin Gaye,1984-06-09,Marvin Gaye - What's Going On,49,51,51,49.0,49,What's Going On,1.0,1,-2,0,2,1,down,1984-06-02
25238,Soundtrack,1984-06-09,Soundtrack - Breakin',51,51,19,2.0,37,Breakin',19.0,0,18,14,0,1,up,1984-06-09
25239,Soundtrack,1984-06-16,Soundtrack - Breakin',37,51,10,2.0,19,Breakin',19.0,1,9,18,14,1,up,1984-06-09
25240,Soundtrack,1984-06-23,Soundtrack - Breakin',19,37,6,2.0,10,Breakin',19.0,2,4,9,18,1,up,1984-06-09
25241,Soundtrack,1984-06-30,Soundtrack - Breakin',10,19,5,2.0,6,Breakin',19.0,3,1,4,9,1,up,1984-06-09
25242,Soundtrack,1984-07-07,Soundtrack - Breakin',6,10,5,2.0,5,Breakin',19.0,4,0,1,4,0,stay,1984-06-09
25243,Soundtrack,1984-07-14,Soundtrack - Breakin',5,6,2,2.0,5,Breakin',19.0,5,3,0,1,1,up,1984-06-09
25244,Soundtrack,1984-07-21,Soundtrack - Breakin',5,5,2,2.0,2,Breakin',19.0,6,0,3,0,0,stay,1984-06-09
25245,Soundtrack,1984-07-28,Soundtrack - Breakin',2,5,3,2.0,2,Breakin',19.0,7,-1,0,3,1,down,1984-06-09
25246,Soundtrack,1984-08-04,Soundtrack - Breakin',2,2,5,2.0,3,Breakin',19.0,8,-2,-1,0,1,down,1984-06-09
25247,Soundtrack,1984-08-11,Soundtrack - Breakin',3,2,7,2.0,5,Breakin',19.0,9,-2,-2,-1,1,down,1984-06-09
25248,Soundtrack,1984-08-18,Soundtrack - Breakin',5,3,8,2.0,7,Breakin',19.0,10,-1,-2,-2,1,down,1984-06-09
25249,Soundtrack,1984-08-25,Soundtrack - Breakin',7,5,10,2.0,8,Breakin',19.0,11,-2,-1,-2,1,down,1984-06-09
25250,Soundtrack,1984-09-01,Soundtrack - Breakin',8,7,22,2.0,10,Breakin',19.0,12,-12,-2,-1,1,down,1984-06-09
25251,Soundtrack,1984-09-08,Soundtrack - Breakin',10,8,22,2.0,22,Breakin',19.0,13,0,-12,-2,0,stay,1984-06-09
25252,Soundtrack,1984-09-15,Soundtrack - Breakin',22,10,27,2.0,22,Breakin',19.0,14,-5,0,-12,1,down,1984-06-09
25253,Soundtrack,1984-09-22,Soundtrack - Breakin',22,22,27,2.0,27,Breakin',19.0,15,0,-5,0,0,stay,1984-06-09
25254,Soundtrack,1984-09-29,Soundtrack - Breakin',27,22,41,2.0,27,Breakin',19.0,16,-14,0,-5,1,down,1984-06-09
25255,Soundtrack,1984-10-06,Soundtrack - Breakin',27,27,41,2.0,41,Breakin',19.0,17,0,-14,0,0,stay,1984-06-09
25256,Soundtrack,1984-10-13,Soundtrack - Breakin',41,27,44,2.0,41,Breakin',19.0,18,-3,0,-14,1,down,1984-06-09
25257,Soundtrack,1984-10-20,Soundtrack - Breakin',41,41,51,2.0,44,Breakin',19.0,19,-7,-3,0,1,down,1984-06-09
25258,The O'Jays,1984-06-09,The O'Jays - Love And More,51,51,37,35.0,41,Love And More,8.0,0,4,10,0,1,up,1984-06-09
25259,The O'Jays,1984-06-16,The O'Jays - Love And More,41,51,35,35.0,37,Love And More,8.0,1,2,4,10,1,up,1984-06-09
25260,The O'Jays,1984-06-23,The O'Jays - Love And More,37,41,35,35.0,35,Love And More,8.0,2,0,2,4,0,stay,1984-06-09
25261,The O'Jays,1984-06-30,The O'Jays - Love And More,35,37,41,35.0,35,Love And More,8.0,3,-6,0,2,1,down,1984-06-09
25262,The O'Jays,1984-07-07,The O'Jays - Love And More,35,35,40,35.0,41,Love And More,8.0,4,1,-6,0,1,up,1984-06-09
25263,The O'Jays,1984-07-14,The O'Jays - Love And More,41,35,48,35.0,40,Love And More,8.0,5,-8,1,-6,1,down,1984-06-09
25264,The O'Jays,1984-07-21,The O'Jays - Love And More,40,41,48,35.0,48,Love And More,8.0,6,0,-8,1,0,stay,1984-06-09
25265,The O'Jays,1984-07-28,The O'Jays - Love And More,48,40,48,35.0,48,Love And More,8.0,7,0,0,-8,0,stay,1984-06-09
25266,The O'Jays,1984-08-04,The O'Jays - Love And More,48,48,51,35.0,48,Love And More,8.0,8,-3,0,0,1,down,1984-06-09
25267,Soundtrack,1984-06-09,Soundtrack - Beat Street,51,51,38,10.0,46,Beat Street,18.0,0,8,5,0,1,up,1984-06-09
25268,Soundtrack,1984-06-16,Soundtrack - Beat Street,46,51,27,10.0,38,Beat Street,18.0,1,11,8,5,1,up,1984-06-09
25269,Soundtrack,1984-06-23,Soundtrack - Beat Street,38,46,18,10.0,27,Beat Street,18.0,2,9,11,8,1,up,1984-06-09
25270,Soundtrack,1984-06-30,Soundtrack - Beat Street,27,38,14,10.0,18,Beat Street,18.0,3,4,9,11,1,up,1984-06-09
25271,Soundtrack,1984-07-07,Soundtrack - Beat Street,18,27,13,10.0,14,Beat Street,18.0,4,1,4,9,1,up,1984-06-09
25272,Soundtrack,1984-07-14,Soundtrack - Beat Street,14,18,10,10.0,13,Beat Street,18.0,5,3,1,4,1,up,1984-06-09
25273,Soundtrack,1984-07-21,Soundtrack - Beat Street,13,14,10,10.0,10,Beat Street,18.0,6,0,3,1,0,stay,1984-06-09
25274,Soundtrack,1984-07-28,Soundtrack - Beat Street,10,13,14,10.0,10,Beat Street,18.0,7,-4,0,3,1,down,1984-06-09
25275,Soundtrack,1984-08-04,Soundtrack - Beat Street,10,10,19,10.0,14,Beat Street,18.0,8,-5,-4,0,1,down,1984-06-09
25276,Soundtrack,1984-08-11,Soundtrack - Beat Street,14,10,19,10.0,19,Beat Street,18.0,9,0,-5,-4,0,stay,1984-06-09
25277,Soundtrack,1984-08-18,Soundtrack - Beat Street,19,14,21,10.0,19,Beat Street,18.0,10,-2,0,-5,1,down,1984-06-09
25278,Soundtrack,1984-08-25,Soundtrack - Beat Street,19,19,22,10.0,21,Beat Street,18.0,11,-1,-2,0,1,down,1984-06-09
25279,Soundtrack,1984-09-01,Soundtrack - Beat Street,21,19,29,10.0,22,Beat Street,18.0,12,-7,-1,-2,1,down,1984-06-09
25280,Soundtrack,1984-09-08,Soundtrack - Beat Street,22,21,32,10.0,29,Beat Street,18.0,13,-3,-7,-1,1,down,1984-06-09
25281,Soundtrack,1984-09-15,Soundtrack - Beat Street,29,22,32,10.0,32,Beat Street,18.0,14,0,-3,-7,0,stay,1984-06-09
25282,Soundtrack,1984-09-22,Soundtrack - Beat Street,32,29,33,10.0,32,Beat Street,18.0,15,-1,0,-3,1,down,1984-06-09
25283,Soundtrack,1984-09-29,Soundtrack - Beat Street,32,32,44,10.0,33,Beat Street,18.0,16,-11,-1,0,1,down,1984-06-09
25284,Soundtrack,1984-10-06,Soundtrack - Beat Street,33,32,44,10.0,44,Beat Street,18.0,17,0,-11,-1,0,stay,1984-06-09
25285,Soundtrack,1984-10-13,Soundtrack - Beat Street,44,33,51,10.0,44,Beat Street,18.0,18,-7,0,-11,1,down,1984-06-09
25286,Michael Jackson,1984-06-09,Michael Jackson - Farewell My Summer Love,51,51,36,31.0,47,Farewell My Summer Love,9.0,0,11,4,0,1,up,1984-06-09
25287,Michael Jackson,1984-06-16,Michael Jackson - Farewell My Summer Love,47,51,32,31.0,36,Farewell My Summer Love,9.0,1,4,11,4,1,up,1984-06-09
25288,Michael Jackson,1984-06-23,Michael Jackson - Farewell My Summer Love,36,47,32,31.0,32,Farewell My Summer Love,9.0,2,0,4,11,0,stay,1984-06-09
25289,Michael Jackson,1984-06-30,Michael Jackson - Farewell My Summer Love,32,36,33,31.0,32,Farewell My Summer Love,9.0,3,-1,0,4,1,down,1984-06-09
25290,Michael Jackson,1984-07-07,Michael Jackson - Farewell My Summer Love,32,32,31,31.0,33,Farewell My Summer Love,9.0,4,2,-1,0,1,up,1984-06-09
25291,Michael Jackson,1984-07-14,Michael Jackson - Farewell My Summer Love,33,32,31,31.0,31,Farewell My Summer Love,9.0,5,0,2,-1,0,stay,1984-06-09
25292,Michael Jackson,1984-07-21,Michael Jackson - Farewell My Summer Love,31,33,38,31.0,31,Farewell My Summer Love,9.0,6,-7,0,2,1,down,1984-06-09
25293,Michael Jackson,1984-07-28,Michael Jackson - Farewell My Summer Love,31,31,43,31.0,38,Farewell My Summer Love,9.0,7,-5,-7,0,1,down,1984-06-09
25294,Michael Jackson,1984-08-04,Michael Jackson - Farewell My Summer Love,38,31,47,31.0,43,Farewell My Summer Love,9.0,8,-4,-5,-7,1,down,1984-06-09
25295,Michael Jackson,1984-08-11,Michael Jackson - Farewell My Summer Love,43,38,51,31.0,47,Farewell My Summer Love,9.0,9,-4,-4,-5,1,down,1984-06-09
25296,Womack & Womack,1984-06-09,Womack & Womack - Love Wars,51,51,43,34.0,48,Love Wars,15.0,0,5,3,0,1,up,1984-06-09
25297,Womack & Womack,1984-06-16,Womack & Womack - Love Wars,48,51,40,34.0,43,Love Wars,15.0,1,3,5,3,1,up,1984-06-09
25298,Womack & Womack,1984-06-23,Womack & Womack - Love Wars,43,48,40,34.0,40,Love Wars,15.0,2,0,3,5,0,stay,1984-06-09
25299,Womack & Womack,1984-06-30,Womack & Womack - Love Wars,40,43,44,34.0,40,Love Wars,15.0,3,-4,0,3,1,down,1984-06-09
25300,Womack & Womack,1984-07-07,Womack & Womack - Love Wars,40,40,43,34.0,44,Love Wars,15.0,4,1,-4,0,1,up,1984-06-09
25301,Womack & Womack,1984-07-14,Womack & Womack - Love Wars,44,40,42,34.0,43,Love Wars,15.0,5,1,1,-4,1,up,1984-06-09
25302,Womack & Womack,1984-07-21,Womack & Womack - Love Wars,43,44,40,34.0,42,Love Wars,15.0,6,2,1,1,1,up,1984-06-09
25303,Womack & Womack,1984-07-28,Womack & Womack - Love Wars,42,43,37,34.0,40,Love Wars,15.0,7,3,2,1,1,up,1984-06-09
25304,Womack & Womack,1984-08-04,Womack & Womack - Love Wars,40,42,34,34.0,37,Love Wars,15.0,8,3,3,2,1,up,1984-06-09
25305,Womack & Womack,1984-08-11,Womack & Womack - Love Wars,37,40,34,34.0,34,Love Wars,15.0,9,0,3,3,0,stay,1984-06-09
25306,Womack & Womack,1984-08-18,Womack & Womack - Love Wars,34,37,34,34.0,34,Love Wars,15.0,10,0,0,3,0,stay,1984-06-09
25307,Womack & Womack,1984-08-25,Womack & Womack - Love Wars,34,34,39,34.0,34,Love Wars,15.0,11,-5,0,0,1,down,1984-06-09
25308,Womack & Womack,1984-09-01,Womack & Womack - Love Wars,34,34,48,34.0,39,Love Wars,15.0,12,-9,-5,0,1,down,1984-06-09
25309,Womack & Womack,1984-09-08,Womack & Womack - Love Wars,39,34,48,34.0,48,Love Wars,15.0,13,0,-9,-5,0,stay,1984-06-09
25310,Womack & Womack,1984-09-15,Womack & Womack - Love Wars,48,39,47,34.0,48,Love Wars,15.0,14,1,0,-9,1,up,1984-06-09
25311,Womack & Womack,1984-09-22,Womack & Womack - Love Wars,48,48,51,34.0,47,Love Wars,15.0,15,-4,1,0,1,down,1984-06-09
25312,Deniece Williams,1984-06-16,Deniece Williams - Let's Hear It For The Boy,51,51,11,10.0,17,Let's Hear It For The Boy,19.0,0,6,34,0,1,up,1984-06-16
25313,Deniece Williams,1984-06-23,Deniece Williams - Let's Hear It For The Boy,17,51,10,10.0,11,Let's Hear It For The Boy,19.0,1,1,6,34,1,up,1984-06-16
25314,Deniece Williams,1984-06-30,Deniece Williams - Let's Hear It For The Boy,11,17,10,10.0,10,Let's Hear It For The Boy,19.0,2,0,1,6,0,stay,1984-06-16
25315,Deniece Williams,1984-07-07,Deniece Williams - Let's Hear It For The Boy,10,11,11,10.0,10,Let's Hear It For The Boy,19.0,3,-1,0,1,1,down,1984-06-16
25316,Deniece Williams,1984-07-14,Deniece Williams - Let's Hear It For The Boy,10,10,16,10.0,11,Let's Hear It For The Boy,19.0,4,-5,-1,0,1,down,1984-06-16
25317,Deniece Williams,1984-07-21,Deniece Williams - Let's Hear It For The Boy,11,10,15,10.0,16,Let's Hear It For The Boy,19.0,5,1,-5,-1,1,up,1984-06-16
25318,Deniece Williams,1984-07-28,Deniece Williams - Let's Hear It For The Boy,16,11,20,10.0,15,Let's Hear It For The Boy,19.0,6,-5,1,-5,1,down,1984-06-16
25319,Deniece Williams,1984-08-04,Deniece Williams - Let's Hear It For The Boy,15,16,21,10.0,20,Let's Hear It For The Boy,19.0,7,-1,-5,1,1,down,1984-06-16
25320,Deniece Williams,1984-08-11,Deniece Williams - Let's Hear It For The Boy,20,15,21,10.0,21,Let's Hear It For The Boy,19.0,8,0,-1,-5,0,stay,1984-06-16
25321,Deniece Williams,1984-08-18,Deniece Williams - Let's Hear It For The Boy,21,20,26,10.0,21,Let's Hear It For The Boy,19.0,9,-5,0,-1,1,down,1984-06-16
25322,Deniece Williams,1984-08-25,Deniece Williams - Let's Hear It For The Boy,21,21,26,10.0,26,Let's Hear It For The Boy,19.0,10,0,-5,0,0,stay,1984-06-16
25323,Deniece Williams,1984-09-01,Deniece Williams - Let's Hear It For The Boy,26,21,33,10.0,26,Let's Hear It For The Boy,19.0,11,-7,0,-5,1,down,1984-06-16
25324,Deniece Williams,1984-09-08,Deniece Williams - Let's Hear It For The Boy,26,26,37,10.0,33,Let's Hear It For The Boy,19.0,12,-4,-7,0,1,down,1984-06-16
25325,Deniece Williams,1984-09-15,Deniece Williams - Let's Hear It For The Boy,33,26,30,10.0,37,Let's Hear It For The Boy,19.0,13,7,-4,-7,1,up,1984-06-16
25326,Deniece Williams,1984-09-22,Deniece Williams - Let's Hear It For The Boy,37,33,30,10.0,30,Let's Hear It For The Boy,19.0,14,0,7,-4,0,stay,1984-06-16
25327,Deniece Williams,1984-09-29,Deniece Williams - Let's Hear It For The Boy,30,37,38,10.0,30,Let's Hear It For The Boy,19.0,15,-8,0,7,1,down,1984-06-16
25328,Deniece Williams,1984-10-06,Deniece Williams - Let's Hear It For The Boy,30,30,37,10.0,38,Let's Hear It For The Boy,19.0,16,1,-8,0,1,up,1984-06-16
25329,Deniece Williams,1984-10-13,Deniece Williams - Let's Hear It For The Boy,38,30,43,10.0,37,Let's Hear It For The Boy,19.0,17,-6,1,-8,1,down,1984-06-16
25330,Deniece Williams,1984-10-20,Deniece Williams - Let's Hear It For The Boy,37,38,48,10.0,43,Let's Hear It For The Boy,19.0,18,-5,-6,1,1,down,1984-06-16
25331,Deniece Williams,1984-10-27,Deniece Williams - Let's Hear It For The Boy,43,37,51,10.0,48,Let's Hear It For The Boy,19.0,19,-3,-5,-6,1,down,1984-06-16
25332,Roger,1984-06-16,Roger - The Saga Continues,51,51,15,13.0,20,The Saga Continues,16.0,0,5,31,0,1,up,1984-06-16
25333,Roger,1984-06-23,Roger - The Saga Continues,20,51,13,13.0,15,The Saga Continues,16.0,1,2,5,31,1,up,1984-06-16
25334,Roger,1984-06-30,Roger - The Saga Continues,15,20,13,13.0,13,The Saga Continues,16.0,2,0,2,5,0,stay,1984-06-16
25335,Roger,1984-07-07,Roger - The Saga Continues,13,15,19,13.0,13,The Saga Continues,16.0,3,-6,0,2,1,down,1984-06-16
25336,Roger,1984-07-14,Roger - The Saga Continues,13,13,19,13.0,19,The Saga Continues,16.0,4,0,-6,0,0,stay,1984-06-16
25337,Roger,1984-07-21,Roger - The Saga Continues,19,13,27,13.0,19,The Saga Continues,16.0,5,-8,0,-6,1,down,1984-06-16
25338,Roger,1984-07-28,Roger - The Saga Continues,19,19,25,13.0,27,The Saga Continues,16.0,6,2,-8,0,1,up,1984-06-16
25339,Roger,1984-08-04,Roger - The Saga Continues,27,19,25,13.0,25,The Saga Continues,16.0,7,0,2,-8,0,stay,1984-06-16
25340,Roger,1984-08-11,Roger - The Saga Continues,25,27,24,13.0,25,The Saga Continues,16.0,8,1,0,2,1,up,1984-06-16
25341,Roger,1984-08-18,Roger - The Saga Continues,25,25,23,13.0,24,The Saga Continues,16.0,9,1,1,0,1,up,1984-06-16
25342,Roger,1984-08-25,Roger - The Saga Continues,24,25,25,13.0,23,The Saga Continues,16.0,10,-2,1,1,1,down,1984-06-16
25343,Roger,1984-09-01,Roger - The Saga Continues,23,24,39,13.0,25,The Saga Continues,16.0,11,-14,-2,1,1,down,1984-06-16
25344,Roger,1984-09-08,Roger - The Saga Continues,25,23,33,13.0,39,The Saga Continues,16.0,12,6,-14,-2,1,up,1984-06-16
25345,Roger,1984-09-15,Roger - The Saga Continues,39,25,33,13.0,33,The Saga Continues,16.0,13,0,6,-14,0,stay,1984-06-16
25346,Roger,1984-09-22,Roger - The Saga Continues,33,39,45,13.0,33,The Saga Continues,16.0,14,-12,0,6,1,down,1984-06-16
25347,Roger,1984-09-29,Roger - The Saga Continues,33,33,47,13.0,45,The Saga Continues,16.0,15,-2,-12,0,1,down,1984-06-16
25348,Roger,1984-10-06,Roger - The Saga Continues,45,33,51,13.0,47,The Saga Continues,16.0,16,-4,-2,-12,1,down,1984-06-16
25349,Cherrelle,1984-06-16,Cherrelle - Fragile,51,51,47,27.0,50,Fragile,18.0,0,3,1,0,1,up,1984-06-16
25350,Cherrelle,1984-06-23,Cherrelle - Fragile,50,51,45,27.0,47,Fragile,18.0,1,2,3,1,1,up,1984-06-16
25351,Cherrelle,1984-06-30,Cherrelle - Fragile,47,50,38,27.0,45,Fragile,18.0,2,7,2,3,1,up,1984-06-16
25352,Cherrelle,1984-07-07,Cherrelle - Fragile,45,47,38,27.0,38,Fragile,18.0,3,0,7,2,0,stay,1984-06-16
25353,Cherrelle,1984-07-14,Cherrelle - Fragile,38,45,38,27.0,38,Fragile,18.0,4,0,0,7,0,stay,1984-06-16
25354,Cherrelle,1984-07-21,Cherrelle - Fragile,38,38,34,27.0,38,Fragile,18.0,5,4,0,0,1,up,1984-06-16
25355,Cherrelle,1984-07-28,Cherrelle - Fragile,38,38,34,27.0,34,Fragile,18.0,6,0,4,0,0,stay,1984-06-16
25356,Cherrelle,1984-08-04,Cherrelle - Fragile,34,38,30,27.0,34,Fragile,18.0,7,4,0,4,1,up,1984-06-16
25357,Cherrelle,1984-08-11,Cherrelle - Fragile,34,34,29,27.0,30,Fragile,18.0,8,1,4,0,1,up,1984-06-16
25358,Cherrelle,1984-08-18,Cherrelle - Fragile,30,34,30,27.0,29,Fragile,18.0,9,-1,1,4,1,down,1984-06-16
25359,Cherrelle,1984-08-25,Cherrelle - Fragile,29,30,27,27.0,30,Fragile,18.0,10,3,-1,1,1,up,1984-06-16
25360,Cherrelle,1984-09-01,Cherrelle - Fragile,30,29,27,27.0,27,Fragile,18.0,11,0,3,-1,0,stay,1984-06-16
25361,Cherrelle,1984-09-08,Cherrelle - Fragile,27,30,29,27.0,27,Fragile,18.0,12,-2,0,3,1,down,1984-06-16
25362,Cherrelle,1984-09-15,Cherrelle - Fragile,27,27,35,27.0,29,Fragile,18.0,13,-6,-2,0,1,down,1984-06-16
25363,Cherrelle,1984-09-22,Cherrelle - Fragile,29,27,40,27.0,35,Fragile,18.0,14,-5,-6,-2,1,down,1984-06-16
25364,Cherrelle,1984-09-29,Cherrelle - Fragile,35,29,46,27.0,40,Fragile,18.0,15,-6,-5,-6,1,down,1984-06-16
25365,Cherrelle,1984-10-06,Cherrelle - Fragile,40,35,45,27.0,46,Fragile,18.0,16,1,-6,-5,1,up,1984-06-16
25366,Cherrelle,1984-10-13,Cherrelle - Fragile,46,40,47,27.0,45,Fragile,18.0,17,-2,1,-6,1,down,1984-06-16
25367,Cherrelle,1984-10-20,Cherrelle - Fragile,45,46,51,27.0,47,Fragile,18.0,18,-4,-2,1,1,down,1984-06-16
25368,Tina Turner,1984-06-23,Tina Turner - Private Dancer,51,51,11,1.0,19,Private Dancer,69.0,0,8,32,0,1,up,1984-06-23
25369,Tina Turner,1984-06-30,Tina Turner - Private Dancer,19,51,8,1.0,11,Private Dancer,69.0,1,3,8,32,1,up,1984-06-23
25370,Tina Turner,1984-07-07,Tina Turner - Private Dancer,11,19,4,1.0,8,Private Dancer,69.0,2,4,3,8,1,up,1984-06-23
25371,Tina Turner,1984-07-14,Tina Turner - Private Dancer,8,11,1,1.0,4,Private Dancer,69.0,3,3,4,3,1,up,1984-06-23
25372,Tina Turner,1984-07-21,Tina Turner - Private Dancer,4,8,3,1.0,1,Private Dancer,69.0,4,-2,3,4,1,down,1984-06-23
25373,Tina Turner,1984-07-28,Tina Turner - Private Dancer,1,4,2,1.0,3,Private Dancer,69.0,5,1,-2,3,1,up,1984-06-23
25374,Tina Turner,1984-08-04,Tina Turner - Private Dancer,3,1,2,1.0,2,Private Dancer,69.0,6,0,1,-2,0,stay,1984-06-23
25375,Tina Turner,1984-08-11,Tina Turner - Private Dancer,2,3,2,1.0,2,Private Dancer,69.0,7,0,0,1,0,stay,1984-06-23
25376,Tina Turner,1984-08-18,Tina Turner - Private Dancer,2,2,2,1.0,2,Private Dancer,69.0,8,0,0,0,0,stay,1984-06-23
25377,Tina Turner,1984-08-25,Tina Turner - Private Dancer,2,2,2,1.0,2,Private Dancer,69.0,9,0,0,0,0,stay,1984-06-23
25378,Tina Turner,1984-09-01,Tina Turner - Private Dancer,2,2,2,1.0,2,Private Dancer,69.0,10,0,0,0,0,stay,1984-06-23
25379,Tina Turner,1984-09-08,Tina Turner - Private Dancer,2,2,2,1.0,2,Private Dancer,69.0,11,0,0,0,0,stay,1984-06-23
25380,Tina Turner,1984-09-15,Tina Turner - Private Dancer,2,2,2,1.0,2,Private Dancer,69.0,12,0,0,0,0,stay,1984-06-23
25381,Tina Turner,1984-09-22,Tina Turner - Private Dancer,2,2,2,1.0,2,Private Dancer,69.0,13,0,0,0,0,stay,1984-06-23
25382,Tina Turner,1984-09-29,Tina Turner - Private Dancer,2,2,2,1.0,2,Private Dancer,69.0,14,0,0,0,0,stay,1984-06-23
25383,Tina Turner,1984-10-06,Tina Turner - Private Dancer,2,2,2,1.0,2,Private Dancer,69.0,15,0,0,0,0,stay,1984-06-23
25384,Tina Turner,1984-10-13,Tina Turner - Private Dancer,2,2,2,1.0,2,Private Dancer,69.0,16,0,0,0,0,stay,1984-06-23
25385,Tina Turner,1984-10-20,Tina Turner - Private Dancer,2,2,2,1.0,2,Private Dancer,69.0,17,0,0,0,0,stay,1984-06-23
25386,Tina Turner,1984-10-27,Tina Turner - Private Dancer,2,2,2,1.0,2,Private Dancer,69.0,18,0,0,0,0,stay,1984-06-23
25387,Tina Turner,1984-11-03,Tina Turner - Private Dancer,2,2,3,1.0,2,Private Dancer,69.0,19,-1,0,0,1,down,1984-06-23
25388,Tina Turner,1984-11-10,Tina Turner - Private Dancer,2,2,3,1.0,3,Private Dancer,69.0,20,0,-1,0,0,stay,1984-06-23
25389,Tina Turner,1984-11-17,Tina Turner - Private Dancer,3,2,3,1.0,3,Private Dancer,69.0,21,0,0,-1,0,stay,1984-06-23
25390,Tina Turner,1984-11-24,Tina Turner - Private Dancer,3,3,3,1.0,3,Private Dancer,69.0,22,0,0,0,0,stay,1984-06-23
25391,Tina Turner,1984-12-01,Tina Turner - Private Dancer,3,3,3,1.0,3,Private Dancer,69.0,23,0,0,0,0,stay,1984-06-23
25392,Tina Turner,1984-12-08,Tina Turner - Private Dancer,3,3,3,1.0,3,Private Dancer,69.0,24,0,0,0,0,stay,1984-06-23
25393,Tina Turner,1984-12-15,Tina Turner - Private Dancer,3,3,6,1.0,3,Private Dancer,69.0,25,-3,0,0,1,down,1984-06-23
25394,Tina Turner,1984-12-22,Tina Turner - Private Dancer,3,3,6,1.0,6,Private Dancer,69.0,26,0,-3,0,0,stay,1984-06-23
25395,Tina Turner,1984-12-29,Tina Turner - Private Dancer,6,3,5,1.0,6,Private Dancer,69.0,27,1,0,-3,1,up,1984-06-23
25396,Tina Turner,1985-01-05,Tina Turner - Private Dancer,6,6,5,1.0,5,Private Dancer,69.0,28,0,1,0,0,stay,1984-06-23
25397,Tina Turner,1985-01-12,Tina Turner - Private Dancer,5,6,6,1.0,5,Private Dancer,69.0,29,-1,0,1,1,down,1984-06-23
25398,Tina Turner,1985-01-19,Tina Turner - Private Dancer,5,5,9,1.0,6,Private Dancer,69.0,30,-3,-1,0,1,down,1984-06-23
25399,Tina Turner,1985-01-26,Tina Turner - Private Dancer,6,5,8,1.0,9,Private Dancer,69.0,31,1,-3,-1,1,up,1984-06-23
25400,Tina Turner,1985-02-02,Tina Turner - Private Dancer,9,6,5,1.0,8,Private Dancer,69.0,32,3,1,-3,1,up,1984-06-23
25401,Tina Turner,1985-02-09,Tina Turner - Private Dancer,8,9,4,1.0,5,Private Dancer,69.0,33,1,3,1,1,up,1984-06-23
25402,Tina Turner,1985-02-16,Tina Turner - Private Dancer,5,8,5,1.0,4,Private Dancer,69.0,34,-1,1,3,1,down,1984-06-23
25403,Tina Turner,1985-02-23,Tina Turner - Private Dancer,4,5,5,1.0,5,Private Dancer,69.0,35,0,-1,1,0,stay,1984-06-23
25404,Tina Turner,1985-03-02,Tina Turner - Private Dancer,5,4,5,1.0,5,Private Dancer,69.0,36,0,0,-1,0,stay,1984-06-23
25405,Tina Turner,1985-03-09,Tina Turner - Private Dancer,5,5,3,1.0,5,Private Dancer,69.0,37,2,0,0,1,up,1984-06-23
25406,Tina Turner,1985-03-16,Tina Turner - Private Dancer,5,5,1,1.0,3,Private Dancer,69.0,38,2,2,0,1,up,1984-06-23
25407,Tina Turner,1985-03-23,Tina Turner - Private Dancer,3,5,1,1.0,1,Private Dancer,69.0,39,0,2,2,0,stay,1984-06-23
25408,Tina Turner,1985-03-30,Tina Turner - Private Dancer,1,3,2,1.0,1,Private Dancer,69.0,40,-1,0,2,1,down,1984-06-23
25409,Tina Turner,1985-04-06,Tina Turner - Private Dancer,1,1,2,1.0,2,Private Dancer,69.0,41,0,-1,0,0,stay,1984-06-23
25410,Tina Turner,1985-04-13,Tina Turner - Private Dancer,2,1,6,1.0,2,Private Dancer,69.0,42,-4,0,-1,1,down,1984-06-23
25411,Tina Turner,1985-04-20,Tina Turner - Private Dancer,2,2,9,1.0,6,Private Dancer,69.0,43,-3,-4,0,1,down,1984-06-23
25412,Tina Turner,1985-04-27,Tina Turner - Private Dancer,6,2,10,1.0,9,Private Dancer,69.0,44,-1,-3,-4,1,down,1984-06-23
25413,Tina Turner,1985-05-04,Tina Turner - Private Dancer,9,6,10,1.0,10,Private Dancer,69.0,45,0,-1,-3,0,stay,1984-06-23
25414,Tina Turner,1985-05-11,Tina Turner - Private Dancer,10,9,12,1.0,10,Private Dancer,69.0,46,-2,0,-1,1,down,1984-06-23
25415,Tina Turner,1985-05-18,Tina Turner - Private Dancer,10,10,15,1.0,12,Private Dancer,69.0,47,-3,-2,0,1,down,1984-06-23
25416,Tina Turner,1985-05-25,Tina Turner - Private Dancer,12,10,16,1.0,15,Private Dancer,69.0,48,-1,-3,-2,1,down,1984-06-23
25417,Tina Turner,1985-06-01,Tina Turner - Private Dancer,15,12,21,1.0,16,Private Dancer,69.0,49,-5,-1,-3,1,down,1984-06-23
25418,Tina Turner,1985-06-08,Tina Turner - Private Dancer,16,15,21,1.0,21,Private Dancer,69.0,50,0,-5,-1,0,stay,1984-06-23
25419,Tina Turner,1985-06-15,Tina Turner - Private Dancer,21,16,21,1.0,21,Private Dancer,69.0,51,0,0,-5,0,stay,1984-06-23
25420,Tina Turner,1985-06-22,Tina Turner - Private Dancer,21,21,24,1.0,21,Private Dancer,69.0,52,-3,0,0,1,down,1984-06-23
25421,Tina Turner,1985-06-29,Tina Turner - Private Dancer,21,21,24,1.0,24,Private Dancer,69.0,53,0,-3,0,0,stay,1984-06-23
25422,Tina Turner,1985-07-06,Tina Turner - Private Dancer,24,21,24,1.0,24,Private Dancer,69.0,54,0,0,-3,0,stay,1984-06-23
25423,Tina Turner,1985-07-13,Tina Turner - Private Dancer,24,24,26,1.0,24,Private Dancer,69.0,55,-2,0,0,1,down,1984-06-23
25424,Tina Turner,1985-07-20,Tina Turner - Private Dancer,24,24,25,1.0,26,Private Dancer,69.0,56,1,-2,0,1,up,1984-06-23
25425,Tina Turner,1985-07-27,Tina Turner - Private Dancer,26,24,24,1.0,25,Private Dancer,69.0,57,1,1,-2,1,up,1984-06-23
25426,Tina Turner,1985-08-03,Tina Turner - Private Dancer,25,26,23,1.0,24,Private Dancer,69.0,58,1,1,1,1,up,1984-06-23
25427,Tina Turner,1985-08-10,Tina Turner - Private Dancer,24,25,28,1.0,23,Private Dancer,69.0,59,-5,1,1,1,down,1984-06-23
25428,Tina Turner,1985-08-17,Tina Turner - Private Dancer,23,24,28,1.0,28,Private Dancer,69.0,60,0,-5,1,0,stay,1984-06-23
25429,Tina Turner,1985-08-24,Tina Turner - Private Dancer,28,23,27,1.0,28,Private Dancer,69.0,61,1,0,-5,1,up,1984-06-23
25430,Tina Turner,1985-08-31,Tina Turner - Private Dancer,28,28,31,1.0,27,Private Dancer,69.0,62,-4,1,0,1,down,1984-06-23
25431,Tina Turner,1985-09-07,Tina Turner - Private Dancer,27,28,41,1.0,31,Private Dancer,69.0,63,-10,-4,1,1,down,1984-06-23
25432,Tina Turner,1985-09-14,Tina Turner - Private Dancer,31,27,41,1.0,41,Private Dancer,69.0,64,0,-10,-4,0,stay,1984-06-23
25433,Tina Turner,1985-09-21,Tina Turner - Private Dancer,41,31,43,1.0,41,Private Dancer,69.0,65,-2,0,-10,1,down,1984-06-23
25434,Tina Turner,1985-09-28,Tina Turner - Private Dancer,41,41,46,1.0,43,Private Dancer,69.0,66,-3,-2,0,1,down,1984-06-23
25435,Tina Turner,1985-10-05,Tina Turner - Private Dancer,43,41,50,1.0,46,Private Dancer,69.0,67,-4,-3,-2,1,down,1984-06-23
25436,Tina Turner,1985-10-12,Tina Turner - Private Dancer,46,43,49,1.0,50,Private Dancer,69.0,68,1,-4,-3,1,up,1984-06-23
25437,Tina Turner,1985-11-16,Tina Turner - Private Dancer,50,46,51,1.0,49,Private Dancer,69.0,69,-2,1,-4,1,down,1984-06-23
25438,Teddy Pendergrass,1984-06-23,Teddy Pendergrass - Love Language,51,51,16,4.0,20,Love Language,30.0,0,4,31,0,1,up,1984-06-23
25439,Teddy Pendergrass,1984-06-30,Teddy Pendergrass - Love Language,20,51,12,4.0,16,Love Language,30.0,1,4,4,31,1,up,1984-06-23
25440,Teddy Pendergrass,1984-07-07,Teddy Pendergrass - Love Language,16,20,9,4.0,12,Love Language,30.0,2,3,4,4,1,up,1984-06-23
25441,Teddy Pendergrass,1984-07-14,Teddy Pendergrass - Love Language,12,16,8,4.0,9,Love Language,30.0,3,1,3,4,1,up,1984-06-23
25442,Teddy Pendergrass,1984-07-21,Teddy Pendergrass - Love Language,9,12,8,4.0,8,Love Language,30.0,4,0,1,3,0,stay,1984-06-23
25443,Teddy Pendergrass,1984-07-28,Teddy Pendergrass - Love Language,8,9,4,4.0,8,Love Language,30.0,5,4,0,1,1,up,1984-06-23
25444,Teddy Pendergrass,1984-08-04,Teddy Pendergrass - Love Language,8,8,4,4.0,4,Love Language,30.0,6,0,4,0,0,stay,1984-06-23
25445,Teddy Pendergrass,1984-08-11,Teddy Pendergrass - Love Language,4,8,4,4.0,4,Love Language,30.0,7,0,0,4,0,stay,1984-06-23
25446,Teddy Pendergrass,1984-08-18,Teddy Pendergrass - Love Language,4,4,4,4.0,4,Love Language,30.0,8,0,0,0,0,stay,1984-06-23
25447,Teddy Pendergrass,1984-08-25,Teddy Pendergrass - Love Language,4,4,6,4.0,4,Love Language,30.0,9,-2,0,0,1,down,1984-06-23
25448,Teddy Pendergrass,1984-09-01,Teddy Pendergrass - Love Language,4,4,6,4.0,6,Love Language,30.0,10,0,-2,0,0,stay,1984-06-23
25449,Teddy Pendergrass,1984-09-08,Teddy Pendergrass - Love Language,6,4,5,4.0,6,Love Language,30.0,11,1,0,-2,1,up,1984-06-23
25450,Teddy Pendergrass,1984-09-15,Teddy Pendergrass - Love Language,6,6,5,4.0,5,Love Language,30.0,12,0,1,0,0,stay,1984-06-23
25451,Teddy Pendergrass,1984-09-22,Teddy Pendergrass - Love Language,5,6,6,4.0,5,Love Language,30.0,13,-1,0,1,1,down,1984-06-23
25452,Teddy Pendergrass,1984-09-29,Teddy Pendergrass - Love Language,5,5,12,4.0,6,Love Language,30.0,14,-6,-1,0,1,down,1984-06-23
25453,Teddy Pendergrass,1984-10-06,Teddy Pendergrass - Love Language,6,5,12,4.0,12,Love Language,30.0,15,0,-6,-1,0,stay,1984-06-23
25454,Teddy Pendergrass,1984-10-13,Teddy Pendergrass - Love Language,12,6,11,4.0,12,Love Language,30.0,16,1,0,-6,1,up,1984-06-23
25455,Teddy Pendergrass,1984-10-20,Teddy Pendergrass - Love Language,12,12,10,4.0,11,Love Language,30.0,17,1,1,0,1,up,1984-06-23
25456,Teddy Pendergrass,1984-10-27,Teddy Pendergrass - Love Language,11,12,9,4.0,10,Love Language,30.0,18,1,1,1,1,up,1984-06-23
25457,Teddy Pendergrass,1984-11-03,Teddy Pendergrass - Love Language,10,11,11,4.0,9,Love Language,30.0,19,-2,1,1,1,down,1984-06-23
25458,Teddy Pendergrass,1984-11-10,Teddy Pendergrass - Love Language,9,10,12,4.0,11,Love Language,30.0,20,-1,-2,1,1,down,1984-06-23
25459,Teddy Pendergrass,1984-11-17,Teddy Pendergrass - Love Language,11,9,17,4.0,12,Love Language,30.0,21,-5,-1,-2,1,down,1984-06-23
25460,Teddy Pendergrass,1984-11-24,Teddy Pendergrass - Love Language,12,11,21,4.0,17,Love Language,30.0,22,-4,-5,-1,1,down,1984-06-23
25461,Teddy Pendergrass,1984-12-01,Teddy Pendergrass - Love Language,17,12,21,4.0,21,Love Language,30.0,23,0,-4,-5,0,stay,1984-06-23
25462,Teddy Pendergrass,1984-12-08,Teddy Pendergrass - Love Language,21,17,43,4.0,21,Love Language,30.0,24,-22,0,-4,1,down,1984-06-23
25463,Teddy Pendergrass,1984-12-15,Teddy Pendergrass - Love Language,21,21,43,4.0,43,Love Language,30.0,25,0,-22,0,0,stay,1984-06-23
25464,Teddy Pendergrass,1984-12-22,Teddy Pendergrass - Love Language,43,21,43,4.0,43,Love Language,30.0,26,0,0,-22,0,stay,1984-06-23
25465,Teddy Pendergrass,1984-12-29,Teddy Pendergrass - Love Language,43,43,45,4.0,43,Love Language,30.0,27,-2,0,0,1,down,1984-06-23
25466,Teddy Pendergrass,1985-01-05,Teddy Pendergrass - Love Language,43,43,48,4.0,45,Love Language,30.0,28,-3,-2,0,1,down,1984-06-23
25467,Teddy Pendergrass,1985-01-12,Teddy Pendergrass - Love Language,45,43,48,4.0,48,Love Language,30.0,29,0,-3,-2,0,stay,1984-06-23
25468,Teddy Pendergrass,1985-01-19,Teddy Pendergrass - Love Language,48,45,51,4.0,48,Love Language,30.0,30,-3,0,-3,1,down,1984-06-23
25469,Peabo Bryson,1984-06-23,Peabo Bryson - Straight From The Heart,51,51,20,12.0,24,Straight From The Heart,20.0,0,4,27,0,1,up,1984-06-23
25470,Peabo Bryson,1984-06-30,Peabo Bryson - Straight From The Heart,24,51,18,12.0,20,Straight From The Heart,20.0,1,2,4,27,1,up,1984-06-23
25471,Peabo Bryson,1984-07-07,Peabo Bryson - Straight From The Heart,20,24,14,12.0,18,Straight From The Heart,20.0,2,4,2,4,1,up,1984-06-23
25472,Peabo Bryson,1984-07-14,Peabo Bryson - Straight From The Heart,18,20,13,12.0,14,Straight From The Heart,20.0,3,1,4,2,1,up,1984-06-23
25473,Peabo Bryson,1984-07-21,Peabo Bryson - Straight From The Heart,14,18,12,12.0,13,Straight From The Heart,20.0,4,1,1,4,1,up,1984-06-23
25474,Peabo Bryson,1984-07-28,Peabo Bryson - Straight From The Heart,13,14,12,12.0,12,Straight From The Heart,20.0,5,0,1,1,0,stay,1984-06-23
25475,Peabo Bryson,1984-08-04,Peabo Bryson - Straight From The Heart,12,13,18,12.0,12,Straight From The Heart,20.0,6,-6,0,1,1,down,1984-06-23
25476,Peabo Bryson,1984-08-11,Peabo Bryson - Straight From The Heart,12,12,17,12.0,18,Straight From The Heart,20.0,7,1,-6,0,1,up,1984-06-23
25477,Peabo Bryson,1984-08-18,Peabo Bryson - Straight From The Heart,18,12,17,12.0,17,Straight From The Heart,20.0,8,0,1,-6,0,stay,1984-06-23
25478,Peabo Bryson,1984-08-25,Peabo Bryson - Straight From The Heart,17,18,19,12.0,17,Straight From The Heart,20.0,9,-2,0,1,1,down,1984-06-23
25479,Peabo Bryson,1984-09-01,Peabo Bryson - Straight From The Heart,17,17,18,12.0,19,Straight From The Heart,20.0,10,1,-2,0,1,up,1984-06-23
25480,Peabo Bryson,1984-09-08,Peabo Bryson - Straight From The Heart,19,17,24,12.0,18,Straight From The Heart,20.0,11,-6,1,-2,1,down,1984-06-23
25481,Peabo Bryson,1984-09-15,Peabo Bryson - Straight From The Heart,18,19,22,12.0,24,Straight From The Heart,20.0,12,2,-6,1,1,up,1984-06-23
25482,Peabo Bryson,1984-09-22,Peabo Bryson - Straight From The Heart,24,18,21,12.0,22,Straight From The Heart,20.0,13,1,2,-6,1,up,1984-06-23
25483,Peabo Bryson,1984-09-29,Peabo Bryson - Straight From The Heart,22,24,21,12.0,21,Straight From The Heart,20.0,14,0,1,2,0,stay,1984-06-23
25484,Peabo Bryson,1984-10-06,Peabo Bryson - Straight From The Heart,21,22,21,12.0,21,Straight From The Heart,20.0,15,0,0,1,0,stay,1984-06-23
25485,Peabo Bryson,1984-10-13,Peabo Bryson - Straight From The Heart,21,21,26,12.0,21,Straight From The Heart,20.0,16,-5,0,0,1,down,1984-06-23
25486,Peabo Bryson,1984-10-20,Peabo Bryson - Straight From The Heart,21,21,30,12.0,26,Straight From The Heart,20.0,17,-4,-5,0,1,down,1984-06-23
25487,Peabo Bryson,1984-10-27,Peabo Bryson - Straight From The Heart,26,21,29,12.0,30,Straight From The Heart,20.0,18,1,-4,-5,1,up,1984-06-23
25488,Peabo Bryson,1984-11-03,Peabo Bryson - Straight From The Heart,30,26,32,12.0,29,Straight From The Heart,20.0,19,-3,1,-4,1,down,1984-06-23
25489,Peabo Bryson,1984-11-10,Peabo Bryson - Straight From The Heart,29,30,51,12.0,32,Straight From The Heart,20.0,20,-19,-3,1,1,down,1984-06-23
25490,Patrice Rushen,1984-06-23,Patrice Rushen - Now,51,51,15,7.0,26,Now,21.0,0,11,25,0,1,up,1984-06-23
25491,Patrice Rushen,1984-06-30,Patrice Rushen - Now,26,51,9,7.0,15,Now,21.0,1,6,11,25,1,up,1984-06-23
25492,Patrice Rushen,1984-07-07,Patrice Rushen - Now,15,26,7,7.0,9,Now,21.0,2,2,6,11,1,up,1984-06-23
25493,Patrice Rushen,1984-07-14,Patrice Rushen - Now,9,15,7,7.0,7,Now,21.0,3,0,2,6,0,stay,1984-06-23
25494,Patrice Rushen,1984-07-21,Patrice Rushen - Now,7,9,7,7.0,7,Now,21.0,4,0,0,2,0,stay,1984-06-23
25495,Patrice Rushen,1984-07-28,Patrice Rushen - Now,7,7,8,7.0,7,Now,21.0,5,-1,0,0,1,down,1984-06-23
25496,Patrice Rushen,1984-08-04,Patrice Rushen - Now,7,7,11,7.0,8,Now,21.0,6,-3,-1,0,1,down,1984-06-23
25497,Patrice Rushen,1984-08-11,Patrice Rushen - Now,8,7,18,7.0,11,Now,21.0,7,-7,-3,-1,1,down,1984-06-23
25498,Patrice Rushen,1984-08-18,Patrice Rushen - Now,11,8,18,7.0,18,Now,21.0,8,0,-7,-3,0,stay,1984-06-23
25499,Patrice Rushen,1984-08-25,Patrice Rushen - Now,18,11,17,7.0,18,Now,21.0,9,1,0,-7,1,up,1984-06-23
25500,Patrice Rushen,1984-09-01,Patrice Rushen - Now,18,18,17,7.0,17,Now,21.0,10,0,1,0,0,stay,1984-06-23
25501,Patrice Rushen,1984-09-08,Patrice Rushen - Now,17,18,19,7.0,17,Now,21.0,11,-2,0,1,1,down,1984-06-23
25502,Patrice Rushen,1984-09-15,Patrice Rushen - Now,17,17,19,7.0,19,Now,21.0,12,0,-2,0,0,stay,1984-06-23
25503,Patrice Rushen,1984-09-22,Patrice Rushen - Now,19,17,25,7.0,19,Now,21.0,13,-6,0,-2,1,down,1984-06-23
25504,Patrice Rushen,1984-09-29,Patrice Rushen - Now,19,19,24,7.0,25,Now,21.0,14,1,-6,0,1,up,1984-06-23
25505,Patrice Rushen,1984-10-06,Patrice Rushen - Now,25,19,29,7.0,24,Now,21.0,15,-5,1,-6,1,down,1984-06-23
25506,Patrice Rushen,1984-10-13,Patrice Rushen - Now,24,25,29,7.0,29,Now,21.0,16,0,-5,1,0,stay,1984-06-23
25507,Patrice Rushen,1984-10-20,Patrice Rushen - Now,29,24,31,7.0,29,Now,21.0,17,-2,0,-5,1,down,1984-06-23
25508,Patrice Rushen,1984-10-27,Patrice Rushen - Now,29,29,46,7.0,31,Now,21.0,18,-15,-2,0,1,down,1984-06-23
25509,Patrice Rushen,1984-11-03,Patrice Rushen - Now,31,29,46,7.0,46,Now,21.0,19,0,-15,-2,0,stay,1984-06-23
25510,Patrice Rushen,1984-11-10,Patrice Rushen - Now,46,31,50,7.0,46,Now,21.0,20,-4,0,-15,1,down,1984-06-23
25511,Patrice Rushen,1984-11-17,Patrice Rushen - Now,46,46,51,7.0,50,Now,21.0,21,-1,-4,0,1,down,1984-06-23
25512,George Howard,1984-06-23,George Howard - Steppin' Out,51,51,46,39.0,50,Steppin' Out,11.0,0,4,1,0,1,up,1984-06-23
25513,George Howard,1984-07-14,George Howard - Steppin' Out,50,51,46,39.0,46,Steppin' Out,11.0,1,0,4,1,0,stay,1984-06-23
25514,George Howard,1984-07-21,George Howard - Steppin' Out,46,50,43,39.0,46,Steppin' Out,11.0,2,3,0,4,1,up,1984-06-23
25515,George Howard,1984-07-28,George Howard - Steppin' Out,46,46,42,39.0,43,Steppin' Out,11.0,3,1,3,0,1,up,1984-06-23
25516,George Howard,1984-08-04,George Howard - Steppin' Out,43,46,39,39.0,42,Steppin' Out,11.0,4,3,1,3,1,up,1984-06-23
25517,George Howard,1984-08-11,George Howard - Steppin' Out,42,43,39,39.0,39,Steppin' Out,11.0,5,0,3,1,0,stay,1984-06-23
25518,George Howard,1984-08-18,George Howard - Steppin' Out,39,42,43,39.0,39,Steppin' Out,11.0,6,-4,0,3,1,down,1984-06-23
25519,George Howard,1984-08-25,George Howard - Steppin' Out,39,39,44,39.0,43,Steppin' Out,11.0,7,-1,-4,0,1,down,1984-06-23
25520,George Howard,1984-09-01,George Howard - Steppin' Out,43,39,46,39.0,44,Steppin' Out,11.0,8,-2,-1,-4,1,down,1984-06-23
25521,George Howard,1984-09-08,George Howard - Steppin' Out,44,43,45,39.0,46,Steppin' Out,11.0,9,1,-2,-1,1,up,1984-06-23
25522,George Howard,1984-09-15,George Howard - Steppin' Out,46,44,50,39.0,45,Steppin' Out,11.0,10,-5,1,-2,1,down,1984-06-23
25523,George Howard,1984-09-29,George Howard - Steppin' Out,45,46,51,39.0,50,Steppin' Out,11.0,11,-1,-5,1,1,down,1984-06-23
25524,The Art Of Noise,1984-07-07,The Art Of Noise - (Who's Afraid Of) Art Of Noise,51,51,25,22.0,32,(Who's Afraid Of) Art Of Noise,8.0,0,7,19,0,1,up,1984-07-07
25525,The Art Of Noise,1984-07-14,The Art Of Noise - (Who's Afraid Of) Art Of Noise,32,51,23,22.0,25,(Who's Afraid Of) Art Of Noise,8.0,1,2,7,19,1,up,1984-07-07
25526,The Art Of Noise,1984-07-21,The Art Of Noise - (Who's Afraid Of) Art Of Noise,25,32,22,22.0,23,(Who's Afraid Of) Art Of Noise,8.0,2,1,2,7,1,up,1984-07-07
25527,The Art Of Noise,1984-07-28,The Art Of Noise - (Who's Afraid Of) Art Of Noise,23,25,22,22.0,22,(Who's Afraid Of) Art Of Noise,8.0,3,0,1,2,0,stay,1984-07-07
25528,The Art Of Noise,1984-08-04,The Art Of Noise - (Who's Afraid Of) Art Of Noise,22,23,24,22.0,22,(Who's Afraid Of) Art Of Noise,8.0,4,-2,0,1,1,down,1984-07-07
25529,The Art Of Noise,1984-08-11,The Art Of Noise - (Who's Afraid Of) Art Of Noise,22,22,33,22.0,24,(Who's Afraid Of) Art Of Noise,8.0,5,-9,-2,0,1,down,1984-07-07
25530,The Art Of Noise,1984-08-18,The Art Of Noise - (Who's Afraid Of) Art Of Noise,24,22,33,22.0,33,(Who's Afraid Of) Art Of Noise,8.0,6,0,-9,-2,0,stay,1984-07-07
25531,The Art Of Noise,1984-08-25,The Art Of Noise - (Who's Afraid Of) Art Of Noise,33,24,33,22.0,33,(Who's Afraid Of) Art Of Noise,8.0,7,0,0,-9,0,stay,1984-07-07
25532,The Art Of Noise,1984-09-01,The Art Of Noise - (Who's Afraid Of) Art Of Noise,33,33,51,22.0,33,(Who's Afraid Of) Art Of Noise,8.0,8,-18,0,0,1,down,1984-07-07
25533,Smokey Robinson,1984-07-07,Smokey Robinson - Essar,51,51,37,35.0,40,Essar,7.0,0,3,11,0,1,up,1984-07-07
25534,Smokey Robinson,1984-07-14,Smokey Robinson - Essar,40,51,35,35.0,37,Essar,7.0,1,2,3,11,1,up,1984-07-07
25535,Smokey Robinson,1984-07-21,Smokey Robinson - Essar,37,40,35,35.0,35,Essar,7.0,2,0,2,3,0,stay,1984-07-07
25536,Smokey Robinson,1984-07-28,Smokey Robinson - Essar,35,37,44,35.0,35,Essar,7.0,3,-9,0,2,1,down,1984-07-07
25537,Smokey Robinson,1984-08-04,Smokey Robinson - Essar,35,35,50,35.0,44,Essar,7.0,4,-6,-9,0,1,down,1984-07-07
25538,Smokey Robinson,1984-08-11,Smokey Robinson - Essar,44,35,48,35.0,50,Essar,7.0,5,2,-6,-9,1,up,1984-07-07
25539,Smokey Robinson,1984-08-18,Smokey Robinson - Essar,50,44,48,35.0,48,Essar,7.0,6,0,2,-6,0,stay,1984-07-07
25540,Smokey Robinson,1984-08-25,Smokey Robinson - Essar,48,50,51,35.0,48,Essar,7.0,7,-3,0,2,1,down,1984-07-07
25541,Sheila E.,1984-07-07,Sheila E. - The Glamorous Life,51,51,33,7.0,45,The Glamorous Life,35.0,0,12,6,0,1,up,1984-07-07
25542,Sheila E.,1984-07-14,Sheila E. - The Glamorous Life,45,51,28,7.0,33,The Glamorous Life,35.0,1,5,12,6,1,up,1984-07-07
25543,Sheila E.,1984-07-21,Sheila E. - The Glamorous Life,33,45,25,7.0,28,The Glamorous Life,35.0,2,3,5,12,1,up,1984-07-07
25544,Sheila E.,1984-07-28,Sheila E. - The Glamorous Life,28,33,19,7.0,25,The Glamorous Life,35.0,3,6,3,5,1,up,1984-07-07
25545,Sheila E.,1984-08-04,Sheila E. - The Glamorous Life,25,28,14,7.0,19,The Glamorous Life,35.0,4,5,6,3,1,up,1984-07-07
25546,Sheila E.,1984-08-11,Sheila E. - The Glamorous Life,19,25,14,7.0,14,The Glamorous Life,35.0,5,0,5,6,0,stay,1984-07-07
25547,Sheila E.,1984-08-18,Sheila E. - The Glamorous Life,14,19,12,7.0,14,The Glamorous Life,35.0,6,2,0,5,1,up,1984-07-07
25548,Sheila E.,1984-08-25,Sheila E. - The Glamorous Life,14,14,9,7.0,12,The Glamorous Life,35.0,7,3,2,0,1,up,1984-07-07
25549,Sheila E.,1984-09-01,Sheila E. - The Glamorous Life,12,14,9,7.0,9,The Glamorous Life,35.0,8,0,3,2,0,stay,1984-07-07
25550,Sheila E.,1984-09-08,Sheila E. - The Glamorous Life,9,12,9,7.0,9,The Glamorous Life,35.0,9,0,0,3,0,stay,1984-07-07
25551,Sheila E.,1984-09-15,Sheila E. - The Glamorous Life,9,9,8,7.0,9,The Glamorous Life,35.0,10,1,0,0,1,up,1984-07-07
25552,Sheila E.,1984-09-22,Sheila E. - The Glamorous Life,9,9,7,7.0,8,The Glamorous Life,35.0,11,1,1,0,1,up,1984-07-07
25553,Sheila E.,1984-09-29,Sheila E. - The Glamorous Life,8,9,15,7.0,7,The Glamorous Life,35.0,12,-8,1,1,1,down,1984-07-07
25554,Sheila E.,1984-10-06,Sheila E. - The Glamorous Life,7,8,14,7.0,15,The Glamorous Life,35.0,13,1,-8,1,1,up,1984-07-07
25555,Sheila E.,1984-10-13,Sheila E. - The Glamorous Life,15,7,14,7.0,14,The Glamorous Life,35.0,14,0,1,-8,0,stay,1984-07-07
25556,Sheila E.,1984-10-20,Sheila E. - The Glamorous Life,14,15,15,7.0,14,The Glamorous Life,35.0,15,-1,0,1,1,down,1984-07-07
25557,Sheila E.,1984-10-27,Sheila E. - The Glamorous Life,14,14,27,7.0,15,The Glamorous Life,35.0,16,-12,-1,0,1,down,1984-07-07
25558,Sheila E.,1984-11-03,Sheila E. - The Glamorous Life,15,14,27,7.0,27,The Glamorous Life,35.0,17,0,-12,-1,0,stay,1984-07-07
25559,Sheila E.,1984-11-10,Sheila E. - The Glamorous Life,27,15,26,7.0,27,The Glamorous Life,35.0,18,1,0,-12,1,up,1984-07-07
25560,Sheila E.,1984-11-17,Sheila E. - The Glamorous Life,27,27,29,7.0,26,The Glamorous Life,35.0,19,-3,1,0,1,down,1984-07-07
25561,Sheila E.,1984-11-24,Sheila E. - The Glamorous Life,26,27,27,7.0,29,The Glamorous Life,35.0,20,2,-3,1,1,up,1984-07-07
25562,Sheila E.,1984-12-01,Sheila E. - The Glamorous Life,29,26,26,7.0,27,The Glamorous Life,35.0,21,1,2,-3,1,up,1984-07-07
25563,Sheila E.,1984-12-08,Sheila E. - The Glamorous Life,27,29,26,7.0,26,The Glamorous Life,35.0,22,0,1,2,0,stay,1984-07-07
25564,Sheila E.,1984-12-15,Sheila E. - The Glamorous Life,26,27,39,7.0,26,The Glamorous Life,35.0,23,-13,0,1,1,down,1984-07-07
25565,Sheila E.,1984-12-22,Sheila E. - The Glamorous Life,26,26,39,7.0,39,The Glamorous Life,35.0,24,0,-13,0,0,stay,1984-07-07
25566,Sheila E.,1984-12-29,Sheila E. - The Glamorous Life,39,26,42,7.0,39,The Glamorous Life,35.0,25,-3,0,-13,1,down,1984-07-07
25567,Sheila E.,1985-01-05,Sheila E. - The Glamorous Life,39,39,41,7.0,42,The Glamorous Life,35.0,26,1,-3,0,1,up,1984-07-07
25568,Sheila E.,1985-01-12,Sheila E. - The Glamorous Life,42,39,41,7.0,41,The Glamorous Life,35.0,27,0,1,-3,0,stay,1984-07-07
25569,Sheila E.,1985-01-19,Sheila E. - The Glamorous Life,41,42,45,7.0,41,The Glamorous Life,35.0,28,-4,0,1,1,down,1984-07-07
25570,Sheila E.,1985-01-26,Sheila E. - The Glamorous Life,41,41,44,7.0,45,The Glamorous Life,35.0,29,1,-4,0,1,up,1984-07-07
25571,Sheila E.,1985-02-02,Sheila E. - The Glamorous Life,45,41,46,7.0,44,The Glamorous Life,35.0,30,-2,1,-4,1,down,1984-07-07
25572,Sheila E.,1985-02-16,Sheila E. - The Glamorous Life,44,45,45,7.0,46,The Glamorous Life,35.0,31,1,-2,1,1,up,1984-07-07
25573,Sheila E.,1985-02-23,Sheila E. - The Glamorous Life,46,44,49,7.0,45,The Glamorous Life,35.0,32,-4,1,-2,1,down,1984-07-07
25574,Sheila E.,1985-03-02,Sheila E. - The Glamorous Life,45,46,47,7.0,49,The Glamorous Life,35.0,33,2,-4,1,1,up,1984-07-07
25575,Sheila E.,1985-03-09,Sheila E. - The Glamorous Life,49,45,47,7.0,47,The Glamorous Life,35.0,34,0,2,-4,0,stay,1984-07-07
25576,Sheila E.,1985-03-16,Sheila E. - The Glamorous Life,47,49,51,7.0,47,The Glamorous Life,35.0,35,-4,0,2,1,down,1984-07-07
25577,Prince And The Revolution,1984-07-14,Prince And The Revolution - Purple Rain,51,51,6,1.0,18,Purple Rain,42.0,0,12,33,0,1,up,1984-07-14
25578,Prince And The Revolution,1984-07-21,Prince And The Revolution - Purple Rain,18,51,1,1.0,6,Purple Rain,42.0,1,5,12,33,1,up,1984-07-14
25579,Prince And The Revolution,1984-07-28,Prince And The Revolution - Purple Rain,6,18,1,1.0,1,Purple Rain,42.0,2,0,5,12,0,stay,1984-07-14
25580,Prince And The Revolution,1984-08-04,Prince And The Revolution - Purple Rain,1,6,1,1.0,1,Purple Rain,42.0,3,0,0,5,0,stay,1984-07-14
25581,Prince And The Revolution,1984-08-11,Prince And The Revolution - Purple Rain,1,1,1,1.0,1,Purple Rain,42.0,4,0,0,0,0,stay,1984-07-14
25582,Prince And The Revolution,1984-08-18,Prince And The Revolution - Purple Rain,1,1,1,1.0,1,Purple Rain,42.0,5,0,0,0,0,stay,1984-07-14
25583,Prince And The Revolution,1984-08-25,Prince And The Revolution - Purple Rain,1,1,1,1.0,1,Purple Rain,42.0,6,0,0,0,0,stay,1984-07-14
25584,Prince And The Revolution,1984-09-01,Prince And The Revolution - Purple Rain,1,1,1,1.0,1,Purple Rain,42.0,7,0,0,0,0,stay,1984-07-14
25585,Prince And The Revolution,1984-09-08,Prince And The Revolution - Purple Rain,1,1,1,1.0,1,Purple Rain,42.0,8,0,0,0,0,stay,1984-07-14
25586,Prince And The Revolution,1984-09-15,Prince And The Revolution - Purple Rain,1,1,1,1.0,1,Purple Rain,42.0,9,0,0,0,0,stay,1984-07-14
25587,Prince And The Revolution,1984-09-22,Prince And The Revolution - Purple Rain,1,1,1,1.0,1,Purple Rain,42.0,10,0,0,0,0,stay,1984-07-14
25588,Prince And The Revolution,1984-09-29,Prince And The Revolution - Purple Rain,1,1,1,1.0,1,Purple Rain,42.0,11,0,0,0,0,stay,1984-07-14
25589,Prince And The Revolution,1984-10-06,Prince And The Revolution - Purple Rain,1,1,1,1.0,1,Purple Rain,42.0,12,0,0,0,0,stay,1984-07-14
25590,Prince And The Revolution,1984-10-13,Prince And The Revolution - Purple Rain,1,1,1,1.0,1,Purple Rain,42.0,13,0,0,0,0,stay,1984-07-14
25591,Prince And The Revolution,1984-10-20,Prince And The Revolution - Purple Rain,1,1,1,1.0,1,Purple Rain,42.0,14,0,0,0,0,stay,1984-07-14
25592,Prince And The Revolution,1984-10-27,Prince And The Revolution - Purple Rain,1,1,1,1.0,1,Purple Rain,42.0,15,0,0,0,0,stay,1984-07-14
25593,Prince And The Revolution,1984-11-03,Prince And The Revolution - Purple Rain,1,1,1,1.0,1,Purple Rain,42.0,16,0,0,0,0,stay,1984-07-14
25594,Prince And The Revolution,1984-11-10,Prince And The Revolution - Purple Rain,1,1,1,1.0,1,Purple Rain,42.0,17,0,0,0,0,stay,1984-07-14
25595,Prince And The Revolution,1984-11-17,Prince And The Revolution - Purple Rain,1,1,1,1.0,1,Purple Rain,42.0,18,0,0,0,0,stay,1984-07-14
25596,Prince And The Revolution,1984-11-24,Prince And The Revolution - Purple Rain,1,1,1,1.0,1,Purple Rain,42.0,19,0,0,0,0,stay,1984-07-14
25597,Prince And The Revolution,1984-12-01,Prince And The Revolution - Purple Rain,1,1,2,1.0,1,Purple Rain,42.0,20,-1,0,0,1,down,1984-07-14
25598,Prince And The Revolution,1984-12-08,Prince And The Revolution - Purple Rain,1,1,2,1.0,2,Purple Rain,42.0,21,0,-1,0,0,stay,1984-07-14
25599,Prince And The Revolution,1984-12-15,Prince And The Revolution - Purple Rain,2,1,2,1.0,2,Purple Rain,42.0,22,0,0,-1,0,stay,1984-07-14
25600,Prince And The Revolution,1984-12-22,Prince And The Revolution - Purple Rain,2,2,2,1.0,2,Purple Rain,42.0,23,0,0,0,0,stay,1984-07-14
25601,Prince And The Revolution,1984-12-29,Prince And The Revolution - Purple Rain,2,2,2,1.0,2,Purple Rain,42.0,24,0,0,0,0,stay,1984-07-14
25602,Prince And The Revolution,1985-01-05,Prince And The Revolution - Purple Rain,2,2,3,1.0,2,Purple Rain,42.0,25,-1,0,0,1,down,1984-07-14
25603,Prince And The Revolution,1985-01-12,Prince And The Revolution - Purple Rain,2,2,3,1.0,3,Purple Rain,42.0,26,0,-1,0,0,stay,1984-07-14
25604,Prince And The Revolution,1985-01-19,Prince And The Revolution - Purple Rain,3,2,4,1.0,3,Purple Rain,42.0,27,-1,0,-1,1,down,1984-07-14
25605,Prince And The Revolution,1985-01-26,Prince And The Revolution - Purple Rain,3,3,4,1.0,4,Purple Rain,42.0,28,0,-1,0,0,stay,1984-07-14
25606,Prince And The Revolution,1985-02-02,Prince And The Revolution - Purple Rain,4,3,10,1.0,4,Purple Rain,42.0,29,-6,0,-1,1,down,1984-07-14
25607,Prince And The Revolution,1985-02-09,Prince And The Revolution - Purple Rain,4,4,11,1.0,10,Purple Rain,42.0,30,-1,-6,0,1,down,1984-07-14
25608,Prince And The Revolution,1985-02-16,Prince And The Revolution - Purple Rain,10,4,10,1.0,11,Purple Rain,42.0,31,1,-1,-6,1,up,1984-07-14
25609,Prince And The Revolution,1985-02-23,Prince And The Revolution - Purple Rain,11,10,16,1.0,10,Purple Rain,42.0,32,-6,1,-1,1,down,1984-07-14
25610,Prince And The Revolution,1985-03-02,Prince And The Revolution - Purple Rain,10,11,17,1.0,16,Purple Rain,42.0,33,-1,-6,1,1,down,1984-07-14
25611,Prince And The Revolution,1985-03-09,Prince And The Revolution - Purple Rain,16,10,21,1.0,17,Purple Rain,42.0,34,-4,-1,-6,1,down,1984-07-14
25612,Prince And The Revolution,1985-03-16,Prince And The Revolution - Purple Rain,17,16,25,1.0,21,Purple Rain,42.0,35,-4,-4,-1,1,down,1984-07-14
25613,Prince And The Revolution,1985-03-23,Prince And The Revolution - Purple Rain,21,17,25,1.0,25,Purple Rain,42.0,36,0,-4,-4,0,stay,1984-07-14
25614,Prince And The Revolution,1985-03-30,Prince And The Revolution - Purple Rain,25,21,28,1.0,25,Purple Rain,42.0,37,-3,0,-4,1,down,1984-07-14
25615,Prince And The Revolution,1985-04-06,Prince And The Revolution - Purple Rain,25,25,32,1.0,28,Purple Rain,42.0,38,-4,-3,0,1,down,1984-07-14
25616,Prince And The Revolution,1985-04-13,Prince And The Revolution - Purple Rain,28,25,44,1.0,32,Purple Rain,42.0,39,-12,-4,-3,1,down,1984-07-14
25617,Prince And The Revolution,1985-04-20,Prince And The Revolution - Purple Rain,32,28,43,1.0,44,Purple Rain,42.0,40,1,-12,-4,1,up,1984-07-14
25618,Prince And The Revolution,1985-04-27,Prince And The Revolution - Purple Rain,44,32,49,1.0,43,Purple Rain,42.0,41,-6,1,-12,1,down,1984-07-14
25619,Prince And The Revolution,1985-05-04,Prince And The Revolution - Purple Rain,43,44,51,1.0,49,Purple Rain,42.0,42,-2,-6,1,1,down,1984-07-14
25620,Newcleus,1984-07-14,Newcleus - Jam On Revenge,51,51,26,15.0,32,Jam On Revenge,19.0,0,6,19,0,1,up,1984-07-14
25621,Newcleus,1984-07-21,Newcleus - Jam On Revenge,32,51,23,15.0,26,Jam On Revenge,19.0,1,3,6,19,1,up,1984-07-14
25622,Newcleus,1984-07-28,Newcleus - Jam On Revenge,26,32,16,15.0,23,Jam On Revenge,19.0,2,7,3,6,1,up,1984-07-14
25623,Newcleus,1984-08-04,Newcleus - Jam On Revenge,23,26,15,15.0,16,Jam On Revenge,19.0,3,1,7,3,1,up,1984-07-14
25624,Newcleus,1984-08-11,Newcleus - Jam On Revenge,16,23,15,15.0,15,Jam On Revenge,19.0,4,0,1,7,0,stay,1984-07-14
25625,Newcleus,1984-08-18,Newcleus - Jam On Revenge,15,16,16,15.0,15,Jam On Revenge,19.0,5,-1,0,1,1,down,1984-07-14
25626,Newcleus,1984-08-25,Newcleus - Jam On Revenge,15,15,21,15.0,16,Jam On Revenge,19.0,6,-5,-1,0,1,down,1984-07-14
25627,Newcleus,1984-09-01,Newcleus - Jam On Revenge,16,15,21,15.0,21,Jam On Revenge,19.0,7,0,-5,-1,0,stay,1984-07-14
25628,Newcleus,1984-09-08,Newcleus - Jam On Revenge,21,16,26,15.0,21,Jam On Revenge,19.0,8,-5,0,-5,1,down,1984-07-14
25629,Newcleus,1984-09-15,Newcleus - Jam On Revenge,21,21,20,15.0,26,Jam On Revenge,19.0,9,6,-5,0,1,up,1984-07-14
25630,Newcleus,1984-09-22,Newcleus - Jam On Revenge,26,21,20,15.0,20,Jam On Revenge,19.0,10,0,6,-5,0,stay,1984-07-14
25631,Newcleus,1984-09-29,Newcleus - Jam On Revenge,20,26,26,15.0,20,Jam On Revenge,19.0,11,-6,0,6,1,down,1984-07-14
25632,Newcleus,1984-10-06,Newcleus - Jam On Revenge,20,20,25,15.0,26,Jam On Revenge,19.0,12,1,-6,0,1,up,1984-07-14
25633,Newcleus,1984-10-13,Newcleus - Jam On Revenge,26,20,27,15.0,25,Jam On Revenge,19.0,13,-2,1,-6,1,down,1984-07-14
25634,Newcleus,1984-10-20,Newcleus - Jam On Revenge,25,26,32,15.0,27,Jam On Revenge,19.0,14,-5,-2,1,1,down,1984-07-14
25635,Newcleus,1984-10-27,Newcleus - Jam On Revenge,27,25,32,15.0,32,Jam On Revenge,19.0,15,0,-5,-2,0,stay,1984-07-14
25636,Newcleus,1984-11-03,Newcleus - Jam On Revenge,32,27,40,15.0,32,Jam On Revenge,19.0,16,-8,0,-5,1,down,1984-07-14
25637,Newcleus,1984-11-10,Newcleus - Jam On Revenge,32,32,49,15.0,40,Jam On Revenge,19.0,17,-9,-8,0,1,down,1984-07-14
25638,Newcleus,1984-11-17,Newcleus - Jam On Revenge,40,32,48,15.0,49,Jam On Revenge,19.0,18,1,-9,-8,1,up,1984-07-14
25639,Newcleus,1984-11-24,Newcleus - Jam On Revenge,49,40,51,15.0,48,Jam On Revenge,19.0,19,-3,1,-9,1,down,1984-07-14
25640,Kashif,1984-07-21,Kashif - Send Me Your Love,51,51,17,4.0,29,Send Me Your Love,29.0,0,12,22,0,1,up,1984-07-21
25641,Kashif,1984-07-28,Kashif - Send Me Your Love,29,51,13,4.0,17,Send Me Your Love,29.0,1,4,12,22,1,up,1984-07-21
25642,Kashif,1984-08-04,Kashif - Send Me Your Love,17,29,9,4.0,13,Send Me Your Love,29.0,2,4,4,12,1,up,1984-07-21
25643,Kashif,1984-08-11,Kashif - Send Me Your Love,13,17,5,4.0,9,Send Me Your Love,29.0,3,4,4,4,1,up,1984-07-21
25644,Kashif,1984-08-18,Kashif - Send Me Your Love,9,13,5,4.0,5,Send Me Your Love,29.0,4,0,4,4,0,stay,1984-07-21
25645,Kashif,1984-08-25,Kashif - Send Me Your Love,5,9,5,4.0,5,Send Me Your Love,29.0,5,0,0,4,0,stay,1984-07-21
25646,Kashif,1984-09-01,Kashif - Send Me Your Love,5,5,4,4.0,5,Send Me Your Love,29.0,6,1,0,0,1,up,1984-07-21
25647,Kashif,1984-09-08,Kashif - Send Me Your Love,5,5,4,4.0,4,Send Me Your Love,29.0,7,0,1,0,0,stay,1984-07-21
25648,Kashif,1984-09-15,Kashif - Send Me Your Love,4,5,7,4.0,4,Send Me Your Love,29.0,8,-3,0,1,1,down,1984-07-21
25649,Kashif,1984-09-22,Kashif - Send Me Your Love,4,4,5,4.0,7,Send Me Your Love,29.0,9,2,-3,0,1,up,1984-07-21
25650,Kashif,1984-09-29,Kashif - Send Me Your Love,7,4,5,4.0,5,Send Me Your Love,29.0,10,0,2,-3,0,stay,1984-07-21
25651,Kashif,1984-10-06,Kashif - Send Me Your Love,5,7,10,4.0,5,Send Me Your Love,29.0,11,-5,0,2,1,down,1984-07-21
25652,Kashif,1984-10-13,Kashif - Send Me Your Love,5,5,10,4.0,10,Send Me Your Love,29.0,12,0,-5,0,0,stay,1984-07-21
25653,Kashif,1984-10-20,Kashif - Send Me Your Love,10,5,9,4.0,10,Send Me Your Love,29.0,13,1,0,-5,1,up,1984-07-21
25654,Kashif,1984-10-27,Kashif - Send Me Your Love,10,10,11,4.0,9,Send Me Your Love,29.0,14,-2,1,0,1,down,1984-07-21
25655,Kashif,1984-11-03,Kashif - Send Me Your Love,9,10,19,4.0,11,Send Me Your Love,29.0,15,-8,-2,1,1,down,1984-07-21
25656,Kashif,1984-11-10,Kashif - Send Me Your Love,11,9,19,4.0,19,Send Me Your Love,29.0,16,0,-8,-2,0,stay,1984-07-21
25657,Kashif,1984-11-17,Kashif - Send Me Your Love,19,11,22,4.0,19,Send Me Your Love,29.0,17,-3,0,-8,1,down,1984-07-21
25658,Kashif,1984-11-24,Kashif - Send Me Your Love,19,19,24,4.0,22,Send Me Your Love,29.0,18,-2,-3,0,1,down,1984-07-21
25659,Kashif,1984-12-01,Kashif - Send Me Your Love,22,19,31,4.0,24,Send Me Your Love,29.0,19,-7,-2,-3,1,down,1984-07-21
25660,Kashif,1984-12-08,Kashif - Send Me Your Love,24,22,46,4.0,31,Send Me Your Love,29.0,20,-15,-7,-2,1,down,1984-07-21
25661,Kashif,1984-12-15,Kashif - Send Me Your Love,31,24,44,4.0,46,Send Me Your Love,29.0,21,2,-15,-7,1,up,1984-07-21
25662,Kashif,1984-12-22,Kashif - Send Me Your Love,46,31,44,4.0,44,Send Me Your Love,29.0,22,0,2,-15,0,stay,1984-07-21
25663,Kashif,1984-12-29,Kashif - Send Me Your Love,44,46,44,4.0,44,Send Me Your Love,29.0,23,0,0,2,0,stay,1984-07-21
25664,Kashif,1985-01-05,Kashif - Send Me Your Love,44,44,43,4.0,44,Send Me Your Love,29.0,24,1,0,0,1,up,1984-07-21
25665,Kashif,1985-01-12,Kashif - Send Me Your Love,44,44,43,4.0,43,Send Me Your Love,29.0,25,0,1,0,0,stay,1984-07-21
25666,Kashif,1985-01-19,Kashif - Send Me Your Love,43,44,46,4.0,43,Send Me Your Love,29.0,26,-3,0,1,1,down,1984-07-21
25667,Kashif,1985-01-26,Kashif - Send Me Your Love,43,43,46,4.0,46,Send Me Your Love,29.0,27,0,-3,0,0,stay,1984-07-21
25668,Kashif,1985-02-02,Kashif - Send Me Your Love,46,43,45,4.0,46,Send Me Your Love,29.0,28,1,0,-3,1,up,1984-07-21
25669,Kashif,1985-02-09,Kashif - Send Me Your Love,46,46,51,4.0,45,Send Me Your Love,29.0,29,-6,1,0,1,down,1984-07-21
25670,Soundtrack,1984-07-21,Soundtrack - Ghostbusters,51,51,24,8.0,32,Ghostbusters,14.0,0,8,19,0,1,up,1984-07-21
25671,Soundtrack,1984-07-28,Soundtrack - Ghostbusters,32,51,18,8.0,24,Ghostbusters,14.0,1,6,8,19,1,up,1984-07-21
25672,Soundtrack,1984-08-04,Soundtrack - Ghostbusters,24,32,12,8.0,18,Ghostbusters,14.0,2,6,6,8,1,up,1984-07-21
25673,Soundtrack,1984-08-11,Soundtrack - Ghostbusters,18,24,11,8.0,12,Ghostbusters,14.0,3,1,6,6,1,up,1984-07-21
25674,Soundtrack,1984-08-18,Soundtrack - Ghostbusters,12,18,10,8.0,11,Ghostbusters,14.0,4,1,1,6,1,up,1984-07-21
25675,Soundtrack,1984-08-25,Soundtrack - Ghostbusters,11,12,8,8.0,10,Ghostbusters,14.0,5,2,1,1,1,up,1984-07-21
25676,Soundtrack,1984-09-01,Soundtrack - Ghostbusters,10,11,8,8.0,8,Ghostbusters,14.0,6,0,2,1,0,stay,1984-07-21
25677,Soundtrack,1984-09-08,Soundtrack - Ghostbusters,8,10,8,8.0,8,Ghostbusters,14.0,7,0,0,2,0,stay,1984-07-21
25678,Soundtrack,1984-09-15,Soundtrack - Ghostbusters,8,8,15,8.0,8,Ghostbusters,14.0,8,-7,0,0,1,down,1984-07-21
25679,Soundtrack,1984-09-22,Soundtrack - Ghostbusters,8,8,15,8.0,15,Ghostbusters,14.0,9,0,-7,0,0,stay,1984-07-21
25680,Soundtrack,1984-09-29,Soundtrack - Ghostbusters,15,8,23,8.0,15,Ghostbusters,14.0,10,-8,0,-7,1,down,1984-07-21
25681,Soundtrack,1984-10-06,Soundtrack - Ghostbusters,15,15,31,8.0,23,Ghostbusters,14.0,11,-8,-8,0,1,down,1984-07-21
25682,Soundtrack,1984-10-13,Soundtrack - Ghostbusters,23,15,31,8.0,31,Ghostbusters,14.0,12,0,-8,-8,0,stay,1984-07-21
25683,Soundtrack,1984-10-20,Soundtrack - Ghostbusters,31,23,40,8.0,31,Ghostbusters,14.0,13,-9,0,-8,1,down,1984-07-21
25684,Soundtrack,1984-10-27,Soundtrack - Ghostbusters,31,31,51,8.0,40,Ghostbusters,14.0,14,-11,-9,0,1,down,1984-07-21
25685,Jacksons,1984-07-28,Jacksons - Victory,51,51,9,3.0,19,Victory,18.0,0,10,32,0,1,up,1984-07-28
25686,Jacksons,1984-08-04,Jacksons - Victory,19,51,3,3.0,9,Victory,18.0,1,6,10,32,1,up,1984-07-28
25687,Jacksons,1984-08-11,Jacksons - Victory,9,19,3,3.0,3,Victory,18.0,2,0,6,10,0,stay,1984-07-28
25688,Jacksons,1984-08-18,Jacksons - Victory,3,9,3,3.0,3,Victory,18.0,3,0,0,6,0,stay,1984-07-28
25689,Jacksons,1984-08-25,Jacksons - Victory,3,3,4,3.0,3,Victory,18.0,4,-1,0,0,1,down,1984-07-28
25690,Jacksons,1984-09-01,Jacksons - Victory,3,3,5,3.0,4,Victory,18.0,5,-1,-1,0,1,down,1984-07-28
25691,Jacksons,1984-09-08,Jacksons - Victory,4,3,6,3.0,5,Victory,18.0,6,-1,-1,-1,1,down,1984-07-28
25692,Jacksons,1984-09-15,Jacksons - Victory,5,4,6,3.0,6,Victory,18.0,7,0,-1,-1,0,stay,1984-07-28
25693,Jacksons,1984-09-22,Jacksons - Victory,6,5,11,3.0,6,Victory,18.0,8,-5,0,-1,1,down,1984-07-28
25694,Jacksons,1984-09-29,Jacksons - Victory,6,6,13,3.0,11,Victory,18.0,9,-2,-5,0,1,down,1984-07-28
25695,Jacksons,1984-10-06,Jacksons - Victory,11,6,19,3.0,13,Victory,18.0,10,-6,-2,-5,1,down,1984-07-28
25696,Jacksons,1984-10-13,Jacksons - Victory,13,11,18,3.0,19,Victory,18.0,11,1,-6,-2,1,up,1984-07-28
25697,Jacksons,1984-10-20,Jacksons - Victory,19,13,16,3.0,18,Victory,18.0,12,2,1,-6,1,up,1984-07-28
25698,Jacksons,1984-10-27,Jacksons - Victory,18,19,24,3.0,16,Victory,18.0,13,-8,2,1,1,down,1984-07-28
25699,Jacksons,1984-11-03,Jacksons - Victory,16,18,24,3.0,24,Victory,18.0,14,0,-8,2,0,stay,1984-07-28
25700,Jacksons,1984-11-10,Jacksons - Victory,24,16,27,3.0,24,Victory,18.0,15,-3,0,-8,1,down,1984-07-28
25701,Jacksons,1984-11-17,Jacksons - Victory,24,24,47,3.0,27,Victory,18.0,16,-20,-3,0,1,down,1984-07-28
25702,Jacksons,1984-12-08,Jacksons - Victory,27,24,47,3.0,47,Victory,18.0,17,0,-20,-3,0,stay,1984-07-28
25703,Jacksons,1984-12-15,Jacksons - Victory,47,27,51,3.0,47,Victory,18.0,18,-4,0,-20,1,down,1984-07-28
25704,Lakeside,1984-07-28,Lakeside - Outrageous,51,51,17,11.0,32,Outrageous,15.0,0,15,19,0,1,up,1984-07-28
25705,Lakeside,1984-08-04,Lakeside - Outrageous,32,51,13,11.0,17,Outrageous,15.0,1,4,15,19,1,up,1984-07-28
25706,Lakeside,1984-08-11,Lakeside - Outrageous,17,32,12,11.0,13,Outrageous,15.0,2,1,4,15,1,up,1984-07-28
25707,Lakeside,1984-08-18,Lakeside - Outrageous,13,17,11,11.0,12,Outrageous,15.0,3,1,1,4,1,up,1984-07-28
25708,Lakeside,1984-08-25,Lakeside - Outrageous,12,13,11,11.0,11,Outrageous,15.0,4,0,1,1,0,stay,1984-07-28
25709,Lakeside,1984-09-01,Lakeside - Outrageous,11,12,23,11.0,11,Outrageous,15.0,5,-12,0,1,1,down,1984-07-28
25710,Lakeside,1984-09-08,Lakeside - Outrageous,11,11,25,11.0,23,Outrageous,15.0,6,-2,-12,0,1,down,1984-07-28
25711,Lakeside,1984-09-15,Lakeside - Outrageous,23,11,28,11.0,25,Outrageous,15.0,7,-3,-2,-12,1,down,1984-07-28
25712,Lakeside,1984-09-22,Lakeside - Outrageous,25,23,28,11.0,28,Outrageous,15.0,8,0,-3,-2,0,stay,1984-07-28
25713,Lakeside,1984-09-29,Lakeside - Outrageous,28,25,33,11.0,28,Outrageous,15.0,9,-5,0,-3,1,down,1984-07-28
25714,Lakeside,1984-10-06,Lakeside - Outrageous,28,28,33,11.0,33,Outrageous,15.0,10,0,-5,0,0,stay,1984-07-28
25715,Lakeside,1984-10-13,Lakeside - Outrageous,33,28,32,11.0,33,Outrageous,15.0,11,1,0,-5,1,up,1984-07-28
25716,Lakeside,1984-10-20,Lakeside - Outrageous,33,33,41,11.0,32,Outrageous,15.0,12,-9,1,0,1,down,1984-07-28
25717,Lakeside,1984-10-27,Lakeside - Outrageous,32,33,41,11.0,41,Outrageous,15.0,13,0,-9,1,0,stay,1984-07-28
25718,Lakeside,1984-11-03,Lakeside - Outrageous,41,32,48,11.0,41,Outrageous,15.0,14,-7,0,-9,1,down,1984-07-28
25719,Lakeside,1984-11-10,Lakeside - Outrageous,41,41,51,11.0,48,Outrageous,15.0,15,-3,-7,0,1,down,1984-07-28
25720,The Time,1984-08-04,The Time - Ice Cream Castle,51,51,16,3.0,24,Ice Cream Castle,38.0,0,8,27,0,1,up,1984-08-04
25721,The Time,1984-08-11,The Time - Ice Cream Castle,24,51,9,3.0,16,Ice Cream Castle,38.0,1,7,8,27,1,up,1984-08-04
25722,The Time,1984-08-18,The Time - Ice Cream Castle,16,24,7,3.0,9,Ice Cream Castle,38.0,2,2,7,8,1,up,1984-08-04
25723,The Time,1984-08-25,The Time - Ice Cream Castle,9,16,3,3.0,7,Ice Cream Castle,38.0,3,4,2,7,1,up,1984-08-04
25724,The Time,1984-09-01,The Time - Ice Cream Castle,7,9,3,3.0,3,Ice Cream Castle,38.0,4,0,4,2,0,stay,1984-08-04
25725,The Time,1984-09-08,The Time - Ice Cream Castle,3,7,3,3.0,3,Ice Cream Castle,38.0,5,0,0,4,0,stay,1984-08-04
25726,The Time,1984-09-15,The Time - Ice Cream Castle,3,3,3,3.0,3,Ice Cream Castle,38.0,6,0,0,0,0,stay,1984-08-04
25727,The Time,1984-09-22,The Time - Ice Cream Castle,3,3,3,3.0,3,Ice Cream Castle,38.0,7,0,0,0,0,stay,1984-08-04
25728,The Time,1984-09-29,The Time - Ice Cream Castle,3,3,3,3.0,3,Ice Cream Castle,38.0,8,0,0,0,0,stay,1984-08-04
25729,The Time,1984-10-06,The Time - Ice Cream Castle,3,3,4,3.0,3,Ice Cream Castle,38.0,9,-1,0,0,1,down,1984-08-04
25730,The Time,1984-10-13,The Time - Ice Cream Castle,3,3,6,3.0,4,Ice Cream Castle,38.0,10,-2,-1,0,1,down,1984-08-04
25731,The Time,1984-10-20,The Time - Ice Cream Castle,4,3,5,3.0,6,Ice Cream Castle,38.0,11,1,-2,-1,1,up,1984-08-04
25732,The Time,1984-10-27,The Time - Ice Cream Castle,6,4,5,3.0,5,Ice Cream Castle,38.0,12,0,1,-2,0,stay,1984-08-04
25733,The Time,1984-11-03,The Time - Ice Cream Castle,5,6,5,3.0,5,Ice Cream Castle,38.0,13,0,0,1,0,stay,1984-08-04
25734,The Time,1984-11-10,The Time - Ice Cream Castle,5,5,5,3.0,5,Ice Cream Castle,38.0,14,0,0,0,0,stay,1984-08-04
25735,The Time,1984-11-17,The Time - Ice Cream Castle,5,5,8,3.0,5,Ice Cream Castle,38.0,15,-3,0,0,1,down,1984-08-04
25736,The Time,1984-11-24,The Time - Ice Cream Castle,5,5,10,3.0,8,Ice Cream Castle,38.0,16,-2,-3,0,1,down,1984-08-04
25737,The Time,1984-12-01,The Time - Ice Cream Castle,8,5,11,3.0,10,Ice Cream Castle,38.0,17,-1,-2,-3,1,down,1984-08-04
25738,The Time,1984-12-08,The Time - Ice Cream Castle,10,8,11,3.0,11,Ice Cream Castle,38.0,18,0,-1,-2,0,stay,1984-08-04
25739,The Time,1984-12-15,The Time - Ice Cream Castle,11,10,13,3.0,11,Ice Cream Castle,38.0,19,-2,0,-1,1,down,1984-08-04
25740,The Time,1984-12-22,The Time - Ice Cream Castle,11,11,13,3.0,13,Ice Cream Castle,38.0,20,0,-2,0,0,stay,1984-08-04
25741,The Time,1984-12-29,The Time - Ice Cream Castle,13,11,15,3.0,13,Ice Cream Castle,38.0,21,-2,0,-2,1,down,1984-08-04
25742,The Time,1985-01-05,The Time - Ice Cream Castle,13,13,17,3.0,15,Ice Cream Castle,38.0,22,-2,-2,0,1,down,1984-08-04
25743,The Time,1985-01-12,The Time - Ice Cream Castle,15,13,17,3.0,17,Ice Cream Castle,38.0,23,0,-2,-2,0,stay,1984-08-04
25744,The Time,1985-01-19,The Time - Ice Cream Castle,17,15,22,3.0,17,Ice Cream Castle,38.0,24,-5,0,-2,1,down,1984-08-04
25745,The Time,1985-01-26,The Time - Ice Cream Castle,17,17,20,3.0,22,Ice Cream Castle,38.0,25,2,-5,0,1,up,1984-08-04
25746,The Time,1985-02-02,The Time - Ice Cream Castle,22,17,20,3.0,20,Ice Cream Castle,38.0,26,0,2,-5,0,stay,1984-08-04
25747,The Time,1985-02-09,The Time - Ice Cream Castle,20,22,19,3.0,20,Ice Cream Castle,38.0,27,1,0,2,1,up,1984-08-04
25748,The Time,1985-02-16,The Time - Ice Cream Castle,20,20,23,3.0,19,Ice Cream Castle,38.0,28,-4,1,0,1,down,1984-08-04
25749,The Time,1985-02-23,The Time - Ice Cream Castle,19,20,35,3.0,23,Ice Cream Castle,38.0,29,-12,-4,1,1,down,1984-08-04
25750,The Time,1985-03-02,The Time - Ice Cream Castle,23,19,30,3.0,35,Ice Cream Castle,38.0,30,5,-12,-4,1,up,1984-08-04
25751,The Time,1985-03-09,The Time - Ice Cream Castle,35,23,30,3.0,30,Ice Cream Castle,38.0,31,0,5,-12,0,stay,1984-08-04
25752,The Time,1985-03-16,The Time - Ice Cream Castle,30,35,28,3.0,30,Ice Cream Castle,38.0,32,2,0,5,1,up,1984-08-04
25753,The Time,1985-03-23,The Time - Ice Cream Castle,30,30,33,3.0,28,Ice Cream Castle,38.0,33,-5,2,0,1,down,1984-08-04
25754,The Time,1985-03-30,The Time - Ice Cream Castle,28,30,32,3.0,33,Ice Cream Castle,38.0,34,1,-5,2,1,up,1984-08-04
25755,The Time,1985-04-06,The Time - Ice Cream Castle,33,28,40,3.0,32,Ice Cream Castle,38.0,35,-8,1,-5,1,down,1984-08-04
25756,The Time,1985-04-13,The Time - Ice Cream Castle,32,33,46,3.0,40,Ice Cream Castle,38.0,36,-6,-8,1,1,down,1984-08-04
25757,The Time,1985-04-20,The Time - Ice Cream Castle,40,32,44,3.0,46,Ice Cream Castle,38.0,37,2,-6,-8,1,up,1984-08-04
25758,The Time,1985-04-27,The Time - Ice Cream Castle,46,40,51,3.0,44,Ice Cream Castle,38.0,38,-7,2,-6,1,down,1984-08-04
25759,Brass Construction,1984-08-04,Brass Construction - Renegades,51,51,42,31.0,45,Renegades,14.0,0,3,6,0,1,up,1984-08-04
25760,Brass Construction,1984-08-11,Brass Construction - Renegades,45,51,42,31.0,42,Renegades,14.0,1,0,3,6,0,stay,1984-08-04
25761,Brass Construction,1984-08-18,Brass Construction - Renegades,42,45,40,31.0,42,Renegades,14.0,2,2,0,3,1,up,1984-08-04
25762,Brass Construction,1984-08-25,Brass Construction - Renegades,42,42,38,31.0,40,Renegades,14.0,3,2,2,0,1,up,1984-08-04
25763,Brass Construction,1984-09-01,Brass Construction - Renegades,40,42,35,31.0,38,Renegades,14.0,4,3,2,2,1,up,1984-08-04
25764,Brass Construction,1984-09-08,Brass Construction - Renegades,38,40,35,31.0,35,Renegades,14.0,5,0,3,2,0,stay,1984-08-04
25765,Brass Construction,1984-09-15,Brass Construction - Renegades,35,38,31,31.0,35,Renegades,14.0,6,4,0,3,1,up,1984-08-04
25766,Brass Construction,1984-09-22,Brass Construction - Renegades,35,35,31,31.0,31,Renegades,14.0,7,0,4,0,0,stay,1984-08-04
25767,Brass Construction,1984-09-29,Brass Construction - Renegades,31,35,37,31.0,31,Renegades,14.0,8,-6,0,4,1,down,1984-08-04
25768,Brass Construction,1984-10-06,Brass Construction - Renegades,31,31,36,31.0,37,Renegades,14.0,9,1,-6,0,1,up,1984-08-04
25769,Brass Construction,1984-10-13,Brass Construction - Renegades,37,31,35,31.0,36,Renegades,14.0,10,1,1,-6,1,up,1984-08-04
25770,Brass Construction,1984-10-20,Brass Construction - Renegades,36,37,44,31.0,35,Renegades,14.0,11,-9,1,1,1,down,1984-08-04
25771,Brass Construction,1984-10-27,Brass Construction - Renegades,35,36,44,31.0,44,Renegades,14.0,12,0,-9,1,0,stay,1984-08-04
25772,Brass Construction,1984-11-03,Brass Construction - Renegades,44,35,42,31.0,44,Renegades,14.0,13,2,0,-9,1,up,1984-08-04
25773,Brass Construction,1984-11-10,Brass Construction - Renegades,44,44,51,31.0,42,Renegades,14.0,14,-9,2,0,1,down,1984-08-04
25774,Tyzik,1984-08-04,Tyzik - Jammin' In Manhattan,51,51,48,35.0,49,Jammin' In Manhattan,7.0,0,1,2,0,1,up,1984-08-04
25775,Tyzik,1984-08-11,Tyzik - Jammin' In Manhattan,49,51,40,35.0,48,Jammin' In Manhattan,7.0,1,8,1,2,1,up,1984-08-04
25776,Tyzik,1984-08-18,Tyzik - Jammin' In Manhattan,48,49,35,35.0,40,Jammin' In Manhattan,7.0,2,5,8,1,1,up,1984-08-04
25777,Tyzik,1984-08-25,Tyzik - Jammin' In Manhattan,40,48,35,35.0,35,Jammin' In Manhattan,7.0,3,0,5,8,0,stay,1984-08-04
25778,Tyzik,1984-09-01,Tyzik - Jammin' In Manhattan,35,40,37,35.0,35,Jammin' In Manhattan,7.0,4,-2,0,5,1,down,1984-08-04
25779,Tyzik,1984-09-08,Tyzik - Jammin' In Manhattan,35,35,36,35.0,37,Jammin' In Manhattan,7.0,5,1,-2,0,1,up,1984-08-04
25780,Tyzik,1984-09-15,Tyzik - Jammin' In Manhattan,37,35,40,35.0,36,Jammin' In Manhattan,7.0,6,-4,1,-2,1,down,1984-08-04
25781,Tyzik,1984-09-22,Tyzik - Jammin' In Manhattan,36,37,51,35.0,40,Jammin' In Manhattan,7.0,7,-11,-4,1,1,down,1984-08-04
25782,Billy Ocean,1984-08-11,Billy Ocean - Suddenly,51,51,30,3.0,37,Suddenly,66.0,0,7,14,0,1,up,1984-08-11
25783,Billy Ocean,1984-08-18,Billy Ocean - Suddenly,37,51,20,3.0,30,Suddenly,66.0,1,10,7,14,1,up,1984-08-11
25784,Billy Ocean,1984-08-25,Billy Ocean - Suddenly,30,37,16,3.0,20,Suddenly,66.0,2,4,10,7,1,up,1984-08-11
25785,Billy Ocean,1984-09-01,Billy Ocean - Suddenly,20,30,11,3.0,16,Suddenly,66.0,3,5,4,10,1,up,1984-08-11
25786,Billy Ocean,1984-09-08,Billy Ocean - Suddenly,16,20,7,3.0,11,Suddenly,66.0,4,4,5,4,1,up,1984-08-11
25787,Billy Ocean,1984-09-15,Billy Ocean - Suddenly,11,16,4,3.0,7,Suddenly,66.0,5,3,4,5,1,up,1984-08-11
25788,Billy Ocean,1984-09-22,Billy Ocean - Suddenly,7,11,4,3.0,4,Suddenly,66.0,6,0,3,4,0,stay,1984-08-11
25789,Billy Ocean,1984-09-29,Billy Ocean - Suddenly,4,7,4,3.0,4,Suddenly,66.0,7,0,0,3,0,stay,1984-08-11
25790,Billy Ocean,1984-10-06,Billy Ocean - Suddenly,4,4,3,3.0,4,Suddenly,66.0,8,1,0,0,1,up,1984-08-11
25791,Billy Ocean,1984-10-13,Billy Ocean - Suddenly,4,4,3,3.0,3,Suddenly,66.0,9,0,1,0,0,stay,1984-08-11
25792,Billy Ocean,1984-10-20,Billy Ocean - Suddenly,3,4,4,3.0,3,Suddenly,66.0,10,-1,0,1,1,down,1984-08-11
25793,Billy Ocean,1984-10-27,Billy Ocean - Suddenly,3,3,4,3.0,4,Suddenly,66.0,11,0,-1,0,0,stay,1984-08-11
25794,Billy Ocean,1984-11-03,Billy Ocean - Suddenly,4,3,4,3.0,4,Suddenly,66.0,12,0,0,-1,0,stay,1984-08-11
25795,Billy Ocean,1984-11-10,Billy Ocean - Suddenly,4,4,4,3.0,4,Suddenly,66.0,13,0,0,0,0,stay,1984-08-11
25796,Billy Ocean,1984-11-17,Billy Ocean - Suddenly,4,4,6,3.0,4,Suddenly,66.0,14,-2,0,0,1,down,1984-08-11
25797,Billy Ocean,1984-11-24,Billy Ocean - Suddenly,4,4,6,3.0,6,Suddenly,66.0,15,0,-2,0,0,stay,1984-08-11
25798,Billy Ocean,1984-12-01,Billy Ocean - Suddenly,6,4,8,3.0,6,Suddenly,66.0,16,-2,0,-2,1,down,1984-08-11
25799,Billy Ocean,1984-12-08,Billy Ocean - Suddenly,6,6,8,3.0,8,Suddenly,66.0,17,0,-2,0,0,stay,1984-08-11
25800,Billy Ocean,1984-12-15,Billy Ocean - Suddenly,8,6,9,3.0,8,Suddenly,66.0,18,-1,0,-2,1,down,1984-08-11
25801,Billy Ocean,1984-12-22,Billy Ocean - Suddenly,8,8,9,3.0,9,Suddenly,66.0,19,0,-1,0,0,stay,1984-08-11
25802,Billy Ocean,1984-12-29,Billy Ocean - Suddenly,9,8,19,3.0,9,Suddenly,66.0,20,-10,0,-1,1,down,1984-08-11
25803,Billy Ocean,1985-01-05,Billy Ocean - Suddenly,9,9,19,3.0,19,Suddenly,66.0,21,0,-10,0,0,stay,1984-08-11
25804,Billy Ocean,1985-01-12,Billy Ocean - Suddenly,19,9,18,3.0,19,Suddenly,66.0,22,1,0,-10,1,up,1984-08-11
25805,Billy Ocean,1985-01-19,Billy Ocean - Suddenly,19,19,18,3.0,18,Suddenly,66.0,23,0,1,0,0,stay,1984-08-11
25806,Billy Ocean,1985-01-26,Billy Ocean - Suddenly,18,19,18,3.0,18,Suddenly,66.0,24,0,0,1,0,stay,1984-08-11
25807,Billy Ocean,1985-02-02,Billy Ocean - Suddenly,18,18,22,3.0,18,Suddenly,66.0,25,-4,0,0,1,down,1984-08-11
25808,Billy Ocean,1985-02-09,Billy Ocean - Suddenly,18,18,22,3.0,22,Suddenly,66.0,26,0,-4,0,0,stay,1984-08-11
25809,Billy Ocean,1985-02-16,Billy Ocean - Suddenly,22,18,21,3.0,22,Suddenly,66.0,27,1,0,-4,1,up,1984-08-11
25810,Billy Ocean,1985-02-23,Billy Ocean - Suddenly,22,22,21,3.0,21,Suddenly,66.0,28,0,1,0,0,stay,1984-08-11
25811,Billy Ocean,1985-03-02,Billy Ocean - Suddenly,21,22,18,3.0,21,Suddenly,66.0,29,3,0,1,1,up,1984-08-11
25812,Billy Ocean,1985-03-09,Billy Ocean - Suddenly,21,21,18,3.0,18,Suddenly,66.0,30,0,3,0,0,stay,1984-08-11
25813,Billy Ocean,1985-03-16,Billy Ocean - Suddenly,18,21,24,3.0,18,Suddenly,66.0,31,-6,0,3,1,down,1984-08-11
25814,Billy Ocean,1985-03-23,Billy Ocean - Suddenly,18,18,24,3.0,24,Suddenly,66.0,32,0,-6,0,0,stay,1984-08-11
25815,Billy Ocean,1985-03-30,Billy Ocean - Suddenly,24,18,27,3.0,24,Suddenly,66.0,33,-3,0,-6,1,down,1984-08-11
25816,Billy Ocean,1985-04-06,Billy Ocean - Suddenly,24,24,27,3.0,27,Suddenly,66.0,34,0,-3,0,0,stay,1984-08-11
25817,Billy Ocean,1985-04-13,Billy Ocean - Suddenly,27,24,27,3.0,27,Suddenly,66.0,35,0,0,-3,0,stay,1984-08-11
25818,Billy Ocean,1985-04-20,Billy Ocean - Suddenly,27,27,27,3.0,27,Suddenly,66.0,36,0,0,0,0,stay,1984-08-11
25819,Billy Ocean,1985-04-27,Billy Ocean - Suddenly,27,27,26,3.0,27,Suddenly,66.0,37,1,0,0,1,up,1984-08-11
25820,Billy Ocean,1985-05-04,Billy Ocean - Suddenly,27,27,22,3.0,26,Suddenly,66.0,38,4,1,0,1,up,1984-08-11
25821,Billy Ocean,1985-05-11,Billy Ocean - Suddenly,26,27,17,3.0,22,Suddenly,66.0,39,5,4,1,1,up,1984-08-11
25822,Billy Ocean,1985-05-18,Billy Ocean - Suddenly,22,26,17,3.0,17,Suddenly,66.0,40,0,5,4,0,stay,1984-08-11
25823,Billy Ocean,1985-05-25,Billy Ocean - Suddenly,17,22,14,3.0,17,Suddenly,66.0,41,3,0,5,1,up,1984-08-11
25824,Billy Ocean,1985-06-01,Billy Ocean - Suddenly,17,17,12,3.0,14,Suddenly,66.0,42,2,3,0,1,up,1984-08-11
25825,Billy Ocean,1985-06-08,Billy Ocean - Suddenly,14,17,12,3.0,12,Suddenly,66.0,43,0,2,3,0,stay,1984-08-11
25826,Billy Ocean,1985-06-15,Billy Ocean - Suddenly,12,14,9,3.0,12,Suddenly,66.0,44,3,0,2,1,up,1984-08-11
25827,Billy Ocean,1985-06-22,Billy Ocean - Suddenly,12,12,11,3.0,9,Suddenly,66.0,45,-2,3,0,1,down,1984-08-11
25828,Billy Ocean,1985-06-29,Billy Ocean - Suddenly,9,12,12,3.0,11,Suddenly,66.0,46,-1,-2,3,1,down,1984-08-11
25829,Billy Ocean,1985-07-06,Billy Ocean - Suddenly,11,9,16,3.0,12,Suddenly,66.0,47,-4,-1,-2,1,down,1984-08-11
25830,Billy Ocean,1985-07-13,Billy Ocean - Suddenly,12,11,15,3.0,16,Suddenly,66.0,48,1,-4,-1,1,up,1984-08-11
25831,Billy Ocean,1985-07-20,Billy Ocean - Suddenly,16,12,15,3.0,15,Suddenly,66.0,49,0,1,-4,0,stay,1984-08-11
25832,Billy Ocean,1985-07-27,Billy Ocean - Suddenly,15,16,18,3.0,15,Suddenly,66.0,50,-3,0,1,1,down,1984-08-11
25833,Billy Ocean,1985-08-03,Billy Ocean - Suddenly,15,15,18,3.0,18,Suddenly,66.0,51,0,-3,0,0,stay,1984-08-11
25834,Billy Ocean,1985-08-10,Billy Ocean - Suddenly,18,15,17,3.0,18,Suddenly,66.0,52,1,0,-3,1,up,1984-08-11
25835,Billy Ocean,1985-08-17,Billy Ocean - Suddenly,18,18,18,3.0,17,Suddenly,66.0,53,-1,1,0,1,down,1984-08-11
25836,Billy Ocean,1985-08-24,Billy Ocean - Suddenly,17,18,16,3.0,18,Suddenly,66.0,54,2,-1,1,1,up,1984-08-11
25837,Billy Ocean,1985-08-31,Billy Ocean - Suddenly,18,17,15,3.0,16,Suddenly,66.0,55,1,2,-1,1,up,1984-08-11
25838,Billy Ocean,1985-09-07,Billy Ocean - Suddenly,16,18,14,3.0,15,Suddenly,66.0,56,1,1,2,1,up,1984-08-11
25839,Billy Ocean,1985-09-14,Billy Ocean - Suddenly,15,16,18,3.0,14,Suddenly,66.0,57,-4,1,1,1,down,1984-08-11
25840,Billy Ocean,1985-09-21,Billy Ocean - Suddenly,14,15,21,3.0,18,Suddenly,66.0,58,-3,-4,1,1,down,1984-08-11
25841,Billy Ocean,1985-09-28,Billy Ocean - Suddenly,18,14,23,3.0,21,Suddenly,66.0,59,-2,-3,-4,1,down,1984-08-11
25842,Billy Ocean,1985-10-05,Billy Ocean - Suddenly,21,18,31,3.0,23,Suddenly,66.0,60,-8,-2,-3,1,down,1984-08-11
25843,Billy Ocean,1985-10-12,Billy Ocean - Suddenly,23,21,31,3.0,31,Suddenly,66.0,61,0,-8,-2,0,stay,1984-08-11
25844,Billy Ocean,1985-10-19,Billy Ocean - Suddenly,31,23,34,3.0,31,Suddenly,66.0,62,-3,0,-8,1,down,1984-08-11
25845,Billy Ocean,1985-10-26,Billy Ocean - Suddenly,31,31,46,3.0,34,Suddenly,66.0,63,-12,-3,0,1,down,1984-08-11
25846,Billy Ocean,1985-11-02,Billy Ocean - Suddenly,34,31,46,3.0,46,Suddenly,66.0,64,0,-12,-3,0,stay,1984-08-11
25847,Billy Ocean,1985-11-09,Billy Ocean - Suddenly,46,34,47,3.0,46,Suddenly,66.0,65,-1,0,-12,1,down,1984-08-11
25848,Billy Ocean,1985-11-16,Billy Ocean - Suddenly,46,46,51,3.0,47,Suddenly,66.0,66,-4,-1,0,1,down,1984-08-11
25849,The Brothers Johnson,1984-08-11,The Brothers Johnson - Out Of Control,51,51,27,20.0,38,Out Of Control,11.0,0,11,13,0,1,up,1984-08-11
25850,The Brothers Johnson,1984-08-18,The Brothers Johnson - Out Of Control,38,51,24,20.0,27,Out Of Control,11.0,1,3,11,13,1,up,1984-08-11
25851,The Brothers Johnson,1984-08-25,The Brothers Johnson - Out Of Control,27,38,20,20.0,24,Out Of Control,11.0,2,4,3,11,1,up,1984-08-11
25852,The Brothers Johnson,1984-09-01,The Brothers Johnson - Out Of Control,24,27,20,20.0,20,Out Of Control,11.0,3,0,4,3,0,stay,1984-08-11
25853,The Brothers Johnson,1984-09-08,The Brothers Johnson - Out Of Control,20,24,20,20.0,20,Out Of Control,11.0,4,0,0,4,0,stay,1984-08-11
25854,The Brothers Johnson,1984-09-15,The Brothers Johnson - Out Of Control,20,20,26,20.0,20,Out Of Control,11.0,5,-6,0,0,1,down,1984-08-11
25855,The Brothers Johnson,1984-09-22,The Brothers Johnson - Out Of Control,20,20,29,20.0,26,Out Of Control,11.0,6,-3,-6,0,1,down,1984-08-11
25856,The Brothers Johnson,1984-09-29,The Brothers Johnson - Out Of Control,26,20,29,20.0,29,Out Of Control,11.0,7,0,-3,-6,0,stay,1984-08-11
25857,The Brothers Johnson,1984-10-06,The Brothers Johnson - Out Of Control,29,26,34,20.0,29,Out Of Control,11.0,8,-5,0,-3,1,down,1984-08-11
25858,The Brothers Johnson,1984-10-13,The Brothers Johnson - Out Of Control,29,29,38,20.0,34,Out Of Control,11.0,9,-4,-5,0,1,down,1984-08-11
25859,The Brothers Johnson,1984-10-20,The Brothers Johnson - Out Of Control,34,29,47,20.0,38,Out Of Control,11.0,10,-9,-4,-5,1,down,1984-08-11
25860,The Brothers Johnson,1984-10-27,The Brothers Johnson - Out Of Control,38,34,51,20.0,47,Out Of Control,11.0,11,-4,-9,-4,1,down,1984-08-11
25861,Spyro Gyra,1984-08-11,Spyro Gyra - Access All Areas,51,51,45,41.0,49,Access All Areas,5.0,0,4,2,0,1,up,1984-08-11
25862,Spyro Gyra,1984-08-18,Spyro Gyra - Access All Areas,49,51,41,41.0,45,Access All Areas,5.0,1,4,4,2,1,up,1984-08-11
25863,Spyro Gyra,1984-08-25,Spyro Gyra - Access All Areas,45,49,41,41.0,41,Access All Areas,5.0,2,0,4,4,0,stay,1984-08-11
25864,Spyro Gyra,1984-09-01,Spyro Gyra - Access All Areas,41,45,49,41.0,41,Access All Areas,5.0,3,-8,0,4,1,down,1984-08-11
25865,Spyro Gyra,1984-09-08,Spyro Gyra - Access All Areas,41,41,49,41.0,49,Access All Areas,5.0,4,0,-8,0,0,stay,1984-08-11
25866,Spyro Gyra,1984-09-15,Spyro Gyra - Access All Areas,49,41,51,41.0,49,Access All Areas,5.0,5,-2,0,-8,1,down,1984-08-11
25867,The Valentine Brothers,1984-08-25,The Valentine Brothers - Have A Good Time,51,51,43,40.0,46,Have A Good Time,5.0,0,3,5,0,1,up,1984-08-25
25868,The Valentine Brothers,1984-09-01,The Valentine Brothers - Have A Good Time,46,51,40,40.0,43,Have A Good Time,5.0,1,3,3,5,1,up,1984-08-25
25869,The Valentine Brothers,1984-09-08,The Valentine Brothers - Have A Good Time,43,46,40,40.0,40,Have A Good Time,5.0,2,0,3,3,0,stay,1984-08-25
25870,The Valentine Brothers,1984-09-15,The Valentine Brothers - Have A Good Time,40,43,50,40.0,40,Have A Good Time,5.0,3,-10,0,3,1,down,1984-08-25
25871,The Valentine Brothers,1984-10-06,The Valentine Brothers - Have A Good Time,40,40,50,40.0,50,Have A Good Time,5.0,4,0,-10,0,0,stay,1984-08-25
25872,The Valentine Brothers,1984-10-13,The Valentine Brothers - Have A Good Time,50,40,51,40.0,50,Have A Good Time,5.0,5,-1,0,-10,1,down,1984-08-25
25873,Lillo,1984-09-01,Lillo - All Of You,51,51,24,9.0,31,All Of You,23.0,0,7,20,0,1,up,1984-09-01
25874,Lillo,1984-09-08,Lillo - All Of You,31,51,21,9.0,24,All Of You,23.0,1,3,7,20,1,up,1984-09-01
25875,Lillo,1984-09-15,Lillo - All Of You,24,31,18,9.0,21,All Of You,23.0,2,3,3,7,1,up,1984-09-01
25876,Lillo,1984-09-22,Lillo - All Of You,21,24,14,9.0,18,All Of You,23.0,3,4,3,3,1,up,1984-09-01
25877,Lillo,1984-09-29,Lillo - All Of You,18,21,9,9.0,14,All Of You,23.0,4,5,4,3,1,up,1984-09-01
25878,Lillo,1984-10-06,Lillo - All Of You,14,18,9,9.0,9,All Of You,23.0,5,0,5,4,0,stay,1984-09-01
25879,Lillo,1984-10-13,Lillo - All Of You,9,14,9,9.0,9,All Of You,23.0,6,0,0,5,0,stay,1984-09-01
25880,Lillo,1984-10-20,Lillo - All Of You,9,9,11,9.0,9,All Of You,23.0,7,-2,0,0,1,down,1984-09-01
25881,Lillo,1984-10-27,Lillo - All Of You,9,9,16,9.0,11,All Of You,23.0,8,-5,-2,0,1,down,1984-09-01
25882,Lillo,1984-11-03,Lillo - All Of You,11,9,16,9.0,16,All Of You,23.0,9,0,-5,-2,0,stay,1984-09-01
25883,Lillo,1984-11-10,Lillo - All Of You,16,11,16,9.0,16,All Of You,23.0,10,0,0,-5,0,stay,1984-09-01
25884,Lillo,1984-11-17,Lillo - All Of You,16,16,16,9.0,16,All Of You,23.0,11,0,0,0,0,stay,1984-09-01
25885,Lillo,1984-11-24,Lillo - All Of You,16,16,17,9.0,16,All Of You,23.0,12,-1,0,0,1,down,1984-09-01
25886,Lillo,1984-12-01,Lillo - All Of You,16,16,17,9.0,17,All Of You,23.0,13,0,-1,0,0,stay,1984-09-01
25887,Lillo,1984-12-08,Lillo - All Of You,17,16,17,9.0,17,All Of You,23.0,14,0,0,-1,0,stay,1984-09-01
25888,Lillo,1984-12-15,Lillo - All Of You,17,17,22,9.0,17,All Of You,23.0,15,-5,0,0,1,down,1984-09-01
25889,Lillo,1984-12-22,Lillo - All Of You,17,17,22,9.0,22,All Of You,23.0,16,0,-5,0,0,stay,1984-09-01
25890,Lillo,1984-12-29,Lillo - All Of You,22,17,23,9.0,22,All Of You,23.0,17,-1,0,-5,1,down,1984-09-01
25891,Lillo,1985-01-05,Lillo - All Of You,22,22,37,9.0,23,All Of You,23.0,18,-14,-1,0,1,down,1984-09-01
25892,Lillo,1985-01-12,Lillo - All Of You,23,22,40,9.0,37,All Of You,23.0,19,-3,-14,-1,1,down,1984-09-01
25893,Lillo,1985-01-19,Lillo - All Of You,37,23,40,9.0,40,All Of You,23.0,20,0,-3,-14,0,stay,1984-09-01
25894,Lillo,1985-01-26,Lillo - All Of You,40,37,41,9.0,40,All Of You,23.0,21,-1,0,-3,1,down,1984-09-01
25895,Lillo,1985-02-02,Lillo - All Of You,40,40,40,9.0,41,All Of You,23.0,22,1,-1,0,1,up,1984-09-01
25896,Lillo,1985-02-09,Lillo - All Of You,41,40,51,9.0,40,All Of You,23.0,23,-11,1,-1,1,down,1984-09-01
25897,Mtume,1984-09-01,"Mtume - You, Me And He",51,51,19,5.0,37,"You, Me And He",25.0,0,18,14,0,1,up,1984-09-01
25898,Mtume,1984-09-08,"Mtume - You, Me And He",37,51,17,5.0,19,"You, Me And He",25.0,1,2,18,14,1,up,1984-09-01
25899,Mtume,1984-09-15,"Mtume - You, Me And He",19,37,10,5.0,17,"You, Me And He",25.0,2,7,2,18,1,up,1984-09-01
25900,Mtume,1984-09-22,"Mtume - You, Me And He",17,19,8,5.0,10,"You, Me And He",25.0,3,2,7,2,1,up,1984-09-01
25901,Mtume,1984-09-29,"Mtume - You, Me And He",10,17,7,5.0,8,"You, Me And He",25.0,4,1,2,7,1,up,1984-09-01
25902,Mtume,1984-10-06,"Mtume - You, Me And He",8,10,5,5.0,7,"You, Me And He",25.0,5,2,1,2,1,up,1984-09-01
25903,Mtume,1984-10-13,"Mtume - You, Me And He",7,8,5,5.0,5,"You, Me And He",25.0,6,0,2,1,0,stay,1984-09-01
25904,Mtume,1984-10-20,"Mtume - You, Me And He",5,7,7,5.0,5,"You, Me And He",25.0,7,-2,0,2,1,down,1984-09-01
25905,Mtume,1984-10-27,"Mtume - You, Me And He",5,5,8,5.0,7,"You, Me And He",25.0,8,-1,-2,0,1,down,1984-09-01
25906,Mtume,1984-11-03,"Mtume - You, Me And He",7,5,15,5.0,8,"You, Me And He",25.0,9,-7,-1,-2,1,down,1984-09-01
25907,Mtume,1984-11-10,"Mtume - You, Me And He",8,7,15,5.0,15,"You, Me And He",25.0,10,0,-7,-1,0,stay,1984-09-01
25908,Mtume,1984-11-17,"Mtume - You, Me And He",15,8,15,5.0,15,"You, Me And He",25.0,11,0,0,-7,0,stay,1984-09-01
25909,Mtume,1984-11-24,"Mtume - You, Me And He",15,15,16,5.0,15,"You, Me And He",25.0,12,-1,0,0,1,down,1984-09-01
25910,Mtume,1984-12-01,"Mtume - You, Me And He",15,15,19,5.0,16,"You, Me And He",25.0,13,-3,-1,0,1,down,1984-09-01
25911,Mtume,1984-12-08,"Mtume - You, Me And He",16,15,23,5.0,19,"You, Me And He",25.0,14,-4,-3,-1,1,down,1984-09-01
25912,Mtume,1984-12-15,"Mtume - You, Me And He",19,16,35,5.0,23,"You, Me And He",25.0,15,-12,-4,-3,1,down,1984-09-01
25913,Mtume,1984-12-22,"Mtume - You, Me And He",23,19,35,5.0,35,"You, Me And He",25.0,16,0,-12,-4,0,stay,1984-09-01
25914,Mtume,1984-12-29,"Mtume - You, Me And He",35,23,35,5.0,35,"You, Me And He",25.0,17,0,0,-12,0,stay,1984-09-01
25915,Mtume,1985-01-05,"Mtume - You, Me And He",35,35,35,5.0,35,"You, Me And He",25.0,18,0,0,0,0,stay,1984-09-01
25916,Mtume,1985-01-12,"Mtume - You, Me And He",35,35,44,5.0,35,"You, Me And He",25.0,19,-9,0,0,1,down,1984-09-01
25917,Mtume,1985-01-19,"Mtume - You, Me And He",35,35,32,5.0,44,"You, Me And He",25.0,20,12,-9,0,1,up,1984-09-01
25918,Mtume,1985-01-26,"Mtume - You, Me And He",44,35,32,5.0,32,"You, Me And He",25.0,21,0,12,-9,0,stay,1984-09-01
25919,Mtume,1985-02-02,"Mtume - You, Me And He",32,44,36,5.0,32,"You, Me And He",25.0,22,-4,0,12,1,down,1984-09-01
25920,Mtume,1985-02-09,"Mtume - You, Me And He",32,32,36,5.0,36,"You, Me And He",25.0,23,0,-4,0,0,stay,1984-09-01
25921,Mtume,1985-02-16,"Mtume - You, Me And He",36,32,50,5.0,36,"You, Me And He",25.0,24,-14,0,-4,1,down,1984-09-01
25922,Mtume,1985-02-23,"Mtume - You, Me And He",36,36,51,5.0,50,"You, Me And He",25.0,25,-1,-14,0,1,down,1984-09-01
25923,The S.O.S. Band,1984-09-01,The S.O.S. Band - Just The Way You Like It,51,51,25,6.0,42,Just The Way You Like It,30.0,0,17,9,0,1,up,1984-09-01
25924,The S.O.S. Band,1984-09-08,The S.O.S. Band - Just The Way You Like It,42,51,18,6.0,25,Just The Way You Like It,30.0,1,7,17,9,1,up,1984-09-01
25925,The S.O.S. Band,1984-09-15,The S.O.S. Band - Just The Way You Like It,25,42,16,6.0,18,Just The Way You Like It,30.0,2,2,7,17,1,up,1984-09-01
25926,The S.O.S. Band,1984-09-22,The S.O.S. Band - Just The Way You Like It,18,25,12,6.0,16,Just The Way You Like It,30.0,3,4,2,7,1,up,1984-09-01
25927,The S.O.S. Band,1984-09-29,The S.O.S. Band - Just The Way You Like It,16,18,6,6.0,12,Just The Way You Like It,30.0,4,6,4,2,1,up,1984-09-01
25928,The S.O.S. Band,1984-10-06,The S.O.S. Band - Just The Way You Like It,12,16,6,6.0,6,Just The Way You Like It,30.0,5,0,6,4,0,stay,1984-09-01
25929,The S.O.S. Band,1984-10-13,The S.O.S. Band - Just The Way You Like It,6,12,8,6.0,6,Just The Way You Like It,30.0,6,-2,0,6,1,down,1984-09-01
25930,The S.O.S. Band,1984-10-20,The S.O.S. Band - Just The Way You Like It,6,6,8,6.0,8,Just The Way You Like It,30.0,7,0,-2,0,0,stay,1984-09-01
25931,The S.O.S. Band,1984-10-27,The S.O.S. Band - Just The Way You Like It,8,6,13,6.0,8,Just The Way You Like It,30.0,8,-5,0,-2,1,down,1984-09-01
25932,The S.O.S. Band,1984-11-03,The S.O.S. Band - Just The Way You Like It,8,8,13,6.0,13,Just The Way You Like It,30.0,9,0,-5,0,0,stay,1984-09-01
25933,The S.O.S. Band,1984-11-10,The S.O.S. Band - Just The Way You Like It,13,8,13,6.0,13,Just The Way You Like It,30.0,10,0,0,-5,0,stay,1984-09-01
25934,The S.O.S. Band,1984-11-17,The S.O.S. Band - Just The Way You Like It,13,13,13,6.0,13,Just The Way You Like It,30.0,11,0,0,0,0,stay,1984-09-01
25935,The S.O.S. Band,1984-11-24,The S.O.S. Band - Just The Way You Like It,13,13,14,6.0,13,Just The Way You Like It,30.0,12,-1,0,0,1,down,1984-09-01
25936,The S.O.S. Band,1984-12-01,The S.O.S. Band - Just The Way You Like It,13,13,14,6.0,14,Just The Way You Like It,30.0,13,0,-1,0,0,stay,1984-09-01
25937,The S.O.S. Band,1984-12-08,The S.O.S. Band - Just The Way You Like It,14,13,14,6.0,14,Just The Way You Like It,30.0,14,0,0,-1,0,stay,1984-09-01
25938,The S.O.S. Band,1984-12-15,The S.O.S. Band - Just The Way You Like It,14,14,16,6.0,14,Just The Way You Like It,30.0,15,-2,0,0,1,down,1984-09-01
25939,The S.O.S. Band,1984-12-22,The S.O.S. Band - Just The Way You Like It,14,14,16,6.0,16,Just The Way You Like It,30.0,16,0,-2,0,0,stay,1984-09-01
25940,The S.O.S. Band,1984-12-29,The S.O.S. Band - Just The Way You Like It,16,14,21,6.0,16,Just The Way You Like It,30.0,17,-5,0,-2,1,down,1984-09-01
25941,The S.O.S. Band,1985-01-05,The S.O.S. Band - Just The Way You Like It,16,16,21,6.0,21,Just The Way You Like It,30.0,18,0,-5,0,0,stay,1984-09-01
25942,The S.O.S. Band,1985-01-12,The S.O.S. Band - Just The Way You Like It,21,16,22,6.0,21,Just The Way You Like It,30.0,19,-1,0,-5,1,down,1984-09-01
25943,The S.O.S. Band,1985-01-19,The S.O.S. Band - Just The Way You Like It,21,21,31,6.0,22,Just The Way You Like It,30.0,20,-9,-1,0,1,down,1984-09-01
25944,The S.O.S. Band,1985-01-26,The S.O.S. Band - Just The Way You Like It,22,21,37,6.0,31,Just The Way You Like It,30.0,21,-6,-9,-1,1,down,1984-09-01
25945,The S.O.S. Band,1985-02-02,The S.O.S. Band - Just The Way You Like It,31,22,42,6.0,37,Just The Way You Like It,30.0,22,-5,-6,-9,1,down,1984-09-01
25946,The S.O.S. Band,1985-02-09,The S.O.S. Band - Just The Way You Like It,37,31,41,6.0,42,Just The Way You Like It,30.0,23,1,-5,-6,1,up,1984-09-01
25947,The S.O.S. Band,1985-02-16,The S.O.S. Band - Just The Way You Like It,42,37,37,6.0,41,Just The Way You Like It,30.0,24,4,1,-5,1,up,1984-09-01
25948,The S.O.S. Band,1985-02-23,The S.O.S. Band - Just The Way You Like It,41,42,37,6.0,37,Just The Way You Like It,30.0,25,0,4,1,0,stay,1984-09-01
25949,The S.O.S. Band,1985-03-02,The S.O.S. Band - Just The Way You Like It,37,41,39,6.0,37,Just The Way You Like It,30.0,26,-2,0,4,1,down,1984-09-01
25950,The S.O.S. Band,1985-03-09,The S.O.S. Band - Just The Way You Like It,37,37,39,6.0,39,Just The Way You Like It,30.0,27,0,-2,0,0,stay,1984-09-01
25951,The S.O.S. Band,1985-03-16,The S.O.S. Band - Just The Way You Like It,39,37,42,6.0,39,Just The Way You Like It,30.0,28,-3,0,-2,1,down,1984-09-01
25952,The S.O.S. Band,1985-03-23,The S.O.S. Band - Just The Way You Like It,39,39,48,6.0,42,Just The Way You Like It,30.0,29,-6,-3,0,1,down,1984-09-01
25953,The S.O.S. Band,1985-03-30,The S.O.S. Band - Just The Way You Like It,42,39,51,6.0,48,Just The Way You Like It,30.0,30,-3,-6,-3,1,down,1984-09-01
25954,Joyce Kennedy,1984-09-01,Joyce Kennedy - Lookin' For Trouble,51,51,30,17.0,47,Lookin' For Trouble,20.0,0,17,4,0,1,up,1984-09-01
25955,Joyce Kennedy,1984-09-08,Joyce Kennedy - Lookin' For Trouble,47,51,27,17.0,30,Lookin' For Trouble,20.0,1,3,17,4,1,up,1984-09-01
25956,Joyce Kennedy,1984-09-15,Joyce Kennedy - Lookin' For Trouble,30,47,25,17.0,27,Lookin' For Trouble,20.0,2,2,3,17,1,up,1984-09-01
25957,Joyce Kennedy,1984-09-22,Joyce Kennedy - Lookin' For Trouble,27,30,23,17.0,25,Lookin' For Trouble,20.0,3,2,2,3,1,up,1984-09-01
25958,Joyce Kennedy,1984-09-29,Joyce Kennedy - Lookin' For Trouble,25,27,19,17.0,23,Lookin' For Trouble,20.0,4,4,2,2,1,up,1984-09-01
25959,Joyce Kennedy,1984-10-06,Joyce Kennedy - Lookin' For Trouble,23,25,17,17.0,19,Lookin' For Trouble,20.0,5,2,4,2,1,up,1984-09-01
25960,Joyce Kennedy,1984-10-13,Joyce Kennedy - Lookin' For Trouble,19,23,17,17.0,17,Lookin' For Trouble,20.0,6,0,2,4,0,stay,1984-09-01
25961,Joyce Kennedy,1984-10-20,Joyce Kennedy - Lookin' For Trouble,17,19,21,17.0,17,Lookin' For Trouble,20.0,7,-4,0,2,1,down,1984-09-01
25962,Joyce Kennedy,1984-10-27,Joyce Kennedy - Lookin' For Trouble,17,17,20,17.0,21,Lookin' For Trouble,20.0,8,1,-4,0,1,up,1984-09-01
25963,Joyce Kennedy,1984-11-03,Joyce Kennedy - Lookin' For Trouble,21,17,22,17.0,20,Lookin' For Trouble,20.0,9,-2,1,-4,1,down,1984-09-01
25964,Joyce Kennedy,1984-11-10,Joyce Kennedy - Lookin' For Trouble,20,21,28,17.0,22,Lookin' For Trouble,20.0,10,-6,-2,1,1,down,1984-09-01
25965,Joyce Kennedy,1984-11-17,Joyce Kennedy - Lookin' For Trouble,22,20,27,17.0,28,Lookin' For Trouble,20.0,11,1,-6,-2,1,up,1984-09-01
25966,Joyce Kennedy,1984-11-24,Joyce Kennedy - Lookin' For Trouble,28,22,36,17.0,27,Lookin' For Trouble,20.0,12,-9,1,-6,1,down,1984-09-01
25967,Joyce Kennedy,1984-12-01,Joyce Kennedy - Lookin' For Trouble,27,28,37,17.0,36,Lookin' For Trouble,20.0,13,-1,-9,1,1,down,1984-09-01
25968,Joyce Kennedy,1984-12-08,Joyce Kennedy - Lookin' For Trouble,36,27,49,17.0,37,Lookin' For Trouble,20.0,14,-12,-1,-9,1,down,1984-09-01
25969,Joyce Kennedy,1984-12-15,Joyce Kennedy - Lookin' For Trouble,37,36,47,17.0,49,Lookin' For Trouble,20.0,15,2,-12,-1,1,up,1984-09-01
25970,Joyce Kennedy,1984-12-22,Joyce Kennedy - Lookin' For Trouble,49,37,47,17.0,47,Lookin' For Trouble,20.0,16,0,2,-12,0,stay,1984-09-01
25971,Joyce Kennedy,1984-12-29,Joyce Kennedy - Lookin' For Trouble,47,49,47,17.0,47,Lookin' For Trouble,20.0,17,0,0,2,0,stay,1984-09-01
25972,Joyce Kennedy,1985-01-05,Joyce Kennedy - Lookin' For Trouble,47,47,46,17.0,47,Lookin' For Trouble,20.0,18,1,0,0,1,up,1984-09-01
25973,Joyce Kennedy,1985-01-12,Joyce Kennedy - Lookin' For Trouble,47,47,46,17.0,46,Lookin' For Trouble,20.0,19,0,1,0,0,stay,1984-09-01
25974,Joyce Kennedy,1985-01-19,Joyce Kennedy - Lookin' For Trouble,46,47,51,17.0,46,Lookin' For Trouble,20.0,20,-5,0,1,1,down,1984-09-01
25975,Rick James,1984-09-01,Rick James - Reflections,51,51,15,10.0,49,Reflections,14.0,0,34,2,0,1,up,1984-09-01
25976,Rick James,1984-09-08,Rick James - Reflections,49,51,13,10.0,15,Reflections,14.0,1,2,34,2,1,up,1984-09-01
25977,Rick James,1984-09-15,Rick James - Reflections,15,49,11,10.0,13,Reflections,14.0,2,2,2,34,1,up,1984-09-01
25978,Rick James,1984-09-22,Rick James - Reflections,13,15,10,10.0,11,Reflections,14.0,3,1,2,2,1,up,1984-09-01
25979,Rick James,1984-09-29,Rick James - Reflections,11,13,10,10.0,10,Reflections,14.0,4,0,1,2,0,stay,1984-09-01
25980,Rick James,1984-10-06,Rick James - Reflections,10,11,11,10.0,10,Reflections,14.0,5,-1,0,1,1,down,1984-09-01
25981,Rick James,1984-10-13,Rick James - Reflections,10,10,19,10.0,11,Reflections,14.0,6,-8,-1,0,1,down,1984-09-01
25982,Rick James,1984-10-20,Rick James - Reflections,11,10,29,10.0,19,Reflections,14.0,7,-10,-8,-1,1,down,1984-09-01
25983,Rick James,1984-10-27,Rick James - Reflections,19,11,28,10.0,29,Reflections,14.0,8,1,-10,-8,1,up,1984-09-01
25984,Rick James,1984-11-03,Rick James - Reflections,29,19,28,10.0,28,Reflections,14.0,9,0,1,-10,0,stay,1984-09-01
25985,Rick James,1984-11-10,Rick James - Reflections,28,29,37,10.0,28,Reflections,14.0,10,-9,0,1,1,down,1984-09-01
25986,Rick James,1984-11-17,Rick James - Reflections,28,28,36,10.0,37,Reflections,14.0,11,1,-9,0,1,up,1984-09-01
25987,Rick James,1984-11-24,Rick James - Reflections,37,28,43,10.0,36,Reflections,14.0,12,-7,1,-9,1,down,1984-09-01
25988,Rick James,1984-12-01,Rick James - Reflections,36,37,43,10.0,43,Reflections,14.0,13,0,-7,1,0,stay,1984-09-01
25989,Rick James,1984-12-08,Rick James - Reflections,43,36,51,10.0,43,Reflections,14.0,14,-8,0,-7,1,down,1984-09-01
25990,Alicia Myers,1984-09-08,Alicia Myers - I Appreciate,51,51,30,12.0,38,I Appreciate,22.0,0,8,13,0,1,up,1984-09-08
25991,Alicia Myers,1984-09-15,Alicia Myers - I Appreciate,38,51,24,12.0,30,I Appreciate,22.0,1,6,8,13,1,up,1984-09-08
25992,Alicia Myers,1984-09-22,Alicia Myers - I Appreciate,30,38,19,12.0,24,I Appreciate,22.0,2,5,6,8,1,up,1984-09-08
25993,Alicia Myers,1984-09-29,Alicia Myers - I Appreciate,24,30,16,12.0,19,I Appreciate,22.0,3,3,5,6,1,up,1984-09-08
25994,Alicia Myers,1984-10-06,Alicia Myers - I Appreciate,19,24,15,12.0,16,I Appreciate,22.0,4,1,3,5,1,up,1984-09-08
25995,Alicia Myers,1984-10-13,Alicia Myers - I Appreciate,16,19,13,12.0,15,I Appreciate,22.0,5,2,1,3,1,up,1984-09-08
25996,Alicia Myers,1984-10-20,Alicia Myers - I Appreciate,15,16,13,12.0,13,I Appreciate,22.0,6,0,2,1,0,stay,1984-09-08
25997,Alicia Myers,1984-10-27,Alicia Myers - I Appreciate,13,15,12,12.0,13,I Appreciate,22.0,7,1,0,2,1,up,1984-09-08
25998,Alicia Myers,1984-11-03,Alicia Myers - I Appreciate,13,13,12,12.0,12,I Appreciate,22.0,8,0,1,0,0,stay,1984-09-08
25999,Alicia Myers,1984-11-10,Alicia Myers - I Appreciate,12,13,21,12.0,12,I Appreciate,22.0,9,-9,0,1,1,down,1984-09-08
26000,Alicia Myers,1984-11-17,Alicia Myers - I Appreciate,12,12,21,12.0,21,I Appreciate,22.0,10,0,-9,0,0,stay,1984-09-08
26001,Alicia Myers,1984-11-24,Alicia Myers - I Appreciate,21,12,25,12.0,21,I Appreciate,22.0,11,-4,0,-9,1,down,1984-09-08
26002,Alicia Myers,1984-12-01,Alicia Myers - I Appreciate,21,21,36,12.0,25,I Appreciate,22.0,12,-11,-4,0,1,down,1984-09-08
26003,Alicia Myers,1984-12-08,Alicia Myers - I Appreciate,25,21,32,12.0,36,I Appreciate,22.0,13,4,-11,-4,1,up,1984-09-08
26004,Alicia Myers,1984-12-15,Alicia Myers - I Appreciate,36,25,32,12.0,32,I Appreciate,22.0,14,0,4,-11,0,stay,1984-09-08
26005,Alicia Myers,1984-12-22,Alicia Myers - I Appreciate,32,36,32,12.0,32,I Appreciate,22.0,15,0,0,4,0,stay,1984-09-08
26006,Alicia Myers,1984-12-29,Alicia Myers - I Appreciate,32,32,38,12.0,32,I Appreciate,22.0,16,-6,0,0,1,down,1984-09-08
26007,Alicia Myers,1985-01-05,Alicia Myers - I Appreciate,32,32,44,12.0,38,I Appreciate,22.0,17,-6,-6,0,1,down,1984-09-08
26008,Alicia Myers,1985-01-12,Alicia Myers - I Appreciate,38,32,42,12.0,44,I Appreciate,22.0,18,2,-6,-6,1,up,1984-09-08
26009,Alicia Myers,1985-01-19,Alicia Myers - I Appreciate,44,38,42,12.0,42,I Appreciate,22.0,19,0,2,-6,0,stay,1984-09-08
26010,Alicia Myers,1985-01-26,Alicia Myers - I Appreciate,42,44,47,12.0,42,I Appreciate,22.0,20,-5,0,2,1,down,1984-09-08
26011,Alicia Myers,1985-02-02,Alicia Myers - I Appreciate,42,42,48,12.0,47,I Appreciate,22.0,21,-1,-5,0,1,down,1984-09-08
26012,Alicia Myers,1985-02-09,Alicia Myers - I Appreciate,47,42,51,12.0,48,I Appreciate,22.0,22,-3,-1,-5,1,down,1984-09-08
26013,Herbie Hancock,1984-09-08,Herbie Hancock - Sound-System,51,51,38,34.0,41,Sound-System,6.0,0,3,10,0,1,up,1984-09-08
26014,Herbie Hancock,1984-09-15,Herbie Hancock - Sound-System,41,51,37,34.0,38,Sound-System,6.0,1,1,3,10,1,up,1984-09-08
26015,Herbie Hancock,1984-09-22,Herbie Hancock - Sound-System,38,41,34,34.0,37,Sound-System,6.0,2,3,1,3,1,up,1984-09-08
26016,Herbie Hancock,1984-09-29,Herbie Hancock - Sound-System,37,38,34,34.0,34,Sound-System,6.0,3,0,3,1,0,stay,1984-09-08
26017,Herbie Hancock,1984-10-06,Herbie Hancock - Sound-System,34,37,40,34.0,34,Sound-System,6.0,4,-6,0,3,1,down,1984-09-08
26018,Herbie Hancock,1984-10-13,Herbie Hancock - Sound-System,34,34,40,34.0,40,Sound-System,6.0,5,0,-6,0,0,stay,1984-09-08
26019,Herbie Hancock,1984-10-20,Herbie Hancock - Sound-System,40,34,51,34.0,40,Sound-System,6.0,6,-11,0,-6,1,down,1984-09-08
26020,Bobby Bland,1984-09-08,Bobby Bland - You've Got Me Loving You,51,51,39,35.0,43,You've Got Me Loving You,6.0,0,4,8,0,1,up,1984-09-08
26021,Bobby Bland,1984-09-15,Bobby Bland - You've Got Me Loving You,43,51,39,35.0,39,You've Got Me Loving You,6.0,1,0,4,8,0,stay,1984-09-08
26022,Bobby Bland,1984-09-22,Bobby Bland - You've Got Me Loving You,39,43,35,35.0,39,You've Got Me Loving You,6.0,2,4,0,4,1,up,1984-09-08
26023,Bobby Bland,1984-09-29,Bobby Bland - You've Got Me Loving You,39,39,35,35.0,35,You've Got Me Loving You,6.0,3,0,4,0,0,stay,1984-09-08
26024,Bobby Bland,1984-10-06,Bobby Bland - You've Got Me Loving You,35,39,38,35.0,35,You've Got Me Loving You,6.0,4,-3,0,4,1,down,1984-09-08
26025,Bobby Bland,1984-10-13,Bobby Bland - You've Got Me Loving You,35,35,41,35.0,38,You've Got Me Loving You,6.0,5,-3,-3,0,1,down,1984-09-08
26026,Bobby Bland,1984-10-20,Bobby Bland - You've Got Me Loving You,38,35,51,35.0,41,You've Got Me Loving You,6.0,6,-10,-3,-3,1,down,1984-09-08
26027,Randy Hall,1984-09-08,Randy Hall - I Belong To You,51,51,46,30.0,50,I Belong To You,10.0,0,4,1,0,1,up,1984-09-08
26028,Randy Hall,1984-09-15,Randy Hall - I Belong To You,50,51,38,30.0,46,I Belong To You,10.0,1,8,4,1,1,up,1984-09-08
26029,Randy Hall,1984-09-22,Randy Hall - I Belong To You,46,50,32,30.0,38,I Belong To You,10.0,2,6,8,4,1,up,1984-09-08
26030,Randy Hall,1984-09-29,Randy Hall - I Belong To You,38,46,30,30.0,32,I Belong To You,10.0,3,2,6,8,1,up,1984-09-08
26031,Randy Hall,1984-10-06,Randy Hall - I Belong To You,32,38,30,30.0,30,I Belong To You,10.0,4,0,2,6,0,stay,1984-09-08
26032,Randy Hall,1984-10-13,Randy Hall - I Belong To You,30,32,37,30.0,30,I Belong To You,10.0,5,-7,0,2,1,down,1984-09-08
26033,Randy Hall,1984-10-20,Randy Hall - I Belong To You,30,30,37,30.0,37,I Belong To You,10.0,6,0,-7,0,0,stay,1984-09-08
26034,Randy Hall,1984-10-27,Randy Hall - I Belong To You,37,30,35,30.0,37,I Belong To You,10.0,7,2,0,-7,1,up,1984-09-08
26035,Randy Hall,1984-11-03,Randy Hall - I Belong To You,37,37,35,30.0,35,I Belong To You,10.0,8,0,2,0,0,stay,1984-09-08
26036,Randy Hall,1984-11-10,Randy Hall - I Belong To You,35,37,39,30.0,35,I Belong To You,10.0,9,-4,0,2,1,down,1984-09-08
26037,Randy Hall,1984-11-17,Randy Hall - I Belong To You,35,35,51,30.0,39,I Belong To You,10.0,10,-12,-4,0,1,down,1984-09-08
26038,Janet Jackson,1984-09-22,Janet Jackson - Dream Street,51,51,37,19.0,41,Dream Street,11.0,0,4,10,0,1,up,1984-09-22
26039,Janet Jackson,1984-09-29,Janet Jackson - Dream Street,41,51,27,19.0,37,Dream Street,11.0,1,10,4,10,1,up,1984-09-22
26040,Janet Jackson,1984-10-06,Janet Jackson - Dream Street,37,41,24,19.0,27,Dream Street,11.0,2,3,10,4,1,up,1984-09-22
26041,Janet Jackson,1984-10-13,Janet Jackson - Dream Street,27,37,21,19.0,24,Dream Street,11.0,3,3,3,10,1,up,1984-09-22
26042,Janet Jackson,1984-10-20,Janet Jackson - Dream Street,24,27,19,19.0,21,Dream Street,11.0,4,2,3,3,1,up,1984-09-22
26043,Janet Jackson,1984-10-27,Janet Jackson - Dream Street,21,24,19,19.0,19,Dream Street,11.0,5,0,2,3,0,stay,1984-09-22
26044,Janet Jackson,1984-11-03,Janet Jackson - Dream Street,19,21,26,19.0,19,Dream Street,11.0,6,-7,0,2,1,down,1984-09-22
26045,Janet Jackson,1984-11-10,Janet Jackson - Dream Street,19,19,36,19.0,26,Dream Street,11.0,7,-10,-7,0,1,down,1984-09-22
26046,Janet Jackson,1984-11-17,Janet Jackson - Dream Street,26,19,40,19.0,36,Dream Street,11.0,8,-4,-10,-7,1,down,1984-09-22
26047,Janet Jackson,1984-11-24,Janet Jackson - Dream Street,36,26,40,19.0,40,Dream Street,11.0,9,0,-4,-10,0,stay,1984-09-22
26048,Janet Jackson,1984-12-01,Janet Jackson - Dream Street,40,36,50,19.0,40,Dream Street,11.0,10,-10,0,-4,1,down,1984-09-22
26049,Janet Jackson,1984-12-08,Janet Jackson - Dream Street,40,40,51,19.0,50,Dream Street,11.0,11,-1,-10,0,1,down,1984-09-22
26050,Bob Marley And The Wailers,1984-09-22,Bob Marley And The Wailers - Legend: The Best Of...,51,51,44,34.0,46,Legend: The Best Of...,7.0,0,2,5,0,1,up,1984-09-22
26051,Bob Marley And The Wailers,1984-09-29,Bob Marley And The Wailers - Legend: The Best Of...,46,51,39,34.0,44,Legend: The Best Of...,7.0,1,5,2,5,1,up,1984-09-22
26052,Bob Marley And The Wailers,1984-10-06,Bob Marley And The Wailers - Legend: The Best Of...,44,46,39,34.0,39,Legend: The Best Of...,7.0,2,0,5,2,0,stay,1984-09-22
26053,Bob Marley And The Wailers,1984-10-13,Bob Marley And The Wailers - Legend: The Best Of...,39,44,36,34.0,39,Legend: The Best Of...,7.0,3,3,0,5,1,up,1984-09-22
26054,Bob Marley And The Wailers,1984-10-20,Bob Marley And The Wailers - Legend: The Best Of...,39,39,36,34.0,36,Legend: The Best Of...,7.0,4,0,3,0,0,stay,1984-09-22
26055,Bob Marley And The Wailers,1984-10-27,Bob Marley And The Wailers - Legend: The Best Of...,36,39,34,34.0,36,Legend: The Best Of...,7.0,5,2,0,3,1,up,1984-09-22
26056,Bob Marley And The Wailers,1984-11-03,Bob Marley And The Wailers - Legend: The Best Of...,36,36,34,34.0,34,Legend: The Best Of...,7.0,6,0,2,0,0,stay,1984-09-22
26057,Bob Marley And The Wailers,1984-11-10,Bob Marley And The Wailers - Legend: The Best Of...,34,36,51,34.0,34,Legend: The Best Of...,7.0,7,-17,0,2,1,down,1984-09-22
26058,Ramsey Lewis & Nancy Wilson,1984-09-22,Ramsey Lewis & Nancy Wilson - The Two Of Us,51,51,42,42.0,48,The Two Of Us,4.0,0,6,3,0,1,up,1984-09-22
26059,Ramsey Lewis & Nancy Wilson,1984-09-29,Ramsey Lewis & Nancy Wilson - The Two Of Us,48,51,42,42.0,42,The Two Of Us,4.0,1,0,6,3,0,stay,1984-09-22
26060,Ramsey Lewis & Nancy Wilson,1984-10-06,Ramsey Lewis & Nancy Wilson - The Two Of Us,42,48,46,42.0,42,The Two Of Us,4.0,2,-4,0,6,1,down,1984-09-22
26061,Ramsey Lewis & Nancy Wilson,1984-10-13,Ramsey Lewis & Nancy Wilson - The Two Of Us,42,42,46,42.0,46,The Two Of Us,4.0,3,0,-4,0,0,stay,1984-09-22
26062,Ramsey Lewis & Nancy Wilson,1984-10-20,Ramsey Lewis & Nancy Wilson - The Two Of Us,46,42,51,42.0,46,The Two Of Us,4.0,4,-5,0,-4,1,down,1984-09-22
26063,Kurtis Blow,1984-09-22,Kurtis Blow - Ego Trip,51,51,39,18.0,49,Ego Trip,37.0,0,10,2,0,1,up,1984-09-22
26064,Kurtis Blow,1984-09-29,Kurtis Blow - Ego Trip,49,51,32,18.0,39,Ego Trip,37.0,1,7,10,2,1,up,1984-09-22
26065,Kurtis Blow,1984-10-06,Kurtis Blow - Ego Trip,39,49,26,18.0,32,Ego Trip,37.0,2,6,7,10,1,up,1984-09-22
26066,Kurtis Blow,1984-10-13,Kurtis Blow - Ego Trip,32,39,23,18.0,26,Ego Trip,37.0,3,3,6,7,1,up,1984-09-22
26067,Kurtis Blow,1984-10-20,Kurtis Blow - Ego Trip,26,32,23,18.0,23,Ego Trip,37.0,4,0,3,6,0,stay,1984-09-22
26068,Kurtis Blow,1984-10-27,Kurtis Blow - Ego Trip,23,26,22,18.0,23,Ego Trip,37.0,5,1,0,3,1,up,1984-09-22
26069,Kurtis Blow,1984-11-03,Kurtis Blow - Ego Trip,23,23,18,18.0,22,Ego Trip,37.0,6,4,1,0,1,up,1984-09-22
26070,Kurtis Blow,1984-11-10,Kurtis Blow - Ego Trip,22,23,18,18.0,18,Ego Trip,37.0,7,0,4,1,0,stay,1984-09-22
26071,Kurtis Blow,1984-11-17,Kurtis Blow - Ego Trip,18,22,26,18.0,18,Ego Trip,37.0,8,-8,0,4,1,down,1984-09-22
26072,Kurtis Blow,1984-11-24,Kurtis Blow - Ego Trip,18,18,33,18.0,26,Ego Trip,37.0,9,-7,-8,0,1,down,1984-09-22
26073,Kurtis Blow,1984-12-01,Kurtis Blow - Ego Trip,26,18,30,18.0,33,Ego Trip,37.0,10,3,-7,-8,1,up,1984-09-22
26074,Kurtis Blow,1984-12-08,Kurtis Blow - Ego Trip,33,26,25,18.0,30,Ego Trip,37.0,11,5,3,-7,1,up,1984-09-22
26075,Kurtis Blow,1984-12-15,Kurtis Blow - Ego Trip,30,33,24,18.0,25,Ego Trip,37.0,12,1,5,3,1,up,1984-09-22
26076,Kurtis Blow,1984-12-22,Kurtis Blow - Ego Trip,25,30,24,18.0,24,Ego Trip,37.0,13,0,1,5,0,stay,1984-09-22
26077,Kurtis Blow,1984-12-29,Kurtis Blow - Ego Trip,24,25,36,18.0,24,Ego Trip,37.0,14,-12,0,1,1,down,1984-09-22
26078,Kurtis Blow,1985-01-05,Kurtis Blow - Ego Trip,24,24,31,18.0,36,Ego Trip,37.0,15,5,-12,0,1,up,1984-09-22
26079,Kurtis Blow,1985-01-12,Kurtis Blow - Ego Trip,36,24,27,18.0,31,Ego Trip,37.0,16,4,5,-12,1,up,1984-09-22
26080,Kurtis Blow,1985-01-19,Kurtis Blow - Ego Trip,31,36,27,18.0,27,Ego Trip,37.0,17,0,4,5,0,stay,1984-09-22
26081,Kurtis Blow,1985-01-26,Kurtis Blow - Ego Trip,27,31,24,18.0,27,Ego Trip,37.0,18,3,0,4,1,up,1984-09-22
26082,Kurtis Blow,1985-02-02,Kurtis Blow - Ego Trip,27,27,24,18.0,24,Ego Trip,37.0,19,0,3,0,0,stay,1984-09-22
26083,Kurtis Blow,1985-02-09,Kurtis Blow - Ego Trip,24,27,23,18.0,24,Ego Trip,37.0,20,1,0,3,1,up,1984-09-22
26084,Kurtis Blow,1985-02-16,Kurtis Blow - Ego Trip,24,24,28,18.0,23,Ego Trip,37.0,21,-5,1,0,1,down,1984-09-22
26085,Kurtis Blow,1985-02-23,Kurtis Blow - Ego Trip,23,24,27,18.0,28,Ego Trip,37.0,22,1,-5,1,1,up,1984-09-22
26086,Kurtis Blow,1985-03-02,Kurtis Blow - Ego Trip,28,23,34,18.0,27,Ego Trip,37.0,23,-7,1,-5,1,down,1984-09-22
26087,Kurtis Blow,1985-03-09,Kurtis Blow - Ego Trip,27,28,37,18.0,34,Ego Trip,37.0,24,-3,-7,1,1,down,1984-09-22
26088,Kurtis Blow,1985-03-16,Kurtis Blow - Ego Trip,34,27,30,18.0,37,Ego Trip,37.0,25,7,-3,-7,1,up,1984-09-22
26089,Kurtis Blow,1985-03-23,Kurtis Blow - Ego Trip,37,34,29,18.0,30,Ego Trip,37.0,26,1,7,-3,1,up,1984-09-22
26090,Kurtis Blow,1985-03-30,Kurtis Blow - Ego Trip,30,37,46,18.0,29,Ego Trip,37.0,27,-17,1,7,1,down,1984-09-22
26091,Kurtis Blow,1985-04-06,Kurtis Blow - Ego Trip,29,30,44,18.0,46,Ego Trip,37.0,28,2,-17,1,1,up,1984-09-22
26092,Kurtis Blow,1985-04-13,Kurtis Blow - Ego Trip,46,29,39,18.0,44,Ego Trip,37.0,29,5,2,-17,1,up,1984-09-22
26093,Kurtis Blow,1985-04-20,Kurtis Blow - Ego Trip,44,46,34,18.0,39,Ego Trip,37.0,30,5,5,2,1,up,1984-09-22
26094,Kurtis Blow,1985-04-27,Kurtis Blow - Ego Trip,39,44,27,18.0,34,Ego Trip,37.0,31,7,5,5,1,up,1984-09-22
26095,Kurtis Blow,1985-05-04,Kurtis Blow - Ego Trip,34,39,27,18.0,27,Ego Trip,37.0,32,0,7,5,0,stay,1984-09-22
26096,Kurtis Blow,1985-05-11,Kurtis Blow - Ego Trip,27,34,27,18.0,27,Ego Trip,37.0,33,0,0,7,0,stay,1984-09-22
26097,Kurtis Blow,1985-05-18,Kurtis Blow - Ego Trip,27,27,38,18.0,27,Ego Trip,37.0,34,-11,0,0,1,down,1984-09-22
26098,Kurtis Blow,1985-05-25,Kurtis Blow - Ego Trip,27,27,40,18.0,38,Ego Trip,37.0,35,-2,-11,0,1,down,1984-09-22
26099,Kurtis Blow,1985-06-01,Kurtis Blow - Ego Trip,38,27,49,18.0,40,Ego Trip,37.0,36,-9,-2,-11,1,down,1984-09-22
26100,Kurtis Blow,1985-06-08,Kurtis Blow - Ego Trip,40,38,51,18.0,49,Ego Trip,37.0,37,-2,-9,-2,1,down,1984-09-22
26101,Stevie Wonder,1984-09-29,Stevie Wonder - The Woman In Red (Soundtrack),51,51,11,1.0,24,The Woman In Red (Soundtrack),33.0,0,13,27,0,1,up,1984-09-29
26102,Stevie Wonder,1984-10-06,Stevie Wonder - The Woman In Red (Soundtrack),24,51,7,1.0,11,The Woman In Red (Soundtrack),33.0,1,4,13,27,1,up,1984-09-29
26103,Stevie Wonder,1984-10-13,Stevie Wonder - The Woman In Red (Soundtrack),11,24,4,1.0,7,The Woman In Red (Soundtrack),33.0,2,3,4,13,1,up,1984-09-29
26104,Stevie Wonder,1984-10-20,Stevie Wonder - The Woman In Red (Soundtrack),7,11,3,1.0,4,The Woman In Red (Soundtrack),33.0,3,1,3,4,1,up,1984-09-29
26105,Stevie Wonder,1984-10-27,Stevie Wonder - The Woman In Red (Soundtrack),4,7,3,1.0,3,The Woman In Red (Soundtrack),33.0,4,0,1,3,0,stay,1984-09-29
26106,Stevie Wonder,1984-11-03,Stevie Wonder - The Woman In Red (Soundtrack),3,4,2,1.0,3,The Woman In Red (Soundtrack),33.0,5,1,0,1,1,up,1984-09-29
26107,Stevie Wonder,1984-11-10,Stevie Wonder - The Woman In Red (Soundtrack),3,3,2,1.0,2,The Woman In Red (Soundtrack),33.0,6,0,1,0,0,stay,1984-09-29
26108,Stevie Wonder,1984-11-17,Stevie Wonder - The Woman In Red (Soundtrack),2,3,2,1.0,2,The Woman In Red (Soundtrack),33.0,7,0,0,1,0,stay,1984-09-29
26109,Stevie Wonder,1984-11-24,Stevie Wonder - The Woman In Red (Soundtrack),2,2,2,1.0,2,The Woman In Red (Soundtrack),33.0,8,0,0,0,0,stay,1984-09-29
26110,Stevie Wonder,1984-12-01,Stevie Wonder - The Woman In Red (Soundtrack),2,2,1,1.0,2,The Woman In Red (Soundtrack),33.0,9,1,0,0,1,up,1984-09-29
26111,Stevie Wonder,1984-12-08,Stevie Wonder - The Woman In Red (Soundtrack),2,2,1,1.0,1,The Woman In Red (Soundtrack),33.0,10,0,1,0,0,stay,1984-09-29
26112,Stevie Wonder,1984-12-15,Stevie Wonder - The Woman In Red (Soundtrack),1,2,1,1.0,1,The Woman In Red (Soundtrack),33.0,11,0,0,1,0,stay,1984-09-29
26113,Stevie Wonder,1984-12-22,Stevie Wonder - The Woman In Red (Soundtrack),1,1,1,1.0,1,The Woman In Red (Soundtrack),33.0,12,0,0,0,0,stay,1984-09-29
26114,Stevie Wonder,1984-12-29,Stevie Wonder - The Woman In Red (Soundtrack),1,1,3,1.0,1,The Woman In Red (Soundtrack),33.0,13,-2,0,0,1,down,1984-09-29
26115,Stevie Wonder,1985-01-05,Stevie Wonder - The Woman In Red (Soundtrack),1,1,2,1.0,3,The Woman In Red (Soundtrack),33.0,14,1,-2,0,1,up,1984-09-29
26116,Stevie Wonder,1985-01-12,Stevie Wonder - The Woman In Red (Soundtrack),3,1,2,1.0,2,The Woman In Red (Soundtrack),33.0,15,0,1,-2,0,stay,1984-09-29
26117,Stevie Wonder,1985-01-19,Stevie Wonder - The Woman In Red (Soundtrack),2,3,2,1.0,2,The Woman In Red (Soundtrack),33.0,16,0,0,1,0,stay,1984-09-29
26118,Stevie Wonder,1985-01-26,Stevie Wonder - The Woman In Red (Soundtrack),2,2,3,1.0,2,The Woman In Red (Soundtrack),33.0,17,-1,0,0,1,down,1984-09-29
26119,Stevie Wonder,1985-02-02,Stevie Wonder - The Woman In Red (Soundtrack),2,2,3,1.0,3,The Woman In Red (Soundtrack),33.0,18,0,-1,0,0,stay,1984-09-29
26120,Stevie Wonder,1985-02-09,Stevie Wonder - The Woman In Red (Soundtrack),3,2,5,1.0,3,The Woman In Red (Soundtrack),33.0,19,-2,0,-1,1,down,1984-09-29
26121,Stevie Wonder,1985-02-16,Stevie Wonder - The Woman In Red (Soundtrack),3,3,6,1.0,5,The Woman In Red (Soundtrack),33.0,20,-1,-2,0,1,down,1984-09-29
26122,Stevie Wonder,1985-02-23,Stevie Wonder - The Woman In Red (Soundtrack),5,3,7,1.0,6,The Woman In Red (Soundtrack),33.0,21,-1,-1,-2,1,down,1984-09-29
26123,Stevie Wonder,1985-03-02,Stevie Wonder - The Woman In Red (Soundtrack),6,5,15,1.0,7,The Woman In Red (Soundtrack),33.0,22,-8,-1,-1,1,down,1984-09-29
26124,Stevie Wonder,1985-03-09,Stevie Wonder - The Woman In Red (Soundtrack),7,6,16,1.0,15,The Woman In Red (Soundtrack),33.0,23,-1,-8,-1,1,down,1984-09-29
26125,Stevie Wonder,1985-03-16,Stevie Wonder - The Woman In Red (Soundtrack),15,7,19,1.0,16,The Woman In Red (Soundtrack),33.0,24,-3,-1,-8,1,down,1984-09-29
26126,Stevie Wonder,1985-03-23,Stevie Wonder - The Woman In Red (Soundtrack),16,15,26,1.0,19,The Woman In Red (Soundtrack),33.0,25,-7,-3,-1,1,down,1984-09-29
26127,Stevie Wonder,1985-03-30,Stevie Wonder - The Woman In Red (Soundtrack),19,16,29,1.0,26,The Woman In Red (Soundtrack),33.0,26,-3,-7,-3,1,down,1984-09-29
26128,Stevie Wonder,1985-04-06,Stevie Wonder - The Woman In Red (Soundtrack),26,19,29,1.0,29,The Woman In Red (Soundtrack),33.0,27,0,-3,-7,0,stay,1984-09-29
26129,Stevie Wonder,1985-04-13,Stevie Wonder - The Woman In Red (Soundtrack),29,26,30,1.0,29,The Woman In Red (Soundtrack),33.0,28,-1,0,-3,1,down,1984-09-29
26130,Stevie Wonder,1985-04-20,Stevie Wonder - The Woman In Red (Soundtrack),29,29,36,1.0,30,The Woman In Red (Soundtrack),33.0,29,-6,-1,0,1,down,1984-09-29
26131,Stevie Wonder,1985-04-27,Stevie Wonder - The Woman In Red (Soundtrack),30,29,40,1.0,36,The Woman In Red (Soundtrack),33.0,30,-4,-6,-1,1,down,1984-09-29
26132,Stevie Wonder,1985-05-04,Stevie Wonder - The Woman In Red (Soundtrack),36,30,43,1.0,40,The Woman In Red (Soundtrack),33.0,31,-3,-4,-6,1,down,1984-09-29
26133,Stevie Wonder,1985-05-11,Stevie Wonder - The Woman In Red (Soundtrack),40,36,46,1.0,43,The Woman In Red (Soundtrack),33.0,32,-3,-3,-4,1,down,1984-09-29
26134,Stevie Wonder,1985-05-18,Stevie Wonder - The Woman In Red (Soundtrack),43,40,51,1.0,46,The Woman In Red (Soundtrack),33.0,33,-5,-3,-3,1,down,1984-09-29
26135,Ralph MacDonald,1984-09-29,Ralph MacDonald - Universal Rhythm,51,51,36,26.0,38,Universal Rhythm,9.0,0,2,13,0,1,up,1984-09-29
26136,Ralph MacDonald,1984-10-06,Ralph MacDonald - Universal Rhythm,38,51,32,26.0,36,Universal Rhythm,9.0,1,4,2,13,1,up,1984-09-29
26137,Ralph MacDonald,1984-10-13,Ralph MacDonald - Universal Rhythm,36,38,30,26.0,32,Universal Rhythm,9.0,2,2,4,2,1,up,1984-09-29
26138,Ralph MacDonald,1984-10-20,Ralph MacDonald - Universal Rhythm,32,36,27,26.0,30,Universal Rhythm,9.0,3,3,2,4,1,up,1984-09-29
26139,Ralph MacDonald,1984-10-27,Ralph MacDonald - Universal Rhythm,30,32,26,26.0,27,Universal Rhythm,9.0,4,1,3,2,1,up,1984-09-29
26140,Ralph MacDonald,1984-11-03,Ralph MacDonald - Universal Rhythm,27,30,30,26.0,26,Universal Rhythm,9.0,5,-4,1,3,1,down,1984-09-29
26141,Ralph MacDonald,1984-11-10,Ralph MacDonald - Universal Rhythm,26,27,34,26.0,30,Universal Rhythm,9.0,6,-4,-4,1,1,down,1984-09-29
26142,Ralph MacDonald,1984-11-17,Ralph MacDonald - Universal Rhythm,30,26,50,26.0,34,Universal Rhythm,9.0,7,-16,-4,-4,1,down,1984-09-29
26143,Ralph MacDonald,1984-11-24,Ralph MacDonald - Universal Rhythm,34,30,48,26.0,50,Universal Rhythm,9.0,8,2,-16,-4,1,up,1984-09-29
26144,Ralph MacDonald,1984-12-01,Ralph MacDonald - Universal Rhythm,50,34,51,26.0,48,Universal Rhythm,9.0,9,-3,2,-16,1,down,1984-09-29
26145,Diana Ross,1984-10-06,Diana Ross - Swept Away,51,51,18,7.0,25,Swept Away,41.0,0,7,26,0,1,up,1984-10-06
26146,Diana Ross,1984-10-13,Diana Ross - Swept Away,25,51,12,7.0,18,Swept Away,41.0,1,6,7,26,1,up,1984-10-06
26147,Diana Ross,1984-10-20,Diana Ross - Swept Away,18,25,12,7.0,12,Swept Away,41.0,2,0,6,7,0,stay,1984-10-06
26148,Diana Ross,1984-10-27,Diana Ross - Swept Away,12,18,7,7.0,12,Swept Away,41.0,3,5,0,6,1,up,1984-10-06
26149,Diana Ross,1984-11-03,Diana Ross - Swept Away,12,12,7,7.0,7,Swept Away,41.0,4,0,5,0,0,stay,1984-10-06
26150,Diana Ross,1984-11-10,Diana Ross - Swept Away,7,12,7,7.0,7,Swept Away,41.0,5,0,0,5,0,stay,1984-10-06
26151,Diana Ross,1984-11-17,Diana Ross - Swept Away,7,7,7,7.0,7,Swept Away,41.0,6,0,0,0,0,stay,1984-10-06
26152,Diana Ross,1984-11-24,Diana Ross - Swept Away,7,7,12,7.0,7,Swept Away,41.0,7,-5,0,0,1,down,1984-10-06
26153,Diana Ross,1984-12-01,Diana Ross - Swept Away,7,7,12,7.0,12,Swept Away,41.0,8,0,-5,0,0,stay,1984-10-06
26154,Diana Ross,1984-12-08,Diana Ross - Swept Away,12,7,13,7.0,12,Swept Away,41.0,9,-1,0,-5,1,down,1984-10-06
26155,Diana Ross,1984-12-15,Diana Ross - Swept Away,12,12,20,7.0,13,Swept Away,41.0,10,-7,-1,0,1,down,1984-10-06
26156,Diana Ross,1984-12-22,Diana Ross - Swept Away,13,12,20,7.0,20,Swept Away,41.0,11,0,-7,-1,0,stay,1984-10-06
26157,Diana Ross,1984-12-29,Diana Ross - Swept Away,20,13,22,7.0,20,Swept Away,41.0,12,-2,0,-7,1,down,1984-10-06
26158,Diana Ross,1985-01-05,Diana Ross - Swept Away,20,20,22,7.0,22,Swept Away,41.0,13,0,-2,0,0,stay,1984-10-06
26159,Diana Ross,1985-01-12,Diana Ross - Swept Away,22,20,28,7.0,22,Swept Away,41.0,14,-6,0,-2,1,down,1984-10-06
26160,Diana Ross,1985-01-19,Diana Ross - Swept Away,22,22,26,7.0,28,Swept Away,41.0,15,2,-6,0,1,up,1984-10-06
26161,Diana Ross,1985-01-26,Diana Ross - Swept Away,28,22,22,7.0,26,Swept Away,41.0,16,4,2,-6,1,up,1984-10-06
26162,Diana Ross,1985-02-02,Diana Ross - Swept Away,26,28,19,7.0,22,Swept Away,41.0,17,3,4,2,1,up,1984-10-06
26163,Diana Ross,1985-02-09,Diana Ross - Swept Away,22,26,17,7.0,19,Swept Away,41.0,18,2,3,4,1,up,1984-10-06
26164,Diana Ross,1985-02-16,Diana Ross - Swept Away,19,22,12,7.0,17,Swept Away,41.0,19,5,2,3,1,up,1984-10-06
26165,Diana Ross,1985-02-23,Diana Ross - Swept Away,17,19,10,7.0,12,Swept Away,41.0,20,2,5,2,1,up,1984-10-06
26166,Diana Ross,1985-03-02,Diana Ross - Swept Away,12,17,7,7.0,10,Swept Away,41.0,21,3,2,5,1,up,1984-10-06
26167,Diana Ross,1985-03-09,Diana Ross - Swept Away,10,12,7,7.0,7,Swept Away,41.0,22,0,3,2,0,stay,1984-10-06
26168,Diana Ross,1985-03-16,Diana Ross - Swept Away,7,10,7,7.0,7,Swept Away,41.0,23,0,0,3,0,stay,1984-10-06
26169,Diana Ross,1985-03-23,Diana Ross - Swept Away,7,7,7,7.0,7,Swept Away,41.0,24,0,0,0,0,stay,1984-10-06
26170,Diana Ross,1985-03-30,Diana Ross - Swept Away,7,7,14,7.0,7,Swept Away,41.0,25,-7,0,0,1,down,1984-10-06
26171,Diana Ross,1985-04-06,Diana Ross - Swept Away,7,7,14,7.0,14,Swept Away,41.0,26,0,-7,0,0,stay,1984-10-06
26172,Diana Ross,1985-04-13,Diana Ross - Swept Away,14,7,19,7.0,14,Swept Away,41.0,27,-5,0,-7,1,down,1984-10-06
26173,Diana Ross,1985-04-20,Diana Ross - Swept Away,14,14,20,7.0,19,Swept Away,41.0,28,-1,-5,0,1,down,1984-10-06
26174,Diana Ross,1985-04-27,Diana Ross - Swept Away,19,14,22,7.0,20,Swept Away,41.0,29,-2,-1,-5,1,down,1984-10-06
26175,Diana Ross,1985-05-04,Diana Ross - Swept Away,20,19,24,7.0,22,Swept Away,41.0,30,-2,-2,-1,1,down,1984-10-06
26176,Diana Ross,1985-05-11,Diana Ross - Swept Away,22,20,37,7.0,24,Swept Away,41.0,31,-13,-2,-2,1,down,1984-10-06
26177,Diana Ross,1985-05-18,Diana Ross - Swept Away,24,22,37,7.0,37,Swept Away,41.0,32,0,-13,-2,0,stay,1984-10-06
26178,Diana Ross,1985-05-25,Diana Ross - Swept Away,37,24,41,7.0,37,Swept Away,41.0,33,-4,0,-13,1,down,1984-10-06
26179,Diana Ross,1985-06-01,Diana Ross - Swept Away,37,37,39,7.0,41,Swept Away,41.0,34,2,-4,0,1,up,1984-10-06
26180,Diana Ross,1985-06-08,Diana Ross - Swept Away,41,37,48,7.0,39,Swept Away,41.0,35,-9,2,-4,1,down,1984-10-06
26181,Diana Ross,1985-06-15,Diana Ross - Swept Away,39,41,48,7.0,48,Swept Away,41.0,36,0,-9,2,0,stay,1984-10-06
26182,Diana Ross,1985-07-13,Diana Ross - Swept Away,48,39,47,7.0,48,Swept Away,41.0,37,1,0,-9,1,up,1984-10-06
26183,Diana Ross,1985-07-20,Diana Ross - Swept Away,48,48,45,7.0,47,Swept Away,41.0,38,2,1,0,1,up,1984-10-06
26184,Diana Ross,1985-07-27,Diana Ross - Swept Away,47,48,46,7.0,45,Swept Away,41.0,39,-1,2,1,1,down,1984-10-06
26185,Diana Ross,1985-08-03,Diana Ross - Swept Away,45,47,46,7.0,46,Swept Away,41.0,40,0,-1,2,0,stay,1984-10-06
26186,Diana Ross,1985-08-10,Diana Ross - Swept Away,46,45,51,7.0,46,Swept Away,41.0,41,-5,0,-1,1,down,1984-10-06
26187,Donna Summer,1984-10-06,Donna Summer - Cats Without Claws,51,51,27,24.0,31,Cats Without Claws,6.0,0,4,20,0,1,up,1984-10-06
26188,Donna Summer,1984-10-13,Donna Summer - Cats Without Claws,31,51,24,24.0,27,Cats Without Claws,6.0,1,3,4,20,1,up,1984-10-06
26189,Donna Summer,1984-10-20,Donna Summer - Cats Without Claws,27,31,24,24.0,24,Cats Without Claws,6.0,2,0,3,4,0,stay,1984-10-06
26190,Donna Summer,1984-10-27,Donna Summer - Cats Without Claws,24,27,31,24.0,24,Cats Without Claws,6.0,3,-7,0,3,1,down,1984-10-06
26191,Donna Summer,1984-11-03,Donna Summer - Cats Without Claws,24,24,33,24.0,31,Cats Without Claws,6.0,4,-2,-7,0,1,down,1984-10-06
26192,Donna Summer,1984-11-10,Donna Summer - Cats Without Claws,31,24,42,24.0,33,Cats Without Claws,6.0,5,-9,-2,-7,1,down,1984-10-06
26193,Donna Summer,1984-11-17,Donna Summer - Cats Without Claws,33,31,51,24.0,42,Cats Without Claws,6.0,6,-9,-9,-2,1,down,1984-10-06
26194,Vanity,1984-10-06,Vanity - Wild Animal,51,51,23,14.0,40,Wild Animal,22.0,0,17,11,0,1,up,1984-10-06
26195,Vanity,1984-10-13,Vanity - Wild Animal,40,51,20,14.0,23,Wild Animal,22.0,1,3,17,11,1,up,1984-10-06
26196,Vanity,1984-10-20,Vanity - Wild Animal,23,40,18,14.0,20,Wild Animal,22.0,2,2,3,17,1,up,1984-10-06
26197,Vanity,1984-10-27,Vanity - Wild Animal,20,23,15,14.0,18,Wild Animal,22.0,3,3,2,3,1,up,1984-10-06
26198,Vanity,1984-11-03,Vanity - Wild Animal,18,20,14,14.0,15,Wild Animal,22.0,4,1,3,2,1,up,1984-10-06
26199,Vanity,1984-11-10,Vanity - Wild Animal,15,18,14,14.0,14,Wild Animal,22.0,5,0,1,3,0,stay,1984-10-06
26200,Vanity,1984-11-17,Vanity - Wild Animal,14,15,23,14.0,14,Wild Animal,22.0,6,-9,0,1,1,down,1984-10-06
26201,Vanity,1984-11-24,Vanity - Wild Animal,14,14,22,14.0,23,Wild Animal,22.0,7,1,-9,0,1,up,1984-10-06
26202,Vanity,1984-12-01,Vanity - Wild Animal,23,14,22,14.0,22,Wild Animal,22.0,8,0,1,-9,0,stay,1984-10-06
26203,Vanity,1984-12-08,Vanity - Wild Animal,22,23,37,14.0,22,Wild Animal,22.0,9,-15,0,1,1,down,1984-10-06
26204,Vanity,1984-12-15,Vanity - Wild Animal,22,22,31,14.0,37,Wild Animal,22.0,10,6,-15,0,1,up,1984-10-06
26205,Vanity,1984-12-22,Vanity - Wild Animal,37,22,31,14.0,31,Wild Animal,22.0,11,0,6,-15,0,stay,1984-10-06
26206,Vanity,1984-12-29,Vanity - Wild Animal,31,37,31,14.0,31,Wild Animal,22.0,12,0,0,6,0,stay,1984-10-06
26207,Vanity,1985-01-05,Vanity - Wild Animal,31,31,42,14.0,31,Wild Animal,22.0,13,-11,0,0,1,down,1984-10-06
26208,Vanity,1985-01-12,Vanity - Wild Animal,31,31,37,14.0,42,Wild Animal,22.0,14,5,-11,0,1,up,1984-10-06
26209,Vanity,1985-01-19,Vanity - Wild Animal,42,31,37,14.0,37,Wild Animal,22.0,15,0,5,-11,0,stay,1984-10-06
26210,Vanity,1985-01-26,Vanity - Wild Animal,37,42,35,14.0,37,Wild Animal,22.0,16,2,0,5,1,up,1984-10-06
26211,Vanity,1985-02-02,Vanity - Wild Animal,37,37,34,14.0,35,Wild Animal,22.0,17,1,2,0,1,up,1984-10-06
26212,Vanity,1985-02-09,Vanity - Wild Animal,35,37,34,14.0,34,Wild Animal,22.0,18,0,1,2,0,stay,1984-10-06
26213,Vanity,1985-02-16,Vanity - Wild Animal,34,35,42,14.0,34,Wild Animal,22.0,19,-8,0,1,1,down,1984-10-06
26214,Vanity,1985-02-23,Vanity - Wild Animal,34,34,44,14.0,42,Wild Animal,22.0,20,-2,-8,0,1,down,1984-10-06
26215,Vanity,1985-03-02,Vanity - Wild Animal,42,34,45,14.0,44,Wild Animal,22.0,21,-1,-2,-8,1,down,1984-10-06
26216,Vanity,1985-03-09,Vanity - Wild Animal,44,42,51,14.0,45,Wild Animal,22.0,22,-6,-1,-2,1,down,1984-10-06
26217,Sam Harris,1984-10-13,Sam Harris - Sam Harris,51,51,34,29.0,42,Sam Harris,11.0,0,8,9,0,1,up,1984-10-13
26218,Sam Harris,1984-10-20,Sam Harris - Sam Harris,42,51,34,29.0,34,Sam Harris,11.0,1,0,8,9,0,stay,1984-10-13
26219,Sam Harris,1984-10-27,Sam Harris - Sam Harris,34,42,30,29.0,34,Sam Harris,11.0,2,4,0,8,1,up,1984-10-13
26220,Sam Harris,1984-11-03,Sam Harris - Sam Harris,34,34,29,29.0,30,Sam Harris,11.0,3,1,4,0,1,up,1984-10-13
26221,Sam Harris,1984-11-10,Sam Harris - Sam Harris,30,34,31,29.0,29,Sam Harris,11.0,4,-2,1,4,1,down,1984-10-13
26222,Sam Harris,1984-11-17,Sam Harris - Sam Harris,29,30,30,29.0,31,Sam Harris,11.0,5,1,-2,1,1,up,1984-10-13
26223,Sam Harris,1984-11-24,Sam Harris - Sam Harris,31,29,34,29.0,30,Sam Harris,11.0,6,-4,1,-2,1,down,1984-10-13
26224,Sam Harris,1984-12-01,Sam Harris - Sam Harris,30,31,44,29.0,34,Sam Harris,11.0,7,-10,-4,1,1,down,1984-10-13
26225,Sam Harris,1984-12-08,Sam Harris - Sam Harris,34,30,44,29.0,44,Sam Harris,11.0,8,0,-10,-4,0,stay,1984-10-13
26226,Sam Harris,1984-12-15,Sam Harris - Sam Harris,44,34,46,29.0,44,Sam Harris,11.0,9,-2,0,-10,1,down,1984-10-13
26227,Sam Harris,1984-12-22,Sam Harris - Sam Harris,44,44,46,29.0,46,Sam Harris,11.0,10,0,-2,0,0,stay,1984-10-13
26228,Sam Harris,1984-12-29,Sam Harris - Sam Harris,46,44,51,29.0,46,Sam Harris,11.0,11,-5,0,-2,1,down,1984-10-13
26229,Gil Scott-Heron,1984-10-13,Gil Scott-Heron - The Best Of Gil Scott-Heron,51,51,48,45.0,48,The Best Of Gil Scott-Heron,3.0,0,0,3,0,0,stay,1984-10-13
26230,Gil Scott-Heron,1984-10-20,Gil Scott-Heron - The Best Of Gil Scott-Heron,48,51,45,45.0,48,The Best Of Gil Scott-Heron,3.0,1,3,0,3,1,up,1984-10-13
26231,Gil Scott-Heron,1984-10-27,Gil Scott-Heron - The Best Of Gil Scott-Heron,48,48,45,45.0,45,The Best Of Gil Scott-Heron,3.0,2,0,3,0,0,stay,1984-10-13
26232,Gil Scott-Heron,1984-11-03,Gil Scott-Heron - The Best Of Gil Scott-Heron,45,48,51,45.0,45,The Best Of Gil Scott-Heron,3.0,3,-6,0,3,1,down,1984-10-13
26233,New Edition,1984-10-20,New Edition - New Edition,51,51,17,1.0,33,New Edition,50.0,0,16,18,0,1,up,1984-10-20
26234,New Edition,1984-10-27,New Edition - New Edition,33,51,10,1.0,17,New Edition,50.0,1,7,16,18,1,up,1984-10-20
26235,New Edition,1984-11-03,New Edition - New Edition,17,33,8,1.0,10,New Edition,50.0,2,2,7,16,1,up,1984-10-20
26236,New Edition,1984-11-10,New Edition - New Edition,10,17,8,1.0,8,New Edition,50.0,3,0,2,7,0,stay,1984-10-20
26237,New Edition,1984-11-17,New Edition - New Edition,8,10,5,1.0,8,New Edition,50.0,4,3,0,2,1,up,1984-10-20
26238,New Edition,1984-11-24,New Edition - New Edition,8,8,5,1.0,5,New Edition,50.0,5,0,3,0,0,stay,1984-10-20
26239,New Edition,1984-12-01,New Edition - New Edition,5,8,5,1.0,5,New Edition,50.0,6,0,0,3,0,stay,1984-10-20
26240,New Edition,1984-12-08,New Edition - New Edition,5,5,6,1.0,5,New Edition,50.0,7,-1,0,0,1,down,1984-10-20
26241,New Edition,1984-12-15,New Edition - New Edition,5,5,3,1.0,6,New Edition,50.0,8,3,-1,0,1,up,1984-10-20
26242,New Edition,1984-12-22,New Edition - New Edition,6,5,3,1.0,3,New Edition,50.0,9,0,3,-1,0,stay,1984-10-20
26243,New Edition,1984-12-29,New Edition - New Edition,3,6,1,1.0,3,New Edition,50.0,10,2,0,3,1,up,1984-10-20
26244,New Edition,1985-01-05,New Edition - New Edition,3,3,1,1.0,1,New Edition,50.0,11,0,2,0,0,stay,1984-10-20
26245,New Edition,1985-01-12,New Edition - New Edition,1,3,1,1.0,1,New Edition,50.0,12,0,0,2,0,stay,1984-10-20
26246,New Edition,1985-01-19,New Edition - New Edition,1,1,1,1.0,1,New Edition,50.0,13,0,0,0,0,stay,1984-10-20
26247,New Edition,1985-01-26,New Edition - New Edition,1,1,1,1.0,1,New Edition,50.0,14,0,0,0,0,stay,1984-10-20
26248,New Edition,1985-02-02,New Edition - New Edition,1,1,2,1.0,1,New Edition,50.0,15,-1,0,0,1,down,1984-10-20
26249,New Edition,1985-02-09,New Edition - New Edition,1,1,2,1.0,2,New Edition,50.0,16,0,-1,0,0,stay,1984-10-20
26250,New Edition,1985-02-16,New Edition - New Edition,2,1,2,1.0,2,New Edition,50.0,17,0,0,-1,0,stay,1984-10-20
26251,New Edition,1985-02-23,New Edition - New Edition,2,2,2,1.0,2,New Edition,50.0,18,0,0,0,0,stay,1984-10-20
26252,New Edition,1985-03-02,New Edition - New Edition,2,2,3,1.0,2,New Edition,50.0,19,-1,0,0,1,down,1984-10-20
26253,New Edition,1985-03-09,New Edition - New Edition,2,2,4,1.0,3,New Edition,50.0,20,-1,-1,0,1,down,1984-10-20
26254,New Edition,1985-03-16,New Edition - New Edition,3,2,4,1.0,4,New Edition,50.0,21,0,-1,-1,0,stay,1984-10-20
26255,New Edition,1985-03-23,New Edition - New Edition,4,3,4,1.0,4,New Edition,50.0,22,0,0,-1,0,stay,1984-10-20
26256,New Edition,1985-03-30,New Edition - New Edition,4,4,3,1.0,4,New Edition,50.0,23,1,0,0,1,up,1984-10-20
26257,New Edition,1985-04-06,New Edition - New Edition,4,4,4,1.0,3,New Edition,50.0,24,-1,1,0,1,down,1984-10-20
26258,New Edition,1985-04-13,New Edition - New Edition,3,4,5,1.0,4,New Edition,50.0,25,-1,-1,1,1,down,1984-10-20
26259,New Edition,1985-04-20,New Edition - New Edition,4,3,7,1.0,5,New Edition,50.0,26,-2,-1,-1,1,down,1984-10-20
26260,New Edition,1985-04-27,New Edition - New Edition,5,4,8,1.0,7,New Edition,50.0,27,-1,-2,-1,1,down,1984-10-20
26261,New Edition,1985-05-04,New Edition - New Edition,7,5,8,1.0,8,New Edition,50.0,28,0,-1,-2,0,stay,1984-10-20
26262,New Edition,1985-05-11,New Edition - New Edition,8,7,8,1.0,8,New Edition,50.0,29,0,0,-1,0,stay,1984-10-20
26263,New Edition,1985-05-18,New Edition - New Edition,8,8,14,1.0,8,New Edition,50.0,30,-6,0,0,1,down,1984-10-20
26264,New Edition,1985-05-25,New Edition - New Edition,8,8,18,1.0,14,New Edition,50.0,31,-4,-6,0,1,down,1984-10-20
26265,New Edition,1985-06-01,New Edition - New Edition,14,8,18,1.0,18,New Edition,50.0,32,0,-4,-6,0,stay,1984-10-20
26266,New Edition,1985-06-08,New Edition - New Edition,18,14,18,1.0,18,New Edition,50.0,33,0,0,-4,0,stay,1984-10-20
26267,New Edition,1985-06-15,New Edition - New Edition,18,18,24,1.0,18,New Edition,50.0,34,-6,0,0,1,down,1984-10-20
26268,New Edition,1985-06-22,New Edition - New Edition,18,18,28,1.0,24,New Edition,50.0,35,-4,-6,0,1,down,1984-10-20
26269,New Edition,1985-06-29,New Edition - New Edition,24,18,38,1.0,28,New Edition,50.0,36,-10,-4,-6,1,down,1984-10-20
26270,New Edition,1985-07-06,New Edition - New Edition,28,24,37,1.0,38,New Edition,50.0,37,1,-10,-4,1,up,1984-10-20
26271,New Edition,1985-07-13,New Edition - New Edition,38,28,37,1.0,37,New Edition,50.0,38,0,1,-10,0,stay,1984-10-20
26272,New Edition,1985-07-20,New Edition - New Edition,37,38,39,1.0,37,New Edition,50.0,39,-2,0,1,1,down,1984-10-20
26273,New Edition,1985-07-27,New Edition - New Edition,37,37,41,1.0,39,New Edition,50.0,40,-2,-2,0,1,down,1984-10-20
26274,New Edition,1985-08-03,New Edition - New Edition,39,37,39,1.0,41,New Edition,50.0,41,2,-2,-2,1,up,1984-10-20
26275,New Edition,1985-08-10,New Edition - New Edition,41,39,46,1.0,39,New Edition,50.0,42,-7,2,-2,1,down,1984-10-20
26276,New Edition,1985-08-17,New Edition - New Edition,39,41,45,1.0,46,New Edition,50.0,43,1,-7,2,1,up,1984-10-20
26277,New Edition,1985-08-24,New Edition - New Edition,46,39,42,1.0,45,New Edition,50.0,44,3,1,-7,1,up,1984-10-20
26278,New Edition,1985-08-31,New Edition - New Edition,45,46,34,1.0,42,New Edition,50.0,45,8,3,1,1,up,1984-10-20
26279,New Edition,1985-09-07,New Edition - New Edition,42,45,34,1.0,34,New Edition,50.0,46,0,8,3,0,stay,1984-10-20
26280,New Edition,1985-09-14,New Edition - New Edition,34,42,49,1.0,34,New Edition,50.0,47,-15,0,8,1,down,1984-10-20
26281,New Edition,1985-09-21,New Edition - New Edition,34,34,48,1.0,49,New Edition,50.0,48,1,-15,0,1,up,1984-10-20
26282,New Edition,1985-09-28,New Edition - New Edition,49,34,48,1.0,48,New Edition,50.0,49,0,1,-15,0,stay,1984-10-20
26283,New Edition,1985-10-05,New Edition - New Edition,48,49,51,1.0,48,New Edition,50.0,50,-3,0,1,1,down,1984-10-20
26284,Rebbie Jackson,1984-10-20,Rebbie Jackson - Centipede,51,51,35,13.0,45,Centipede,16.0,0,10,6,0,1,up,1984-10-20
26285,Rebbie Jackson,1984-10-27,Rebbie Jackson - Centipede,45,51,25,13.0,35,Centipede,16.0,1,10,10,6,1,up,1984-10-20
26286,Rebbie Jackson,1984-11-03,Rebbie Jackson - Centipede,35,45,21,13.0,25,Centipede,16.0,2,4,10,10,1,up,1984-10-20
26287,Rebbie Jackson,1984-11-10,Rebbie Jackson - Centipede,25,35,20,13.0,21,Centipede,16.0,3,1,4,10,1,up,1984-10-20
26288,Rebbie Jackson,1984-11-17,Rebbie Jackson - Centipede,21,25,18,13.0,20,Centipede,16.0,4,2,1,4,1,up,1984-10-20
26289,Rebbie Jackson,1984-11-24,Rebbie Jackson - Centipede,20,21,13,13.0,18,Centipede,16.0,5,5,2,1,1,up,1984-10-20
26290,Rebbie Jackson,1984-12-01,Rebbie Jackson - Centipede,18,20,13,13.0,13,Centipede,16.0,6,0,5,2,0,stay,1984-10-20
26291,Rebbie Jackson,1984-12-08,Rebbie Jackson - Centipede,13,18,22,13.0,13,Centipede,16.0,7,-9,0,5,1,down,1984-10-20
26292,Rebbie Jackson,1984-12-15,Rebbie Jackson - Centipede,13,13,25,13.0,22,Centipede,16.0,8,-3,-9,0,1,down,1984-10-20
26293,Rebbie Jackson,1984-12-22,Rebbie Jackson - Centipede,22,13,25,13.0,25,Centipede,16.0,9,0,-3,-9,0,stay,1984-10-20
26294,Rebbie Jackson,1984-12-29,Rebbie Jackson - Centipede,25,22,37,13.0,25,Centipede,16.0,10,-12,0,-3,1,down,1984-10-20
26295,Rebbie Jackson,1985-01-05,Rebbie Jackson - Centipede,25,25,39,13.0,37,Centipede,16.0,11,-2,-12,0,1,down,1984-10-20
26296,Rebbie Jackson,1985-01-12,Rebbie Jackson - Centipede,37,25,39,13.0,39,Centipede,16.0,12,0,-2,-12,0,stay,1984-10-20
26297,Rebbie Jackson,1985-01-19,Rebbie Jackson - Centipede,39,37,47,13.0,39,Centipede,16.0,13,-8,0,-2,1,down,1984-10-20
26298,Rebbie Jackson,1985-01-26,Rebbie Jackson - Centipede,39,39,48,13.0,47,Centipede,16.0,14,-1,-8,0,1,down,1984-10-20
26299,Rebbie Jackson,1985-02-02,Rebbie Jackson - Centipede,47,39,50,13.0,48,Centipede,16.0,15,-2,-1,-8,1,down,1984-10-20
26300,Rebbie Jackson,1985-02-09,Rebbie Jackson - Centipede,48,47,51,13.0,50,Centipede,16.0,16,-1,-2,-1,1,down,1984-10-20
26301,Grandmaster Flash & The Furious Five,1984-10-20,Grandmaster Flash & The Furious Five - Grandmaster Melle Mel & The Furious Five,51,51,43,43.0,49,Grandmaster Melle Mel & The Furious Five,2.0,0,6,2,0,1,up,1984-10-20
26302,Grandmaster Flash & The Furious Five,1984-10-27,Grandmaster Flash & The Furious Five - Grandmaster Melle Mel & The Furious Five,49,51,43,43.0,43,Grandmaster Melle Mel & The Furious Five,2.0,1,0,6,2,0,stay,1984-10-20
26303,Grandmaster Flash & The Furious Five,1984-11-03,Grandmaster Flash & The Furious Five - Grandmaster Melle Mel & The Furious Five,43,49,51,43.0,43,Grandmaster Melle Mel & The Furious Five,2.0,2,-8,0,6,1,down,1984-10-20
26304,Stephanie Mills,1984-10-27,Stephanie Mills - I've Got The Cure,51,51,14,10.0,26,I've Got The Cure,15.0,0,12,25,0,1,up,1984-10-27
26305,Stephanie Mills,1984-11-03,Stephanie Mills - I've Got The Cure,26,51,10,10.0,14,I've Got The Cure,15.0,1,4,12,25,1,up,1984-10-27
26306,Stephanie Mills,1984-11-10,Stephanie Mills - I've Got The Cure,14,26,10,10.0,10,I've Got The Cure,15.0,2,0,4,12,0,stay,1984-10-27
26307,Stephanie Mills,1984-11-17,Stephanie Mills - I've Got The Cure,10,14,10,10.0,10,I've Got The Cure,15.0,3,0,0,4,0,stay,1984-10-27
26308,Stephanie Mills,1984-11-24,Stephanie Mills - I've Got The Cure,10,10,15,10.0,10,I've Got The Cure,15.0,4,-5,0,0,1,down,1984-10-27
26309,Stephanie Mills,1984-12-01,Stephanie Mills - I've Got The Cure,10,10,15,10.0,15,I've Got The Cure,15.0,5,0,-5,0,0,stay,1984-10-27
26310,Stephanie Mills,1984-12-08,Stephanie Mills - I've Got The Cure,15,10,24,10.0,15,I've Got The Cure,15.0,6,-9,0,-5,1,down,1984-10-27
26311,Stephanie Mills,1984-12-15,Stephanie Mills - I've Got The Cure,15,15,27,10.0,24,I've Got The Cure,15.0,7,-3,-9,0,1,down,1984-10-27
26312,Stephanie Mills,1984-12-22,Stephanie Mills - I've Got The Cure,24,15,27,10.0,27,I've Got The Cure,15.0,8,0,-3,-9,0,stay,1984-10-27
26313,Stephanie Mills,1984-12-29,Stephanie Mills - I've Got The Cure,27,24,27,10.0,27,I've Got The Cure,15.0,9,0,0,-3,0,stay,1984-10-27
26314,Stephanie Mills,1985-01-05,Stephanie Mills - I've Got The Cure,27,27,36,10.0,27,I've Got The Cure,15.0,10,-9,0,0,1,down,1984-10-27
26315,Stephanie Mills,1985-01-12,Stephanie Mills - I've Got The Cure,27,27,36,10.0,36,I've Got The Cure,15.0,11,0,-9,0,0,stay,1984-10-27
26316,Stephanie Mills,1985-01-19,Stephanie Mills - I've Got The Cure,36,27,44,10.0,36,I've Got The Cure,15.0,12,-8,0,-9,1,down,1984-10-27
26317,Stephanie Mills,1985-01-26,Stephanie Mills - I've Got The Cure,36,36,43,10.0,44,I've Got The Cure,15.0,13,1,-8,0,1,up,1984-10-27
26318,Stephanie Mills,1985-02-02,Stephanie Mills - I've Got The Cure,44,36,50,10.0,43,I've Got The Cure,15.0,14,-7,1,-8,1,down,1984-10-27
26319,Stephanie Mills,1985-02-16,Stephanie Mills - I've Got The Cure,43,44,51,10.0,50,I've Got The Cure,15.0,15,-1,-7,1,1,down,1984-10-27
26320,Chaka Khan,1984-10-27,Chaka Khan - I Feel For You,51,51,23,4.0,33,I Feel For You,33.0,0,10,18,0,1,up,1984-10-27
26321,Chaka Khan,1984-11-03,Chaka Khan - I Feel For You,33,51,6,4.0,23,I Feel For You,33.0,1,17,10,18,1,up,1984-10-27
26322,Chaka Khan,1984-11-10,Chaka Khan - I Feel For You,23,33,6,4.0,6,I Feel For You,33.0,2,0,17,10,0,stay,1984-10-27
26323,Chaka Khan,1984-11-17,Chaka Khan - I Feel For You,6,23,4,4.0,6,I Feel For You,33.0,3,2,0,17,1,up,1984-10-27
26324,Chaka Khan,1984-11-24,Chaka Khan - I Feel For You,6,6,4,4.0,4,I Feel For You,33.0,4,0,2,0,0,stay,1984-10-27
26325,Chaka Khan,1984-12-01,Chaka Khan - I Feel For You,4,6,4,4.0,4,I Feel For You,33.0,5,0,0,2,0,stay,1984-10-27
26326,Chaka Khan,1984-12-08,Chaka Khan - I Feel For You,4,4,4,4.0,4,I Feel For You,33.0,6,0,0,0,0,stay,1984-10-27
26327,Chaka Khan,1984-12-15,Chaka Khan - I Feel For You,4,4,5,4.0,4,I Feel For You,33.0,7,-1,0,0,1,down,1984-10-27
26328,Chaka Khan,1984-12-22,Chaka Khan - I Feel For You,4,4,5,4.0,5,I Feel For You,33.0,8,0,-1,0,0,stay,1984-10-27
26329,Chaka Khan,1984-12-29,Chaka Khan - I Feel For You,5,4,6,4.0,5,I Feel For You,33.0,9,-1,0,-1,1,down,1984-10-27
26330,Chaka Khan,1985-01-05,Chaka Khan - I Feel For You,5,5,6,4.0,6,I Feel For You,33.0,10,0,-1,0,0,stay,1984-10-27
26331,Chaka Khan,1985-01-12,Chaka Khan - I Feel For You,6,5,5,4.0,6,I Feel For You,33.0,11,1,0,-1,1,up,1984-10-27
26332,Chaka Khan,1985-01-19,Chaka Khan - I Feel For You,6,6,11,4.0,5,I Feel For You,33.0,12,-6,1,0,1,down,1984-10-27
26333,Chaka Khan,1985-01-26,Chaka Khan - I Feel For You,5,6,15,4.0,11,I Feel For You,33.0,13,-4,-6,1,1,down,1984-10-27
26334,Chaka Khan,1985-02-02,Chaka Khan - I Feel For You,11,5,15,4.0,15,I Feel For You,33.0,14,0,-4,-6,0,stay,1984-10-27
26335,Chaka Khan,1985-02-09,Chaka Khan - I Feel For You,15,11,24,4.0,15,I Feel For You,33.0,15,-9,0,-4,1,down,1984-10-27
26336,Chaka Khan,1985-02-16,Chaka Khan - I Feel For You,15,15,24,4.0,24,I Feel For You,33.0,16,0,-9,0,0,stay,1984-10-27
26337,Chaka Khan,1985-02-23,Chaka Khan - I Feel For You,24,15,24,4.0,24,I Feel For You,33.0,17,0,0,-9,0,stay,1984-10-27
26338,Chaka Khan,1985-03-02,Chaka Khan - I Feel For You,24,24,32,4.0,24,I Feel For You,33.0,18,-8,0,0,1,down,1984-10-27
26339,Chaka Khan,1985-03-09,Chaka Khan - I Feel For You,24,24,32,4.0,32,I Feel For You,33.0,19,0,-8,0,0,stay,1984-10-27
26340,Chaka Khan,1985-03-16,Chaka Khan - I Feel For You,32,24,35,4.0,32,I Feel For You,33.0,20,-3,0,-8,1,down,1984-10-27
26341,Chaka Khan,1985-03-23,Chaka Khan - I Feel For You,32,32,44,4.0,35,I Feel For You,33.0,21,-9,-3,0,1,down,1984-10-27
26342,Chaka Khan,1985-03-30,Chaka Khan - I Feel For You,35,32,43,4.0,44,I Feel For You,33.0,22,1,-9,-3,1,up,1984-10-27
26343,Chaka Khan,1985-04-06,Chaka Khan - I Feel For You,44,35,43,4.0,43,I Feel For You,33.0,23,0,1,-9,0,stay,1984-10-27
26344,Chaka Khan,1985-04-13,Chaka Khan - I Feel For You,43,44,50,4.0,43,I Feel For You,33.0,24,-7,0,1,1,down,1984-10-27
26345,Chaka Khan,1985-06-15,Chaka Khan - I Feel For You,43,43,50,4.0,50,I Feel For You,33.0,25,0,-7,0,0,stay,1984-10-27
26346,Chaka Khan,1985-06-22,Chaka Khan - I Feel For You,50,43,50,4.0,50,I Feel For You,33.0,26,0,0,-7,0,stay,1984-10-27
26347,Chaka Khan,1985-06-29,Chaka Khan - I Feel For You,50,50,45,4.0,50,I Feel For You,33.0,27,5,0,0,1,up,1984-10-27
26348,Chaka Khan,1985-07-06,Chaka Khan - I Feel For You,50,50,45,4.0,45,I Feel For You,33.0,28,0,5,0,0,stay,1984-10-27
26349,Chaka Khan,1985-07-13,Chaka Khan - I Feel For You,45,50,43,4.0,45,I Feel For You,33.0,29,2,0,5,1,up,1984-10-27
26350,Chaka Khan,1985-07-20,Chaka Khan - I Feel For You,45,45,48,4.0,43,I Feel For You,33.0,30,-5,2,0,1,down,1984-10-27
26351,Chaka Khan,1985-07-27,Chaka Khan - I Feel For You,43,45,49,4.0,48,I Feel For You,33.0,31,-1,-5,2,1,down,1984-10-27
26352,Chaka Khan,1985-08-03,Chaka Khan - I Feel For You,48,43,50,4.0,49,I Feel For You,33.0,32,-1,-1,-5,1,down,1984-10-27
26353,Chaka Khan,1985-08-10,Chaka Khan - I Feel For You,49,48,51,4.0,50,I Feel For You,33.0,33,-1,-1,-1,1,down,1984-10-27
26354,Jeffrey Osborne,1984-10-27,Jeffrey Osborne - Don't Stop,51,51,33,7.0,42,Don't Stop,28.0,0,9,9,0,1,up,1984-10-27
26355,Jeffrey Osborne,1984-11-03,Jeffrey Osborne - Don't Stop,42,51,20,7.0,33,Don't Stop,28.0,1,13,9,9,1,up,1984-10-27
26356,Jeffrey Osborne,1984-11-10,Jeffrey Osborne - Don't Stop,33,42,11,7.0,20,Don't Stop,28.0,2,9,13,9,1,up,1984-10-27
26357,Jeffrey Osborne,1984-11-17,Jeffrey Osborne - Don't Stop,20,33,11,7.0,11,Don't Stop,28.0,3,0,9,13,0,stay,1984-10-27
26358,Jeffrey Osborne,1984-11-24,Jeffrey Osborne - Don't Stop,11,20,7,7.0,11,Don't Stop,28.0,4,4,0,9,1,up,1984-10-27
26359,Jeffrey Osborne,1984-12-01,Jeffrey Osborne - Don't Stop,11,11,7,7.0,7,Don't Stop,28.0,5,0,4,0,0,stay,1984-10-27
26360,Jeffrey Osborne,1984-12-08,Jeffrey Osborne - Don't Stop,7,11,9,7.0,7,Don't Stop,28.0,6,-2,0,4,1,down,1984-10-27
26361,Jeffrey Osborne,1984-12-15,Jeffrey Osborne - Don't Stop,7,7,8,7.0,9,Don't Stop,28.0,7,1,-2,0,1,up,1984-10-27
26362,Jeffrey Osborne,1984-12-22,Jeffrey Osborne - Don't Stop,9,7,8,7.0,8,Don't Stop,28.0,8,0,1,-2,0,stay,1984-10-27
26363,Jeffrey Osborne,1984-12-29,Jeffrey Osborne - Don't Stop,8,9,9,7.0,8,Don't Stop,28.0,9,-1,0,1,1,down,1984-10-27
26364,Jeffrey Osborne,1985-01-05,Jeffrey Osborne - Don't Stop,8,8,9,7.0,9,Don't Stop,28.0,10,0,-1,0,0,stay,1984-10-27
26365,Jeffrey Osborne,1985-01-12,Jeffrey Osborne - Don't Stop,9,8,15,7.0,9,Don't Stop,28.0,11,-6,0,-1,1,down,1984-10-27
26366,Jeffrey Osborne,1985-01-19,Jeffrey Osborne - Don't Stop,9,9,15,7.0,15,Don't Stop,28.0,12,0,-6,0,0,stay,1984-10-27
26367,Jeffrey Osborne,1985-01-26,Jeffrey Osborne - Don't Stop,15,9,21,7.0,15,Don't Stop,28.0,13,-6,0,-6,1,down,1984-10-27
26368,Jeffrey Osborne,1985-02-02,Jeffrey Osborne - Don't Stop,15,15,18,7.0,21,Don't Stop,28.0,14,3,-6,0,1,up,1984-10-27
26369,Jeffrey Osborne,1985-02-09,Jeffrey Osborne - Don't Stop,21,15,18,7.0,18,Don't Stop,28.0,15,0,3,-6,0,stay,1984-10-27
26370,Jeffrey Osborne,1985-02-16,Jeffrey Osborne - Don't Stop,18,21,17,7.0,18,Don't Stop,28.0,16,1,0,3,1,up,1984-10-27
26371,Jeffrey Osborne,1985-02-23,Jeffrey Osborne - Don't Stop,18,18,19,7.0,17,Don't Stop,28.0,17,-2,1,0,1,down,1984-10-27
26372,Jeffrey Osborne,1985-03-02,Jeffrey Osborne - Don't Stop,17,18,22,7.0,19,Don't Stop,28.0,18,-3,-2,1,1,down,1984-10-27
26373,Jeffrey Osborne,1985-03-09,Jeffrey Osborne - Don't Stop,19,17,25,7.0,22,Don't Stop,28.0,19,-3,-3,-2,1,down,1984-10-27
26374,Jeffrey Osborne,1985-03-16,Jeffrey Osborne - Don't Stop,22,19,26,7.0,25,Don't Stop,28.0,20,-1,-3,-3,1,down,1984-10-27
26375,Jeffrey Osborne,1985-03-23,Jeffrey Osborne - Don't Stop,25,22,28,7.0,26,Don't Stop,28.0,21,-2,-1,-3,1,down,1984-10-27
26376,Jeffrey Osborne,1985-03-30,Jeffrey Osborne - Don't Stop,26,25,38,7.0,28,Don't Stop,28.0,22,-10,-2,-1,1,down,1984-10-27
26377,Jeffrey Osborne,1985-04-06,Jeffrey Osborne - Don't Stop,28,26,38,7.0,38,Don't Stop,28.0,23,0,-10,-2,0,stay,1984-10-27
26378,Jeffrey Osborne,1985-04-13,Jeffrey Osborne - Don't Stop,38,28,38,7.0,38,Don't Stop,28.0,24,0,0,-10,0,stay,1984-10-27
26379,Jeffrey Osborne,1985-04-20,Jeffrey Osborne - Don't Stop,38,38,40,7.0,38,Don't Stop,28.0,25,-2,0,0,1,down,1984-10-27
26380,Jeffrey Osborne,1985-04-27,Jeffrey Osborne - Don't Stop,38,38,42,7.0,40,Don't Stop,28.0,26,-2,-2,0,1,down,1984-10-27
26381,Jeffrey Osborne,1985-05-04,Jeffrey Osborne - Don't Stop,40,38,46,7.0,42,Don't Stop,28.0,27,-4,-2,-2,1,down,1984-10-27
26382,Jeffrey Osborne,1985-05-11,Jeffrey Osborne - Don't Stop,42,40,51,7.0,46,Don't Stop,28.0,28,-5,-4,-2,1,down,1984-10-27
26383,Sadao Watanabe,1984-10-27,Sadao Watanabe - Rendezvous,51,51,37,37.0,46,Rendezvous,2.0,0,9,5,0,1,up,1984-10-27
26384,Sadao Watanabe,1984-11-03,Sadao Watanabe - Rendezvous,46,51,37,37.0,37,Rendezvous,2.0,1,0,9,5,0,stay,1984-10-27
26385,Sadao Watanabe,1984-11-10,Sadao Watanabe - Rendezvous,37,46,51,37.0,37,Rendezvous,2.0,2,-14,0,9,1,down,1984-10-27
26386,Apollonia 6,1984-10-27,Apollonia 6 - Apollonia 6,51,51,42,24.0,49,Apollonia 6,13.0,0,7,2,0,1,up,1984-10-27
26387,Apollonia 6,1984-11-03,Apollonia 6 - Apollonia 6,49,51,31,24.0,42,Apollonia 6,13.0,1,11,7,2,1,up,1984-10-27
26388,Apollonia 6,1984-11-10,Apollonia 6 - Apollonia 6,42,49,24,24.0,31,Apollonia 6,13.0,2,7,11,7,1,up,1984-10-27
26389,Apollonia 6,1984-11-17,Apollonia 6 - Apollonia 6,31,42,24,24.0,24,Apollonia 6,13.0,3,0,7,11,0,stay,1984-10-27
26390,Apollonia 6,1984-11-24,Apollonia 6 - Apollonia 6,24,31,31,24.0,24,Apollonia 6,13.0,4,-7,0,7,1,down,1984-10-27
26391,Apollonia 6,1984-12-01,Apollonia 6 - Apollonia 6,24,24,41,24.0,31,Apollonia 6,13.0,5,-10,-7,0,1,down,1984-10-27
26392,Apollonia 6,1984-12-08,Apollonia 6 - Apollonia 6,31,24,42,24.0,41,Apollonia 6,13.0,6,-1,-10,-7,1,down,1984-10-27
26393,Apollonia 6,1984-12-15,Apollonia 6 - Apollonia 6,41,31,41,24.0,42,Apollonia 6,13.0,7,1,-1,-10,1,up,1984-10-27
26394,Apollonia 6,1984-12-22,Apollonia 6 - Apollonia 6,42,41,41,24.0,41,Apollonia 6,13.0,8,0,1,-1,0,stay,1984-10-27
26395,Apollonia 6,1984-12-29,Apollonia 6 - Apollonia 6,41,42,46,24.0,41,Apollonia 6,13.0,9,-5,0,1,1,down,1984-10-27
26396,Apollonia 6,1985-01-05,Apollonia 6 - Apollonia 6,41,41,45,24.0,46,Apollonia 6,13.0,10,1,-5,0,1,up,1984-10-27
26397,Apollonia 6,1985-01-12,Apollonia 6 - Apollonia 6,46,41,45,24.0,45,Apollonia 6,13.0,11,0,1,-5,0,stay,1984-10-27
26398,Apollonia 6,1985-01-19,Apollonia 6 - Apollonia 6,45,46,49,24.0,45,Apollonia 6,13.0,12,-4,0,1,1,down,1984-10-27
26399,Apollonia 6,1985-01-26,Apollonia 6 - Apollonia 6,45,45,51,24.0,49,Apollonia 6,13.0,13,-2,-4,0,1,down,1984-10-27
26400,Soundtrack,1984-11-03,Soundtrack - Beat Street Vol. II,51,51,47,47.0,47,Beat Street Vol. II,1.0,0,0,4,0,0,stay,1984-11-03
26401,Soundtrack,1984-11-10,Soundtrack - Beat Street Vol. II,47,51,51,47.0,47,Beat Street Vol. II,1.0,1,-4,0,4,1,down,1984-11-03
26402,The Staple Singers,1984-11-03,The Staple Singers - Turning Point,51,51,45,43.0,48,Turning Point,3.0,0,3,3,0,1,up,1984-11-03
26403,The Staple Singers,1984-11-10,The Staple Singers - Turning Point,48,51,43,43.0,45,Turning Point,3.0,1,2,3,3,1,up,1984-11-03
26404,The Staple Singers,1984-11-17,The Staple Singers - Turning Point,45,48,43,43.0,43,Turning Point,3.0,2,0,2,3,0,stay,1984-11-03
26405,The Staple Singers,1984-11-24,The Staple Singers - Turning Point,43,45,51,43.0,43,Turning Point,3.0,3,-8,0,2,1,down,1984-11-03
26406,Glenn Jones,1984-11-03,Glenn Jones - Finesse,51,51,44,18.0,50,Finesse,30.0,0,6,1,0,1,up,1984-11-03
26407,Glenn Jones,1984-11-10,Glenn Jones - Finesse,50,51,38,18.0,44,Finesse,30.0,1,6,6,1,1,up,1984-11-03
26408,Glenn Jones,1984-11-17,Glenn Jones - Finesse,44,50,33,18.0,38,Finesse,30.0,2,5,6,6,1,up,1984-11-03
26409,Glenn Jones,1984-11-24,Glenn Jones - Finesse,38,44,26,18.0,33,Finesse,30.0,3,7,5,6,1,up,1984-11-03
26410,Glenn Jones,1984-12-01,Glenn Jones - Finesse,33,38,20,18.0,26,Finesse,30.0,4,6,7,5,1,up,1984-11-03
26411,Glenn Jones,1984-12-08,Glenn Jones - Finesse,26,33,20,18.0,20,Finesse,30.0,5,0,6,7,0,stay,1984-11-03
26412,Glenn Jones,1984-12-15,Glenn Jones - Finesse,20,26,18,18.0,20,Finesse,30.0,6,2,0,6,1,up,1984-11-03
26413,Glenn Jones,1984-12-22,Glenn Jones - Finesse,20,20,18,18.0,18,Finesse,30.0,7,0,2,0,0,stay,1984-11-03
26414,Glenn Jones,1984-12-29,Glenn Jones - Finesse,18,20,18,18.0,18,Finesse,30.0,8,0,0,2,0,stay,1984-11-03
26415,Glenn Jones,1985-01-05,Glenn Jones - Finesse,18,18,20,18.0,18,Finesse,30.0,9,-2,0,0,1,down,1984-11-03
26416,Glenn Jones,1985-01-12,Glenn Jones - Finesse,18,18,20,18.0,20,Finesse,30.0,10,0,-2,0,0,stay,1984-11-03
26417,Glenn Jones,1985-01-19,Glenn Jones - Finesse,20,18,23,18.0,20,Finesse,30.0,11,-3,0,-2,1,down,1984-11-03
26418,Glenn Jones,1985-01-26,Glenn Jones - Finesse,20,20,25,18.0,23,Finesse,30.0,12,-2,-3,0,1,down,1984-11-03
26419,Glenn Jones,1985-02-02,Glenn Jones - Finesse,23,20,31,18.0,25,Finesse,30.0,13,-6,-2,-3,1,down,1984-11-03
26420,Glenn Jones,1985-02-09,Glenn Jones - Finesse,25,23,37,18.0,31,Finesse,30.0,14,-6,-6,-2,1,down,1984-11-03
26421,Glenn Jones,1985-02-16,Glenn Jones - Finesse,31,25,43,18.0,37,Finesse,30.0,15,-6,-6,-6,1,down,1984-11-03
26422,Glenn Jones,1985-02-23,Glenn Jones - Finesse,37,31,42,18.0,43,Finesse,30.0,16,1,-6,-6,1,up,1984-11-03
26423,Glenn Jones,1985-03-02,Glenn Jones - Finesse,43,37,42,18.0,42,Finesse,30.0,17,0,1,-6,0,stay,1984-11-03
26424,Glenn Jones,1985-03-09,Glenn Jones - Finesse,42,43,42,18.0,42,Finesse,30.0,18,0,0,1,0,stay,1984-11-03
26425,Glenn Jones,1985-03-16,Glenn Jones - Finesse,42,42,44,18.0,42,Finesse,30.0,19,-2,0,0,1,down,1984-11-03
26426,Glenn Jones,1985-03-23,Glenn Jones - Finesse,42,42,49,18.0,44,Finesse,30.0,20,-5,-2,0,1,down,1984-11-03
26427,Glenn Jones,1985-03-30,Glenn Jones - Finesse,44,42,48,18.0,49,Finesse,30.0,21,1,-5,-2,1,up,1984-11-03
26428,Glenn Jones,1985-04-06,Glenn Jones - Finesse,49,44,48,18.0,48,Finesse,30.0,22,0,1,-5,0,stay,1984-11-03
26429,Glenn Jones,1985-04-13,Glenn Jones - Finesse,48,49,47,18.0,48,Finesse,30.0,23,1,0,1,1,up,1984-11-03
26430,Glenn Jones,1985-04-20,Glenn Jones - Finesse,48,48,49,18.0,47,Finesse,30.0,24,-2,1,0,1,down,1984-11-03
26431,Glenn Jones,1985-04-27,Glenn Jones - Finesse,47,48,44,18.0,49,Finesse,30.0,25,5,-2,1,1,up,1984-11-03
26432,Glenn Jones,1985-05-04,Glenn Jones - Finesse,49,47,44,18.0,44,Finesse,30.0,26,0,5,-2,0,stay,1984-11-03
26433,Glenn Jones,1985-05-11,Glenn Jones - Finesse,44,49,42,18.0,44,Finesse,30.0,27,2,0,5,1,up,1984-11-03
26434,Glenn Jones,1985-05-18,Glenn Jones - Finesse,44,44,43,18.0,42,Finesse,30.0,28,-1,2,0,1,down,1984-11-03
26435,Glenn Jones,1985-05-25,Glenn Jones - Finesse,42,44,44,18.0,43,Finesse,30.0,29,-1,-1,2,1,down,1984-11-03
26436,Glenn Jones,1985-06-01,Glenn Jones - Finesse,43,42,51,18.0,44,Finesse,30.0,30,-7,-1,-1,1,down,1984-11-03
26437,"Grover Washington, Jr.",1984-11-10,"Grover Washington, Jr. - Inside Moves",51,51,30,21.0,41,Inside Moves,15.0,0,11,10,0,1,up,1984-11-10
26438,"Grover Washington, Jr.",1984-11-17,"Grover Washington, Jr. - Inside Moves",41,51,25,21.0,30,Inside Moves,15.0,1,5,11,10,1,up,1984-11-10
26439,"Grover Washington, Jr.",1984-11-24,"Grover Washington, Jr. - Inside Moves",30,41,23,21.0,25,Inside Moves,15.0,2,2,5,11,1,up,1984-11-10
26440,"Grover Washington, Jr.",1984-12-01,"Grover Washington, Jr. - Inside Moves",25,30,23,21.0,23,Inside Moves,15.0,3,0,2,5,0,stay,1984-11-10
26441,"Grover Washington, Jr.",1984-12-08,"Grover Washington, Jr. - Inside Moves",23,25,21,21.0,23,Inside Moves,15.0,4,2,0,2,1,up,1984-11-10
26442,"Grover Washington, Jr.",1984-12-15,"Grover Washington, Jr. - Inside Moves",23,23,21,21.0,21,Inside Moves,15.0,5,0,2,0,0,stay,1984-11-10
26443,"Grover Washington, Jr.",1984-12-22,"Grover Washington, Jr. - Inside Moves",21,23,21,21.0,21,Inside Moves,15.0,6,0,0,2,0,stay,1984-11-10
26444,"Grover Washington, Jr.",1984-12-29,"Grover Washington, Jr. - Inside Moves",21,21,24,21.0,21,Inside Moves,15.0,7,-3,0,0,1,down,1984-11-10
26445,"Grover Washington, Jr.",1985-01-05,"Grover Washington, Jr. - Inside Moves",21,21,33,21.0,24,Inside Moves,15.0,8,-9,-3,0,1,down,1984-11-10
26446,"Grover Washington, Jr.",1985-01-12,"Grover Washington, Jr. - Inside Moves",24,21,34,21.0,33,Inside Moves,15.0,9,-1,-9,-3,1,down,1984-11-10
26447,"Grover Washington, Jr.",1985-01-19,"Grover Washington, Jr. - Inside Moves",33,24,41,21.0,34,Inside Moves,15.0,10,-7,-1,-9,1,down,1984-11-10
26448,"Grover Washington, Jr.",1985-01-26,"Grover Washington, Jr. - Inside Moves",34,33,47,21.0,41,Inside Moves,15.0,11,-6,-7,-1,1,down,1984-11-10
26449,"Grover Washington, Jr.",1985-02-09,"Grover Washington, Jr. - Inside Moves",41,34,47,21.0,47,Inside Moves,15.0,12,0,-6,-7,0,stay,1984-11-10
26450,"Grover Washington, Jr.",1985-02-16,"Grover Washington, Jr. - Inside Moves",47,41,46,21.0,47,Inside Moves,15.0,13,1,0,-6,1,up,1984-11-10
26451,"Grover Washington, Jr.",1985-02-23,"Grover Washington, Jr. - Inside Moves",47,47,45,21.0,46,Inside Moves,15.0,14,1,1,0,1,up,1984-11-10
26452,"Grover Washington, Jr.",1985-03-02,"Grover Washington, Jr. - Inside Moves",46,47,51,21.0,45,Inside Moves,15.0,15,-6,1,1,1,down,1984-11-10
26453,Dazz Band,1984-11-10,Dazz Band - Jukebox,51,51,32,18.0,43,Jukebox,25.0,0,11,8,0,1,up,1984-11-10
26454,Dazz Band,1984-11-17,Dazz Band - Jukebox,43,51,20,18.0,32,Jukebox,25.0,1,12,11,8,1,up,1984-11-10
26455,Dazz Band,1984-11-24,Dazz Band - Jukebox,32,43,18,18.0,20,Jukebox,25.0,2,2,12,11,1,up,1984-11-10
26456,Dazz Band,1984-12-01,Dazz Band - Jukebox,20,32,18,18.0,18,Jukebox,25.0,3,0,2,12,0,stay,1984-11-10
26457,Dazz Band,1984-12-08,Dazz Band - Jukebox,18,20,18,18.0,18,Jukebox,25.0,4,0,0,2,0,stay,1984-11-10
26458,Dazz Band,1984-12-15,Dazz Band - Jukebox,18,18,26,18.0,18,Jukebox,25.0,5,-8,0,0,1,down,1984-11-10
26459,Dazz Band,1984-12-22,Dazz Band - Jukebox,18,18,26,18.0,26,Jukebox,25.0,6,0,-8,0,0,stay,1984-11-10
26460,Dazz Band,1984-12-29,Dazz Band - Jukebox,26,18,25,18.0,26,Jukebox,25.0,7,1,0,-8,1,up,1984-11-10
26461,Dazz Band,1985-01-05,Dazz Band - Jukebox,26,26,24,18.0,25,Jukebox,25.0,8,1,1,0,1,up,1984-11-10
26462,Dazz Band,1985-01-12,Dazz Band - Jukebox,25,26,29,18.0,24,Jukebox,25.0,9,-5,1,1,1,down,1984-11-10
26463,Dazz Band,1985-01-19,Dazz Band - Jukebox,24,25,28,18.0,29,Jukebox,25.0,10,1,-5,1,1,up,1984-11-10
26464,Dazz Band,1985-01-26,Dazz Band - Jukebox,29,24,27,18.0,28,Jukebox,25.0,11,1,1,-5,1,up,1984-11-10
26465,Dazz Band,1985-02-02,Dazz Band - Jukebox,28,29,26,18.0,27,Jukebox,25.0,12,1,1,1,1,up,1984-11-10
26466,Dazz Band,1985-02-09,Dazz Band - Jukebox,27,28,31,18.0,26,Jukebox,25.0,13,-5,1,1,1,down,1984-11-10
26467,Dazz Band,1985-02-16,Dazz Band - Jukebox,26,27,30,18.0,31,Jukebox,25.0,14,1,-5,1,1,up,1984-11-10
26468,Dazz Band,1985-02-23,Dazz Band - Jukebox,31,26,29,18.0,30,Jukebox,25.0,15,1,1,-5,1,up,1984-11-10
26469,Dazz Band,1985-03-02,Dazz Band - Jukebox,30,31,35,18.0,29,Jukebox,25.0,16,-6,1,1,1,down,1984-11-10
26470,Dazz Band,1985-03-09,Dazz Band - Jukebox,29,30,34,18.0,35,Jukebox,25.0,17,1,-6,1,1,up,1984-11-10
26471,Dazz Band,1985-03-16,Dazz Band - Jukebox,35,29,34,18.0,34,Jukebox,25.0,18,0,1,-6,0,stay,1984-11-10
26472,Dazz Band,1985-03-23,Dazz Band - Jukebox,34,35,34,18.0,34,Jukebox,25.0,19,0,0,1,0,stay,1984-11-10
26473,Dazz Band,1985-03-30,Dazz Band - Jukebox,34,34,33,18.0,34,Jukebox,25.0,20,1,0,0,1,up,1984-11-10
26474,Dazz Band,1985-04-06,Dazz Band - Jukebox,34,34,34,18.0,33,Jukebox,25.0,21,-1,1,0,1,down,1984-11-10
26475,Dazz Band,1985-04-13,Dazz Band - Jukebox,33,34,33,18.0,34,Jukebox,25.0,22,1,-1,1,1,up,1984-11-10
26476,Dazz Band,1985-04-20,Dazz Band - Jukebox,34,33,39,18.0,33,Jukebox,25.0,23,-6,1,-1,1,down,1984-11-10
26477,Dazz Band,1985-04-27,Dazz Band - Jukebox,33,34,47,18.0,39,Jukebox,25.0,24,-8,-6,1,1,down,1984-11-10
26478,Dazz Band,1985-05-04,Dazz Band - Jukebox,39,33,51,18.0,47,Jukebox,25.0,25,-4,-8,-6,1,down,1984-11-10
26479,The Controllers,1984-11-10,The Controllers - The Controllers,51,51,47,47.0,49,The Controllers,2.0,0,2,2,0,1,up,1984-11-10
26480,The Controllers,1984-11-17,The Controllers - The Controllers,49,51,47,47.0,47,The Controllers,2.0,1,0,2,2,0,stay,1984-11-10
26481,The Controllers,1984-11-24,The Controllers - The Controllers,47,49,51,47.0,47,The Controllers,2.0,2,-4,0,2,1,down,1984-11-10
26482,Champaign,1984-11-10,Champaign - Woman In Flames,51,51,45,45.0,50,Woman In Flames,2.0,0,5,1,0,1,up,1984-11-10
26483,Champaign,1984-11-17,Champaign - Woman In Flames,50,51,45,45.0,45,Woman In Flames,2.0,1,0,5,1,0,stay,1984-11-10
26484,Champaign,1984-11-24,Champaign - Woman In Flames,45,50,51,45.0,45,Woman In Flames,2.0,2,-6,0,5,1,down,1984-11-10
26485,Whodini,1984-11-17,Whodini - Escape,51,51,12,5.0,22,Escape,41.0,0,10,29,0,1,up,1984-11-17
26486,Whodini,1984-11-24,Whodini - Escape,22,51,11,5.0,12,Escape,41.0,1,1,10,29,1,up,1984-11-17
26487,Whodini,1984-12-01,Whodini - Escape,12,22,10,5.0,11,Escape,41.0,2,1,1,10,1,up,1984-11-17
26488,Whodini,1984-12-08,Whodini - Escape,11,12,7,5.0,10,Escape,41.0,3,3,1,1,1,up,1984-11-17
26489,Whodini,1984-12-15,Whodini - Escape,10,11,7,5.0,7,Escape,41.0,4,0,3,1,0,stay,1984-11-17
26490,Whodini,1984-12-22,Whodini - Escape,7,10,7,5.0,7,Escape,41.0,5,0,0,3,0,stay,1984-11-17
26491,Whodini,1984-12-29,Whodini - Escape,7,7,7,5.0,7,Escape,41.0,6,0,0,0,0,stay,1984-11-17
26492,Whodini,1985-01-05,Whodini - Escape,7,7,10,5.0,7,Escape,41.0,7,-3,0,0,1,down,1984-11-17
26493,Whodini,1985-01-12,Whodini - Escape,7,7,9,5.0,10,Escape,41.0,8,1,-3,0,1,up,1984-11-17
26494,Whodini,1985-01-19,Whodini - Escape,10,7,5,5.0,9,Escape,41.0,9,4,1,-3,1,up,1984-11-17
26495,Whodini,1985-01-26,Whodini - Escape,9,10,11,5.0,5,Escape,41.0,10,-6,4,1,1,down,1984-11-17
26496,Whodini,1985-02-02,Whodini - Escape,5,9,8,5.0,11,Escape,41.0,11,3,-6,4,1,up,1984-11-17
26497,Whodini,1985-02-09,Whodini - Escape,11,5,8,5.0,8,Escape,41.0,12,0,3,-6,0,stay,1984-11-17
26498,Whodini,1985-02-16,Whodini - Escape,8,11,11,5.0,8,Escape,41.0,13,-3,0,3,1,down,1984-11-17
26499,Whodini,1985-02-23,Whodini - Escape,8,8,11,5.0,11,Escape,41.0,14,0,-3,0,0,stay,1984-11-17
26500,Whodini,1985-03-02,Whodini - Escape,11,8,11,5.0,11,Escape,41.0,15,0,0,-3,0,stay,1984-11-17
26501,Whodini,1985-03-09,Whodini - Escape,11,11,13,5.0,11,Escape,41.0,16,-2,0,0,1,down,1984-11-17
26502,Whodini,1985-03-16,Whodini - Escape,11,11,18,5.0,13,Escape,41.0,17,-5,-2,0,1,down,1984-11-17
26503,Whodini,1985-03-23,Whodini - Escape,13,11,18,5.0,18,Escape,41.0,18,0,-5,-2,0,stay,1984-11-17
26504,Whodini,1985-03-30,Whodini - Escape,18,13,18,5.0,18,Escape,41.0,19,0,0,-5,0,stay,1984-11-17
26505,Whodini,1985-04-06,Whodini - Escape,18,18,18,5.0,18,Escape,41.0,20,0,0,0,0,stay,1984-11-17
26506,Whodini,1985-04-13,Whodini - Escape,18,18,21,5.0,18,Escape,41.0,21,-3,0,0,1,down,1984-11-17
26507,Whodini,1985-04-20,Whodini - Escape,18,18,21,5.0,21,Escape,41.0,22,0,-3,0,0,stay,1984-11-17
26508,Whodini,1985-04-27,Whodini - Escape,21,18,21,5.0,21,Escape,41.0,23,0,0,-3,0,stay,1984-11-17
26509,Whodini,1985-05-04,Whodini - Escape,21,21,21,5.0,21,Escape,41.0,24,0,0,0,0,stay,1984-11-17
26510,Whodini,1985-05-11,Whodini - Escape,21,21,22,5.0,21,Escape,41.0,25,-1,0,0,1,down,1984-11-17
26511,Whodini,1985-05-18,Whodini - Escape,21,21,21,5.0,22,Escape,41.0,26,1,-1,0,1,up,1984-11-17
26512,Whodini,1985-05-25,Whodini - Escape,22,21,21,5.0,21,Escape,41.0,27,0,1,-1,0,stay,1984-11-17
26513,Whodini,1985-06-01,Whodini - Escape,21,22,22,5.0,21,Escape,41.0,28,-1,0,1,1,down,1984-11-17
26514,Whodini,1985-06-08,Whodini - Escape,21,21,33,5.0,22,Escape,41.0,29,-11,-1,0,1,down,1984-11-17
26515,Whodini,1985-06-15,Whodini - Escape,22,21,28,5.0,33,Escape,41.0,30,5,-11,-1,1,up,1984-11-17
26516,Whodini,1985-06-22,Whodini - Escape,33,22,25,5.0,28,Escape,41.0,31,3,5,-11,1,up,1984-11-17
26517,Whodini,1985-06-29,Whodini - Escape,28,33,25,5.0,25,Escape,41.0,32,0,3,5,0,stay,1984-11-17
26518,Whodini,1985-07-06,Whodini - Escape,25,28,30,5.0,25,Escape,41.0,33,-5,0,3,1,down,1984-11-17
26519,Whodini,1985-07-13,Whodini - Escape,25,25,38,5.0,30,Escape,41.0,34,-8,-5,0,1,down,1984-11-17
26520,Whodini,1985-07-20,Whodini - Escape,30,25,38,5.0,38,Escape,41.0,35,0,-8,-5,0,stay,1984-11-17
26521,Whodini,1985-07-27,Whodini - Escape,38,30,38,5.0,38,Escape,41.0,36,0,0,-8,0,stay,1984-11-17
26522,Whodini,1985-08-03,Whodini - Escape,38,38,42,5.0,38,Escape,41.0,37,-4,0,0,1,down,1984-11-17
26523,Whodini,1985-08-10,Whodini - Escape,38,38,36,5.0,42,Escape,41.0,38,6,-4,0,1,up,1984-11-17
26524,Whodini,1985-08-17,Whodini - Escape,42,38,36,5.0,36,Escape,41.0,39,0,6,-4,0,stay,1984-11-17
26525,Whodini,1985-08-24,Whodini - Escape,36,42,39,5.0,36,Escape,41.0,40,-3,0,6,1,down,1984-11-17
26526,Whodini,1985-08-31,Whodini - Escape,36,36,51,5.0,39,Escape,41.0,41,-12,-3,0,1,down,1984-11-17
26527,Ashford & Simpson,1984-11-17,Ashford & Simpson - Solid,51,51,14,1.0,23,Solid,35.0,0,9,28,0,1,up,1984-11-17
26528,Ashford & Simpson,1984-11-24,Ashford & Simpson - Solid,23,51,9,1.0,14,Solid,35.0,1,5,9,28,1,up,1984-11-17
26529,Ashford & Simpson,1984-12-01,Ashford & Simpson - Solid,14,23,6,1.0,9,Solid,35.0,2,3,5,9,1,up,1984-11-17
26530,Ashford & Simpson,1984-12-08,Ashford & Simpson - Solid,9,14,5,1.0,6,Solid,35.0,3,1,3,5,1,up,1984-11-17
26531,Ashford & Simpson,1984-12-15,Ashford & Simpson - Solid,6,9,4,1.0,5,Solid,35.0,4,1,1,3,1,up,1984-11-17
26532,Ashford & Simpson,1984-12-22,Ashford & Simpson - Solid,5,6,4,1.0,4,Solid,35.0,5,0,1,1,0,stay,1984-11-17
26533,Ashford & Simpson,1984-12-29,Ashford & Simpson - Solid,4,5,4,1.0,4,Solid,35.0,6,0,0,1,0,stay,1984-11-17
26534,Ashford & Simpson,1985-01-05,Ashford & Simpson - Solid,4,4,4,1.0,4,Solid,35.0,7,0,0,0,0,stay,1984-11-17
26535,Ashford & Simpson,1985-01-12,Ashford & Simpson - Solid,4,4,4,1.0,4,Solid,35.0,8,0,0,0,0,stay,1984-11-17
26536,Ashford & Simpson,1985-01-19,Ashford & Simpson - Solid,4,4,3,1.0,4,Solid,35.0,9,1,0,0,1,up,1984-11-17
26537,Ashford & Simpson,1985-01-26,Ashford & Simpson - Solid,4,4,2,1.0,3,Solid,35.0,10,1,1,0,1,up,1984-11-17
26538,Ashford & Simpson,1985-02-02,Ashford & Simpson - Solid,3,4,1,1.0,2,Solid,35.0,11,1,1,1,1,up,1984-11-17
26539,Ashford & Simpson,1985-02-09,Ashford & Simpson - Solid,2,3,1,1.0,1,Solid,35.0,12,0,1,1,0,stay,1984-11-17
26540,Ashford & Simpson,1985-02-16,Ashford & Simpson - Solid,1,2,1,1.0,1,Solid,35.0,13,0,0,1,0,stay,1984-11-17
26541,Ashford & Simpson,1985-02-23,Ashford & Simpson - Solid,1,1,1,1.0,1,Solid,35.0,14,0,0,0,0,stay,1984-11-17
26542,Ashford & Simpson,1985-03-02,Ashford & Simpson - Solid,1,1,2,1.0,1,Solid,35.0,15,-1,0,0,1,down,1984-11-17
26543,Ashford & Simpson,1985-03-09,Ashford & Simpson - Solid,1,1,2,1.0,2,Solid,35.0,16,0,-1,0,0,stay,1984-11-17
26544,Ashford & Simpson,1985-03-16,Ashford & Simpson - Solid,2,1,2,1.0,2,Solid,35.0,17,0,0,-1,0,stay,1984-11-17
26545,Ashford & Simpson,1985-03-23,Ashford & Simpson - Solid,2,2,3,1.0,2,Solid,35.0,18,-1,0,0,1,down,1984-11-17
26546,Ashford & Simpson,1985-03-30,Ashford & Simpson - Solid,2,2,4,1.0,3,Solid,35.0,19,-1,-1,0,1,down,1984-11-17
26547,Ashford & Simpson,1985-04-06,Ashford & Simpson - Solid,3,2,9,1.0,4,Solid,35.0,20,-5,-1,-1,1,down,1984-11-17
26548,Ashford & Simpson,1985-04-13,Ashford & Simpson - Solid,4,3,12,1.0,9,Solid,35.0,21,-3,-5,-1,1,down,1984-11-17
26549,Ashford & Simpson,1985-04-20,Ashford & Simpson - Solid,9,4,18,1.0,12,Solid,35.0,22,-6,-3,-5,1,down,1984-11-17
26550,Ashford & Simpson,1985-04-27,Ashford & Simpson - Solid,12,9,17,1.0,18,Solid,35.0,23,1,-6,-3,1,up,1984-11-17
26551,Ashford & Simpson,1985-05-04,Ashford & Simpson - Solid,18,12,19,1.0,17,Solid,35.0,24,-2,1,-6,1,down,1984-11-17
26552,Ashford & Simpson,1985-05-11,Ashford & Simpson - Solid,17,18,21,1.0,19,Solid,35.0,25,-2,-2,1,1,down,1984-11-17
26553,Ashford & Simpson,1985-05-18,Ashford & Simpson - Solid,19,17,27,1.0,21,Solid,35.0,26,-6,-2,-2,1,down,1984-11-17
26554,Ashford & Simpson,1985-05-25,Ashford & Simpson - Solid,21,19,30,1.0,27,Solid,35.0,27,-3,-6,-2,1,down,1984-11-17
26555,Ashford & Simpson,1985-06-01,Ashford & Simpson - Solid,27,21,29,1.0,30,Solid,35.0,28,1,-3,-6,1,up,1984-11-17
26556,Ashford & Simpson,1985-06-08,Ashford & Simpson - Solid,30,27,31,1.0,29,Solid,35.0,29,-2,1,-3,1,down,1984-11-17
26557,Ashford & Simpson,1985-06-15,Ashford & Simpson - Solid,29,30,32,1.0,31,Solid,35.0,30,-1,-2,1,1,down,1984-11-17
26558,Ashford & Simpson,1985-06-22,Ashford & Simpson - Solid,31,29,34,1.0,32,Solid,35.0,31,-2,-1,-2,1,down,1984-11-17
26559,Ashford & Simpson,1985-06-29,Ashford & Simpson - Solid,32,31,42,1.0,34,Solid,35.0,32,-8,-2,-1,1,down,1984-11-17
26560,Ashford & Simpson,1985-07-06,Ashford & Simpson - Solid,34,32,43,1.0,42,Solid,35.0,33,-1,-8,-2,1,down,1984-11-17
26561,Ashford & Simpson,1985-07-13,Ashford & Simpson - Solid,42,34,46,1.0,43,Solid,35.0,34,-3,-1,-8,1,down,1984-11-17
26562,Ashford & Simpson,1985-07-20,Ashford & Simpson - Solid,43,42,51,1.0,46,Solid,35.0,35,-5,-3,-1,1,down,1984-11-17
26563,Z.Z. Hill,1984-11-17,Z.Z. Hill - Bluesmaster,51,51,37,35.0,41,Bluesmaster,6.0,0,4,10,0,1,up,1984-11-17
26564,Z.Z. Hill,1984-11-24,Z.Z. Hill - Bluesmaster,41,51,37,35.0,37,Bluesmaster,6.0,1,0,4,10,0,stay,1984-11-17
26565,Z.Z. Hill,1984-12-01,Z.Z. Hill - Bluesmaster,37,41,35,35.0,37,Bluesmaster,6.0,2,2,0,4,1,up,1984-11-17
26566,Z.Z. Hill,1984-12-08,Z.Z. Hill - Bluesmaster,37,37,35,35.0,35,Bluesmaster,6.0,3,0,2,0,0,stay,1984-11-17
26567,Z.Z. Hill,1984-12-15,Z.Z. Hill - Bluesmaster,35,37,50,35.0,35,Bluesmaster,6.0,4,-15,0,2,1,down,1984-11-17
26568,Z.Z. Hill,1984-12-22,Z.Z. Hill - Bluesmaster,35,35,50,35.0,50,Bluesmaster,6.0,5,0,-15,0,0,stay,1984-11-17
26569,Z.Z. Hill,1984-12-29,Z.Z. Hill - Bluesmaster,50,35,51,35.0,50,Bluesmaster,6.0,6,-1,0,-15,1,down,1984-11-17
26570,The Temptations,1984-11-17,The Temptations - Truly For You,51,51,34,3.0,44,Truly For You,33.0,0,10,7,0,1,up,1984-11-17
26571,The Temptations,1984-11-24,The Temptations - Truly For You,44,51,32,3.0,34,Truly For You,33.0,1,2,10,7,1,up,1984-11-17
26572,The Temptations,1984-12-01,The Temptations - Truly For You,34,44,25,3.0,32,Truly For You,33.0,2,7,2,10,1,up,1984-11-17
26573,The Temptations,1984-12-08,The Temptations - Truly For You,32,34,15,3.0,25,Truly For You,33.0,3,10,7,2,1,up,1984-11-17
26574,The Temptations,1984-12-15,The Temptations - Truly For You,25,32,14,3.0,15,Truly For You,33.0,4,1,10,7,1,up,1984-11-17
26575,The Temptations,1984-12-22,The Temptations - Truly For You,15,25,14,3.0,14,Truly For You,33.0,5,0,1,10,0,stay,1984-11-17
26576,The Temptations,1984-12-29,The Temptations - Truly For You,14,15,11,3.0,14,Truly For You,33.0,6,3,0,1,1,up,1984-11-17
26577,The Temptations,1985-01-05,The Temptations - Truly For You,14,14,11,3.0,11,Truly For You,33.0,7,0,3,0,0,stay,1984-11-17
26578,The Temptations,1985-01-12,The Temptations - Truly For You,11,14,10,3.0,11,Truly For You,33.0,8,1,0,3,1,up,1984-11-17
26579,The Temptations,1985-01-19,The Temptations - Truly For You,11,11,7,3.0,10,Truly For You,33.0,9,3,1,0,1,up,1984-11-17
26580,The Temptations,1985-01-26,The Temptations - Truly For You,10,11,5,3.0,7,Truly For You,33.0,10,2,3,1,1,up,1984-11-17
26581,The Temptations,1985-02-02,The Temptations - Truly For You,7,10,4,3.0,5,Truly For You,33.0,11,1,2,3,1,up,1984-11-17
26582,The Temptations,1985-02-09,The Temptations - Truly For You,5,7,3,3.0,4,Truly For You,33.0,12,1,1,2,1,up,1984-11-17
26583,The Temptations,1985-02-16,The Temptations - Truly For You,4,5,3,3.0,3,Truly For You,33.0,13,0,1,1,0,stay,1984-11-17
26584,The Temptations,1985-02-23,The Temptations - Truly For You,3,4,3,3.0,3,Truly For You,33.0,14,0,0,1,0,stay,1984-11-17
26585,The Temptations,1985-03-02,The Temptations - Truly For You,3,3,4,3.0,3,Truly For You,33.0,15,-1,0,0,1,down,1984-11-17
26586,The Temptations,1985-03-09,The Temptations - Truly For You,3,3,5,3.0,4,Truly For You,33.0,16,-1,-1,0,1,down,1984-11-17
26587,The Temptations,1985-03-16,The Temptations - Truly For You,4,3,5,3.0,5,Truly For You,33.0,17,0,-1,-1,0,stay,1984-11-17
26588,The Temptations,1985-03-23,The Temptations - Truly For You,5,4,5,3.0,5,Truly For You,33.0,18,0,0,-1,0,stay,1984-11-17
26589,The Temptations,1985-03-30,The Temptations - Truly For You,5,5,7,3.0,5,Truly For You,33.0,19,-2,0,0,1,down,1984-11-17
26590,The Temptations,1985-04-06,The Temptations - Truly For You,5,5,10,3.0,7,Truly For You,33.0,20,-3,-2,0,1,down,1984-11-17
26591,The Temptations,1985-04-13,The Temptations - Truly For You,7,5,16,3.0,10,Truly For You,33.0,21,-6,-3,-2,1,down,1984-11-17
26592,The Temptations,1985-04-20,The Temptations - Truly For You,10,7,17,3.0,16,Truly For You,33.0,22,-1,-6,-3,1,down,1984-11-17
26593,The Temptations,1985-04-27,The Temptations - Truly For You,16,10,19,3.0,17,Truly For You,33.0,23,-2,-1,-6,1,down,1984-11-17
26594,The Temptations,1985-05-04,The Temptations - Truly For You,17,16,23,3.0,19,Truly For You,33.0,24,-4,-2,-1,1,down,1984-11-17
26595,The Temptations,1985-05-11,The Temptations - Truly For You,19,17,23,3.0,23,Truly For You,33.0,25,0,-4,-2,0,stay,1984-11-17
26596,The Temptations,1985-05-18,The Temptations - Truly For You,23,19,28,3.0,23,Truly For You,33.0,26,-5,0,-4,1,down,1984-11-17
26597,The Temptations,1985-05-25,The Temptations - Truly For You,23,23,32,3.0,28,Truly For You,33.0,27,-4,-5,0,1,down,1984-11-17
26598,The Temptations,1985-06-01,The Temptations - Truly For You,28,23,38,3.0,32,Truly For You,33.0,28,-6,-4,-5,1,down,1984-11-17
26599,The Temptations,1985-06-08,The Temptations - Truly For You,32,28,43,3.0,38,Truly For You,33.0,29,-5,-6,-4,1,down,1984-11-17
26600,The Temptations,1985-06-22,The Temptations - Truly For You,38,32,43,3.0,43,Truly For You,33.0,30,0,-5,-6,0,stay,1984-11-17
26601,The Temptations,1985-06-29,The Temptations - Truly For You,43,38,48,3.0,43,Truly For You,33.0,31,-5,0,-5,1,down,1984-11-17
26602,The Temptations,1985-07-06,The Temptations - Truly For You,43,43,47,3.0,48,Truly For You,33.0,32,1,-5,0,1,up,1984-11-17
26603,The Temptations,1985-07-13,The Temptations - Truly For You,48,43,51,3.0,47,Truly For You,33.0,33,-4,1,-5,1,down,1984-11-17
26604,Earl Klugh,1984-11-17,Earl Klugh - Nightsongs,51,51,42,42.0,46,Nightsongs,3.0,0,4,5,0,1,up,1984-11-17
26605,Earl Klugh,1984-11-24,Earl Klugh - Nightsongs,46,51,42,42.0,42,Nightsongs,3.0,1,0,4,5,0,stay,1984-11-17
26606,Earl Klugh,1984-12-01,Earl Klugh - Nightsongs,42,46,49,42.0,42,Nightsongs,3.0,2,-7,0,4,1,down,1984-11-17
26607,Earl Klugh,1984-12-08,Earl Klugh - Nightsongs,42,42,51,42.0,49,Nightsongs,3.0,3,-2,-7,0,1,down,1984-11-17
26608,"Evelyn ""Champagne"" King",1984-11-17,"Evelyn ""Champagne"" King - So Romantic",51,51,44,38.0,48,So Romantic,6.0,0,4,3,0,1,up,1984-11-17
26609,"Evelyn ""Champagne"" King",1984-11-24,"Evelyn ""Champagne"" King - So Romantic",48,51,39,38.0,44,So Romantic,6.0,1,5,4,3,1,up,1984-11-17
26610,"Evelyn ""Champagne"" King",1984-12-01,"Evelyn ""Champagne"" King - So Romantic",44,48,38,38.0,39,So Romantic,6.0,2,1,5,4,1,up,1984-11-17
26611,"Evelyn ""Champagne"" King",1984-12-08,"Evelyn ""Champagne"" King - So Romantic",39,44,38,38.0,38,So Romantic,6.0,3,0,1,5,0,stay,1984-11-17
26612,"Evelyn ""Champagne"" King",1984-12-15,"Evelyn ""Champagne"" King - So Romantic",38,39,45,38.0,38,So Romantic,6.0,4,-7,0,1,1,down,1984-11-17
26613,"Evelyn ""Champagne"" King",1984-12-22,"Evelyn ""Champagne"" King - So Romantic",38,38,45,38.0,45,So Romantic,6.0,5,0,-7,0,0,stay,1984-11-17
26614,"Evelyn ""Champagne"" King",1984-12-29,"Evelyn ""Champagne"" King - So Romantic",45,38,51,38.0,45,So Romantic,6.0,6,-6,0,-7,1,down,1984-11-17
26615,Al Jarreau,1984-11-24,Al Jarreau - High Crime,51,51,20,12.0,39,High Crime,18.0,0,19,12,0,1,up,1984-11-24
26616,Al Jarreau,1984-12-01,Al Jarreau - High Crime,39,51,16,12.0,20,High Crime,18.0,1,4,19,12,1,up,1984-11-24
26617,Al Jarreau,1984-12-08,Al Jarreau - High Crime,20,39,12,12.0,16,High Crime,18.0,2,4,4,19,1,up,1984-11-24
26618,Al Jarreau,1984-12-15,Al Jarreau - High Crime,16,20,12,12.0,12,High Crime,18.0,3,0,4,4,0,stay,1984-11-24
26619,Al Jarreau,1984-12-22,Al Jarreau - High Crime,12,16,12,12.0,12,High Crime,18.0,4,0,0,4,0,stay,1984-11-24
26620,Al Jarreau,1984-12-29,Al Jarreau - High Crime,12,12,12,12.0,12,High Crime,18.0,5,0,0,0,0,stay,1984-11-24
26621,Al Jarreau,1985-01-05,Al Jarreau - High Crime,12,12,12,12.0,12,High Crime,18.0,6,0,0,0,0,stay,1984-11-24
26622,Al Jarreau,1985-01-12,Al Jarreau - High Crime,12,12,12,12.0,12,High Crime,18.0,7,0,0,0,0,stay,1984-11-24
26623,Al Jarreau,1985-01-19,Al Jarreau - High Crime,12,12,21,12.0,12,High Crime,18.0,8,-9,0,0,1,down,1984-11-24
26624,Al Jarreau,1985-01-26,Al Jarreau - High Crime,12,12,23,12.0,21,High Crime,18.0,9,-2,-9,0,1,down,1984-11-24
26625,Al Jarreau,1985-02-02,Al Jarreau - High Crime,21,12,25,12.0,23,High Crime,18.0,10,-2,-2,-9,1,down,1984-11-24
26626,Al Jarreau,1985-02-09,Al Jarreau - High Crime,23,21,29,12.0,25,High Crime,18.0,11,-4,-2,-2,1,down,1984-11-24
26627,Al Jarreau,1985-02-16,Al Jarreau - High Crime,25,23,26,12.0,29,High Crime,18.0,12,3,-4,-2,1,up,1984-11-24
26628,Al Jarreau,1985-02-23,Al Jarreau - High Crime,29,25,26,12.0,26,High Crime,18.0,13,0,3,-4,0,stay,1984-11-24
26629,Al Jarreau,1985-03-02,Al Jarreau - High Crime,26,29,36,12.0,26,High Crime,18.0,14,-10,0,3,1,down,1984-11-24
26630,Al Jarreau,1985-03-09,Al Jarreau - High Crime,26,26,36,12.0,36,High Crime,18.0,15,0,-10,0,0,stay,1984-11-24
26631,Al Jarreau,1985-03-16,Al Jarreau - High Crime,36,26,38,12.0,36,High Crime,18.0,16,-2,0,-10,1,down,1984-11-24
26632,Al Jarreau,1985-03-23,Al Jarreau - High Crime,36,36,46,12.0,38,High Crime,18.0,17,-8,-2,0,1,down,1984-11-24
26633,Al Jarreau,1985-03-30,Al Jarreau - High Crime,38,36,51,12.0,46,High Crime,18.0,18,-5,-8,-2,1,down,1984-11-24
26634,Daryl Hall John Oates,1984-11-24,Daryl Hall John Oates - Big Bam Boom,51,51,30,25.0,41,Big Bam Boom,20.0,0,11,10,0,1,up,1984-11-24
26635,Daryl Hall John Oates,1984-12-01,Daryl Hall John Oates - Big Bam Boom,41,51,28,25.0,30,Big Bam Boom,20.0,1,2,11,10,1,up,1984-11-24
26636,Daryl Hall John Oates,1984-12-08,Daryl Hall John Oates - Big Bam Boom,30,41,28,25.0,28,Big Bam Boom,20.0,2,0,2,11,0,stay,1984-11-24
26637,Daryl Hall John Oates,1984-12-15,Daryl Hall John Oates - Big Bam Boom,28,30,30,25.0,28,Big Bam Boom,20.0,3,-2,0,2,1,down,1984-11-24
26638,Daryl Hall John Oates,1984-12-22,Daryl Hall John Oates - Big Bam Boom,28,28,30,25.0,30,Big Bam Boom,20.0,4,0,-2,0,0,stay,1984-11-24
26639,Daryl Hall John Oates,1984-12-29,Daryl Hall John Oates - Big Bam Boom,30,28,26,25.0,30,Big Bam Boom,20.0,5,4,0,-2,1,up,1984-11-24
26640,Daryl Hall John Oates,1985-01-05,Daryl Hall John Oates - Big Bam Boom,30,30,25,25.0,26,Big Bam Boom,20.0,6,1,4,0,1,up,1984-11-24
26641,Daryl Hall John Oates,1985-01-12,Daryl Hall John Oates - Big Bam Boom,26,30,25,25.0,25,Big Bam Boom,20.0,7,0,1,4,0,stay,1984-11-24
26642,Daryl Hall John Oates,1985-01-19,Daryl Hall John Oates - Big Bam Boom,25,26,25,25.0,25,Big Bam Boom,20.0,8,0,0,1,0,stay,1984-11-24
26643,Daryl Hall John Oates,1985-01-26,Daryl Hall John Oates - Big Bam Boom,25,25,29,25.0,25,Big Bam Boom,20.0,9,-4,0,0,1,down,1984-11-24
26644,Daryl Hall John Oates,1985-02-02,Daryl Hall John Oates - Big Bam Boom,25,25,29,25.0,29,Big Bam Boom,20.0,10,0,-4,0,0,stay,1984-11-24
26645,Daryl Hall John Oates,1985-02-09,Daryl Hall John Oates - Big Bam Boom,29,25,28,25.0,29,Big Bam Boom,20.0,11,1,0,-4,1,up,1984-11-24
26646,Daryl Hall John Oates,1985-02-16,Daryl Hall John Oates - Big Bam Boom,29,29,35,25.0,28,Big Bam Boom,20.0,12,-7,1,0,1,down,1984-11-24
26647,Daryl Hall John Oates,1985-02-23,Daryl Hall John Oates - Big Bam Boom,28,29,34,25.0,35,Big Bam Boom,20.0,13,1,-7,1,1,up,1984-11-24
26648,Daryl Hall John Oates,1985-03-02,Daryl Hall John Oates - Big Bam Boom,35,28,33,25.0,34,Big Bam Boom,20.0,14,1,1,-7,1,up,1984-11-24
26649,Daryl Hall John Oates,1985-03-09,Daryl Hall John Oates - Big Bam Boom,34,35,35,25.0,33,Big Bam Boom,20.0,15,-2,1,1,1,down,1984-11-24
26650,Daryl Hall John Oates,1985-03-16,Daryl Hall John Oates - Big Bam Boom,33,34,36,25.0,35,Big Bam Boom,20.0,16,-1,-2,1,1,down,1984-11-24
26651,Daryl Hall John Oates,1985-03-23,Daryl Hall John Oates - Big Bam Boom,35,33,45,25.0,36,Big Bam Boom,20.0,17,-9,-1,-2,1,down,1984-11-24
26652,Daryl Hall John Oates,1985-03-30,Daryl Hall John Oates - Big Bam Boom,36,35,45,25.0,45,Big Bam Boom,20.0,18,0,-9,-1,0,stay,1984-11-24
26653,Daryl Hall John Oates,1985-04-06,Daryl Hall John Oates - Big Bam Boom,45,36,46,25.0,45,Big Bam Boom,20.0,19,-1,0,-9,1,down,1984-11-24
26654,Daryl Hall John Oates,1985-04-13,Daryl Hall John Oates - Big Bam Boom,45,45,51,25.0,46,Big Bam Boom,20.0,20,-5,-1,0,1,down,1984-11-24
26655,Force M.D.'s,1984-11-24,Force M.D.'s - Love Letters,51,51,38,28.0,46,Love Letters,16.0,0,8,5,0,1,up,1984-11-24
26656,Force M.D.'s,1984-12-01,Force M.D.'s - Love Letters,46,51,34,28.0,38,Love Letters,16.0,1,4,8,5,1,up,1984-11-24
26657,Force M.D.'s,1984-12-08,Force M.D.'s - Love Letters,38,46,30,28.0,34,Love Letters,16.0,2,4,4,8,1,up,1984-11-24
26658,Force M.D.'s,1984-12-15,Force M.D.'s - Love Letters,34,38,28,28.0,30,Love Letters,16.0,3,2,4,4,1,up,1984-11-24
26659,Force M.D.'s,1984-12-22,Force M.D.'s - Love Letters,30,34,28,28.0,28,Love Letters,16.0,4,0,2,4,0,stay,1984-11-24
26660,Force M.D.'s,1984-12-29,Force M.D.'s - Love Letters,28,30,28,28.0,28,Love Letters,16.0,5,0,0,2,0,stay,1984-11-24
26661,Force M.D.'s,1985-01-05,Force M.D.'s - Love Letters,28,28,28,28.0,28,Love Letters,16.0,6,0,0,0,0,stay,1984-11-24
26662,Force M.D.'s,1985-01-12,Force M.D.'s - Love Letters,28,28,33,28.0,28,Love Letters,16.0,7,-5,0,0,1,down,1984-11-24
26663,Force M.D.'s,1985-01-19,Force M.D.'s - Love Letters,28,28,33,28.0,33,Love Letters,16.0,8,0,-5,0,0,stay,1984-11-24
26664,Force M.D.'s,1985-01-26,Force M.D.'s - Love Letters,33,28,38,28.0,33,Love Letters,16.0,9,-5,0,-5,1,down,1984-11-24
26665,Force M.D.'s,1985-02-02,Force M.D.'s - Love Letters,33,33,39,28.0,38,Love Letters,16.0,10,-1,-5,0,1,down,1984-11-24
26666,Force M.D.'s,1985-02-09,Force M.D.'s - Love Letters,38,33,48,28.0,39,Love Letters,16.0,11,-9,-1,-5,1,down,1984-11-24
26667,Force M.D.'s,1985-02-16,Force M.D.'s - Love Letters,39,38,47,28.0,48,Love Letters,16.0,12,1,-9,-1,1,up,1984-11-24
26668,Force M.D.'s,1985-02-23,Force M.D.'s - Love Letters,48,39,48,28.0,47,Love Letters,16.0,13,-1,1,-9,1,down,1984-11-24
26669,Force M.D.'s,1985-03-02,Force M.D.'s - Love Letters,47,48,48,28.0,48,Love Letters,16.0,14,0,-1,1,0,stay,1984-11-24
26670,Force M.D.'s,1985-03-09,Force M.D.'s - Love Letters,48,47,48,28.0,48,Love Letters,16.0,15,0,0,-1,0,stay,1984-11-24
26671,Force M.D.'s,1985-03-16,Force M.D.'s - Love Letters,48,48,51,28.0,48,Love Letters,16.0,16,-3,0,0,1,down,1984-11-24
26672,Angela Bofill,1984-12-01,Angela Bofill - Let Me Be The One,51,51,39,39.0,41,Let Me Be The One,4.0,0,2,10,0,1,up,1984-12-01
26673,Angela Bofill,1984-12-08,Angela Bofill - Let Me Be The One,41,51,39,39.0,39,Let Me Be The One,4.0,1,0,2,10,0,stay,1984-12-01
26674,Angela Bofill,1984-12-15,Angela Bofill - Let Me Be The One,39,41,42,39.0,39,Let Me Be The One,4.0,2,-3,0,2,1,down,1984-12-01
26675,Angela Bofill,1984-12-22,Angela Bofill - Let Me Be The One,39,39,42,39.0,42,Let Me Be The One,4.0,3,0,-3,0,0,stay,1984-12-01
26676,Angela Bofill,1984-12-29,Angela Bofill - Let Me Be The One,42,39,51,39.0,42,Let Me Be The One,4.0,4,-9,0,-3,1,down,1984-12-01
26677,Fat Boys,1984-12-01,Fat Boys - Fat Boys,51,51,32,6.0,45,Fat Boys,25.0,0,13,6,0,1,up,1984-12-01
26678,Fat Boys,1984-12-08,Fat Boys - Fat Boys,45,51,19,6.0,32,Fat Boys,25.0,1,13,13,6,1,up,1984-12-01
26679,Fat Boys,1984-12-15,Fat Boys - Fat Boys,32,45,15,6.0,19,Fat Boys,25.0,2,4,13,13,1,up,1984-12-01
26680,Fat Boys,1984-12-22,Fat Boys - Fat Boys,19,32,15,6.0,15,Fat Boys,25.0,3,0,4,13,0,stay,1984-12-01
26681,Fat Boys,1984-12-29,Fat Boys - Fat Boys,15,19,10,6.0,15,Fat Boys,25.0,4,5,0,4,1,up,1984-12-01
26682,Fat Boys,1985-01-05,Fat Boys - Fat Boys,15,15,7,6.0,10,Fat Boys,25.0,5,3,5,0,1,up,1984-12-01
26683,Fat Boys,1985-01-12,Fat Boys - Fat Boys,10,15,7,6.0,7,Fat Boys,25.0,6,0,3,5,0,stay,1984-12-01
26684,Fat Boys,1985-01-19,Fat Boys - Fat Boys,7,10,6,6.0,7,Fat Boys,25.0,7,1,0,3,1,up,1984-12-01
26685,Fat Boys,1985-01-26,Fat Boys - Fat Boys,7,7,6,6.0,6,Fat Boys,25.0,8,0,1,0,0,stay,1984-12-01
26686,Fat Boys,1985-02-02,Fat Boys - Fat Boys,6,7,6,6.0,6,Fat Boys,25.0,9,0,0,1,0,stay,1984-12-01
26687,Fat Boys,1985-02-09,Fat Boys - Fat Boys,6,6,10,6.0,6,Fat Boys,25.0,10,-4,0,0,1,down,1984-12-01
26688,Fat Boys,1985-02-16,Fat Boys - Fat Boys,6,6,16,6.0,10,Fat Boys,25.0,11,-6,-4,0,1,down,1984-12-01
26689,Fat Boys,1985-02-23,Fat Boys - Fat Boys,10,6,15,6.0,16,Fat Boys,25.0,12,1,-6,-4,1,up,1984-12-01
26690,Fat Boys,1985-03-02,Fat Boys - Fat Boys,16,10,16,6.0,15,Fat Boys,25.0,13,-1,1,-6,1,down,1984-12-01
26691,Fat Boys,1985-03-09,Fat Boys - Fat Boys,15,16,15,6.0,16,Fat Boys,25.0,14,1,-1,1,1,up,1984-12-01
26692,Fat Boys,1985-03-16,Fat Boys - Fat Boys,16,15,21,6.0,15,Fat Boys,25.0,15,-6,1,-1,1,down,1984-12-01
26693,Fat Boys,1985-03-23,Fat Boys - Fat Boys,15,16,22,6.0,21,Fat Boys,25.0,16,-1,-6,1,1,down,1984-12-01
26694,Fat Boys,1985-03-30,Fat Boys - Fat Boys,21,15,26,6.0,22,Fat Boys,25.0,17,-4,-1,-6,1,down,1984-12-01
26695,Fat Boys,1985-04-06,Fat Boys - Fat Boys,22,21,26,6.0,26,Fat Boys,25.0,18,0,-4,-1,0,stay,1984-12-01
26696,Fat Boys,1985-04-13,Fat Boys - Fat Boys,26,22,28,6.0,26,Fat Boys,25.0,19,-2,0,-4,1,down,1984-12-01
26697,Fat Boys,1985-04-20,Fat Boys - Fat Boys,26,26,30,6.0,28,Fat Boys,25.0,20,-2,-2,0,1,down,1984-12-01
26698,Fat Boys,1985-04-27,Fat Boys - Fat Boys,28,26,41,6.0,30,Fat Boys,25.0,21,-11,-2,-2,1,down,1984-12-01
26699,Fat Boys,1985-05-04,Fat Boys - Fat Boys,30,28,41,6.0,41,Fat Boys,25.0,22,0,-11,-2,0,stay,1984-12-01
26700,Fat Boys,1985-05-11,Fat Boys - Fat Boys,41,30,40,6.0,41,Fat Boys,25.0,23,1,0,-11,1,up,1984-12-01
26701,Fat Boys,1985-05-18,Fat Boys - Fat Boys,41,41,49,6.0,40,Fat Boys,25.0,24,-9,1,0,1,down,1984-12-01
26702,Fat Boys,1985-05-25,Fat Boys - Fat Boys,40,41,51,6.0,49,Fat Boys,25.0,25,-2,-9,1,1,down,1984-12-01
26703,Philip Bailey,1984-12-01,Philip Bailey - Chinese Wall,51,51,42,10.0,46,Chinese Wall,26.0,0,4,5,0,1,up,1984-12-01
26704,Philip Bailey,1984-12-08,Philip Bailey - Chinese Wall,46,51,41,10.0,42,Chinese Wall,26.0,1,1,4,5,1,up,1984-12-01
26705,Philip Bailey,1984-12-15,Philip Bailey - Chinese Wall,42,46,38,10.0,41,Chinese Wall,26.0,2,3,1,4,1,up,1984-12-01
26706,Philip Bailey,1984-12-22,Philip Bailey - Chinese Wall,41,42,38,10.0,38,Chinese Wall,26.0,3,0,3,1,0,stay,1984-12-01
26707,Philip Bailey,1984-12-29,Philip Bailey - Chinese Wall,38,41,30,10.0,38,Chinese Wall,26.0,4,8,0,3,1,up,1984-12-01
26708,Philip Bailey,1985-01-05,Philip Bailey - Chinese Wall,38,38,23,10.0,30,Chinese Wall,26.0,5,7,8,0,1,up,1984-12-01
26709,Philip Bailey,1985-01-12,Philip Bailey - Chinese Wall,30,38,21,10.0,23,Chinese Wall,26.0,6,2,7,8,1,up,1984-12-01
26710,Philip Bailey,1985-01-19,Philip Bailey - Chinese Wall,23,30,19,10.0,21,Chinese Wall,26.0,7,2,2,7,1,up,1984-12-01
26711,Philip Bailey,1985-01-26,Philip Bailey - Chinese Wall,21,23,19,10.0,19,Chinese Wall,26.0,8,0,2,2,0,stay,1984-12-01
26712,Philip Bailey,1985-02-02,Philip Bailey - Chinese Wall,19,21,16,10.0,19,Chinese Wall,26.0,9,3,0,2,1,up,1984-12-01
26713,Philip Bailey,1985-02-09,Philip Bailey - Chinese Wall,19,19,15,10.0,16,Chinese Wall,26.0,10,1,3,0,1,up,1984-12-01
26714,Philip Bailey,1985-02-16,Philip Bailey - Chinese Wall,16,19,15,10.0,15,Chinese Wall,26.0,11,0,1,3,0,stay,1984-12-01
26715,Philip Bailey,1985-02-23,Philip Bailey - Chinese Wall,15,16,13,10.0,15,Chinese Wall,26.0,12,2,0,1,1,up,1984-12-01
26716,Philip Bailey,1985-03-02,Philip Bailey - Chinese Wall,15,15,12,10.0,13,Chinese Wall,26.0,13,1,2,0,1,up,1984-12-01
26717,Philip Bailey,1985-03-09,Philip Bailey - Chinese Wall,13,15,10,10.0,12,Chinese Wall,26.0,14,2,1,2,1,up,1984-12-01
26718,Philip Bailey,1985-03-16,Philip Bailey - Chinese Wall,12,13,12,10.0,10,Chinese Wall,26.0,15,-2,2,1,1,down,1984-12-01
26719,Philip Bailey,1985-03-23,Philip Bailey - Chinese Wall,10,12,21,10.0,12,Chinese Wall,26.0,16,-9,-2,2,1,down,1984-12-01
26720,Philip Bailey,1985-03-30,Philip Bailey - Chinese Wall,12,10,25,10.0,21,Chinese Wall,26.0,17,-4,-9,-2,1,down,1984-12-01
26721,Philip Bailey,1985-04-06,Philip Bailey - Chinese Wall,21,12,28,10.0,25,Chinese Wall,26.0,18,-3,-4,-9,1,down,1984-12-01
26722,Philip Bailey,1985-04-13,Philip Bailey - Chinese Wall,25,21,35,10.0,28,Chinese Wall,26.0,19,-7,-3,-4,1,down,1984-12-01
26723,Philip Bailey,1985-04-20,Philip Bailey - Chinese Wall,28,25,42,10.0,35,Chinese Wall,26.0,20,-7,-7,-3,1,down,1984-12-01
26724,Philip Bailey,1985-04-27,Philip Bailey - Chinese Wall,35,28,48,10.0,42,Chinese Wall,26.0,21,-6,-7,-7,1,down,1984-12-01
26725,Philip Bailey,1985-05-04,Philip Bailey - Chinese Wall,42,35,50,10.0,48,Chinese Wall,26.0,22,-2,-6,-7,1,down,1984-12-01
26726,Philip Bailey,1985-05-18,Philip Bailey - Chinese Wall,48,42,48,10.0,50,Chinese Wall,26.0,23,2,-2,-6,1,up,1984-12-01
26727,Philip Bailey,1985-05-25,Philip Bailey - Chinese Wall,50,48,48,10.0,48,Chinese Wall,26.0,24,0,2,-2,0,stay,1984-12-01
26728,Philip Bailey,1985-06-01,Philip Bailey - Chinese Wall,48,50,47,10.0,48,Chinese Wall,26.0,25,1,0,2,1,up,1984-12-01
26729,Philip Bailey,1985-06-08,Philip Bailey - Chinese Wall,48,48,51,10.0,47,Chinese Wall,26.0,26,-4,1,0,1,down,1984-12-01
26730,Dreamboy,1984-12-01,Dreamboy - Contact,51,51,45,45.0,50,Contact,2.0,0,5,1,0,1,up,1984-12-01
26731,Dreamboy,1984-12-08,Dreamboy - Contact,50,51,45,45.0,45,Contact,2.0,1,0,5,1,0,stay,1984-12-01
26732,Dreamboy,1984-12-15,Dreamboy - Contact,45,50,51,45.0,45,Contact,2.0,2,-6,0,5,1,down,1984-12-01
26733,Jermaine Stewart,1984-12-08,Jermaine Stewart - The Word Is Out,51,51,36,30.0,48,The Word Is Out,12.0,0,12,3,0,1,up,1984-12-08
26734,Jermaine Stewart,1984-12-15,Jermaine Stewart - The Word Is Out,48,51,33,30.0,36,The Word Is Out,12.0,1,3,12,3,1,up,1984-12-08
26735,Jermaine Stewart,1984-12-22,Jermaine Stewart - The Word Is Out,36,48,33,30.0,33,The Word Is Out,12.0,2,0,3,12,0,stay,1984-12-08
26736,Jermaine Stewart,1984-12-29,Jermaine Stewart - The Word Is Out,33,36,33,30.0,33,The Word Is Out,12.0,3,0,0,3,0,stay,1984-12-08
26737,Jermaine Stewart,1985-01-05,Jermaine Stewart - The Word Is Out,33,33,30,30.0,33,The Word Is Out,12.0,4,3,0,0,1,up,1984-12-08
26738,Jermaine Stewart,1985-01-12,Jermaine Stewart - The Word Is Out,33,33,30,30.0,30,The Word Is Out,12.0,5,0,3,0,0,stay,1984-12-08
26739,Jermaine Stewart,1985-01-19,Jermaine Stewart - The Word Is Out,30,33,30,30.0,30,The Word Is Out,12.0,6,0,0,3,0,stay,1984-12-08
26740,Jermaine Stewart,1985-01-26,Jermaine Stewart - The Word Is Out,30,30,39,30.0,30,The Word Is Out,12.0,7,-9,0,0,1,down,1984-12-08
26741,Jermaine Stewart,1985-02-02,Jermaine Stewart - The Word Is Out,30,30,41,30.0,39,The Word Is Out,12.0,8,-2,-9,0,1,down,1984-12-08
26742,Jermaine Stewart,1985-02-09,Jermaine Stewart - The Word Is Out,39,30,49,30.0,41,The Word Is Out,12.0,9,-8,-2,-9,1,down,1984-12-08
26743,Jermaine Stewart,1985-02-16,Jermaine Stewart - The Word Is Out,41,39,50,30.0,49,The Word Is Out,12.0,10,-1,-8,-2,1,down,1984-12-08
26744,Jermaine Stewart,1985-03-02,Jermaine Stewart - The Word Is Out,49,41,50,30.0,50,The Word Is Out,12.0,11,0,-1,-8,0,stay,1984-12-08
26745,Jermaine Stewart,1985-03-09,Jermaine Stewart - The Word Is Out,50,49,51,30.0,50,The Word Is Out,12.0,12,-1,0,-1,1,down,1984-12-08
26746,Midnight Star,1984-12-15,Midnight Star - Planetary Invasion,51,51,11,7.0,16,Planetary Invasion,30.0,0,5,35,0,1,up,1984-12-15
26747,Midnight Star,1984-12-22,Midnight Star - Planetary Invasion,16,51,11,7.0,11,Planetary Invasion,30.0,1,0,5,35,0,stay,1984-12-15
26748,Midnight Star,1984-12-29,Midnight Star - Planetary Invasion,11,16,8,7.0,11,Planetary Invasion,30.0,2,3,0,5,1,up,1984-12-15
26749,Midnight Star,1985-01-05,Midnight Star - Planetary Invasion,11,11,8,7.0,8,Planetary Invasion,30.0,3,0,3,0,0,stay,1984-12-15
26750,Midnight Star,1985-01-12,Midnight Star - Planetary Invasion,8,11,8,7.0,8,Planetary Invasion,30.0,4,0,0,3,0,stay,1984-12-15
26751,Midnight Star,1985-01-19,Midnight Star - Planetary Invasion,8,8,8,7.0,8,Planetary Invasion,30.0,5,0,0,0,0,stay,1984-12-15
26752,Midnight Star,1985-01-26,Midnight Star - Planetary Invasion,8,8,7,7.0,8,Planetary Invasion,30.0,6,1,0,0,1,up,1984-12-15
26753,Midnight Star,1985-02-02,Midnight Star - Planetary Invasion,8,8,7,7.0,7,Planetary Invasion,30.0,7,0,1,0,0,stay,1984-12-15
26754,Midnight Star,1985-02-09,Midnight Star - Planetary Invasion,7,8,9,7.0,7,Planetary Invasion,30.0,8,-2,0,1,1,down,1984-12-15
26755,Midnight Star,1985-02-16,Midnight Star - Planetary Invasion,7,7,8,7.0,9,Planetary Invasion,30.0,9,1,-2,0,1,up,1984-12-15
26756,Midnight Star,1985-02-23,Midnight Star - Planetary Invasion,9,7,8,7.0,8,Planetary Invasion,30.0,10,0,1,-2,0,stay,1984-12-15
26757,Midnight Star,1985-03-02,Midnight Star - Planetary Invasion,8,9,9,7.0,8,Planetary Invasion,30.0,11,-1,0,1,1,down,1984-12-15
26758,Midnight Star,1985-03-09,Midnight Star - Planetary Invasion,8,8,11,7.0,9,Planetary Invasion,30.0,12,-2,-1,0,1,down,1984-12-15
26759,Midnight Star,1985-03-16,Midnight Star - Planetary Invasion,9,8,13,7.0,11,Planetary Invasion,30.0,13,-2,-2,-1,1,down,1984-12-15
26760,Midnight Star,1985-03-23,Midnight Star - Planetary Invasion,11,9,13,7.0,13,Planetary Invasion,30.0,14,0,-2,-2,0,stay,1984-12-15
26761,Midnight Star,1985-03-30,Midnight Star - Planetary Invasion,13,11,13,7.0,13,Planetary Invasion,30.0,15,0,0,-2,0,stay,1984-12-15
26762,Midnight Star,1985-04-06,Midnight Star - Planetary Invasion,13,13,23,7.0,13,Planetary Invasion,30.0,16,-10,0,0,1,down,1984-12-15
26763,Midnight Star,1985-04-13,Midnight Star - Planetary Invasion,13,13,23,7.0,23,Planetary Invasion,30.0,17,0,-10,0,0,stay,1984-12-15
26764,Midnight Star,1985-04-20,Midnight Star - Planetary Invasion,23,13,23,7.0,23,Planetary Invasion,30.0,18,0,0,-10,0,stay,1984-12-15
26765,Midnight Star,1985-04-27,Midnight Star - Planetary Invasion,23,23,23,7.0,23,Planetary Invasion,30.0,19,0,0,0,0,stay,1984-12-15
26766,Midnight Star,1985-05-04,Midnight Star - Planetary Invasion,23,23,25,7.0,23,Planetary Invasion,30.0,20,-2,0,0,1,down,1984-12-15
26767,Midnight Star,1985-05-11,Midnight Star - Planetary Invasion,23,23,28,7.0,25,Planetary Invasion,30.0,21,-3,-2,0,1,down,1984-12-15
26768,Midnight Star,1985-05-18,Midnight Star - Planetary Invasion,25,23,39,7.0,28,Planetary Invasion,30.0,22,-11,-3,-2,1,down,1984-12-15
26769,Midnight Star,1985-05-25,Midnight Star - Planetary Invasion,28,25,38,7.0,39,Planetary Invasion,30.0,23,1,-11,-3,1,up,1984-12-15
26770,Midnight Star,1985-06-01,Midnight Star - Planetary Invasion,39,28,49,7.0,38,Planetary Invasion,30.0,24,-11,1,-11,1,down,1984-12-15
26771,Midnight Star,1985-06-15,Midnight Star - Planetary Invasion,38,39,48,7.0,49,Planetary Invasion,30.0,25,1,-11,1,1,up,1984-12-15
26772,Midnight Star,1985-06-22,Midnight Star - Planetary Invasion,49,38,48,7.0,48,Planetary Invasion,30.0,26,0,1,-11,0,stay,1984-12-15
26773,Midnight Star,1985-06-29,Midnight Star - Planetary Invasion,48,49,46,7.0,48,Planetary Invasion,30.0,27,2,0,1,1,up,1984-12-15
26774,Midnight Star,1985-07-06,Midnight Star - Planetary Invasion,48,48,46,7.0,46,Planetary Invasion,30.0,28,0,2,0,0,stay,1984-12-15
26775,Midnight Star,1985-07-13,Midnight Star - Planetary Invasion,46,48,45,7.0,46,Planetary Invasion,30.0,29,1,0,2,1,up,1984-12-15
26776,Midnight Star,1985-07-20,Midnight Star - Planetary Invasion,46,46,51,7.0,45,Planetary Invasion,30.0,30,-6,1,0,1,down,1984-12-15
26777,The Whispers,1984-12-15,The Whispers - So Good,51,51,19,8.0,29,So Good,24.0,0,10,22,0,1,up,1984-12-15
26778,The Whispers,1984-12-22,The Whispers - So Good,29,51,19,8.0,19,So Good,24.0,1,0,10,22,0,stay,1984-12-15
26779,The Whispers,1984-12-29,The Whispers - So Good,19,29,13,8.0,19,So Good,24.0,2,6,0,10,1,up,1984-12-15
26780,The Whispers,1985-01-05,The Whispers - So Good,19,19,13,8.0,13,So Good,24.0,3,0,6,0,0,stay,1984-12-15
26781,The Whispers,1985-01-12,The Whispers - So Good,13,19,13,8.0,13,So Good,24.0,4,0,0,6,0,stay,1984-12-15
26782,The Whispers,1985-01-19,The Whispers - So Good,13,13,13,8.0,13,So Good,24.0,5,0,0,0,0,stay,1984-12-15
26783,The Whispers,1985-01-26,The Whispers - So Good,13,13,13,8.0,13,So Good,24.0,6,0,0,0,0,stay,1984-12-15
26784,The Whispers,1985-02-02,The Whispers - So Good,13,13,13,8.0,13,So Good,24.0,7,0,0,0,0,stay,1984-12-15
26785,The Whispers,1985-02-09,The Whispers - So Good,13,13,13,8.0,13,So Good,24.0,8,0,0,0,0,stay,1984-12-15
26786,The Whispers,1985-02-16,The Whispers - So Good,13,13,13,8.0,13,So Good,24.0,9,0,0,0,0,stay,1984-12-15
26787,The Whispers,1985-02-23,The Whispers - So Good,13,13,12,8.0,13,So Good,24.0,10,1,0,0,1,up,1984-12-15
26788,The Whispers,1985-03-02,The Whispers - So Good,13,13,8,8.0,12,So Good,24.0,11,4,1,0,1,up,1984-12-15
26789,The Whispers,1985-03-09,The Whispers - So Good,12,13,12,8.0,8,So Good,24.0,12,-4,4,1,1,down,1984-12-15
26790,The Whispers,1985-03-16,The Whispers - So Good,8,12,10,8.0,12,So Good,24.0,13,2,-4,4,1,up,1984-12-15
26791,The Whispers,1985-03-23,The Whispers - So Good,12,8,10,8.0,10,So Good,24.0,14,0,2,-4,0,stay,1984-12-15
26792,The Whispers,1985-03-30,The Whispers - So Good,10,12,17,8.0,10,So Good,24.0,15,-7,0,2,1,down,1984-12-15
26793,The Whispers,1985-04-06,The Whispers - So Good,10,10,21,8.0,17,So Good,24.0,16,-4,-7,0,1,down,1984-12-15
26794,The Whispers,1985-04-13,The Whispers - So Good,17,10,25,8.0,21,So Good,24.0,17,-4,-4,-7,1,down,1984-12-15
26795,The Whispers,1985-04-20,The Whispers - So Good,21,17,25,8.0,25,So Good,24.0,18,0,-4,-4,0,stay,1984-12-15
26796,The Whispers,1985-04-27,The Whispers - So Good,25,21,28,8.0,25,So Good,24.0,19,-3,0,-4,1,down,1984-12-15
26797,The Whispers,1985-05-04,The Whispers - So Good,25,25,33,8.0,28,So Good,24.0,20,-5,-3,0,1,down,1984-12-15
26798,The Whispers,1985-05-11,The Whispers - So Good,28,25,39,8.0,33,So Good,24.0,21,-6,-5,-3,1,down,1984-12-15
26799,The Whispers,1985-05-18,The Whispers - So Good,33,28,50,8.0,39,So Good,24.0,22,-11,-6,-5,1,down,1984-12-15
26800,The Whispers,1985-05-25,The Whispers - So Good,39,33,50,8.0,50,So Good,24.0,23,0,-11,-6,0,stay,1984-12-15
26801,The Whispers,1985-06-01,The Whispers - So Good,50,39,51,8.0,50,So Good,24.0,24,-1,0,-11,1,down,1984-12-15
26802,Kool & The Gang,1984-12-15,Kool & The Gang - Emergency,51,51,17,3.0,34,Emergency,54.0,0,17,17,0,1,up,1984-12-15
26803,Kool & The Gang,1984-12-22,Kool & The Gang - Emergency,34,51,17,3.0,17,Emergency,54.0,1,0,17,17,0,stay,1984-12-15
26804,Kool & The Gang,1984-12-29,Kool & The Gang - Emergency,17,34,16,3.0,17,Emergency,54.0,2,1,0,17,1,up,1984-12-15
26805,Kool & The Gang,1985-01-05,Kool & The Gang - Emergency,17,17,15,3.0,16,Emergency,54.0,3,1,1,0,1,up,1984-12-15
26806,Kool & The Gang,1985-01-12,Kool & The Gang - Emergency,16,17,14,3.0,15,Emergency,54.0,4,1,1,1,1,up,1984-12-15
26807,Kool & The Gang,1985-01-19,Kool & The Gang - Emergency,15,16,12,3.0,14,Emergency,54.0,5,2,1,1,1,up,1984-12-15
26808,Kool & The Gang,1985-01-26,Kool & The Gang - Emergency,14,15,9,3.0,12,Emergency,54.0,6,3,2,1,1,up,1984-12-15
26809,Kool & The Gang,1985-02-02,Kool & The Gang - Emergency,12,14,9,3.0,9,Emergency,54.0,7,0,3,2,0,stay,1984-12-15
26810,Kool & The Gang,1985-02-09,Kool & The Gang - Emergency,9,12,7,3.0,9,Emergency,54.0,8,2,0,3,1,up,1984-12-15
26811,Kool & The Gang,1985-02-16,Kool & The Gang - Emergency,9,9,7,3.0,7,Emergency,54.0,9,0,2,0,0,stay,1984-12-15
26812,Kool & The Gang,1985-02-23,Kool & The Gang - Emergency,7,9,6,3.0,7,Emergency,54.0,10,1,0,2,1,up,1984-12-15
26813,Kool & The Gang,1985-03-02,Kool & The Gang - Emergency,7,7,6,3.0,6,Emergency,54.0,11,0,1,0,0,stay,1984-12-15
26814,Kool & The Gang,1985-03-09,Kool & The Gang - Emergency,6,7,6,3.0,6,Emergency,54.0,12,0,0,1,0,stay,1984-12-15
26815,Kool & The Gang,1985-03-16,Kool & The Gang - Emergency,6,6,8,3.0,6,Emergency,54.0,13,-2,0,0,1,down,1984-12-15
26816,Kool & The Gang,1985-03-23,Kool & The Gang - Emergency,6,6,8,3.0,8,Emergency,54.0,14,0,-2,0,0,stay,1984-12-15
26817,Kool & The Gang,1985-03-30,Kool & The Gang - Emergency,8,6,6,3.0,8,Emergency,54.0,15,2,0,-2,1,up,1984-12-15
26818,Kool & The Gang,1985-04-06,Kool & The Gang - Emergency,8,8,5,3.0,6,Emergency,54.0,16,1,2,0,1,up,1984-12-15
26819,Kool & The Gang,1985-04-13,Kool & The Gang - Emergency,6,8,7,3.0,5,Emergency,54.0,17,-2,1,2,1,down,1984-12-15
26820,Kool & The Gang,1985-04-20,Kool & The Gang - Emergency,5,6,5,3.0,7,Emergency,54.0,18,2,-2,1,1,up,1984-12-15
26821,Kool & The Gang,1985-04-27,Kool & The Gang - Emergency,7,5,6,3.0,5,Emergency,54.0,19,-1,2,-2,1,down,1984-12-15
26822,Kool & The Gang,1985-05-04,Kool & The Gang - Emergency,5,7,5,3.0,6,Emergency,54.0,20,1,-1,2,1,up,1984-12-15
26823,Kool & The Gang,1985-05-11,Kool & The Gang - Emergency,6,5,4,3.0,5,Emergency,54.0,21,1,1,-1,1,up,1984-12-15
26824,Kool & The Gang,1985-05-18,Kool & The Gang - Emergency,5,6,3,3.0,4,Emergency,54.0,22,1,1,1,1,up,1984-12-15
26825,Kool & The Gang,1985-05-25,Kool & The Gang - Emergency,4,5,3,3.0,3,Emergency,54.0,23,0,1,1,0,stay,1984-12-15
26826,Kool & The Gang,1985-06-01,Kool & The Gang - Emergency,3,4,4,3.0,3,Emergency,54.0,24,-1,0,1,1,down,1984-12-15
26827,Kool & The Gang,1985-06-08,Kool & The Gang - Emergency,3,3,7,3.0,4,Emergency,54.0,25,-3,-1,0,1,down,1984-12-15
26828,Kool & The Gang,1985-06-15,Kool & The Gang - Emergency,4,3,7,3.0,7,Emergency,54.0,26,0,-3,-1,0,stay,1984-12-15
26829,Kool & The Gang,1985-06-22,Kool & The Gang - Emergency,7,4,6,3.0,7,Emergency,54.0,27,1,0,-3,1,up,1984-12-15
26830,Kool & The Gang,1985-06-29,Kool & The Gang - Emergency,7,7,5,3.0,6,Emergency,54.0,28,1,1,0,1,up,1984-12-15
26831,Kool & The Gang,1985-07-06,Kool & The Gang - Emergency,6,7,4,3.0,5,Emergency,54.0,29,1,1,1,1,up,1984-12-15
26832,Kool & The Gang,1985-07-13,Kool & The Gang - Emergency,5,6,4,3.0,4,Emergency,54.0,30,0,1,1,0,stay,1984-12-15
26833,Kool & The Gang,1985-07-20,Kool & The Gang - Emergency,4,5,5,3.0,4,Emergency,54.0,31,-1,0,1,1,down,1984-12-15
26834,Kool & The Gang,1985-07-27,Kool & The Gang - Emergency,4,4,5,3.0,5,Emergency,54.0,32,0,-1,0,0,stay,1984-12-15
26835,Kool & The Gang,1985-08-03,Kool & The Gang - Emergency,5,4,5,3.0,5,Emergency,54.0,33,0,0,-1,0,stay,1984-12-15
26836,Kool & The Gang,1985-08-10,Kool & The Gang - Emergency,5,5,8,3.0,5,Emergency,54.0,34,-3,0,0,1,down,1984-12-15
26837,Kool & The Gang,1985-08-17,Kool & The Gang - Emergency,5,5,7,3.0,8,Emergency,54.0,35,1,-3,0,1,up,1984-12-15
26838,Kool & The Gang,1985-08-24,Kool & The Gang - Emergency,8,5,7,3.0,7,Emergency,54.0,36,0,1,-3,0,stay,1984-12-15
26839,Kool & The Gang,1985-08-31,Kool & The Gang - Emergency,7,8,6,3.0,7,Emergency,54.0,37,1,0,1,1,up,1984-12-15
26840,Kool & The Gang,1985-09-07,Kool & The Gang - Emergency,7,7,5,3.0,6,Emergency,54.0,38,1,1,0,1,up,1984-12-15
26841,Kool & The Gang,1985-09-14,Kool & The Gang - Emergency,6,7,6,3.0,5,Emergency,54.0,39,-1,1,1,1,down,1984-12-15
26842,Kool & The Gang,1985-09-21,Kool & The Gang - Emergency,5,6,6,3.0,6,Emergency,54.0,40,0,-1,1,0,stay,1984-12-15
26843,Kool & The Gang,1985-09-28,Kool & The Gang - Emergency,6,5,6,3.0,6,Emergency,54.0,41,0,0,-1,0,stay,1984-12-15
26844,Kool & The Gang,1985-10-05,Kool & The Gang - Emergency,6,6,7,3.0,6,Emergency,54.0,42,-1,0,0,1,down,1984-12-15
26845,Kool & The Gang,1985-10-12,Kool & The Gang - Emergency,6,6,7,3.0,7,Emergency,54.0,43,0,-1,0,0,stay,1984-12-15
26846,Kool & The Gang,1985-10-19,Kool & The Gang - Emergency,7,6,9,3.0,7,Emergency,54.0,44,-2,0,-1,1,down,1984-12-15
26847,Kool & The Gang,1985-10-26,Kool & The Gang - Emergency,7,7,9,3.0,9,Emergency,54.0,45,0,-2,0,0,stay,1984-12-15
26848,Kool & The Gang,1985-11-02,Kool & The Gang - Emergency,9,7,9,3.0,9,Emergency,54.0,46,0,0,-2,0,stay,1984-12-15
26849,Kool & The Gang,1985-11-09,Kool & The Gang - Emergency,9,9,9,3.0,9,Emergency,54.0,47,0,0,0,0,stay,1984-12-15
26850,Kool & The Gang,1985-11-16,Kool & The Gang - Emergency,9,9,9,3.0,9,Emergency,54.0,48,0,0,0,0,stay,1984-12-15
26851,Kool & The Gang,1985-11-23,Kool & The Gang - Emergency,9,9,5,3.0,9,Emergency,54.0,49,4,0,0,1,up,1984-12-15
26852,Kool & The Gang,1985-11-30,Kool & The Gang - Emergency,9,9,5,3.0,5,Emergency,54.0,50,0,4,0,0,stay,1984-12-15
26853,Kool & The Gang,1985-12-07,Kool & The Gang - Emergency,5,9,4,3.0,5,Emergency,54.0,51,1,0,4,1,up,1984-12-15
26854,Kool & The Gang,1985-12-14,Kool & The Gang - Emergency,5,5,6,3.0,4,Emergency,54.0,52,-2,1,0,1,down,1984-12-15
26855,Kool & The Gang,1985-12-21,Kool & The Gang - Emergency,4,5,6,3.0,6,Emergency,54.0,53,0,-2,1,0,stay,1984-12-15
26856,Kool & The Gang,1985-12-28,Kool & The Gang - Emergency,6,4,51,3.0,6,Emergency,54.0,54,-45,0,-2,1,down,1984-12-15
26857,Shalamar,1984-12-15,Shalamar - Heart Break,51,51,40,32.0,50,Heart Break,20.0,0,10,1,0,1,up,1984-12-15
26858,Shalamar,1984-12-22,Shalamar - Heart Break,50,51,40,32.0,40,Heart Break,20.0,1,0,10,1,0,stay,1984-12-15
26859,Shalamar,1984-12-29,Shalamar - Heart Break,40,50,34,32.0,40,Heart Break,20.0,2,6,0,10,1,up,1984-12-15
26860,Shalamar,1985-01-05,Shalamar - Heart Break,40,40,32,32.0,34,Heart Break,20.0,3,2,6,0,1,up,1984-12-15
26861,Shalamar,1985-01-12,Shalamar - Heart Break,34,40,32,32.0,32,Heart Break,20.0,4,0,2,6,0,stay,1984-12-15
26862,Shalamar,1985-01-19,Shalamar - Heart Break,32,34,38,32.0,32,Heart Break,20.0,5,-6,0,2,1,down,1984-12-15
26863,Shalamar,1985-01-26,Shalamar - Heart Break,32,32,45,32.0,38,Heart Break,20.0,6,-7,-6,0,1,down,1984-12-15
26864,Shalamar,1985-02-02,Shalamar - Heart Break,38,32,43,32.0,45,Heart Break,20.0,7,2,-7,-6,1,up,1984-12-15
26865,Shalamar,1985-02-09,Shalamar - Heart Break,45,38,45,32.0,43,Heart Break,20.0,8,-2,2,-7,1,down,1984-12-15
26866,Shalamar,1985-02-16,Shalamar - Heart Break,43,45,41,32.0,45,Heart Break,20.0,9,4,-2,2,1,up,1984-12-15
26867,Shalamar,1985-02-23,Shalamar - Heart Break,45,43,41,32.0,41,Heart Break,20.0,10,0,4,-2,0,stay,1984-12-15
26868,Shalamar,1985-03-02,Shalamar - Heart Break,41,45,41,32.0,41,Heart Break,20.0,11,0,0,4,0,stay,1984-12-15
26869,Shalamar,1985-03-09,Shalamar - Heart Break,41,41,41,32.0,41,Heart Break,20.0,12,0,0,0,0,stay,1984-12-15
26870,Shalamar,1985-03-16,Shalamar - Heart Break,41,41,40,32.0,41,Heart Break,20.0,13,1,0,0,1,up,1984-12-15
26871,Shalamar,1985-03-23,Shalamar - Heart Break,41,41,36,32.0,40,Heart Break,20.0,14,4,1,0,1,up,1984-12-15
26872,Shalamar,1985-03-30,Shalamar - Heart Break,40,41,36,32.0,36,Heart Break,20.0,15,0,4,1,0,stay,1984-12-15
26873,Shalamar,1985-04-06,Shalamar - Heart Break,36,40,45,32.0,36,Heart Break,20.0,16,-9,0,4,1,down,1984-12-15
26874,Shalamar,1985-04-13,Shalamar - Heart Break,36,36,43,32.0,45,Heart Break,20.0,17,2,-9,0,1,up,1984-12-15
26875,Shalamar,1985-04-20,Shalamar - Heart Break,45,36,47,32.0,43,Heart Break,20.0,18,-4,2,-9,1,down,1984-12-15
26876,Shalamar,1985-04-27,Shalamar - Heart Break,43,45,50,32.0,47,Heart Break,20.0,19,-3,-4,2,1,down,1984-12-15
26877,Shalamar,1985-05-04,Shalamar - Heart Break,47,43,51,32.0,50,Heart Break,20.0,20,-1,-3,-4,1,down,1984-12-15
26878,Madonna,1984-12-22,Madonna - Like A Virgin,51,51,23,10.0,23,Like A Virgin,34.0,0,0,28,0,0,stay,1984-12-22
26879,Madonna,1984-12-29,Madonna - Like A Virgin,23,51,17,10.0,23,Like A Virgin,34.0,1,6,0,28,1,up,1984-12-22
26880,Madonna,1985-01-05,Madonna - Like A Virgin,23,23,16,10.0,17,Like A Virgin,34.0,2,1,6,0,1,up,1984-12-22
26881,Madonna,1985-01-12,Madonna - Like A Virgin,17,23,11,10.0,16,Like A Virgin,34.0,3,5,1,6,1,up,1984-12-22
26882,Madonna,1985-01-19,Madonna - Like A Virgin,16,17,10,10.0,11,Like A Virgin,34.0,4,1,5,1,1,up,1984-12-22
26883,Madonna,1985-01-26,Madonna - Like A Virgin,11,16,10,10.0,10,Like A Virgin,34.0,5,0,1,5,0,stay,1984-12-22
26884,Madonna,1985-02-02,Madonna - Like A Virgin,10,11,14,10.0,10,Like A Virgin,34.0,6,-4,0,1,1,down,1984-12-22
26885,Madonna,1985-02-09,Madonna - Like A Virgin,10,10,16,10.0,14,Like A Virgin,34.0,7,-2,-4,0,1,down,1984-12-22
26886,Madonna,1985-02-16,Madonna - Like A Virgin,14,10,18,10.0,16,Like A Virgin,34.0,8,-2,-2,-4,1,down,1984-12-22
26887,Madonna,1985-02-23,Madonna - Like A Virgin,16,14,25,10.0,18,Like A Virgin,34.0,9,-7,-2,-2,1,down,1984-12-22
26888,Madonna,1985-03-02,Madonna - Like A Virgin,18,16,25,10.0,25,Like A Virgin,34.0,10,0,-7,-2,0,stay,1984-12-22
26889,Madonna,1985-03-09,Madonna - Like A Virgin,25,18,24,10.0,25,Like A Virgin,34.0,11,1,0,-7,1,up,1984-12-22
26890,Madonna,1985-03-16,Madonna - Like A Virgin,25,25,27,10.0,24,Like A Virgin,34.0,12,-3,1,0,1,down,1984-12-22
26891,Madonna,1985-03-23,Madonna - Like A Virgin,24,25,31,10.0,27,Like A Virgin,34.0,13,-4,-3,1,1,down,1984-12-22
26892,Madonna,1985-03-30,Madonna - Like A Virgin,27,24,30,10.0,31,Like A Virgin,34.0,14,1,-4,-3,1,up,1984-12-22
26893,Madonna,1985-04-06,Madonna - Like A Virgin,31,27,31,10.0,30,Like A Virgin,34.0,15,-1,1,-4,1,down,1984-12-22
26894,Madonna,1985-04-13,Madonna - Like A Virgin,30,31,32,10.0,31,Like A Virgin,34.0,16,-1,-1,1,1,down,1984-12-22
26895,Madonna,1985-04-20,Madonna - Like A Virgin,31,30,32,10.0,32,Like A Virgin,34.0,17,0,-1,-1,0,stay,1984-12-22
26896,Madonna,1985-04-27,Madonna - Like A Virgin,32,31,36,10.0,32,Like A Virgin,34.0,18,-4,0,-1,1,down,1984-12-22
26897,Madonna,1985-05-04,Madonna - Like A Virgin,32,32,40,10.0,36,Like A Virgin,34.0,19,-4,-4,0,1,down,1984-12-22
26898,Madonna,1985-05-11,Madonna - Like A Virgin,36,32,34,10.0,40,Like A Virgin,34.0,20,6,-4,-4,1,up,1984-12-22
26899,Madonna,1985-05-18,Madonna - Like A Virgin,40,36,34,10.0,34,Like A Virgin,34.0,21,0,6,-4,0,stay,1984-12-22
26900,Madonna,1985-05-25,Madonna - Like A Virgin,34,40,39,10.0,34,Like A Virgin,34.0,22,-5,0,6,1,down,1984-12-22
26901,Madonna,1985-06-01,Madonna - Like A Virgin,34,34,31,10.0,39,Like A Virgin,34.0,23,8,-5,0,1,up,1984-12-22
26902,Madonna,1985-06-08,Madonna - Like A Virgin,39,34,29,10.0,31,Like A Virgin,34.0,24,2,8,-5,1,up,1984-12-22
26903,Madonna,1985-06-15,Madonna - Like A Virgin,31,39,29,10.0,29,Like A Virgin,34.0,25,0,2,8,0,stay,1984-12-22
26904,Madonna,1985-06-22,Madonna - Like A Virgin,29,31,37,10.0,29,Like A Virgin,34.0,26,-8,0,2,1,down,1984-12-22
26905,Madonna,1985-06-29,Madonna - Like A Virgin,29,29,35,10.0,37,Like A Virgin,34.0,27,2,-8,0,1,up,1984-12-22
26906,Madonna,1985-07-06,Madonna - Like A Virgin,37,29,34,10.0,35,Like A Virgin,34.0,28,1,2,-8,1,up,1984-12-22
26907,Madonna,1985-07-13,Madonna - Like A Virgin,35,37,34,10.0,34,Like A Virgin,34.0,29,0,1,2,0,stay,1984-12-22
26908,Madonna,1985-07-20,Madonna - Like A Virgin,34,35,42,10.0,34,Like A Virgin,34.0,30,-8,0,1,1,down,1984-12-22
26909,Madonna,1985-07-27,Madonna - Like A Virgin,34,34,42,10.0,42,Like A Virgin,34.0,31,0,-8,0,0,stay,1984-12-22
26910,Madonna,1985-08-03,Madonna - Like A Virgin,42,34,41,10.0,42,Like A Virgin,34.0,32,1,0,-8,1,up,1984-12-22
26911,Madonna,1985-08-10,Madonna - Like A Virgin,42,42,39,10.0,41,Like A Virgin,34.0,33,2,1,0,1,up,1984-12-22
26912,Madonna,1985-08-17,Madonna - Like A Virgin,41,42,51,10.0,39,Like A Virgin,34.0,34,-12,2,1,1,down,1984-12-22
26913,Teena Marie,1984-12-22,Teena Marie - Starchild,51,51,34,9.0,34,Starchild,34.0,0,0,17,0,0,stay,1984-12-22
26914,Teena Marie,1984-12-29,Teena Marie - Starchild,34,51,20,9.0,34,Starchild,34.0,1,14,0,17,1,up,1984-12-22
26915,Teena Marie,1985-01-05,Teena Marie - Starchild,34,34,18,9.0,20,Starchild,34.0,2,2,14,0,1,up,1984-12-22
26916,Teena Marie,1985-01-12,Teena Marie - Starchild,20,34,16,9.0,18,Starchild,34.0,3,2,2,14,1,up,1984-12-22
26917,Teena Marie,1985-01-19,Teena Marie - Starchild,18,20,14,9.0,16,Starchild,34.0,4,2,2,2,1,up,1984-12-22
26918,Teena Marie,1985-01-26,Teena Marie - Starchild,16,18,14,9.0,14,Starchild,34.0,5,0,2,2,0,stay,1984-12-22
26919,Teena Marie,1985-02-02,Teena Marie - Starchild,14,16,12,9.0,14,Starchild,34.0,6,2,0,2,1,up,1984-12-22
26920,Teena Marie,1985-02-09,Teena Marie - Starchild,14,14,12,9.0,12,Starchild,34.0,7,0,2,0,0,stay,1984-12-22
26921,Teena Marie,1985-02-16,Teena Marie - Starchild,12,14,9,9.0,12,Starchild,34.0,8,3,0,2,1,up,1984-12-22
26922,Teena Marie,1985-02-23,Teena Marie - Starchild,12,12,9,9.0,9,Starchild,34.0,9,0,3,0,0,stay,1984-12-22
26923,Teena Marie,1985-03-02,Teena Marie - Starchild,9,12,13,9.0,9,Starchild,34.0,10,-4,0,3,1,down,1984-12-22
26924,Teena Marie,1985-03-09,Teena Marie - Starchild,9,9,9,9.0,13,Starchild,34.0,11,4,-4,0,1,up,1984-12-22
26925,Teena Marie,1985-03-16,Teena Marie - Starchild,13,9,9,9.0,9,Starchild,34.0,12,0,4,-4,0,stay,1984-12-22
26926,Teena Marie,1985-03-23,Teena Marie - Starchild,9,13,11,9.0,9,Starchild,34.0,13,-2,0,4,1,down,1984-12-22
26927,Teena Marie,1985-03-30,Teena Marie - Starchild,9,9,16,9.0,11,Starchild,34.0,14,-5,-2,0,1,down,1984-12-22
26928,Teena Marie,1985-04-06,Teena Marie - Starchild,11,9,16,9.0,16,Starchild,34.0,15,0,-5,-2,0,stay,1984-12-22
26929,Teena Marie,1985-04-13,Teena Marie - Starchild,16,11,17,9.0,16,Starchild,34.0,16,-1,0,-5,1,down,1984-12-22
26930,Teena Marie,1985-04-20,Teena Marie - Starchild,16,16,19,9.0,17,Starchild,34.0,17,-2,-1,0,1,down,1984-12-22
26931,Teena Marie,1985-04-27,Teena Marie - Starchild,17,16,18,9.0,19,Starchild,34.0,18,1,-2,-1,1,up,1984-12-22
26932,Teena Marie,1985-05-04,Teena Marie - Starchild,19,17,18,9.0,18,Starchild,34.0,19,0,1,-2,0,stay,1984-12-22
26933,Teena Marie,1985-05-11,Teena Marie - Starchild,18,19,20,9.0,18,Starchild,34.0,20,-2,0,1,1,down,1984-12-22
26934,Teena Marie,1985-05-18,Teena Marie - Starchild,18,18,23,9.0,20,Starchild,34.0,21,-3,-2,0,1,down,1984-12-22
26935,Teena Marie,1985-05-25,Teena Marie - Starchild,20,18,24,9.0,23,Starchild,34.0,22,-1,-3,-2,1,down,1984-12-22
26936,Teena Marie,1985-06-01,Teena Marie - Starchild,23,20,26,9.0,24,Starchild,34.0,23,-2,-1,-3,1,down,1984-12-22
26937,Teena Marie,1985-06-08,Teena Marie - Starchild,24,23,25,9.0,26,Starchild,34.0,24,1,-2,-1,1,up,1984-12-22
26938,Teena Marie,1985-06-15,Teena Marie - Starchild,26,24,25,9.0,25,Starchild,34.0,25,0,1,-2,0,stay,1984-12-22
26939,Teena Marie,1985-06-22,Teena Marie - Starchild,25,26,29,9.0,25,Starchild,34.0,26,-4,0,1,1,down,1984-12-22
26940,Teena Marie,1985-06-29,Teena Marie - Starchild,25,25,36,9.0,29,Starchild,34.0,27,-7,-4,0,1,down,1984-12-22
26941,Teena Marie,1985-07-06,Teena Marie - Starchild,29,25,40,9.0,36,Starchild,34.0,28,-4,-7,-4,1,down,1984-12-22
26942,Teena Marie,1985-07-13,Teena Marie - Starchild,36,29,40,9.0,40,Starchild,34.0,29,0,-4,-7,0,stay,1984-12-22
26943,Teena Marie,1985-07-20,Teena Marie - Starchild,40,36,46,9.0,40,Starchild,34.0,30,-6,0,-4,1,down,1984-12-22
26944,Teena Marie,1985-07-27,Teena Marie - Starchild,40,40,45,9.0,46,Starchild,34.0,31,1,-6,0,1,up,1984-12-22
26945,Teena Marie,1985-08-03,Teena Marie - Starchild,46,40,49,9.0,45,Starchild,34.0,32,-4,1,-6,1,down,1984-12-22
26946,Teena Marie,1985-08-10,Teena Marie - Starchild,45,46,47,9.0,49,Starchild,34.0,33,2,-4,1,1,up,1984-12-22
26947,Teena Marie,1985-08-17,Teena Marie - Starchild,49,45,51,9.0,47,Starchild,34.0,34,-4,2,-4,1,down,1984-12-22
26948,Tom Browne,1984-12-22,Tom Browne - Tommy Gun,51,51,49,49.0,49,Tommy Gun,2.0,0,0,2,0,0,stay,1984-12-22
26949,Tom Browne,1984-12-29,Tom Browne - Tommy Gun,49,51,49,49.0,49,Tommy Gun,2.0,1,0,0,2,0,stay,1984-12-22
26950,Tom Browne,1985-01-05,Tom Browne - Tommy Gun,49,49,51,49.0,49,Tommy Gun,2.0,2,-2,0,0,1,down,1984-12-22
26951,Eugene Wilde,1985-01-05,Eugene Wilde - Eugene Wilde,51,51,29,14.0,32,Eugene Wilde,21.0,0,3,19,0,1,up,1985-01-05
26952,Eugene Wilde,1985-01-12,Eugene Wilde - Eugene Wilde,32,51,26,14.0,29,Eugene Wilde,21.0,1,3,3,19,1,up,1985-01-05
26953,Eugene Wilde,1985-01-19,Eugene Wilde - Eugene Wilde,29,32,20,14.0,26,Eugene Wilde,21.0,2,6,3,3,1,up,1985-01-05
26954,Eugene Wilde,1985-01-26,Eugene Wilde - Eugene Wilde,26,29,17,14.0,20,Eugene Wilde,21.0,3,3,6,3,1,up,1985-01-05
26955,Eugene Wilde,1985-02-02,Eugene Wilde - Eugene Wilde,20,26,17,14.0,17,Eugene Wilde,21.0,4,0,3,6,0,stay,1985-01-05
26956,Eugene Wilde,1985-02-09,Eugene Wilde - Eugene Wilde,17,20,14,14.0,17,Eugene Wilde,21.0,5,3,0,3,1,up,1985-01-05
26957,Eugene Wilde,1985-02-16,Eugene Wilde - Eugene Wilde,17,17,14,14.0,14,Eugene Wilde,21.0,6,0,3,0,0,stay,1985-01-05
26958,Eugene Wilde,1985-02-23,Eugene Wilde - Eugene Wilde,14,17,14,14.0,14,Eugene Wilde,21.0,7,0,0,3,0,stay,1985-01-05
26959,Eugene Wilde,1985-03-02,Eugene Wilde - Eugene Wilde,14,14,14,14.0,14,Eugene Wilde,21.0,8,0,0,0,0,stay,1985-01-05
26960,Eugene Wilde,1985-03-09,Eugene Wilde - Eugene Wilde,14,14,14,14.0,14,Eugene Wilde,21.0,9,0,0,0,0,stay,1985-01-05
26961,Eugene Wilde,1985-03-16,Eugene Wilde - Eugene Wilde,14,14,15,14.0,14,Eugene Wilde,21.0,10,-1,0,0,1,down,1985-01-05
26962,Eugene Wilde,1985-03-23,Eugene Wilde - Eugene Wilde,14,14,20,14.0,15,Eugene Wilde,21.0,11,-5,-1,0,1,down,1985-01-05
26963,Eugene Wilde,1985-03-30,Eugene Wilde - Eugene Wilde,15,14,20,14.0,20,Eugene Wilde,21.0,12,0,-5,-1,0,stay,1985-01-05
26964,Eugene Wilde,1985-04-06,Eugene Wilde - Eugene Wilde,20,15,25,14.0,20,Eugene Wilde,21.0,13,-5,0,-5,1,down,1985-01-05
26965,Eugene Wilde,1985-04-13,Eugene Wilde - Eugene Wilde,20,20,24,14.0,25,Eugene Wilde,21.0,14,1,-5,0,1,up,1985-01-05
26966,Eugene Wilde,1985-04-20,Eugene Wilde - Eugene Wilde,25,20,24,14.0,24,Eugene Wilde,21.0,15,0,1,-5,0,stay,1985-01-05
26967,Eugene Wilde,1985-04-27,Eugene Wilde - Eugene Wilde,24,25,25,14.0,24,Eugene Wilde,21.0,16,-1,0,1,1,down,1985-01-05
26968,Eugene Wilde,1985-05-04,Eugene Wilde - Eugene Wilde,24,24,26,14.0,25,Eugene Wilde,21.0,17,-1,-1,0,1,down,1985-01-05
26969,Eugene Wilde,1985-05-11,Eugene Wilde - Eugene Wilde,25,24,30,14.0,26,Eugene Wilde,21.0,18,-4,-1,-1,1,down,1985-01-05
26970,Eugene Wilde,1985-05-18,Eugene Wilde - Eugene Wilde,26,25,41,14.0,30,Eugene Wilde,21.0,19,-11,-4,-1,1,down,1985-01-05
26971,Eugene Wilde,1985-05-25,Eugene Wilde - Eugene Wilde,30,26,50,14.0,41,Eugene Wilde,21.0,20,-9,-11,-4,1,down,1985-01-05
26972,Eugene Wilde,1985-07-13,Eugene Wilde - Eugene Wilde,41,30,51,14.0,50,Eugene Wilde,21.0,21,-1,-9,-11,1,down,1985-01-05
26973,"Isley, Jasper, Isley",1985-01-05,"Isley, Jasper, Isley - Broadway's Closer to Sunset Blvd.",51,51,34,28.0,40,Broadway's Closer to Sunset Blvd.,9.0,0,6,11,0,1,up,1985-01-05
26974,"Isley, Jasper, Isley",1985-01-12,"Isley, Jasper, Isley - Broadway's Closer to Sunset Blvd.",40,51,31,28.0,34,Broadway's Closer to Sunset Blvd.,9.0,1,3,6,11,1,up,1985-01-05
26975,"Isley, Jasper, Isley",1985-01-19,"Isley, Jasper, Isley - Broadway's Closer to Sunset Blvd.",34,40,29,28.0,31,Broadway's Closer to Sunset Blvd.,9.0,2,2,3,6,1,up,1985-01-05
26976,"Isley, Jasper, Isley",1985-01-26,"Isley, Jasper, Isley - Broadway's Closer to Sunset Blvd.",31,34,28,28.0,29,Broadway's Closer to Sunset Blvd.,9.0,3,1,2,3,1,up,1985-01-05
26977,"Isley, Jasper, Isley",1985-02-02,"Isley, Jasper, Isley - Broadway's Closer to Sunset Blvd.",29,31,32,28.0,28,Broadway's Closer to Sunset Blvd.,9.0,4,-4,1,2,1,down,1985-01-05
26978,"Isley, Jasper, Isley",1985-02-09,"Isley, Jasper, Isley - Broadway's Closer to Sunset Blvd.",28,29,49,28.0,32,Broadway's Closer to Sunset Blvd.,9.0,5,-17,-4,1,1,down,1985-01-05
26979,"Isley, Jasper, Isley",1985-02-23,"Isley, Jasper, Isley - Broadway's Closer to Sunset Blvd.",32,28,47,28.0,49,Broadway's Closer to Sunset Blvd.,9.0,6,2,-17,-4,1,up,1985-01-05
26980,"Isley, Jasper, Isley",1985-03-02,"Isley, Jasper, Isley - Broadway's Closer to Sunset Blvd.",49,32,46,28.0,47,Broadway's Closer to Sunset Blvd.,9.0,7,1,2,-17,1,up,1985-01-05
26981,"Isley, Jasper, Isley",1985-03-09,"Isley, Jasper, Isley - Broadway's Closer to Sunset Blvd.",47,49,46,28.0,46,Broadway's Closer to Sunset Blvd.,9.0,8,0,1,2,0,stay,1985-01-05
26982,"Isley, Jasper, Isley",1985-03-16,"Isley, Jasper, Isley - Broadway's Closer to Sunset Blvd.",46,47,51,28.0,46,Broadway's Closer to Sunset Blvd.,9.0,9,-5,0,1,1,down,1985-01-05
26983,Ray Parker Jr.,1985-01-05,Ray Parker Jr. - Chartbusters,51,51,40,36.0,43,Chartbusters,5.0,0,3,8,0,1,up,1985-01-05
26984,Ray Parker Jr.,1985-01-12,Ray Parker Jr. - Chartbusters,43,51,38,36.0,40,Chartbusters,5.0,1,2,3,8,1,up,1985-01-05
26985,Ray Parker Jr.,1985-01-19,Ray Parker Jr. - Chartbusters,40,43,36,36.0,38,Chartbusters,5.0,2,2,2,3,1,up,1985-01-05
26986,Ray Parker Jr.,1985-01-26,Ray Parker Jr. - Chartbusters,38,40,36,36.0,36,Chartbusters,5.0,3,0,2,2,0,stay,1985-01-05
26987,Ray Parker Jr.,1985-02-02,Ray Parker Jr. - Chartbusters,36,38,37,36.0,36,Chartbusters,5.0,4,-1,0,2,1,down,1985-01-05
26988,Ray Parker Jr.,1985-02-09,Ray Parker Jr. - Chartbusters,36,36,51,36.0,37,Chartbusters,5.0,5,-14,-1,0,1,down,1985-01-05
26989,Linda Clifford,1985-01-05,Linda Clifford - Sneakin' Out,51,51,50,49.0,50,Sneakin' Out,2.0,0,0,1,0,0,stay,1985-01-05
26990,Linda Clifford,1985-01-12,Linda Clifford - Sneakin' Out,50,51,49,49.0,50,Sneakin' Out,2.0,1,1,0,1,1,up,1985-01-05
26991,Linda Clifford,1985-01-19,Linda Clifford - Sneakin' Out,50,50,51,49.0,49,Sneakin' Out,2.0,2,-2,1,0,1,down,1985-01-05
26992,The Gap Band,1985-01-12,The Gap Band - Gap Band VI,51,51,23,1.0,27,Gap Band VI,27.0,0,4,24,0,1,up,1985-01-12
26993,The Gap Band,1985-01-19,The Gap Band - Gap Band VI,27,51,17,1.0,23,Gap Band VI,27.0,1,6,4,24,1,up,1985-01-12
26994,The Gap Band,1985-01-26,The Gap Band - Gap Band VI,23,27,12,1.0,17,Gap Band VI,27.0,2,5,6,4,1,up,1985-01-12
26995,The Gap Band,1985-02-02,The Gap Band - Gap Band VI,17,23,11,1.0,12,Gap Band VI,27.0,3,1,5,6,1,up,1985-01-12
26996,The Gap Band,1985-02-09,The Gap Band - Gap Band VI,12,17,6,1.0,11,Gap Band VI,27.0,4,5,1,5,1,up,1985-01-12
26997,The Gap Band,1985-02-16,The Gap Band - Gap Band VI,11,12,4,1.0,6,Gap Band VI,27.0,5,2,5,1,1,up,1985-01-12
26998,The Gap Band,1985-02-23,The Gap Band - Gap Band VI,6,11,4,1.0,4,Gap Band VI,27.0,6,0,2,5,0,stay,1985-01-12
26999,The Gap Band,1985-03-02,The Gap Band - Gap Band VI,4,6,1,1.0,4,Gap Band VI,27.0,7,3,0,2,1,up,1985-01-12
27000,The Gap Band,1985-03-09,The Gap Band - Gap Band VI,4,4,1,1.0,1,Gap Band VI,27.0,8,0,3,0,0,stay,1985-01-12
27001,The Gap Band,1985-03-16,The Gap Band - Gap Band VI,1,4,3,1.0,1,Gap Band VI,27.0,9,-2,0,3,1,down,1985-01-12
27002,The Gap Band,1985-03-23,The Gap Band - Gap Band VI,1,1,6,1.0,3,Gap Band VI,27.0,10,-3,-2,0,1,down,1985-01-12
27003,The Gap Band,1985-03-30,The Gap Band - Gap Band VI,3,1,5,1.0,6,Gap Band VI,27.0,11,1,-3,-2,1,up,1985-01-12
27004,The Gap Band,1985-04-06,The Gap Band - Gap Band VI,6,3,7,1.0,5,Gap Band VI,27.0,12,-2,1,-3,1,down,1985-01-12
27005,The Gap Band,1985-04-13,The Gap Band - Gap Band VI,5,6,9,1.0,7,Gap Band VI,27.0,13,-2,-2,1,1,down,1985-01-12
27006,The Gap Band,1985-04-20,The Gap Band - Gap Band VI,7,5,12,1.0,9,Gap Band VI,27.0,14,-3,-2,-2,1,down,1985-01-12
27007,The Gap Band,1985-04-27,The Gap Band - Gap Band VI,9,7,12,1.0,12,Gap Band VI,27.0,15,0,-3,-2,0,stay,1985-01-12
27008,The Gap Band,1985-05-04,The Gap Band - Gap Band VI,12,9,12,1.0,12,Gap Band VI,27.0,16,0,0,-3,0,stay,1985-01-12
27009,The Gap Band,1985-05-11,The Gap Band - Gap Band VI,12,12,16,1.0,12,Gap Band VI,27.0,17,-4,0,0,1,down,1985-01-12
27010,The Gap Band,1985-05-18,The Gap Band - Gap Band VI,12,12,18,1.0,16,Gap Band VI,27.0,18,-2,-4,0,1,down,1985-01-12
27011,The Gap Band,1985-05-25,The Gap Band - Gap Band VI,16,12,27,1.0,18,Gap Band VI,27.0,19,-9,-2,-4,1,down,1985-01-12
27012,The Gap Band,1985-06-01,The Gap Band - Gap Band VI,18,16,27,1.0,27,Gap Band VI,27.0,20,0,-9,-2,0,stay,1985-01-12
27013,The Gap Band,1985-06-08,The Gap Band - Gap Band VI,27,18,37,1.0,27,Gap Band VI,27.0,21,-10,0,-9,1,down,1985-01-12
27014,The Gap Band,1985-06-15,The Gap Band - Gap Band VI,27,27,40,1.0,37,Gap Band VI,27.0,22,-3,-10,0,1,down,1985-01-12
27015,The Gap Band,1985-06-22,The Gap Band - Gap Band VI,37,27,46,1.0,40,Gap Band VI,27.0,23,-6,-3,-10,1,down,1985-01-12
27016,The Gap Band,1985-08-24,The Gap Band - Gap Band VI,40,37,46,1.0,46,Gap Band VI,27.0,24,0,-6,-3,0,stay,1985-01-12
27017,The Gap Band,1985-08-31,The Gap Band - Gap Band VI,46,40,39,1.0,46,Gap Band VI,27.0,25,7,0,-6,1,up,1985-01-12
27018,The Gap Band,1985-09-07,The Gap Band - Gap Band VI,46,46,39,1.0,39,Gap Band VI,27.0,26,0,7,0,0,stay,1985-01-12
27019,The Gap Band,1985-09-14,The Gap Band - Gap Band VI,39,46,51,1.0,39,Gap Band VI,27.0,27,-12,0,7,1,down,1985-01-12
27020,Klymaxx,1985-01-19,Klymaxx - Meeting In The Ladies Room,51,51,34,9.0,50,Meeting In The Ladies Room,49.0,0,16,1,0,1,up,1985-01-19
27021,Klymaxx,1985-01-26,Klymaxx - Meeting In The Ladies Room,50,51,30,9.0,34,Meeting In The Ladies Room,49.0,1,4,16,1,1,up,1985-01-19
27022,Klymaxx,1985-02-02,Klymaxx - Meeting In The Ladies Room,34,50,23,9.0,30,Meeting In The Ladies Room,49.0,2,7,4,16,1,up,1985-01-19
27023,Klymaxx,1985-02-09,Klymaxx - Meeting In The Ladies Room,30,34,21,9.0,23,Meeting In The Ladies Room,49.0,3,2,7,4,1,up,1985-01-19
27024,Klymaxx,1985-02-16,Klymaxx - Meeting In The Ladies Room,23,30,20,9.0,21,Meeting In The Ladies Room,49.0,4,1,2,7,1,up,1985-01-19
27025,Klymaxx,1985-02-23,Klymaxx - Meeting In The Ladies Room,21,23,20,9.0,20,Meeting In The Ladies Room,49.0,5,0,1,2,0,stay,1985-01-19
27026,Klymaxx,1985-03-02,Klymaxx - Meeting In The Ladies Room,20,21,21,9.0,20,Meeting In The Ladies Room,49.0,6,-1,0,1,1,down,1985-01-19
27027,Klymaxx,1985-03-09,Klymaxx - Meeting In The Ladies Room,20,20,27,9.0,21,Meeting In The Ladies Room,49.0,7,-6,-1,0,1,down,1985-01-19
27028,Klymaxx,1985-03-16,Klymaxx - Meeting In The Ladies Room,21,20,22,9.0,27,Meeting In The Ladies Room,49.0,8,5,-6,-1,1,up,1985-01-19
27029,Klymaxx,1985-03-23,Klymaxx - Meeting In The Ladies Room,27,21,19,9.0,22,Meeting In The Ladies Room,49.0,9,3,5,-6,1,up,1985-01-19
27030,Klymaxx,1985-03-30,Klymaxx - Meeting In The Ladies Room,22,27,19,9.0,19,Meeting In The Ladies Room,49.0,10,0,3,5,0,stay,1985-01-19
27031,Klymaxx,1985-04-06,Klymaxx - Meeting In The Ladies Room,19,22,19,9.0,19,Meeting In The Ladies Room,49.0,11,0,0,3,0,stay,1985-01-19
27032,Klymaxx,1985-04-13,Klymaxx - Meeting In The Ladies Room,19,19,18,9.0,19,Meeting In The Ladies Room,49.0,12,1,0,0,1,up,1985-01-19
27033,Klymaxx,1985-04-20,Klymaxx - Meeting In The Ladies Room,19,19,15,9.0,18,Meeting In The Ladies Room,49.0,13,3,1,0,1,up,1985-01-19
27034,Klymaxx,1985-04-27,Klymaxx - Meeting In The Ladies Room,18,19,15,9.0,15,Meeting In The Ladies Room,49.0,14,0,3,1,0,stay,1985-01-19
27035,Klymaxx,1985-05-04,Klymaxx - Meeting In The Ladies Room,15,18,14,9.0,15,Meeting In The Ladies Room,49.0,15,1,0,3,1,up,1985-01-19
27036,Klymaxx,1985-05-11,Klymaxx - Meeting In The Ladies Room,15,15,14,9.0,14,Meeting In The Ladies Room,49.0,16,0,1,0,0,stay,1985-01-19
27037,Klymaxx,1985-05-18,Klymaxx - Meeting In The Ladies Room,14,15,11,9.0,14,Meeting In The Ladies Room,49.0,17,3,0,1,1,up,1985-01-19
27038,Klymaxx,1985-05-25,Klymaxx - Meeting In The Ladies Room,14,14,10,9.0,11,Meeting In The Ladies Room,49.0,18,1,3,0,1,up,1985-01-19
27039,Klymaxx,1985-06-01,Klymaxx - Meeting In The Ladies Room,11,14,9,9.0,10,Meeting In The Ladies Room,49.0,19,1,1,3,1,up,1985-01-19
27040,Klymaxx,1985-06-08,Klymaxx - Meeting In The Ladies Room,10,11,10,9.0,9,Meeting In The Ladies Room,49.0,20,-1,1,1,1,down,1985-01-19
27041,Klymaxx,1985-06-15,Klymaxx - Meeting In The Ladies Room,9,10,13,9.0,10,Meeting In The Ladies Room,49.0,21,-3,-1,1,1,down,1985-01-19
27042,Klymaxx,1985-06-22,Klymaxx - Meeting In The Ladies Room,10,9,14,9.0,13,Meeting In The Ladies Room,49.0,22,-1,-3,-1,1,down,1985-01-19
27043,Klymaxx,1985-06-29,Klymaxx - Meeting In The Ladies Room,13,10,18,9.0,14,Meeting In The Ladies Room,49.0,23,-4,-1,-3,1,down,1985-01-19
27044,Klymaxx,1985-07-06,Klymaxx - Meeting In The Ladies Room,14,13,18,9.0,18,Meeting In The Ladies Room,49.0,24,0,-4,-1,0,stay,1985-01-19
27045,Klymaxx,1985-07-13,Klymaxx - Meeting In The Ladies Room,18,14,19,9.0,18,Meeting In The Ladies Room,49.0,25,-1,0,-4,1,down,1985-01-19
27046,Klymaxx,1985-07-20,Klymaxx - Meeting In The Ladies Room,18,18,21,9.0,19,Meeting In The Ladies Room,49.0,26,-2,-1,0,1,down,1985-01-19
27047,Klymaxx,1985-07-27,Klymaxx - Meeting In The Ladies Room,19,18,21,9.0,21,Meeting In The Ladies Room,49.0,27,0,-2,-1,0,stay,1985-01-19
27048,Klymaxx,1985-08-03,Klymaxx - Meeting In The Ladies Room,21,19,25,9.0,21,Meeting In The Ladies Room,49.0,28,-4,0,-2,1,down,1985-01-19
27049,Klymaxx,1985-08-10,Klymaxx - Meeting In The Ladies Room,21,21,24,9.0,25,Meeting In The Ladies Room,49.0,29,1,-4,0,1,up,1985-01-19
27050,Klymaxx,1985-08-17,Klymaxx - Meeting In The Ladies Room,25,21,24,9.0,24,Meeting In The Ladies Room,49.0,30,0,1,-4,0,stay,1985-01-19
27051,Klymaxx,1985-08-24,Klymaxx - Meeting In The Ladies Room,24,25,24,9.0,24,Meeting In The Ladies Room,49.0,31,0,0,1,0,stay,1985-01-19
27052,Klymaxx,1985-08-31,Klymaxx - Meeting In The Ladies Room,24,24,25,9.0,24,Meeting In The Ladies Room,49.0,32,-1,0,0,1,down,1985-01-19
27053,Klymaxx,1985-09-07,Klymaxx - Meeting In The Ladies Room,24,24,32,9.0,25,Meeting In The Ladies Room,49.0,33,-7,-1,0,1,down,1985-01-19
27054,Klymaxx,1985-09-14,Klymaxx - Meeting In The Ladies Room,25,24,29,9.0,32,Meeting In The Ladies Room,49.0,34,3,-7,-1,1,up,1985-01-19
27055,Klymaxx,1985-09-21,Klymaxx - Meeting In The Ladies Room,32,25,29,9.0,29,Meeting In The Ladies Room,49.0,35,0,3,-7,0,stay,1985-01-19
27056,Klymaxx,1985-09-28,Klymaxx - Meeting In The Ladies Room,29,32,30,9.0,29,Meeting In The Ladies Room,49.0,36,-1,0,3,1,down,1985-01-19
27057,Klymaxx,1985-10-05,Klymaxx - Meeting In The Ladies Room,29,29,21,9.0,30,Meeting In The Ladies Room,49.0,37,9,-1,0,1,up,1985-01-19
27058,Klymaxx,1985-10-12,Klymaxx - Meeting In The Ladies Room,30,29,20,9.0,21,Meeting In The Ladies Room,49.0,38,1,9,-1,1,up,1985-01-19
27059,Klymaxx,1985-10-19,Klymaxx - Meeting In The Ladies Room,21,30,24,9.0,20,Meeting In The Ladies Room,49.0,39,-4,1,9,1,down,1985-01-19
27060,Klymaxx,1985-10-26,Klymaxx - Meeting In The Ladies Room,20,21,24,9.0,24,Meeting In The Ladies Room,49.0,40,0,-4,1,0,stay,1985-01-19
27061,Klymaxx,1985-11-02,Klymaxx - Meeting In The Ladies Room,24,20,26,9.0,24,Meeting In The Ladies Room,49.0,41,-2,0,-4,1,down,1985-01-19
27062,Klymaxx,1985-11-09,Klymaxx - Meeting In The Ladies Room,24,24,26,9.0,26,Meeting In The Ladies Room,49.0,42,0,-2,0,0,stay,1985-01-19
27063,Klymaxx,1985-11-16,Klymaxx - Meeting In The Ladies Room,26,24,26,9.0,26,Meeting In The Ladies Room,49.0,43,0,0,-2,0,stay,1985-01-19
27064,Klymaxx,1985-11-23,Klymaxx - Meeting In The Ladies Room,26,26,25,9.0,26,Meeting In The Ladies Room,49.0,44,1,0,0,1,up,1985-01-19
27065,Klymaxx,1985-11-30,Klymaxx - Meeting In The Ladies Room,26,26,26,9.0,25,Meeting In The Ladies Room,49.0,45,-1,1,0,1,down,1985-01-19
27066,Klymaxx,1985-12-07,Klymaxx - Meeting In The Ladies Room,25,26,25,9.0,26,Meeting In The Ladies Room,49.0,46,1,-1,1,1,up,1985-01-19
27067,Klymaxx,1985-12-14,Klymaxx - Meeting In The Ladies Room,26,25,34,9.0,25,Meeting In The Ladies Room,49.0,47,-9,1,-1,1,down,1985-01-19
27068,Klymaxx,1985-12-21,Klymaxx - Meeting In The Ladies Room,25,26,34,9.0,34,Meeting In The Ladies Room,49.0,48,0,-9,1,0,stay,1985-01-19
27069,Klymaxx,1985-12-28,Klymaxx - Meeting In The Ladies Room,34,25,51,9.0,34,Meeting In The Ladies Room,49.0,49,-17,0,-9,1,down,1985-01-19
27070,Soundtrack,1985-01-26,Soundtrack - Breakin' 2 Electric Boogaloo,51,51,31,25.0,39,Breakin' 2 Electric Boogaloo,8.0,0,8,12,0,1,up,1985-01-26
27071,Soundtrack,1985-02-02,Soundtrack - Breakin' 2 Electric Boogaloo,39,51,28,25.0,31,Breakin' 2 Electric Boogaloo,8.0,1,3,8,12,1,up,1985-01-26
27072,Soundtrack,1985-02-09,Soundtrack - Breakin' 2 Electric Boogaloo,31,39,25,25.0,28,Breakin' 2 Electric Boogaloo,8.0,2,3,3,8,1,up,1985-01-26
27073,Soundtrack,1985-02-16,Soundtrack - Breakin' 2 Electric Boogaloo,28,31,25,25.0,25,Breakin' 2 Electric Boogaloo,8.0,3,0,3,3,0,stay,1985-01-26
27074,Soundtrack,1985-02-23,Soundtrack - Breakin' 2 Electric Boogaloo,25,28,36,25.0,25,Breakin' 2 Electric Boogaloo,8.0,4,-11,0,3,1,down,1985-01-26
27075,Soundtrack,1985-03-02,Soundtrack - Breakin' 2 Electric Boogaloo,25,25,38,25.0,36,Breakin' 2 Electric Boogaloo,8.0,5,-2,-11,0,1,down,1985-01-26
27076,Soundtrack,1985-03-09,Soundtrack - Breakin' 2 Electric Boogaloo,36,25,38,25.0,38,Breakin' 2 Electric Boogaloo,8.0,6,0,-2,-11,0,stay,1985-01-26
27077,Soundtrack,1985-03-16,Soundtrack - Breakin' 2 Electric Boogaloo,38,36,50,25.0,38,Breakin' 2 Electric Boogaloo,8.0,7,-12,0,-2,1,down,1985-01-26
27078,Soundtrack,1985-03-23,Soundtrack - Breakin' 2 Electric Boogaloo,38,38,51,25.0,50,Breakin' 2 Electric Boogaloo,8.0,8,-1,-12,0,1,down,1985-01-26
27079,Thelma Houston,1985-01-26,Thelma Houston - Qualifying Heat,51,51,33,30.0,48,Qualifying Heat,8.0,0,15,3,0,1,up,1985-01-26
27080,Thelma Houston,1985-02-02,Thelma Houston - Qualifying Heat,48,51,30,30.0,33,Qualifying Heat,8.0,1,3,15,3,1,up,1985-01-26
27081,Thelma Houston,1985-02-09,Thelma Houston - Qualifying Heat,33,48,30,30.0,30,Qualifying Heat,8.0,2,0,3,15,0,stay,1985-01-26
27082,Thelma Houston,1985-02-16,Thelma Houston - Qualifying Heat,30,33,48,30.0,30,Qualifying Heat,8.0,3,-18,0,3,1,down,1985-01-26
27083,Thelma Houston,1985-02-23,Thelma Houston - Qualifying Heat,30,30,46,30.0,48,Qualifying Heat,8.0,4,2,-18,0,1,up,1985-01-26
27084,Thelma Houston,1985-03-02,Thelma Houston - Qualifying Heat,48,30,47,30.0,46,Qualifying Heat,8.0,5,-1,2,-18,1,down,1985-01-26
27085,Thelma Houston,1985-03-23,Thelma Houston - Qualifying Heat,46,48,41,30.0,47,Qualifying Heat,8.0,6,6,-1,2,1,up,1985-01-26
27086,Thelma Houston,1985-03-30,Thelma Houston - Qualifying Heat,47,46,41,30.0,41,Qualifying Heat,8.0,7,0,6,-1,0,stay,1985-01-26
27087,Thelma Houston,1985-04-06,Thelma Houston - Qualifying Heat,41,47,51,30.0,41,Qualifying Heat,8.0,8,-10,0,6,1,down,1985-01-26
27088,Ronnie Laws,1985-01-26,Ronnie Laws - Classic Masters,51,51,40,33.0,50,Classic Masters,8.0,0,10,1,0,1,up,1985-01-26
27089,Ronnie Laws,1985-02-02,Ronnie Laws - Classic Masters,50,51,35,33.0,40,Classic Masters,8.0,1,5,10,1,1,up,1985-01-26
27090,Ronnie Laws,1985-02-09,Ronnie Laws - Classic Masters,40,50,33,33.0,35,Classic Masters,8.0,2,2,5,10,1,up,1985-01-26
27091,Ronnie Laws,1985-02-16,Ronnie Laws - Classic Masters,35,40,33,33.0,33,Classic Masters,8.0,3,0,2,5,0,stay,1985-01-26
27092,Ronnie Laws,1985-02-23,Ronnie Laws - Classic Masters,33,35,39,33.0,33,Classic Masters,8.0,4,-6,0,2,1,down,1985-01-26
27093,Ronnie Laws,1985-03-02,Ronnie Laws - Classic Masters,33,33,40,33.0,39,Classic Masters,8.0,5,-1,-6,0,1,down,1985-01-26
27094,Ronnie Laws,1985-03-09,Ronnie Laws - Classic Masters,39,33,43,33.0,40,Classic Masters,8.0,6,-3,-1,-6,1,down,1985-01-26
27095,Ronnie Laws,1985-03-16,Ronnie Laws - Classic Masters,40,39,46,33.0,43,Classic Masters,8.0,7,-3,-3,-1,1,down,1985-01-26
27096,Ronnie Laws,1985-03-23,Ronnie Laws - Classic Masters,43,40,51,33.0,46,Classic Masters,8.0,8,-5,-3,-3,1,down,1985-01-26
27097,The Egyptian Lover,1985-02-02,The Egyptian Lover - On The Nile,51,51,46,44.0,49,On The Nile,3.0,0,3,2,0,1,up,1985-02-02
27098,The Egyptian Lover,1985-02-09,The Egyptian Lover - On The Nile,49,51,44,44.0,46,On The Nile,3.0,1,2,3,2,1,up,1985-02-02
27099,The Egyptian Lover,1985-02-16,The Egyptian Lover - On The Nile,46,49,44,44.0,44,On The Nile,3.0,2,0,2,3,0,stay,1985-02-02
27100,The Egyptian Lover,1985-02-23,The Egyptian Lover - On The Nile,44,46,51,44.0,44,On The Nile,3.0,3,-7,0,2,1,down,1985-02-02
27101,Roy Ayers,1985-02-02,Roy Ayers - In The Dark,51,51,51,50.0,50,In The Dark,0.0,0,-1,1,0,1,down,1985-02-02
27102,George Benson,1985-02-09,George Benson - 20/20,51,51,27,20.0,38,20/20,29.0,0,11,13,0,1,up,1985-02-09
27103,George Benson,1985-02-16,George Benson - 20/20,38,51,22,20.0,27,20/20,29.0,1,5,11,13,1,up,1985-02-09
27104,George Benson,1985-02-23,George Benson - 20/20,27,38,22,20.0,22,20/20,29.0,2,0,5,11,0,stay,1985-02-09
27105,George Benson,1985-03-02,George Benson - 20/20,22,27,23,20.0,22,20/20,29.0,3,-1,0,5,1,down,1985-02-09
27106,George Benson,1985-03-09,George Benson - 20/20,22,22,33,20.0,23,20/20,29.0,4,-10,-1,0,1,down,1985-02-09
27107,George Benson,1985-03-16,George Benson - 20/20,23,22,33,20.0,33,20/20,29.0,5,0,-10,-1,0,stay,1985-02-09
27108,George Benson,1985-03-23,George Benson - 20/20,33,23,32,20.0,33,20/20,29.0,6,1,0,-10,1,up,1985-02-09
27109,George Benson,1985-03-30,George Benson - 20/20,33,33,31,20.0,32,20/20,29.0,7,1,1,0,1,up,1985-02-09
27110,George Benson,1985-04-06,George Benson - 20/20,32,33,30,20.0,31,20/20,29.0,8,1,1,1,1,up,1985-02-09
27111,George Benson,1985-04-13,George Benson - 20/20,31,32,29,20.0,30,20/20,29.0,9,1,1,1,1,up,1985-02-09
27112,George Benson,1985-04-20,George Benson - 20/20,30,31,29,20.0,29,20/20,29.0,10,0,1,1,0,stay,1985-02-09
27113,George Benson,1985-04-27,George Benson - 20/20,29,30,30,20.0,29,20/20,29.0,11,-1,0,1,1,down,1985-02-09
27114,George Benson,1985-05-04,George Benson - 20/20,29,29,37,20.0,30,20/20,29.0,12,-7,-1,0,1,down,1985-02-09
27115,George Benson,1985-05-11,George Benson - 20/20,30,29,33,20.0,37,20/20,29.0,13,4,-7,-1,1,up,1985-02-09
27116,George Benson,1985-05-18,George Benson - 20/20,37,30,33,20.0,33,20/20,29.0,14,0,4,-7,0,stay,1985-02-09
27117,George Benson,1985-05-25,George Benson - 20/20,33,37,34,20.0,33,20/20,29.0,15,-1,0,4,1,down,1985-02-09
27118,George Benson,1985-06-01,George Benson - 20/20,33,33,34,20.0,34,20/20,29.0,16,0,-1,0,0,stay,1985-02-09
27119,George Benson,1985-06-08,George Benson - 20/20,34,33,32,20.0,34,20/20,29.0,17,2,0,-1,1,up,1985-02-09
27120,George Benson,1985-06-15,George Benson - 20/20,34,34,31,20.0,32,20/20,29.0,18,1,2,0,1,up,1985-02-09
27121,George Benson,1985-06-22,George Benson - 20/20,32,34,30,20.0,31,20/20,29.0,19,1,1,2,1,up,1985-02-09
27122,George Benson,1985-06-29,George Benson - 20/20,31,32,29,20.0,30,20/20,29.0,20,1,1,1,1,up,1985-02-09
27123,George Benson,1985-07-06,George Benson - 20/20,30,31,20,20.0,29,20/20,29.0,21,9,1,1,1,up,1985-02-09
27124,George Benson,1985-07-13,George Benson - 20/20,29,30,20,20.0,20,20/20,29.0,22,0,9,1,0,stay,1985-02-09
27125,George Benson,1985-07-20,George Benson - 20/20,20,29,22,20.0,20,20/20,29.0,23,-2,0,9,1,down,1985-02-09
27126,George Benson,1985-07-27,George Benson - 20/20,20,20,22,20.0,22,20/20,29.0,24,0,-2,0,0,stay,1985-02-09
27127,George Benson,1985-08-03,George Benson - 20/20,22,20,22,20.0,22,20/20,29.0,25,0,0,-2,0,stay,1985-02-09
27128,George Benson,1985-08-10,George Benson - 20/20,22,22,23,20.0,22,20/20,29.0,26,-1,0,0,1,down,1985-02-09
27129,George Benson,1985-08-17,George Benson - 20/20,22,22,41,20.0,23,20/20,29.0,27,-18,-1,0,1,down,1985-02-09
27130,George Benson,1985-08-24,George Benson - 20/20,23,22,45,20.0,41,20/20,29.0,28,-4,-18,-1,1,down,1985-02-09
27131,George Benson,1985-08-31,George Benson - 20/20,41,23,51,20.0,45,20/20,29.0,29,-6,-4,-18,1,down,1985-02-09
27132,Pennye Ford,1985-02-09,Pennye Ford - Pennye,51,51,39,39.0,49,Pennye,2.0,0,10,2,0,1,up,1985-02-09
27133,Pennye Ford,1985-02-16,Pennye Ford - Pennye,49,51,39,39.0,39,Pennye,2.0,1,0,10,2,0,stay,1985-02-09
27134,Pennye Ford,1985-02-23,Pennye Ford - Pennye,39,49,51,39.0,39,Pennye,2.0,2,-12,0,10,1,down,1985-02-09
27135,Soundtrack,1985-02-16,Soundtrack - Beverly Hills Cop,51,51,27,6.0,32,Beverly Hills Cop,26.0,0,5,19,0,1,up,1985-02-16
27136,Soundtrack,1985-02-23,Soundtrack - Beverly Hills Cop,32,51,23,6.0,27,Beverly Hills Cop,26.0,1,4,5,19,1,up,1985-02-16
27137,Soundtrack,1985-03-02,Soundtrack - Beverly Hills Cop,27,32,19,6.0,23,Beverly Hills Cop,26.0,2,4,4,5,1,up,1985-02-16
27138,Soundtrack,1985-03-09,Soundtrack - Beverly Hills Cop,23,27,17,6.0,19,Beverly Hills Cop,26.0,3,2,4,4,1,up,1985-02-16
27139,Soundtrack,1985-03-16,Soundtrack - Beverly Hills Cop,19,23,11,6.0,17,Beverly Hills Cop,26.0,4,6,2,4,1,up,1985-02-16
27140,Soundtrack,1985-03-23,Soundtrack - Beverly Hills Cop,17,19,9,6.0,11,Beverly Hills Cop,26.0,5,2,6,2,1,up,1985-02-16
27141,Soundtrack,1985-03-30,Soundtrack - Beverly Hills Cop,11,17,8,6.0,9,Beverly Hills Cop,26.0,6,1,2,6,1,up,1985-02-16
27142,Soundtrack,1985-04-06,Soundtrack - Beverly Hills Cop,9,11,8,6.0,8,Beverly Hills Cop,26.0,7,0,1,2,0,stay,1985-02-16
27143,Soundtrack,1985-04-13,Soundtrack - Beverly Hills Cop,8,9,8,6.0,8,Beverly Hills Cop,26.0,8,0,0,1,0,stay,1985-02-16
27144,Soundtrack,1985-04-20,Soundtrack - Beverly Hills Cop,8,8,6,6.0,8,Beverly Hills Cop,26.0,9,2,0,0,1,up,1985-02-16
27145,Soundtrack,1985-04-27,Soundtrack - Beverly Hills Cop,8,8,9,6.0,6,Beverly Hills Cop,26.0,10,-3,2,0,1,down,1985-02-16
27146,Soundtrack,1985-05-04,Soundtrack - Beverly Hills Cop,6,8,9,6.0,9,Beverly Hills Cop,26.0,11,0,-3,2,0,stay,1985-02-16
27147,Soundtrack,1985-05-11,Soundtrack - Beverly Hills Cop,9,6,11,6.0,9,Beverly Hills Cop,26.0,12,-2,0,-3,1,down,1985-02-16
27148,Soundtrack,1985-05-18,Soundtrack - Beverly Hills Cop,9,9,12,6.0,11,Beverly Hills Cop,26.0,13,-1,-2,0,1,down,1985-02-16
27149,Soundtrack,1985-05-25,Soundtrack - Beverly Hills Cop,11,9,11,6.0,12,Beverly Hills Cop,26.0,14,1,-1,-2,1,up,1985-02-16
27150,Soundtrack,1985-06-01,Soundtrack - Beverly Hills Cop,12,11,14,6.0,11,Beverly Hills Cop,26.0,15,-3,1,-1,1,down,1985-02-16
27151,Soundtrack,1985-06-08,Soundtrack - Beverly Hills Cop,11,12,16,6.0,14,Beverly Hills Cop,26.0,16,-2,-3,1,1,down,1985-02-16
27152,Soundtrack,1985-06-15,Soundtrack - Beverly Hills Cop,14,11,19,6.0,16,Beverly Hills Cop,26.0,17,-3,-2,-3,1,down,1985-02-16
27153,Soundtrack,1985-06-22,Soundtrack - Beverly Hills Cop,16,14,26,6.0,19,Beverly Hills Cop,26.0,18,-7,-3,-2,1,down,1985-02-16
27154,Soundtrack,1985-06-29,Soundtrack - Beverly Hills Cop,19,16,26,6.0,26,Beverly Hills Cop,26.0,19,0,-7,-3,0,stay,1985-02-16
27155,Soundtrack,1985-07-06,Soundtrack - Beverly Hills Cop,26,19,25,6.0,26,Beverly Hills Cop,26.0,20,1,0,-7,1,up,1985-02-16
27156,Soundtrack,1985-07-13,Soundtrack - Beverly Hills Cop,26,26,23,6.0,25,Beverly Hills Cop,26.0,21,2,1,0,1,up,1985-02-16
27157,Soundtrack,1985-07-20,Soundtrack - Beverly Hills Cop,25,26,23,6.0,23,Beverly Hills Cop,26.0,22,0,2,1,0,stay,1985-02-16
27158,Soundtrack,1985-07-27,Soundtrack - Beverly Hills Cop,23,25,26,6.0,23,Beverly Hills Cop,26.0,23,-3,0,2,1,down,1985-02-16
27159,Soundtrack,1985-08-03,Soundtrack - Beverly Hills Cop,23,23,27,6.0,26,Beverly Hills Cop,26.0,24,-1,-3,0,1,down,1985-02-16
27160,Soundtrack,1985-08-10,Soundtrack - Beverly Hills Cop,26,23,30,6.0,27,Beverly Hills Cop,26.0,25,-3,-1,-3,1,down,1985-02-16
27161,Soundtrack,1985-08-17,Soundtrack - Beverly Hills Cop,27,26,51,6.0,30,Beverly Hills Cop,26.0,26,-21,-3,-1,1,down,1985-02-16
27162,Sheena Easton,1985-02-16,Sheena Easton - A Private Heaven,51,51,31,26.0,35,A Private Heaven,6.0,0,4,16,0,1,up,1985-02-16
27163,Sheena Easton,1985-02-23,Sheena Easton - A Private Heaven,35,51,28,26.0,31,A Private Heaven,6.0,1,3,4,16,1,up,1985-02-16
27164,Sheena Easton,1985-03-02,Sheena Easton - A Private Heaven,31,35,26,26.0,28,A Private Heaven,6.0,2,2,3,4,1,up,1985-02-16
27165,Sheena Easton,1985-03-09,Sheena Easton - A Private Heaven,28,31,26,26.0,26,A Private Heaven,6.0,3,0,2,3,0,stay,1985-02-16
27166,Sheena Easton,1985-03-16,Sheena Easton - A Private Heaven,26,28,29,26.0,26,A Private Heaven,6.0,4,-3,0,2,1,down,1985-02-16
27167,Sheena Easton,1985-03-23,Sheena Easton - A Private Heaven,26,26,38,26.0,29,A Private Heaven,6.0,5,-9,-3,0,1,down,1985-02-16
27168,Sheena Easton,1985-03-30,Sheena Easton - A Private Heaven,29,26,51,26.0,38,A Private Heaven,6.0,6,-13,-9,-3,1,down,1985-02-16
27169,Wham!,1985-02-16,Wham! - Make It Big,51,51,34,20.0,38,Make It Big,26.0,0,4,13,0,1,up,1985-02-16
27170,Wham!,1985-02-23,Wham! - Make It Big,38,51,31,20.0,34,Make It Big,26.0,1,3,4,13,1,up,1985-02-16
27171,Wham!,1985-03-02,Wham! - Make It Big,34,38,29,20.0,31,Make It Big,26.0,2,2,3,4,1,up,1985-02-16
27172,Wham!,1985-03-09,Wham! - Make It Big,31,34,29,20.0,29,Make It Big,26.0,3,0,2,3,0,stay,1985-02-16
27173,Wham!,1985-03-16,Wham! - Make It Big,29,31,31,20.0,29,Make It Big,26.0,4,-2,0,2,1,down,1985-02-16
27174,Wham!,1985-03-23,Wham! - Make It Big,29,29,30,20.0,31,Make It Big,26.0,5,1,-2,0,1,up,1985-02-16
27175,Wham!,1985-03-30,Wham! - Make It Big,31,29,34,20.0,30,Make It Big,26.0,6,-4,1,-2,1,down,1985-02-16
27176,Wham!,1985-04-06,Wham! - Make It Big,30,31,33,20.0,34,Make It Big,26.0,7,1,-4,1,1,up,1985-02-16
27177,Wham!,1985-04-13,Wham! - Make It Big,34,30,34,20.0,33,Make It Big,26.0,8,-1,1,-4,1,down,1985-02-16
27178,Wham!,1985-04-20,Wham! - Make It Big,33,34,35,20.0,34,Make It Big,26.0,9,-1,-1,1,1,down,1985-02-16
27179,Wham!,1985-04-27,Wham! - Make It Big,34,33,37,20.0,35,Make It Big,26.0,10,-2,-1,-1,1,down,1985-02-16
27180,Wham!,1985-05-04,Wham! - Make It Big,35,34,36,20.0,37,Make It Big,26.0,11,1,-2,-1,1,up,1985-02-16
27181,Wham!,1985-05-11,Wham! - Make It Big,37,35,32,20.0,36,Make It Big,26.0,12,4,1,-2,1,up,1985-02-16
27182,Wham!,1985-05-18,Wham! - Make It Big,36,37,32,20.0,32,Make It Big,26.0,13,0,4,1,0,stay,1985-02-16
27183,Wham!,1985-05-25,Wham! - Make It Big,32,36,29,20.0,32,Make It Big,26.0,14,3,0,4,1,up,1985-02-16
27184,Wham!,1985-06-01,Wham! - Make It Big,32,32,23,20.0,29,Make It Big,26.0,15,6,3,0,1,up,1985-02-16
27185,Wham!,1985-06-08,Wham! - Make It Big,29,32,22,20.0,23,Make It Big,26.0,16,1,6,3,1,up,1985-02-16
27186,Wham!,1985-06-15,Wham! - Make It Big,23,29,20,20.0,22,Make It Big,26.0,17,2,1,6,1,up,1985-02-16
27187,Wham!,1985-06-22,Wham! - Make It Big,22,23,20,20.0,20,Make It Big,26.0,18,0,2,1,0,stay,1985-02-16
27188,Wham!,1985-06-29,Wham! - Make It Big,20,22,22,20.0,20,Make It Big,26.0,19,-2,0,2,1,down,1985-02-16
27189,Wham!,1985-07-06,Wham! - Make It Big,20,20,38,20.0,22,Make It Big,26.0,20,-16,-2,0,1,down,1985-02-16
27190,Wham!,1985-07-13,Wham! - Make It Big,22,20,30,20.0,38,Make It Big,26.0,21,8,-16,-2,1,up,1985-02-16
27191,Wham!,1985-07-20,Wham! - Make It Big,38,22,29,20.0,30,Make It Big,26.0,22,1,8,-16,1,up,1985-02-16
27192,Wham!,1985-07-27,Wham! - Make It Big,30,38,29,20.0,29,Make It Big,26.0,23,0,1,8,0,stay,1985-02-16
27193,Wham!,1985-08-03,Wham! - Make It Big,29,30,29,20.0,29,Make It Big,26.0,24,0,0,1,0,stay,1985-02-16
27194,Wham!,1985-08-10,Wham! - Make It Big,29,29,43,20.0,29,Make It Big,26.0,25,-14,0,0,1,down,1985-02-16
27195,Wham!,1985-08-17,Wham! - Make It Big,29,29,51,20.0,43,Make It Big,26.0,26,-8,-14,0,1,down,1985-02-16
27196,David Sanborn,1985-02-16,David Sanborn - Straight To The Heart,51,51,36,31.0,42,Straight To The Heart,6.0,0,6,9,0,1,up,1985-02-16
27197,David Sanborn,1985-02-23,David Sanborn - Straight To The Heart,42,51,33,31.0,36,Straight To The Heart,6.0,1,3,6,9,1,up,1985-02-16
27198,David Sanborn,1985-03-02,David Sanborn - Straight To The Heart,36,42,31,31.0,33,Straight To The Heart,6.0,2,2,3,6,1,up,1985-02-16
27199,David Sanborn,1985-03-09,David Sanborn - Straight To The Heart,33,36,31,31.0,31,Straight To The Heart,6.0,3,0,2,3,0,stay,1985-02-16
27200,David Sanborn,1985-03-16,David Sanborn - Straight To The Heart,31,33,41,31.0,31,Straight To The Heart,6.0,4,-10,0,2,1,down,1985-02-16
27201,David Sanborn,1985-03-23,David Sanborn - Straight To The Heart,31,31,40,31.0,41,Straight To The Heart,6.0,5,1,-10,0,1,up,1985-02-16
27202,David Sanborn,1985-03-30,David Sanborn - Straight To The Heart,41,31,51,31.0,40,Straight To The Heart,6.0,6,-11,1,-10,1,down,1985-02-16
27203,Commodores,1985-02-23,Commodores - Nightshift,51,51,17,1.0,29,Nightshift,30.0,0,12,22,0,1,up,1985-02-23
27204,Commodores,1985-03-02,Commodores - Nightshift,29,51,10,1.0,17,Nightshift,30.0,1,7,12,22,1,up,1985-02-23
27205,Commodores,1985-03-09,Commodores - Nightshift,17,29,8,1.0,10,Nightshift,30.0,2,2,7,12,1,up,1985-02-23
27206,Commodores,1985-03-16,Commodores - Nightshift,10,17,6,1.0,8,Nightshift,30.0,3,2,2,7,1,up,1985-02-23
27207,Commodores,1985-03-23,Commodores - Nightshift,8,10,2,1.0,6,Nightshift,30.0,4,4,2,2,1,up,1985-02-23
27208,Commodores,1985-03-30,Commodores - Nightshift,6,8,1,1.0,2,Nightshift,30.0,5,1,4,2,1,up,1985-02-23
27209,Commodores,1985-04-06,Commodores - Nightshift,2,6,1,1.0,1,Nightshift,30.0,6,0,1,4,0,stay,1985-02-23
27210,Commodores,1985-04-13,Commodores - Nightshift,1,2,1,1.0,1,Nightshift,30.0,7,0,0,1,0,stay,1985-02-23
27211,Commodores,1985-04-20,Commodores - Nightshift,1,1,3,1.0,1,Nightshift,30.0,8,-2,0,0,1,down,1985-02-23
27212,Commodores,1985-04-27,Commodores - Nightshift,1,1,3,1.0,3,Nightshift,30.0,9,0,-2,0,0,stay,1985-02-23
27213,Commodores,1985-05-04,Commodores - Nightshift,3,1,7,1.0,3,Nightshift,30.0,10,-4,0,-2,1,down,1985-02-23
27214,Commodores,1985-05-11,Commodores - Nightshift,3,3,7,1.0,7,Nightshift,30.0,11,0,-4,0,0,stay,1985-02-23
27215,Commodores,1985-05-18,Commodores - Nightshift,7,3,10,1.0,7,Nightshift,30.0,12,-3,0,-4,1,down,1985-02-23
27216,Commodores,1985-05-25,Commodores - Nightshift,7,7,13,1.0,10,Nightshift,30.0,13,-3,-3,0,1,down,1985-02-23
27217,Commodores,1985-06-01,Commodores - Nightshift,10,7,15,1.0,13,Nightshift,30.0,14,-2,-3,-3,1,down,1985-02-23
27218,Commodores,1985-06-08,Commodores - Nightshift,13,10,17,1.0,15,Nightshift,30.0,15,-2,-2,-3,1,down,1985-02-23
27219,Commodores,1985-06-15,Commodores - Nightshift,15,13,18,1.0,17,Nightshift,30.0,16,-1,-2,-2,1,down,1985-02-23
27220,Commodores,1985-06-22,Commodores - Nightshift,17,15,22,1.0,18,Nightshift,30.0,17,-4,-1,-2,1,down,1985-02-23
27221,Commodores,1985-06-29,Commodores - Nightshift,18,17,21,1.0,22,Nightshift,30.0,18,1,-4,-1,1,up,1985-02-23
27222,Commodores,1985-07-06,Commodores - Nightshift,22,18,22,1.0,21,Nightshift,30.0,19,-1,1,-4,1,down,1985-02-23
27223,Commodores,1985-07-13,Commodores - Nightshift,21,22,22,1.0,22,Nightshift,30.0,20,0,-1,1,0,stay,1985-02-23
27224,Commodores,1985-07-20,Commodores - Nightshift,22,21,32,1.0,22,Nightshift,30.0,21,-10,0,-1,1,down,1985-02-23
27225,Commodores,1985-07-27,Commodores - Nightshift,22,22,31,1.0,32,Nightshift,30.0,22,1,-10,0,1,up,1985-02-23
27226,Commodores,1985-08-03,Commodores - Nightshift,32,22,31,1.0,31,Nightshift,30.0,23,0,1,-10,0,stay,1985-02-23
27227,Commodores,1985-08-10,Commodores - Nightshift,31,32,32,1.0,31,Nightshift,30.0,24,-1,0,1,1,down,1985-02-23
27228,Commodores,1985-08-17,Commodores - Nightshift,31,31,39,1.0,32,Nightshift,30.0,25,-7,-1,0,1,down,1985-02-23
27229,Commodores,1985-08-24,Commodores - Nightshift,32,31,37,1.0,39,Nightshift,30.0,26,2,-7,-1,1,up,1985-02-23
27230,Commodores,1985-08-31,Commodores - Nightshift,39,32,48,1.0,37,Nightshift,30.0,27,-11,2,-7,1,down,1985-02-23
27231,Commodores,1985-09-14,Commodores - Nightshift,37,39,48,1.0,48,Nightshift,30.0,28,0,-11,2,0,stay,1985-02-23
27232,Commodores,1985-09-21,Commodores - Nightshift,48,37,50,1.0,48,Nightshift,30.0,29,-2,0,-11,1,down,1985-02-23
27233,Commodores,1985-09-28,Commodores - Nightshift,48,48,51,1.0,50,Nightshift,30.0,30,-1,-2,0,1,down,1985-02-23
27234,Run-D.M.C.,1985-03-02,Run-D.M.C. - King Of Rock,51,51,24,12.0,30,King Of Rock,31.0,0,6,21,0,1,up,1985-03-02
27235,Run-D.M.C.,1985-03-09,Run-D.M.C. - King Of Rock,30,51,19,12.0,24,King Of Rock,31.0,1,5,6,21,1,up,1985-03-02
27236,Run-D.M.C.,1985-03-16,Run-D.M.C. - King Of Rock,24,30,14,12.0,19,King Of Rock,31.0,2,5,5,6,1,up,1985-03-02
27237,Run-D.M.C.,1985-03-23,Run-D.M.C. - King Of Rock,19,24,12,12.0,14,King Of Rock,31.0,3,2,5,5,1,up,1985-03-02
27238,Run-D.M.C.,1985-03-30,Run-D.M.C. - King Of Rock,14,19,12,12.0,12,King Of Rock,31.0,4,0,2,5,0,stay,1985-03-02
27239,Run-D.M.C.,1985-04-06,Run-D.M.C. - King Of Rock,12,14,12,12.0,12,King Of Rock,31.0,5,0,0,2,0,stay,1985-03-02
27240,Run-D.M.C.,1985-04-13,Run-D.M.C. - King Of Rock,12,12,15,12.0,12,King Of Rock,31.0,6,-3,0,0,1,down,1985-03-02
27241,Run-D.M.C.,1985-04-20,Run-D.M.C. - King Of Rock,12,12,16,12.0,15,King Of Rock,31.0,7,-1,-3,0,1,down,1985-03-02
27242,Run-D.M.C.,1985-04-27,Run-D.M.C. - King Of Rock,15,12,16,12.0,16,King Of Rock,31.0,8,0,-1,-3,0,stay,1985-03-02
27243,Run-D.M.C.,1985-05-04,Run-D.M.C. - King Of Rock,16,15,16,12.0,16,King Of Rock,31.0,9,0,0,-1,0,stay,1985-03-02
27244,Run-D.M.C.,1985-05-11,Run-D.M.C. - King Of Rock,16,16,18,12.0,16,King Of Rock,31.0,10,-2,0,0,1,down,1985-03-02
27245,Run-D.M.C.,1985-05-18,Run-D.M.C. - King Of Rock,16,16,16,12.0,18,King Of Rock,31.0,11,2,-2,0,1,up,1985-03-02
27246,Run-D.M.C.,1985-05-25,Run-D.M.C. - King Of Rock,18,16,20,12.0,16,King Of Rock,31.0,12,-4,2,-2,1,down,1985-03-02
27247,Run-D.M.C.,1985-06-01,Run-D.M.C. - King Of Rock,16,18,19,12.0,20,King Of Rock,31.0,13,1,-4,2,1,up,1985-03-02
27248,Run-D.M.C.,1985-06-08,Run-D.M.C. - King Of Rock,20,16,20,12.0,19,King Of Rock,31.0,14,-1,1,-4,1,down,1985-03-02
27249,Run-D.M.C.,1985-06-15,Run-D.M.C. - King Of Rock,19,20,16,12.0,20,King Of Rock,31.0,15,4,-1,1,1,up,1985-03-02
27250,Run-D.M.C.,1985-06-22,Run-D.M.C. - King Of Rock,20,19,16,12.0,16,King Of Rock,31.0,16,0,4,-1,0,stay,1985-03-02
27251,Run-D.M.C.,1985-06-29,Run-D.M.C. - King Of Rock,16,20,20,12.0,16,King Of Rock,31.0,17,-4,0,4,1,down,1985-03-02
27252,Run-D.M.C.,1985-07-06,Run-D.M.C. - King Of Rock,16,16,28,12.0,20,King Of Rock,31.0,18,-8,-4,0,1,down,1985-03-02
27253,Run-D.M.C.,1985-07-13,Run-D.M.C. - King Of Rock,20,16,27,12.0,28,King Of Rock,31.0,19,1,-8,-4,1,up,1985-03-02
27254,Run-D.M.C.,1985-07-20,Run-D.M.C. - King Of Rock,28,20,31,12.0,27,King Of Rock,31.0,20,-4,1,-8,1,down,1985-03-02
27255,Run-D.M.C.,1985-07-27,Run-D.M.C. - King Of Rock,27,28,30,12.0,31,King Of Rock,31.0,21,1,-4,1,1,up,1985-03-02
27256,Run-D.M.C.,1985-08-03,Run-D.M.C. - King Of Rock,31,27,30,12.0,30,King Of Rock,31.0,22,0,1,-4,0,stay,1985-03-02
27257,Run-D.M.C.,1985-08-10,Run-D.M.C. - King Of Rock,30,31,29,12.0,30,King Of Rock,31.0,23,1,0,1,1,up,1985-03-02
27258,Run-D.M.C.,1985-08-17,Run-D.M.C. - King Of Rock,30,30,31,12.0,29,King Of Rock,31.0,24,-2,1,0,1,down,1985-03-02
27259,Run-D.M.C.,1985-08-24,Run-D.M.C. - King Of Rock,29,30,30,12.0,31,King Of Rock,31.0,25,1,-2,1,1,up,1985-03-02
27260,Run-D.M.C.,1985-08-31,Run-D.M.C. - King Of Rock,31,29,38,12.0,30,King Of Rock,31.0,26,-8,1,-2,1,down,1985-03-02
27261,Run-D.M.C.,1985-09-07,Run-D.M.C. - King Of Rock,30,31,38,12.0,38,King Of Rock,31.0,27,0,-8,1,0,stay,1985-03-02
27262,Run-D.M.C.,1985-09-14,Run-D.M.C. - King Of Rock,38,30,38,12.0,38,King Of Rock,31.0,28,0,0,-8,0,stay,1985-03-02
27263,Run-D.M.C.,1985-09-21,Run-D.M.C. - King Of Rock,38,38,44,12.0,38,King Of Rock,31.0,29,-6,0,0,1,down,1985-03-02
27264,Run-D.M.C.,1985-09-28,Run-D.M.C. - King Of Rock,38,38,44,12.0,44,King Of Rock,31.0,30,0,-6,0,0,stay,1985-03-02
27265,Run-D.M.C.,1985-10-05,Run-D.M.C. - King Of Rock,44,38,51,12.0,44,King Of Rock,31.0,31,-7,0,-6,1,down,1985-03-02
27266,Sade,1985-03-02,Sade - Diamond Life,51,51,28,3.0,38,Diamond Life,34.0,0,10,13,0,1,up,1985-03-02
27267,Sade,1985-03-09,Sade - Diamond Life,38,51,22,3.0,28,Diamond Life,34.0,1,6,10,13,1,up,1985-03-02
27268,Sade,1985-03-16,Sade - Diamond Life,28,38,16,3.0,22,Diamond Life,34.0,2,6,6,10,1,up,1985-03-02
27269,Sade,1985-03-23,Sade - Diamond Life,22,28,16,3.0,16,Diamond Life,34.0,3,0,6,6,0,stay,1985-03-02
27270,Sade,1985-03-30,Sade - Diamond Life,16,22,10,3.0,16,Diamond Life,34.0,4,6,0,6,1,up,1985-03-02
27271,Sade,1985-04-06,Sade - Diamond Life,16,16,6,3.0,10,Diamond Life,34.0,5,4,6,0,1,up,1985-03-02
27272,Sade,1985-04-13,Sade - Diamond Life,10,16,4,3.0,6,Diamond Life,34.0,6,2,4,6,1,up,1985-03-02
27273,Sade,1985-04-20,Sade - Diamond Life,6,10,4,3.0,4,Diamond Life,34.0,7,0,2,4,0,stay,1985-03-02
27274,Sade,1985-04-27,Sade - Diamond Life,4,6,5,3.0,4,Diamond Life,34.0,8,-1,0,2,1,down,1985-03-02
27275,Sade,1985-05-04,Sade - Diamond Life,4,4,3,3.0,5,Diamond Life,34.0,9,2,-1,0,1,up,1985-03-02
27276,Sade,1985-05-11,Sade - Diamond Life,5,4,5,3.0,3,Diamond Life,34.0,10,-2,2,-1,1,down,1985-03-02
27277,Sade,1985-05-18,Sade - Diamond Life,3,5,5,3.0,5,Diamond Life,34.0,11,0,-2,2,0,stay,1985-03-02
27278,Sade,1985-05-25,Sade - Diamond Life,5,3,5,3.0,5,Diamond Life,34.0,12,0,0,-2,0,stay,1985-03-02
27279,Sade,1985-06-01,Sade - Diamond Life,5,5,7,3.0,5,Diamond Life,34.0,13,-2,0,0,1,down,1985-03-02
27280,Sade,1985-06-08,Sade - Diamond Life,5,5,8,3.0,7,Diamond Life,34.0,14,-1,-2,0,1,down,1985-03-02
27281,Sade,1985-06-15,Sade - Diamond Life,7,5,10,3.0,8,Diamond Life,34.0,15,-2,-1,-2,1,down,1985-03-02
27282,Sade,1985-06-22,Sade - Diamond Life,8,7,12,3.0,10,Diamond Life,34.0,16,-2,-2,-1,1,down,1985-03-02
27283,Sade,1985-06-29,Sade - Diamond Life,10,8,16,3.0,12,Diamond Life,34.0,17,-4,-2,-2,1,down,1985-03-02
27284,Sade,1985-07-06,Sade - Diamond Life,12,10,19,3.0,16,Diamond Life,34.0,18,-3,-4,-2,1,down,1985-03-02
27285,Sade,1985-07-13,Sade - Diamond Life,16,12,21,3.0,19,Diamond Life,34.0,19,-2,-3,-4,1,down,1985-03-02
27286,Sade,1985-07-20,Sade - Diamond Life,19,16,20,3.0,21,Diamond Life,34.0,20,1,-2,-3,1,up,1985-03-02
27287,Sade,1985-07-27,Sade - Diamond Life,21,19,20,3.0,20,Diamond Life,34.0,21,0,1,-2,0,stay,1985-03-02
27288,Sade,1985-08-03,Sade - Diamond Life,20,21,19,3.0,20,Diamond Life,34.0,22,1,0,1,1,up,1985-03-02
27289,Sade,1985-08-10,Sade - Diamond Life,20,20,19,3.0,19,Diamond Life,34.0,23,0,1,0,0,stay,1985-03-02
27290,Sade,1985-08-17,Sade - Diamond Life,19,20,19,3.0,19,Diamond Life,34.0,24,0,0,1,0,stay,1985-03-02
27291,Sade,1985-08-24,Sade - Diamond Life,19,19,22,3.0,19,Diamond Life,34.0,25,-3,0,0,1,down,1985-03-02
27292,Sade,1985-08-31,Sade - Diamond Life,19,19,24,3.0,22,Diamond Life,34.0,26,-2,-3,0,1,down,1985-03-02
27293,Sade,1985-09-07,Sade - Diamond Life,22,19,23,3.0,24,Diamond Life,34.0,27,1,-2,-3,1,up,1985-03-02
27294,Sade,1985-09-14,Sade - Diamond Life,24,22,32,3.0,23,Diamond Life,34.0,28,-9,1,-2,1,down,1985-03-02
27295,Sade,1985-09-21,Sade - Diamond Life,23,24,36,3.0,32,Diamond Life,34.0,29,-4,-9,1,1,down,1985-03-02
27296,Sade,1985-09-28,Sade - Diamond Life,32,23,43,3.0,36,Diamond Life,34.0,30,-7,-4,-9,1,down,1985-03-02
27297,Sade,1985-10-05,Sade - Diamond Life,36,32,43,3.0,43,Diamond Life,34.0,31,0,-7,-4,0,stay,1985-03-02
27298,Sade,1985-10-12,Sade - Diamond Life,43,36,48,3.0,43,Diamond Life,34.0,32,-5,0,-7,1,down,1985-03-02
27299,Sade,1985-11-02,Sade - Diamond Life,43,43,48,3.0,48,Diamond Life,34.0,33,0,-5,0,0,stay,1985-03-02
27300,Sade,1985-11-09,Sade - Diamond Life,48,43,51,3.0,48,Diamond Life,34.0,34,-3,0,-5,1,down,1985-03-02
27301,Wilton Felder,1985-03-09,Wilton Felder - Secrets,51,51,28,10.0,37,Secrets,16.0,0,9,14,0,1,up,1985-03-09
27302,Wilton Felder,1985-03-16,Wilton Felder - Secrets,37,51,23,10.0,28,Secrets,16.0,1,5,9,14,1,up,1985-03-09
27303,Wilton Felder,1985-03-23,Wilton Felder - Secrets,28,37,14,10.0,23,Secrets,16.0,2,9,5,9,1,up,1985-03-09
27304,Wilton Felder,1985-03-30,Wilton Felder - Secrets,23,28,11,10.0,14,Secrets,16.0,3,3,9,5,1,up,1985-03-09
27305,Wilton Felder,1985-04-06,Wilton Felder - Secrets,14,23,11,10.0,11,Secrets,16.0,4,0,3,9,0,stay,1985-03-09
27306,Wilton Felder,1985-04-13,Wilton Felder - Secrets,11,14,10,10.0,11,Secrets,16.0,5,1,0,3,1,up,1985-03-09
27307,Wilton Felder,1985-04-20,Wilton Felder - Secrets,11,11,11,10.0,10,Secrets,16.0,6,-1,1,0,1,down,1985-03-09
27308,Wilton Felder,1985-04-27,Wilton Felder - Secrets,10,11,11,10.0,11,Secrets,16.0,7,0,-1,1,0,stay,1985-03-09
27309,Wilton Felder,1985-05-04,Wilton Felder - Secrets,11,10,15,10.0,11,Secrets,16.0,8,-4,0,-1,1,down,1985-03-09
27310,Wilton Felder,1985-05-11,Wilton Felder - Secrets,11,11,19,10.0,15,Secrets,16.0,9,-4,-4,0,1,down,1985-03-09
27311,Wilton Felder,1985-05-18,Wilton Felder - Secrets,15,11,22,10.0,19,Secrets,16.0,10,-3,-4,-4,1,down,1985-03-09
27312,Wilton Felder,1985-05-25,Wilton Felder - Secrets,19,15,23,10.0,22,Secrets,16.0,11,-1,-3,-4,1,down,1985-03-09
27313,Wilton Felder,1985-06-01,Wilton Felder - Secrets,22,19,37,10.0,23,Secrets,16.0,12,-14,-1,-3,1,down,1985-03-09
27314,Wilton Felder,1985-06-08,Wilton Felder - Secrets,23,22,46,10.0,37,Secrets,16.0,13,-9,-14,-1,1,down,1985-03-09
27315,Wilton Felder,1985-06-15,Wilton Felder - Secrets,37,23,46,10.0,46,Secrets,16.0,14,0,-9,-14,0,stay,1985-03-09
27316,Wilton Felder,1985-06-22,Wilton Felder - Secrets,46,37,49,10.0,46,Secrets,16.0,15,-3,0,-9,1,down,1985-03-09
27317,Wilton Felder,1985-06-29,Wilton Felder - Secrets,46,46,51,10.0,49,Secrets,16.0,16,-2,-3,0,1,down,1985-03-09
27318,Grandmaster Flash,1985-03-09,Grandmaster Flash - They Said It Couldn't Be Done,51,51,40,35.0,49,They Said It Couldn't Be Done,10.0,0,9,2,0,1,up,1985-03-09
27319,Grandmaster Flash,1985-03-16,Grandmaster Flash - They Said It Couldn't Be Done,49,51,39,35.0,40,They Said It Couldn't Be Done,10.0,1,1,9,2,1,up,1985-03-09
27320,Grandmaster Flash,1985-03-23,Grandmaster Flash - They Said It Couldn't Be Done,40,49,37,35.0,39,They Said It Couldn't Be Done,10.0,2,2,1,9,1,up,1985-03-09
27321,Grandmaster Flash,1985-03-30,Grandmaster Flash - They Said It Couldn't Be Done,39,40,35,35.0,37,They Said It Couldn't Be Done,10.0,3,2,2,1,1,up,1985-03-09
27322,Grandmaster Flash,1985-04-06,Grandmaster Flash - They Said It Couldn't Be Done,37,39,35,35.0,35,They Said It Couldn't Be Done,10.0,4,0,2,2,0,stay,1985-03-09
27323,Grandmaster Flash,1985-04-13,Grandmaster Flash - They Said It Couldn't Be Done,35,37,49,35.0,35,They Said It Couldn't Be Done,10.0,5,-14,0,2,1,down,1985-03-09
27324,Grandmaster Flash,1985-05-11,Grandmaster Flash - They Said It Couldn't Be Done,35,35,49,35.0,49,They Said It Couldn't Be Done,10.0,6,0,-14,0,0,stay,1985-03-09
27325,Grandmaster Flash,1985-05-18,Grandmaster Flash - They Said It Couldn't Be Done,49,35,45,35.0,49,They Said It Couldn't Be Done,10.0,7,4,0,-14,1,up,1985-03-09
27326,Grandmaster Flash,1985-05-25,Grandmaster Flash - They Said It Couldn't Be Done,49,49,43,35.0,45,They Said It Couldn't Be Done,10.0,8,2,4,0,1,up,1985-03-09
27327,Grandmaster Flash,1985-06-01,Grandmaster Flash - They Said It Couldn't Be Done,45,49,43,35.0,43,They Said It Couldn't Be Done,10.0,9,0,2,4,0,stay,1985-03-09
27328,Grandmaster Flash,1985-06-08,Grandmaster Flash - They Said It Couldn't Be Done,43,45,51,35.0,43,They Said It Couldn't Be Done,10.0,10,-8,0,2,1,down,1985-03-09
27329,Jesse Johnson's Revue,1985-03-16,Jesse Johnson's Revue - Jesse Johnson's Revue,51,51,32,8.0,49,Jesse Johnson's Revue,40.0,0,17,2,0,1,up,1985-03-16
27330,Jesse Johnson's Revue,1985-03-23,Jesse Johnson's Revue - Jesse Johnson's Revue,49,51,23,8.0,32,Jesse Johnson's Revue,40.0,1,9,17,2,1,up,1985-03-16
27331,Jesse Johnson's Revue,1985-03-30,Jesse Johnson's Revue - Jesse Johnson's Revue,32,49,21,8.0,23,Jesse Johnson's Revue,40.0,2,2,9,17,1,up,1985-03-16
27332,Jesse Johnson's Revue,1985-04-06,Jesse Johnson's Revue - Jesse Johnson's Revue,23,32,15,8.0,21,Jesse Johnson's Revue,40.0,3,6,2,9,1,up,1985-03-16
27333,Jesse Johnson's Revue,1985-04-13,Jesse Johnson's Revue - Jesse Johnson's Revue,21,23,13,8.0,15,Jesse Johnson's Revue,40.0,4,2,6,2,1,up,1985-03-16
27334,Jesse Johnson's Revue,1985-04-20,Jesse Johnson's Revue - Jesse Johnson's Revue,15,21,13,8.0,13,Jesse Johnson's Revue,40.0,5,0,2,6,0,stay,1985-03-16
27335,Jesse Johnson's Revue,1985-04-27,Jesse Johnson's Revue - Jesse Johnson's Revue,13,15,13,8.0,13,Jesse Johnson's Revue,40.0,6,0,0,2,0,stay,1985-03-16
27336,Jesse Johnson's Revue,1985-05-04,Jesse Johnson's Revue - Jesse Johnson's Revue,13,13,11,8.0,13,Jesse Johnson's Revue,40.0,7,2,0,0,1,up,1985-03-16
27337,Jesse Johnson's Revue,1985-05-11,Jesse Johnson's Revue - Jesse Johnson's Revue,13,13,10,8.0,11,Jesse Johnson's Revue,40.0,8,1,2,0,1,up,1985-03-16
27338,Jesse Johnson's Revue,1985-05-18,Jesse Johnson's Revue - Jesse Johnson's Revue,11,13,9,8.0,10,Jesse Johnson's Revue,40.0,9,1,1,2,1,up,1985-03-16
27339,Jesse Johnson's Revue,1985-05-25,Jesse Johnson's Revue - Jesse Johnson's Revue,10,11,9,8.0,9,Jesse Johnson's Revue,40.0,10,0,1,1,0,stay,1985-03-16
27340,Jesse Johnson's Revue,1985-06-01,Jesse Johnson's Revue - Jesse Johnson's Revue,9,10,10,8.0,9,Jesse Johnson's Revue,40.0,11,-1,0,1,1,down,1985-03-16
27341,Jesse Johnson's Revue,1985-06-08,Jesse Johnson's Revue - Jesse Johnson's Revue,9,9,9,8.0,10,Jesse Johnson's Revue,40.0,12,1,-1,0,1,up,1985-03-16
27342,Jesse Johnson's Revue,1985-06-15,Jesse Johnson's Revue - Jesse Johnson's Revue,10,9,8,8.0,9,Jesse Johnson's Revue,40.0,13,1,1,-1,1,up,1985-03-16
27343,Jesse Johnson's Revue,1985-06-22,Jesse Johnson's Revue - Jesse Johnson's Revue,9,10,10,8.0,8,Jesse Johnson's Revue,40.0,14,-2,1,1,1,down,1985-03-16
27344,Jesse Johnson's Revue,1985-06-29,Jesse Johnson's Revue - Jesse Johnson's Revue,8,9,10,8.0,10,Jesse Johnson's Revue,40.0,15,0,-2,1,0,stay,1985-03-16
27345,Jesse Johnson's Revue,1985-07-06,Jesse Johnson's Revue - Jesse Johnson's Revue,10,8,11,8.0,10,Jesse Johnson's Revue,40.0,16,-1,0,-2,1,down,1985-03-16
27346,Jesse Johnson's Revue,1985-07-13,Jesse Johnson's Revue - Jesse Johnson's Revue,10,10,11,8.0,11,Jesse Johnson's Revue,40.0,17,0,-1,0,0,stay,1985-03-16
27347,Jesse Johnson's Revue,1985-07-20,Jesse Johnson's Revue - Jesse Johnson's Revue,11,10,18,8.0,11,Jesse Johnson's Revue,40.0,18,-7,0,-1,1,down,1985-03-16
27348,Jesse Johnson's Revue,1985-07-27,Jesse Johnson's Revue - Jesse Johnson's Revue,11,11,13,8.0,18,Jesse Johnson's Revue,40.0,19,5,-7,0,1,up,1985-03-16
27349,Jesse Johnson's Revue,1985-08-03,Jesse Johnson's Revue - Jesse Johnson's Revue,18,11,13,8.0,13,Jesse Johnson's Revue,40.0,20,0,5,-7,0,stay,1985-03-16
27350,Jesse Johnson's Revue,1985-08-10,Jesse Johnson's Revue - Jesse Johnson's Revue,13,18,15,8.0,13,Jesse Johnson's Revue,40.0,21,-2,0,5,1,down,1985-03-16
27351,Jesse Johnson's Revue,1985-08-17,Jesse Johnson's Revue - Jesse Johnson's Revue,13,13,14,8.0,15,Jesse Johnson's Revue,40.0,22,1,-2,0,1,up,1985-03-16
27352,Jesse Johnson's Revue,1985-08-24,Jesse Johnson's Revue - Jesse Johnson's Revue,15,13,14,8.0,14,Jesse Johnson's Revue,40.0,23,0,1,-2,0,stay,1985-03-16
27353,Jesse Johnson's Revue,1985-08-31,Jesse Johnson's Revue - Jesse Johnson's Revue,14,15,10,8.0,14,Jesse Johnson's Revue,40.0,24,4,0,1,1,up,1985-03-16
27354,Jesse Johnson's Revue,1985-09-07,Jesse Johnson's Revue - Jesse Johnson's Revue,14,14,9,8.0,10,Jesse Johnson's Revue,40.0,25,1,4,0,1,up,1985-03-16
27355,Jesse Johnson's Revue,1985-09-14,Jesse Johnson's Revue - Jesse Johnson's Revue,10,14,9,8.0,9,Jesse Johnson's Revue,40.0,26,0,1,4,0,stay,1985-03-16
27356,Jesse Johnson's Revue,1985-09-21,Jesse Johnson's Revue - Jesse Johnson's Revue,9,10,9,8.0,9,Jesse Johnson's Revue,40.0,27,0,0,1,0,stay,1985-03-16
27357,Jesse Johnson's Revue,1985-09-28,Jesse Johnson's Revue - Jesse Johnson's Revue,9,9,12,8.0,9,Jesse Johnson's Revue,40.0,28,-3,0,0,1,down,1985-03-16
27358,Jesse Johnson's Revue,1985-10-05,Jesse Johnson's Revue - Jesse Johnson's Revue,9,9,14,8.0,12,Jesse Johnson's Revue,40.0,29,-2,-3,0,1,down,1985-03-16
27359,Jesse Johnson's Revue,1985-10-12,Jesse Johnson's Revue - Jesse Johnson's Revue,12,9,15,8.0,14,Jesse Johnson's Revue,40.0,30,-1,-2,-3,1,down,1985-03-16
27360,Jesse Johnson's Revue,1985-10-19,Jesse Johnson's Revue - Jesse Johnson's Revue,14,12,19,8.0,15,Jesse Johnson's Revue,40.0,31,-4,-1,-2,1,down,1985-03-16
27361,Jesse Johnson's Revue,1985-10-26,Jesse Johnson's Revue - Jesse Johnson's Revue,15,14,28,8.0,19,Jesse Johnson's Revue,40.0,32,-9,-4,-1,1,down,1985-03-16
27362,Jesse Johnson's Revue,1985-11-02,Jesse Johnson's Revue - Jesse Johnson's Revue,19,15,28,8.0,28,Jesse Johnson's Revue,40.0,33,0,-9,-4,0,stay,1985-03-16
27363,Jesse Johnson's Revue,1985-11-09,Jesse Johnson's Revue - Jesse Johnson's Revue,28,19,34,8.0,28,Jesse Johnson's Revue,40.0,34,-6,0,-9,1,down,1985-03-16
27364,Jesse Johnson's Revue,1985-11-16,Jesse Johnson's Revue - Jesse Johnson's Revue,28,28,36,8.0,34,Jesse Johnson's Revue,40.0,35,-2,-6,0,1,down,1985-03-16
27365,Jesse Johnson's Revue,1985-11-23,Jesse Johnson's Revue - Jesse Johnson's Revue,34,28,35,8.0,36,Jesse Johnson's Revue,40.0,36,1,-2,-6,1,up,1985-03-16
27366,Jesse Johnson's Revue,1985-11-30,Jesse Johnson's Revue - Jesse Johnson's Revue,36,34,46,8.0,35,Jesse Johnson's Revue,40.0,37,-11,1,-2,1,down,1985-03-16
27367,Jesse Johnson's Revue,1985-12-07,Jesse Johnson's Revue - Jesse Johnson's Revue,35,36,42,8.0,46,Jesse Johnson's Revue,40.0,38,4,-11,1,1,up,1985-03-16
27368,Jesse Johnson's Revue,1985-12-14,Jesse Johnson's Revue - Jesse Johnson's Revue,46,35,42,8.0,42,Jesse Johnson's Revue,40.0,39,0,4,-11,0,stay,1985-03-16
27369,Jesse Johnson's Revue,1985-12-21,Jesse Johnson's Revue - Jesse Johnson's Revue,42,46,51,8.0,42,Jesse Johnson's Revue,40.0,40,-9,0,4,1,down,1985-03-16
27370,Foreigner,1985-03-16,Foreigner - Agent Provocateur,51,51,49,49.0,50,Agent Provocateur,1.0,0,1,1,0,1,up,1985-03-16
27371,Foreigner,1985-03-23,Foreigner - Agent Provocateur,50,51,51,49.0,49,Agent Provocateur,1.0,1,-2,1,1,1,down,1985-03-16
27372,Mary Jane Girls,1985-03-23,Mary Jane Girls - Only Four You,51,51,27,5.0,37,Only Four You,30.0,0,10,14,0,1,up,1985-03-23
27373,Mary Jane Girls,1985-03-30,Mary Jane Girls - Only Four You,37,51,23,5.0,27,Only Four You,30.0,1,4,10,14,1,up,1985-03-23
27374,Mary Jane Girls,1985-04-06,Mary Jane Girls - Only Four You,27,37,20,5.0,23,Only Four You,30.0,2,3,4,10,1,up,1985-03-23
27375,Mary Jane Girls,1985-04-13,Mary Jane Girls - Only Four You,23,27,14,5.0,20,Only Four You,30.0,3,6,3,4,1,up,1985-03-23
27376,Mary Jane Girls,1985-04-20,Mary Jane Girls - Only Four You,20,23,14,5.0,14,Only Four You,30.0,4,0,6,3,0,stay,1985-03-23
27377,Mary Jane Girls,1985-04-27,Mary Jane Girls - Only Four You,14,20,14,5.0,14,Only Four You,30.0,5,0,0,6,0,stay,1985-03-23
27378,Mary Jane Girls,1985-05-04,Mary Jane Girls - Only Four You,14,14,13,5.0,14,Only Four You,30.0,6,1,0,0,1,up,1985-03-23
27379,Mary Jane Girls,1985-05-11,Mary Jane Girls - Only Four You,14,14,9,5.0,13,Only Four You,30.0,7,4,1,0,1,up,1985-03-23
27380,Mary Jane Girls,1985-05-18,Mary Jane Girls - Only Four You,13,14,7,5.0,9,Only Four You,30.0,8,2,4,1,1,up,1985-03-23
27381,Mary Jane Girls,1985-05-25,Mary Jane Girls - Only Four You,9,13,7,5.0,7,Only Four You,30.0,9,0,2,4,0,stay,1985-03-23
27382,Mary Jane Girls,1985-06-01,Mary Jane Girls - Only Four You,7,9,6,5.0,7,Only Four You,30.0,10,1,0,2,1,up,1985-03-23
27383,Mary Jane Girls,1985-06-08,Mary Jane Girls - Only Four You,7,7,6,5.0,6,Only Four You,30.0,11,0,1,0,0,stay,1985-03-23
27384,Mary Jane Girls,1985-06-15,Mary Jane Girls - Only Four You,6,7,5,5.0,6,Only Four You,30.0,12,1,0,1,1,up,1985-03-23
27385,Mary Jane Girls,1985-06-22,Mary Jane Girls - Only Four You,6,6,5,5.0,5,Only Four You,30.0,13,0,1,0,0,stay,1985-03-23
27386,Mary Jane Girls,1985-06-29,Mary Jane Girls - Only Four You,5,6,6,5.0,5,Only Four You,30.0,14,-1,0,1,1,down,1985-03-23
27387,Mary Jane Girls,1985-07-06,Mary Jane Girls - Only Four You,5,5,6,5.0,6,Only Four You,30.0,15,0,-1,0,0,stay,1985-03-23
27388,Mary Jane Girls,1985-07-13,Mary Jane Girls - Only Four You,6,5,6,5.0,6,Only Four You,30.0,16,0,0,-1,0,stay,1985-03-23
27389,Mary Jane Girls,1985-07-20,Mary Jane Girls - Only Four You,6,6,6,5.0,6,Only Four You,30.0,17,0,0,0,0,stay,1985-03-23
27390,Mary Jane Girls,1985-07-27,Mary Jane Girls - Only Four You,6,6,6,5.0,6,Only Four You,30.0,18,0,0,0,0,stay,1985-03-23
27391,Mary Jane Girls,1985-08-03,Mary Jane Girls - Only Four You,6,6,6,5.0,6,Only Four You,30.0,19,0,0,0,0,stay,1985-03-23
27392,Mary Jane Girls,1985-08-10,Mary Jane Girls - Only Four You,6,6,9,5.0,6,Only Four You,30.0,20,-3,0,0,1,down,1985-03-23
27393,Mary Jane Girls,1985-08-17,Mary Jane Girls - Only Four You,6,6,10,5.0,9,Only Four You,30.0,21,-1,-3,0,1,down,1985-03-23
27394,Mary Jane Girls,1985-08-24,Mary Jane Girls - Only Four You,9,6,11,5.0,10,Only Four You,30.0,22,-1,-1,-3,1,down,1985-03-23
27395,Mary Jane Girls,1985-08-31,Mary Jane Girls - Only Four You,10,9,13,5.0,11,Only Four You,30.0,23,-2,-1,-1,1,down,1985-03-23
27396,Mary Jane Girls,1985-09-07,Mary Jane Girls - Only Four You,11,10,19,5.0,13,Only Four You,30.0,24,-6,-2,-1,1,down,1985-03-23
27397,Mary Jane Girls,1985-09-14,Mary Jane Girls - Only Four You,13,11,31,5.0,19,Only Four You,30.0,25,-12,-6,-2,1,down,1985-03-23
27398,Mary Jane Girls,1985-09-21,Mary Jane Girls - Only Four You,19,13,32,5.0,31,Only Four You,30.0,26,-1,-12,-6,1,down,1985-03-23
27399,Mary Jane Girls,1985-09-28,Mary Jane Girls - Only Four You,31,19,35,5.0,32,Only Four You,30.0,27,-3,-1,-12,1,down,1985-03-23
27400,Mary Jane Girls,1985-10-05,Mary Jane Girls - Only Four You,32,31,40,5.0,35,Only Four You,30.0,28,-5,-3,-1,1,down,1985-03-23
27401,Mary Jane Girls,1985-10-12,Mary Jane Girls - Only Four You,35,32,43,5.0,40,Only Four You,30.0,29,-3,-5,-3,1,down,1985-03-23
27402,Mary Jane Girls,1985-10-19,Mary Jane Girls - Only Four You,40,35,51,5.0,43,Only Four You,30.0,30,-8,-3,-5,1,down,1985-03-23
27403,Various Artists,1985-03-23,Various Artists - Tommy Boy's Greatest Beats,51,51,42,39.0,45,Tommy Boy's Greatest Beats,3.0,0,3,6,0,1,up,1985-03-23
27404,Various Artists,1985-03-30,Various Artists - Tommy Boy's Greatest Beats,45,51,39,39.0,42,Tommy Boy's Greatest Beats,3.0,1,3,3,6,1,up,1985-03-23
27405,Various Artists,1985-04-06,Various Artists - Tommy Boy's Greatest Beats,42,45,39,39.0,39,Tommy Boy's Greatest Beats,3.0,2,0,3,3,0,stay,1985-03-23
27406,Various Artists,1985-04-13,Various Artists - Tommy Boy's Greatest Beats,39,42,51,39.0,39,Tommy Boy's Greatest Beats,3.0,3,-12,0,3,1,down,1985-03-23
27407,Jeff Lorber,1985-03-23,Jeff Lorber - Step By Step,51,51,43,33.0,48,Step By Step,8.0,0,5,3,0,1,up,1985-03-23
27408,Jeff Lorber,1985-03-30,Jeff Lorber - Step By Step,48,51,37,33.0,43,Step By Step,8.0,1,6,5,3,1,up,1985-03-23
27409,Jeff Lorber,1985-04-06,Jeff Lorber - Step By Step,43,48,36,33.0,37,Step By Step,8.0,2,1,6,5,1,up,1985-03-23
27410,Jeff Lorber,1985-04-13,Jeff Lorber - Step By Step,37,43,36,33.0,36,Step By Step,8.0,3,0,1,6,0,stay,1985-03-23
27411,Jeff Lorber,1985-04-20,Jeff Lorber - Step By Step,36,37,33,33.0,36,Step By Step,8.0,4,3,0,1,1,up,1985-03-23
27412,Jeff Lorber,1985-04-27,Jeff Lorber - Step By Step,36,36,33,33.0,33,Step By Step,8.0,5,0,3,0,0,stay,1985-03-23
27413,Jeff Lorber,1985-05-04,Jeff Lorber - Step By Step,33,36,34,33.0,33,Step By Step,8.0,6,-1,0,3,1,down,1985-03-23
27414,Jeff Lorber,1985-05-11,Jeff Lorber - Step By Step,33,33,44,33.0,34,Step By Step,8.0,7,-10,-1,0,1,down,1985-03-23
27415,Jeff Lorber,1985-05-18,Jeff Lorber - Step By Step,34,33,51,33.0,44,Step By Step,8.0,8,-7,-10,-1,1,down,1985-03-23
27416,Debarge,1985-03-30,Debarge - Rhythm Of The Night,51,51,22,3.0,35,Rhythm Of The Night,39.0,0,13,16,0,1,up,1985-03-30
27417,Debarge,1985-04-06,Debarge - Rhythm Of The Night,35,51,17,3.0,22,Rhythm Of The Night,39.0,1,5,13,16,1,up,1985-03-30
27418,Debarge,1985-04-13,Debarge - Rhythm Of The Night,22,35,11,3.0,17,Rhythm Of The Night,39.0,2,6,5,13,1,up,1985-03-30
27419,Debarge,1985-04-20,Debarge - Rhythm Of The Night,17,22,8,3.0,11,Rhythm Of The Night,39.0,3,3,6,5,1,up,1985-03-30
27420,Debarge,1985-04-27,Debarge - Rhythm Of The Night,11,17,4,3.0,8,Rhythm Of The Night,39.0,4,4,3,6,1,up,1985-03-30
27421,Debarge,1985-05-04,Debarge - Rhythm Of The Night,8,11,4,3.0,4,Rhythm Of The Night,39.0,5,0,4,3,0,stay,1985-03-30
27422,Debarge,1985-05-11,Debarge - Rhythm Of The Night,4,8,3,3.0,4,Rhythm Of The Night,39.0,6,1,0,4,1,up,1985-03-30
27423,Debarge,1985-05-18,Debarge - Rhythm Of The Night,4,4,4,3.0,3,Rhythm Of The Night,39.0,7,-1,1,0,1,down,1985-03-30
27424,Debarge,1985-05-25,Debarge - Rhythm Of The Night,3,4,8,3.0,4,Rhythm Of The Night,39.0,8,-4,-1,1,1,down,1985-03-30
27425,Debarge,1985-06-01,Debarge - Rhythm Of The Night,4,3,11,3.0,8,Rhythm Of The Night,39.0,9,-3,-4,-1,1,down,1985-03-30
27426,Debarge,1985-06-08,Debarge - Rhythm Of The Night,8,4,13,3.0,11,Rhythm Of The Night,39.0,10,-2,-3,-4,1,down,1985-03-30
27427,Debarge,1985-06-15,Debarge - Rhythm Of The Night,11,8,15,3.0,13,Rhythm Of The Night,39.0,11,-2,-2,-3,1,down,1985-03-30
27428,Debarge,1985-06-22,Debarge - Rhythm Of The Night,13,11,18,3.0,15,Rhythm Of The Night,39.0,12,-3,-2,-2,1,down,1985-03-30
27429,Debarge,1985-06-29,Debarge - Rhythm Of The Night,15,13,13,3.0,18,Rhythm Of The Night,39.0,13,5,-3,-2,1,up,1985-03-30
27430,Debarge,1985-07-06,Debarge - Rhythm Of The Night,18,15,13,3.0,13,Rhythm Of The Night,39.0,14,0,5,-3,0,stay,1985-03-30
27431,Debarge,1985-07-13,Debarge - Rhythm Of The Night,13,18,16,3.0,13,Rhythm Of The Night,39.0,15,-3,0,5,1,down,1985-03-30
27432,Debarge,1985-07-20,Debarge - Rhythm Of The Night,13,13,16,3.0,16,Rhythm Of The Night,39.0,16,0,-3,0,0,stay,1985-03-30
27433,Debarge,1985-07-27,Debarge - Rhythm Of The Night,16,13,15,3.0,16,Rhythm Of The Night,39.0,17,1,0,-3,1,up,1985-03-30
27434,Debarge,1985-08-03,Debarge - Rhythm Of The Night,16,16,14,3.0,15,Rhythm Of The Night,39.0,18,1,1,0,1,up,1985-03-30
27435,Debarge,1985-08-10,Debarge - Rhythm Of The Night,15,16,14,3.0,14,Rhythm Of The Night,39.0,19,0,1,1,0,stay,1985-03-30
27436,Debarge,1985-08-17,Debarge - Rhythm Of The Night,14,15,13,3.0,14,Rhythm Of The Night,39.0,20,1,0,1,1,up,1985-03-30
27437,Debarge,1985-08-24,Debarge - Rhythm Of The Night,14,14,12,3.0,13,Rhythm Of The Night,39.0,21,1,1,0,1,up,1985-03-30
27438,Debarge,1985-08-31,Debarge - Rhythm Of The Night,13,14,12,3.0,12,Rhythm Of The Night,39.0,22,0,1,1,0,stay,1985-03-30
27439,Debarge,1985-09-07,Debarge - Rhythm Of The Night,12,13,13,3.0,12,Rhythm Of The Night,39.0,23,-1,0,1,1,down,1985-03-30
27440,Debarge,1985-09-14,Debarge - Rhythm Of The Night,12,12,15,3.0,13,Rhythm Of The Night,39.0,24,-2,-1,0,1,down,1985-03-30
27441,Debarge,1985-09-21,Debarge - Rhythm Of The Night,13,12,18,3.0,15,Rhythm Of The Night,39.0,25,-3,-2,-1,1,down,1985-03-30
27442,Debarge,1985-09-28,Debarge - Rhythm Of The Night,15,13,19,3.0,18,Rhythm Of The Night,39.0,26,-1,-3,-2,1,down,1985-03-30
27443,Debarge,1985-10-05,Debarge - Rhythm Of The Night,18,15,20,3.0,19,Rhythm Of The Night,39.0,27,-1,-1,-3,1,down,1985-03-30
27444,Debarge,1985-10-12,Debarge - Rhythm Of The Night,19,18,28,3.0,20,Rhythm Of The Night,39.0,28,-8,-1,-1,1,down,1985-03-30
27445,Debarge,1985-10-19,Debarge - Rhythm Of The Night,20,19,26,3.0,28,Rhythm Of The Night,39.0,29,2,-8,-1,1,up,1985-03-30
27446,Debarge,1985-10-26,Debarge - Rhythm Of The Night,28,20,26,3.0,26,Rhythm Of The Night,39.0,30,0,2,-8,0,stay,1985-03-30
27447,Debarge,1985-11-02,Debarge - Rhythm Of The Night,26,28,30,3.0,26,Rhythm Of The Night,39.0,31,-4,0,2,1,down,1985-03-30
27448,Debarge,1985-11-09,Debarge - Rhythm Of The Night,26,26,41,3.0,30,Rhythm Of The Night,39.0,32,-11,-4,0,1,down,1985-03-30
27449,Debarge,1985-11-16,Debarge - Rhythm Of The Night,30,26,37,3.0,41,Rhythm Of The Night,39.0,33,4,-11,-4,1,up,1985-03-30
27450,Debarge,1985-11-23,Debarge - Rhythm Of The Night,41,30,36,3.0,37,Rhythm Of The Night,39.0,34,1,4,-11,1,up,1985-03-30
27451,Debarge,1985-11-30,Debarge - Rhythm Of The Night,37,41,36,3.0,36,Rhythm Of The Night,39.0,35,0,1,4,0,stay,1985-03-30
27452,Debarge,1985-12-07,Debarge - Rhythm Of The Night,36,37,43,3.0,36,Rhythm Of The Night,39.0,36,-7,0,1,1,down,1985-03-30
27453,Debarge,1985-12-14,Debarge - Rhythm Of The Night,36,36,41,3.0,43,Rhythm Of The Night,39.0,37,2,-7,0,1,up,1985-03-30
27454,Debarge,1985-12-21,Debarge - Rhythm Of The Night,43,36,46,3.0,41,Rhythm Of The Night,39.0,38,-5,2,-7,1,down,1985-03-30
27455,Debarge,1985-12-28,Debarge - Rhythm Of The Night,41,43,51,3.0,46,Rhythm Of The Night,39.0,39,-5,-5,2,1,down,1985-03-30
27456,Maze Featuring Frankie Beverly,1985-03-30,Maze Featuring Frankie Beverly - Can't Stop The Love,51,51,9,1.0,39,Can't Stop The Love,35.0,0,30,12,0,1,up,1985-03-30
27457,Maze Featuring Frankie Beverly,1985-04-06,Maze Featuring Frankie Beverly - Can't Stop The Love,39,51,3,1.0,9,Can't Stop The Love,35.0,1,6,30,12,1,up,1985-03-30
27458,Maze Featuring Frankie Beverly,1985-04-13,Maze Featuring Frankie Beverly - Can't Stop The Love,9,39,3,1.0,3,Can't Stop The Love,35.0,2,0,6,30,0,stay,1985-03-30
27459,Maze Featuring Frankie Beverly,1985-04-20,Maze Featuring Frankie Beverly - Can't Stop The Love,3,9,1,1.0,3,Can't Stop The Love,35.0,3,2,0,6,1,up,1985-03-30
27460,Maze Featuring Frankie Beverly,1985-04-27,Maze Featuring Frankie Beverly - Can't Stop The Love,3,3,2,1.0,1,Can't Stop The Love,35.0,4,-1,2,0,1,down,1985-03-30
27461,Maze Featuring Frankie Beverly,1985-05-04,Maze Featuring Frankie Beverly - Can't Stop The Love,1,3,2,1.0,2,Can't Stop The Love,35.0,5,0,-1,2,0,stay,1985-03-30
27462,Maze Featuring Frankie Beverly,1985-05-11,Maze Featuring Frankie Beverly - Can't Stop The Love,2,1,2,1.0,2,Can't Stop The Love,35.0,6,0,0,-1,0,stay,1985-03-30
27463,Maze Featuring Frankie Beverly,1985-05-18,Maze Featuring Frankie Beverly - Can't Stop The Love,2,2,2,1.0,2,Can't Stop The Love,35.0,7,0,0,0,0,stay,1985-03-30
27464,Maze Featuring Frankie Beverly,1985-05-25,Maze Featuring Frankie Beverly - Can't Stop The Love,2,2,2,1.0,2,Can't Stop The Love,35.0,8,0,0,0,0,stay,1985-03-30
27465,Maze Featuring Frankie Beverly,1985-06-01,Maze Featuring Frankie Beverly - Can't Stop The Love,2,2,2,1.0,2,Can't Stop The Love,35.0,9,0,0,0,0,stay,1985-03-30
27466,Maze Featuring Frankie Beverly,1985-06-08,Maze Featuring Frankie Beverly - Can't Stop The Love,2,2,2,1.0,2,Can't Stop The Love,35.0,10,0,0,0,0,stay,1985-03-30
27467,Maze Featuring Frankie Beverly,1985-06-15,Maze Featuring Frankie Beverly - Can't Stop The Love,2,2,6,1.0,2,Can't Stop The Love,35.0,11,-4,0,0,1,down,1985-03-30
27468,Maze Featuring Frankie Beverly,1985-06-22,Maze Featuring Frankie Beverly - Can't Stop The Love,2,2,7,1.0,6,Can't Stop The Love,35.0,12,-1,-4,0,1,down,1985-03-30
27469,Maze Featuring Frankie Beverly,1985-06-29,Maze Featuring Frankie Beverly - Can't Stop The Love,6,2,7,1.0,7,Can't Stop The Love,35.0,13,0,-1,-4,0,stay,1985-03-30
27470,Maze Featuring Frankie Beverly,1985-07-06,Maze Featuring Frankie Beverly - Can't Stop The Love,7,6,7,1.0,7,Can't Stop The Love,35.0,14,0,0,-1,0,stay,1985-03-30
27471,Maze Featuring Frankie Beverly,1985-07-13,Maze Featuring Frankie Beverly - Can't Stop The Love,7,7,7,1.0,7,Can't Stop The Love,35.0,15,0,0,0,0,stay,1985-03-30
27472,Maze Featuring Frankie Beverly,1985-07-20,Maze Featuring Frankie Beverly - Can't Stop The Love,7,7,8,1.0,7,Can't Stop The Love,35.0,16,-1,0,0,1,down,1985-03-30
27473,Maze Featuring Frankie Beverly,1985-07-27,Maze Featuring Frankie Beverly - Can't Stop The Love,7,7,12,1.0,8,Can't Stop The Love,35.0,17,-4,-1,0,1,down,1985-03-30
27474,Maze Featuring Frankie Beverly,1985-08-03,Maze Featuring Frankie Beverly - Can't Stop The Love,8,7,11,1.0,12,Can't Stop The Love,35.0,18,1,-4,-1,1,up,1985-03-30
27475,Maze Featuring Frankie Beverly,1985-08-10,Maze Featuring Frankie Beverly - Can't Stop The Love,12,8,13,1.0,11,Can't Stop The Love,35.0,19,-2,1,-4,1,down,1985-03-30
27476,Maze Featuring Frankie Beverly,1985-08-17,Maze Featuring Frankie Beverly - Can't Stop The Love,11,12,11,1.0,13,Can't Stop The Love,35.0,20,2,-2,1,1,up,1985-03-30
27477,Maze Featuring Frankie Beverly,1985-08-24,Maze Featuring Frankie Beverly - Can't Stop The Love,13,11,15,1.0,11,Can't Stop The Love,35.0,21,-4,2,-2,1,down,1985-03-30
27478,Maze Featuring Frankie Beverly,1985-08-31,Maze Featuring Frankie Beverly - Can't Stop The Love,11,13,17,1.0,15,Can't Stop The Love,35.0,22,-2,-4,2,1,down,1985-03-30
27479,Maze Featuring Frankie Beverly,1985-09-07,Maze Featuring Frankie Beverly - Can't Stop The Love,15,11,20,1.0,17,Can't Stop The Love,35.0,23,-3,-2,-4,1,down,1985-03-30
27480,Maze Featuring Frankie Beverly,1985-09-14,Maze Featuring Frankie Beverly - Can't Stop The Love,17,15,21,1.0,20,Can't Stop The Love,35.0,24,-1,-3,-2,1,down,1985-03-30
27481,Maze Featuring Frankie Beverly,1985-09-21,Maze Featuring Frankie Beverly - Can't Stop The Love,20,17,26,1.0,21,Can't Stop The Love,35.0,25,-5,-1,-3,1,down,1985-03-30
27482,Maze Featuring Frankie Beverly,1985-09-28,Maze Featuring Frankie Beverly - Can't Stop The Love,21,20,33,1.0,26,Can't Stop The Love,35.0,26,-7,-5,-1,1,down,1985-03-30
27483,Maze Featuring Frankie Beverly,1985-10-05,Maze Featuring Frankie Beverly - Can't Stop The Love,26,21,33,1.0,33,Can't Stop The Love,35.0,27,0,-7,-5,0,stay,1985-03-30
27484,Maze Featuring Frankie Beverly,1985-10-12,Maze Featuring Frankie Beverly - Can't Stop The Love,33,26,33,1.0,33,Can't Stop The Love,35.0,28,0,0,-7,0,stay,1985-03-30
27485,Maze Featuring Frankie Beverly,1985-10-19,Maze Featuring Frankie Beverly - Can't Stop The Love,33,33,28,1.0,33,Can't Stop The Love,35.0,29,5,0,0,1,up,1985-03-30
27486,Maze Featuring Frankie Beverly,1985-10-26,Maze Featuring Frankie Beverly - Can't Stop The Love,33,33,27,1.0,28,Can't Stop The Love,35.0,30,1,5,0,1,up,1985-03-30
27487,Maze Featuring Frankie Beverly,1985-11-02,Maze Featuring Frankie Beverly - Can't Stop The Love,28,33,27,1.0,27,Can't Stop The Love,35.0,31,0,1,5,0,stay,1985-03-30
27488,Maze Featuring Frankie Beverly,1985-11-09,Maze Featuring Frankie Beverly - Can't Stop The Love,27,28,31,1.0,27,Can't Stop The Love,35.0,32,-4,0,1,1,down,1985-03-30
27489,Maze Featuring Frankie Beverly,1985-11-16,Maze Featuring Frankie Beverly - Can't Stop The Love,27,27,38,1.0,31,Can't Stop The Love,35.0,33,-7,-4,0,1,down,1985-03-30
27490,Maze Featuring Frankie Beverly,1985-11-23,Maze Featuring Frankie Beverly - Can't Stop The Love,31,27,41,1.0,38,Can't Stop The Love,35.0,34,-3,-7,-4,1,down,1985-03-30
27491,Maze Featuring Frankie Beverly,1985-11-30,Maze Featuring Frankie Beverly - Can't Stop The Love,38,31,51,1.0,41,Can't Stop The Love,35.0,35,-10,-3,-7,1,down,1985-03-30
27492,Gladys Knight And The Pips,1985-03-30,Gladys Knight And The Pips - Life,51,51,40,31.0,47,Life,14.0,0,7,4,0,1,up,1985-03-30
27493,Gladys Knight And The Pips,1985-04-06,Gladys Knight And The Pips - Life,47,51,37,31.0,40,Life,14.0,1,3,7,4,1,up,1985-03-30
27494,Gladys Knight And The Pips,1985-04-13,Gladys Knight And The Pips - Life,40,47,37,31.0,37,Life,14.0,2,0,3,7,0,stay,1985-03-30
27495,Gladys Knight And The Pips,1985-04-20,Gladys Knight And The Pips - Life,37,40,41,31.0,37,Life,14.0,3,-4,0,3,1,down,1985-03-30
27496,Gladys Knight And The Pips,1985-04-27,Gladys Knight And The Pips - Life,37,37,38,31.0,41,Life,14.0,4,3,-4,0,1,up,1985-03-30
27497,Gladys Knight And The Pips,1985-05-04,Gladys Knight And The Pips - Life,41,37,31,31.0,38,Life,14.0,5,7,3,-4,1,up,1985-03-30
27498,Gladys Knight And The Pips,1985-05-11,Gladys Knight And The Pips - Life,38,41,31,31.0,31,Life,14.0,6,0,7,3,0,stay,1985-03-30
27499,Gladys Knight And The Pips,1985-05-18,Gladys Knight And The Pips - Life,31,38,40,31.0,31,Life,14.0,7,-9,0,7,1,down,1985-03-30
27500,Gladys Knight And The Pips,1985-05-25,Gladys Knight And The Pips - Life,31,31,33,31.0,40,Life,14.0,8,7,-9,0,1,up,1985-03-30
27501,Gladys Knight And The Pips,1985-06-01,Gladys Knight And The Pips - Life,40,31,33,31.0,33,Life,14.0,9,0,7,-9,0,stay,1985-03-30
27502,Gladys Knight And The Pips,1985-06-08,Gladys Knight And The Pips - Life,33,40,47,31.0,33,Life,14.0,10,-14,0,7,1,down,1985-03-30
27503,Gladys Knight And The Pips,1985-06-15,Gladys Knight And The Pips - Life,33,33,45,31.0,47,Life,14.0,11,2,-14,0,1,up,1985-03-30
27504,Gladys Knight And The Pips,1985-06-22,Gladys Knight And The Pips - Life,47,33,47,31.0,45,Life,14.0,12,-2,2,-14,1,down,1985-03-30
27505,Gladys Knight And The Pips,1985-06-29,Gladys Knight And The Pips - Life,45,47,49,31.0,47,Life,14.0,13,-2,-2,2,1,down,1985-03-30
27506,Gladys Knight And The Pips,1985-07-06,Gladys Knight And The Pips - Life,47,45,51,31.0,49,Life,14.0,14,-2,-2,-2,1,down,1985-03-30
27507,Cashmere,1985-03-30,Cashmere - Cashmere,51,51,49,49.0,50,Cashmere,1.0,0,1,1,0,1,up,1985-03-30
27508,Cashmere,1985-04-06,Cashmere - Cashmere,50,51,51,49.0,49,Cashmere,1.0,1,-2,1,1,1,down,1985-03-30
27509,Luther Vandross,1985-04-06,Luther Vandross - The Night I Fell In Love,51,51,13,1.0,42,The Night I Fell In Love,38.0,0,29,9,0,1,up,1985-04-06
27510,Luther Vandross,1985-04-13,Luther Vandross - The Night I Fell In Love,42,51,2,1.0,13,The Night I Fell In Love,38.0,1,11,29,9,1,up,1985-04-06
27511,Luther Vandross,1985-04-20,Luther Vandross - The Night I Fell In Love,13,42,2,1.0,2,The Night I Fell In Love,38.0,2,0,11,29,0,stay,1985-04-06
27512,Luther Vandross,1985-04-27,Luther Vandross - The Night I Fell In Love,2,13,1,1.0,2,The Night I Fell In Love,38.0,3,1,0,11,1,up,1985-04-06
27513,Luther Vandross,1985-05-04,Luther Vandross - The Night I Fell In Love,2,2,1,1.0,1,The Night I Fell In Love,38.0,4,0,1,0,0,stay,1985-04-06
27514,Luther Vandross,1985-05-11,Luther Vandross - The Night I Fell In Love,1,2,1,1.0,1,The Night I Fell In Love,38.0,5,0,0,1,0,stay,1985-04-06
27515,Luther Vandross,1985-05-18,Luther Vandross - The Night I Fell In Love,1,1,1,1.0,1,The Night I Fell In Love,38.0,6,0,0,0,0,stay,1985-04-06
27516,Luther Vandross,1985-05-25,Luther Vandross - The Night I Fell In Love,1,1,1,1.0,1,The Night I Fell In Love,38.0,7,0,0,0,0,stay,1985-04-06
27517,Luther Vandross,1985-06-01,Luther Vandross - The Night I Fell In Love,1,1,1,1.0,1,The Night I Fell In Love,38.0,8,0,0,0,0,stay,1985-04-06
27518,Luther Vandross,1985-06-08,Luther Vandross - The Night I Fell In Love,1,1,1,1.0,1,The Night I Fell In Love,38.0,9,0,0,0,0,stay,1985-04-06
27519,Luther Vandross,1985-06-15,Luther Vandross - The Night I Fell In Love,1,1,2,1.0,1,The Night I Fell In Love,38.0,10,-1,0,0,1,down,1985-04-06
27520,Luther Vandross,1985-06-22,Luther Vandross - The Night I Fell In Love,1,1,3,1.0,2,The Night I Fell In Love,38.0,11,-1,-1,0,1,down,1985-04-06
27521,Luther Vandross,1985-06-29,Luther Vandross - The Night I Fell In Love,2,1,3,1.0,3,The Night I Fell In Love,38.0,12,0,-1,-1,0,stay,1985-04-06
27522,Luther Vandross,1985-07-06,Luther Vandross - The Night I Fell In Love,3,2,2,1.0,3,The Night I Fell In Love,38.0,13,1,0,-1,1,up,1985-04-06
27523,Luther Vandross,1985-07-13,Luther Vandross - The Night I Fell In Love,3,3,3,1.0,2,The Night I Fell In Love,38.0,14,-1,1,0,1,down,1985-04-06
27524,Luther Vandross,1985-07-20,Luther Vandross - The Night I Fell In Love,2,3,3,1.0,3,The Night I Fell In Love,38.0,15,0,-1,1,0,stay,1985-04-06
27525,Luther Vandross,1985-07-27,Luther Vandross - The Night I Fell In Love,3,2,3,1.0,3,The Night I Fell In Love,38.0,16,0,0,-1,0,stay,1985-04-06
27526,Luther Vandross,1985-08-03,Luther Vandross - The Night I Fell In Love,3,3,3,1.0,3,The Night I Fell In Love,38.0,17,0,0,0,0,stay,1985-04-06
27527,Luther Vandross,1985-08-10,Luther Vandross - The Night I Fell In Love,3,3,4,1.0,3,The Night I Fell In Love,38.0,18,-1,0,0,1,down,1985-04-06
27528,Luther Vandross,1985-08-17,Luther Vandross - The Night I Fell In Love,3,3,4,1.0,4,The Night I Fell In Love,38.0,19,0,-1,0,0,stay,1985-04-06
27529,Luther Vandross,1985-08-24,Luther Vandross - The Night I Fell In Love,4,3,5,1.0,4,The Night I Fell In Love,38.0,20,-1,0,-1,1,down,1985-04-06
27530,Luther Vandross,1985-08-31,Luther Vandross - The Night I Fell In Love,4,4,7,1.0,5,The Night I Fell In Love,38.0,21,-2,-1,0,1,down,1985-04-06
27531,Luther Vandross,1985-09-07,Luther Vandross - The Night I Fell In Love,5,4,7,1.0,7,The Night I Fell In Love,38.0,22,0,-2,-1,0,stay,1985-04-06
27532,Luther Vandross,1985-09-14,Luther Vandross - The Night I Fell In Love,7,5,7,1.0,7,The Night I Fell In Love,38.0,23,0,0,-2,0,stay,1985-04-06
27533,Luther Vandross,1985-09-21,Luther Vandross - The Night I Fell In Love,7,7,7,1.0,7,The Night I Fell In Love,38.0,24,0,0,0,0,stay,1985-04-06
27534,Luther Vandross,1985-09-28,Luther Vandross - The Night I Fell In Love,7,7,7,1.0,7,The Night I Fell In Love,38.0,25,0,0,0,0,stay,1985-04-06
27535,Luther Vandross,1985-10-05,Luther Vandross - The Night I Fell In Love,7,7,9,1.0,7,The Night I Fell In Love,38.0,26,-2,0,0,1,down,1985-04-06
27536,Luther Vandross,1985-10-12,Luther Vandross - The Night I Fell In Love,7,7,14,1.0,9,The Night I Fell In Love,38.0,27,-5,-2,0,1,down,1985-04-06
27537,Luther Vandross,1985-10-19,Luther Vandross - The Night I Fell In Love,9,7,14,1.0,14,The Night I Fell In Love,38.0,28,0,-5,-2,0,stay,1985-04-06
27538,Luther Vandross,1985-10-26,Luther Vandross - The Night I Fell In Love,14,9,11,1.0,14,The Night I Fell In Love,38.0,29,3,0,-5,1,up,1985-04-06
27539,Luther Vandross,1985-11-02,Luther Vandross - The Night I Fell In Love,14,14,11,1.0,11,The Night I Fell In Love,38.0,30,0,3,0,0,stay,1985-04-06
27540,Luther Vandross,1985-11-09,Luther Vandross - The Night I Fell In Love,11,14,11,1.0,11,The Night I Fell In Love,38.0,31,0,0,3,0,stay,1985-04-06
27541,Luther Vandross,1985-11-16,Luther Vandross - The Night I Fell In Love,11,11,13,1.0,11,The Night I Fell In Love,38.0,32,-2,0,0,1,down,1985-04-06
27542,Luther Vandross,1985-11-23,Luther Vandross - The Night I Fell In Love,11,11,13,1.0,13,The Night I Fell In Love,38.0,33,0,-2,0,0,stay,1985-04-06
27543,Luther Vandross,1985-11-30,Luther Vandross - The Night I Fell In Love,13,11,15,1.0,13,The Night I Fell In Love,38.0,34,-2,0,-2,1,down,1985-04-06
27544,Luther Vandross,1985-12-07,Luther Vandross - The Night I Fell In Love,13,13,18,1.0,15,The Night I Fell In Love,38.0,35,-3,-2,0,1,down,1985-04-06
27545,Luther Vandross,1985-12-14,Luther Vandross - The Night I Fell In Love,15,13,19,1.0,18,The Night I Fell In Love,38.0,36,-1,-3,-2,1,down,1985-04-06
27546,Luther Vandross,1985-12-21,Luther Vandross - The Night I Fell In Love,18,15,20,1.0,19,The Night I Fell In Love,38.0,37,-1,-1,-3,1,down,1985-04-06
27547,Luther Vandross,1985-12-28,Luther Vandross - The Night I Fell In Love,19,18,51,1.0,20,The Night I Fell In Love,38.0,38,-31,-1,-1,1,down,1985-04-06
27548,Paul Hardcastle,1985-04-06,Paul Hardcastle - Rain Forest,51,51,42,30.0,44,Rain Forest,16.0,0,2,7,0,1,up,1985-04-06
27549,Paul Hardcastle,1985-04-13,Paul Hardcastle - Rain Forest,44,51,41,30.0,42,Rain Forest,16.0,1,1,2,7,1,up,1985-04-06
27550,Paul Hardcastle,1985-04-20,Paul Hardcastle - Rain Forest,42,44,50,30.0,41,Rain Forest,16.0,2,-9,1,2,1,down,1985-04-06
27551,Paul Hardcastle,1985-04-27,Paul Hardcastle - Rain Forest,41,42,39,30.0,50,Rain Forest,16.0,3,11,-9,1,1,up,1985-04-06
27552,Paul Hardcastle,1985-05-04,Paul Hardcastle - Rain Forest,50,41,38,30.0,39,Rain Forest,16.0,4,1,11,-9,1,up,1985-04-06
27553,Paul Hardcastle,1985-05-11,Paul Hardcastle - Rain Forest,39,50,38,30.0,38,Rain Forest,16.0,5,0,1,11,0,stay,1985-04-06
27554,Paul Hardcastle,1985-05-18,Paul Hardcastle - Rain Forest,38,39,35,30.0,38,Rain Forest,16.0,6,3,0,1,1,up,1985-04-06
27555,Paul Hardcastle,1985-05-25,Paul Hardcastle - Rain Forest,38,38,35,30.0,35,Rain Forest,16.0,7,0,3,0,0,stay,1985-04-06
27556,Paul Hardcastle,1985-06-01,Paul Hardcastle - Rain Forest,35,38,30,30.0,35,Rain Forest,16.0,8,5,0,3,1,up,1985-04-06
27557,Paul Hardcastle,1985-06-08,Paul Hardcastle - Rain Forest,35,35,30,30.0,30,Rain Forest,16.0,9,0,5,0,0,stay,1985-04-06
27558,Paul Hardcastle,1985-06-15,Paul Hardcastle - Rain Forest,30,35,41,30.0,30,Rain Forest,16.0,10,-11,0,5,1,down,1985-04-06
27559,Paul Hardcastle,1985-06-22,Paul Hardcastle - Rain Forest,30,30,32,30.0,41,Rain Forest,16.0,11,9,-11,0,1,up,1985-04-06
27560,Paul Hardcastle,1985-06-29,Paul Hardcastle - Rain Forest,41,30,32,30.0,32,Rain Forest,16.0,12,0,9,-11,0,stay,1985-04-06
27561,Paul Hardcastle,1985-07-06,Paul Hardcastle - Rain Forest,32,41,32,30.0,32,Rain Forest,16.0,13,0,0,9,0,stay,1985-04-06
27562,Paul Hardcastle,1985-07-13,Paul Hardcastle - Rain Forest,32,32,50,30.0,32,Rain Forest,16.0,14,-18,0,0,1,down,1985-04-06
27563,Paul Hardcastle,1985-07-20,Paul Hardcastle - Rain Forest,32,32,49,30.0,50,Rain Forest,16.0,15,1,-18,0,1,up,1985-04-06
27564,Paul Hardcastle,1985-07-27,Paul Hardcastle - Rain Forest,50,32,51,30.0,49,Rain Forest,16.0,16,-2,1,-18,1,down,1985-04-06
27565,Whitney Houston,1985-04-06,Whitney Houston - Whitney Houston,51,51,41,1.0,47,Whitney Houston,38.0,0,6,4,0,1,up,1985-04-06
27566,Whitney Houston,1985-04-13,Whitney Houston - Whitney Houston,47,51,31,1.0,41,Whitney Houston,38.0,1,10,6,4,1,up,1985-04-06
27567,Whitney Houston,1985-04-20,Whitney Houston - Whitney Houston,41,47,26,1.0,31,Whitney Houston,38.0,2,5,10,6,1,up,1985-04-06
27568,Whitney Houston,1985-04-27,Whitney Houston - Whitney Houston,31,41,20,1.0,26,Whitney Houston,38.0,3,6,5,10,1,up,1985-04-06
27569,Whitney Houston,1985-05-04,Whitney Houston - Whitney Houston,26,31,17,1.0,20,Whitney Houston,38.0,4,3,6,5,1,up,1985-04-06
27570,Whitney Houston,1985-05-11,Whitney Houston - Whitney Houston,20,26,15,1.0,17,Whitney Houston,38.0,5,2,3,6,1,up,1985-04-06
27571,Whitney Houston,1985-05-18,Whitney Houston - Whitney Houston,17,20,8,1.0,15,Whitney Houston,38.0,6,7,2,3,1,up,1985-04-06
27572,Whitney Houston,1985-05-25,Whitney Houston - Whitney Houston,15,17,4,1.0,8,Whitney Houston,38.0,7,4,7,2,1,up,1985-04-06
27573,Whitney Houston,1985-06-01,Whitney Houston - Whitney Houston,8,15,3,1.0,4,Whitney Houston,38.0,8,1,4,7,1,up,1985-04-06
27574,Whitney Houston,1985-06-08,Whitney Houston - Whitney Houston,4,8,5,1.0,3,Whitney Houston,38.0,9,-2,1,4,1,down,1985-04-06
27575,Whitney Houston,1985-06-15,Whitney Houston - Whitney Houston,3,4,1,1.0,5,Whitney Houston,38.0,10,4,-2,1,1,up,1985-04-06
27576,Whitney Houston,1985-06-22,Whitney Houston - Whitney Houston,5,3,2,1.0,1,Whitney Houston,38.0,11,-1,4,-2,1,down,1985-04-06
27577,Whitney Houston,1985-06-29,Whitney Houston - Whitney Houston,1,5,2,1.0,2,Whitney Houston,38.0,12,0,-1,4,0,stay,1985-04-06
27578,Whitney Houston,1985-07-06,Whitney Houston - Whitney Houston,2,1,3,1.0,2,Whitney Houston,38.0,13,-1,0,-1,1,down,1985-04-06
27579,Whitney Houston,1985-07-13,Whitney Houston - Whitney Houston,2,2,2,1.0,3,Whitney Houston,38.0,14,1,-1,0,1,up,1985-04-06
27580,Whitney Houston,1985-07-20,Whitney Houston - Whitney Houston,3,2,2,1.0,2,Whitney Houston,38.0,15,0,1,-1,0,stay,1985-04-06
27581,Whitney Houston,1985-07-27,Whitney Houston - Whitney Houston,2,3,2,1.0,2,Whitney Houston,38.0,16,0,0,1,0,stay,1985-04-06
27582,Whitney Houston,1985-08-03,Whitney Houston - Whitney Houston,2,2,2,1.0,2,Whitney Houston,38.0,17,0,0,0,0,stay,1985-04-06
27583,Whitney Houston,1985-08-10,Whitney Houston - Whitney Houston,2,2,2,1.0,2,Whitney Houston,38.0,18,0,0,0,0,stay,1985-04-06
27584,Whitney Houston,1985-08-17,Whitney Houston - Whitney Houston,2,2,3,1.0,2,Whitney Houston,38.0,19,-1,0,0,1,down,1985-04-06
27585,Whitney Houston,1985-08-24,Whitney Houston - Whitney Houston,2,2,3,1.0,3,Whitney Houston,38.0,20,0,-1,0,0,stay,1985-04-06
27586,Whitney Houston,1985-08-31,Whitney Houston - Whitney Houston,3,2,1,1.0,3,Whitney Houston,38.0,21,2,0,-1,1,up,1985-04-06
27587,Whitney Houston,1985-09-07,Whitney Houston - Whitney Houston,3,3,1,1.0,1,Whitney Houston,38.0,22,0,2,0,0,stay,1985-04-06
27588,Whitney Houston,1985-09-14,Whitney Houston - Whitney Houston,1,3,1,1.0,1,Whitney Houston,38.0,23,0,0,2,0,stay,1985-04-06
27589,Whitney Houston,1985-09-21,Whitney Houston - Whitney Houston,1,1,1,1.0,1,Whitney Houston,38.0,24,0,0,0,0,stay,1985-04-06
27590,Whitney Houston,1985-09-28,Whitney Houston - Whitney Houston,1,1,1,1.0,1,Whitney Houston,38.0,25,0,0,0,0,stay,1985-04-06
27591,Whitney Houston,1985-10-05,Whitney Houston - Whitney Houston,1,1,2,1.0,1,Whitney Houston,38.0,26,-1,0,0,1,down,1985-04-06
27592,Whitney Houston,1985-10-12,Whitney Houston - Whitney Houston,1,1,2,1.0,2,Whitney Houston,38.0,27,0,-1,0,0,stay,1985-04-06
27593,Whitney Houston,1985-10-19,Whitney Houston - Whitney Houston,2,1,2,1.0,2,Whitney Houston,38.0,28,0,0,-1,0,stay,1985-04-06
27594,Whitney Houston,1985-10-26,Whitney Houston - Whitney Houston,2,2,3,1.0,2,Whitney Houston,38.0,29,-1,0,0,1,down,1985-04-06
27595,Whitney Houston,1985-11-02,Whitney Houston - Whitney Houston,2,2,3,1.0,3,Whitney Houston,38.0,30,0,-1,0,0,stay,1985-04-06
27596,Whitney Houston,1985-11-09,Whitney Houston - Whitney Houston,3,2,3,1.0,3,Whitney Houston,38.0,31,0,0,-1,0,stay,1985-04-06
27597,Whitney Houston,1985-11-16,Whitney Houston - Whitney Houston,3,3,3,1.0,3,Whitney Houston,38.0,32,0,0,0,0,stay,1985-04-06
27598,Whitney Houston,1985-11-23,Whitney Houston - Whitney Houston,3,3,4,1.0,3,Whitney Houston,38.0,33,-1,0,0,1,down,1985-04-06
27599,Whitney Houston,1985-11-30,Whitney Houston - Whitney Houston,3,3,4,1.0,4,Whitney Houston,38.0,34,0,-1,0,0,stay,1985-04-06
27600,Whitney Houston,1985-12-07,Whitney Houston - Whitney Houston,4,3,6,1.0,4,Whitney Houston,38.0,35,-2,0,-1,1,down,1985-04-06
27601,Whitney Houston,1985-12-14,Whitney Houston - Whitney Houston,4,4,5,1.0,6,Whitney Houston,38.0,36,1,-2,0,1,up,1985-04-06
27602,Whitney Houston,1985-12-21,Whitney Houston - Whitney Houston,6,4,3,1.0,5,Whitney Houston,38.0,37,2,1,-2,1,up,1985-04-06
27603,Whitney Houston,1985-12-28,Whitney Houston - Whitney Houston,5,6,51,1.0,3,Whitney Houston,38.0,38,-48,2,1,1,down,1985-04-06
27604,Dionne Warwick,1985-04-06,Dionne Warwick - Finder Of Lost Loves,51,51,51,50.0,50,Finder Of Lost Loves,0.0,0,-1,1,0,1,down,1985-04-06
27605,Soundtrack,1985-04-13,Soundtrack - Berry Gordy's The Last Dragon,51,51,40,29.0,47,Berry Gordy's The Last Dragon,8.0,0,7,4,0,1,up,1985-04-13
27606,Soundtrack,1985-04-20,Soundtrack - Berry Gordy's The Last Dragon,47,51,31,29.0,40,Berry Gordy's The Last Dragon,8.0,1,9,7,4,1,up,1985-04-13
27607,Soundtrack,1985-04-27,Soundtrack - Berry Gordy's The Last Dragon,40,47,31,29.0,31,Berry Gordy's The Last Dragon,8.0,2,0,9,7,0,stay,1985-04-13
27608,Soundtrack,1985-05-04,Soundtrack - Berry Gordy's The Last Dragon,31,40,29,29.0,31,Berry Gordy's The Last Dragon,8.0,3,2,0,9,1,up,1985-04-13
27609,Soundtrack,1985-05-11,Soundtrack - Berry Gordy's The Last Dragon,31,31,29,29.0,29,Berry Gordy's The Last Dragon,8.0,4,0,2,0,0,stay,1985-04-13
27610,Soundtrack,1985-05-18,Soundtrack - Berry Gordy's The Last Dragon,29,31,30,29.0,29,Berry Gordy's The Last Dragon,8.0,5,-1,0,2,1,down,1985-04-13
27611,Soundtrack,1985-05-25,Soundtrack - Berry Gordy's The Last Dragon,29,29,31,29.0,30,Berry Gordy's The Last Dragon,8.0,6,-1,-1,0,1,down,1985-04-13
27612,Soundtrack,1985-06-01,Soundtrack - Berry Gordy's The Last Dragon,30,29,45,29.0,31,Berry Gordy's The Last Dragon,8.0,7,-14,-1,-1,1,down,1985-04-13
27613,Soundtrack,1985-06-08,Soundtrack - Berry Gordy's The Last Dragon,31,30,51,29.0,45,Berry Gordy's The Last Dragon,8.0,8,-6,-14,-1,1,down,1985-04-13
27614,The Gap Band,1985-04-13,The Gap Band - Gap Gold,51,51,49,46.0,49,Gap Gold,4.0,0,0,2,0,0,stay,1985-04-13
27615,The Gap Band,1985-04-20,The Gap Band - Gap Gold,49,51,46,46.0,49,Gap Gold,4.0,1,3,0,2,1,up,1985-04-13
27616,The Gap Band,1985-04-27,The Gap Band - Gap Gold,49,49,46,46.0,46,Gap Gold,4.0,2,0,3,0,0,stay,1985-04-13
27617,The Gap Band,1985-05-04,The Gap Band - Gap Gold,46,49,47,46.0,46,Gap Gold,4.0,3,-1,0,3,1,down,1985-04-13
27618,The Gap Band,1985-05-11,The Gap Band - Gap Gold,46,46,51,46.0,47,Gap Gold,4.0,4,-4,-1,0,1,down,1985-04-13
27619,Jenny Burton,1985-04-13,Jenny Burton - Jenny Burton,51,51,50,45.0,50,Jenny Burton,4.0,0,0,1,0,0,stay,1985-04-13
27620,Jenny Burton,1985-04-20,Jenny Burton - Jenny Burton,50,51,45,45.0,50,Jenny Burton,4.0,1,5,0,1,1,up,1985-04-13
27621,Jenny Burton,1985-04-27,Jenny Burton - Jenny Burton,50,50,45,45.0,45,Jenny Burton,4.0,2,0,5,0,0,stay,1985-04-13
27622,Jenny Burton,1985-05-04,Jenny Burton - Jenny Burton,45,50,48,45.0,45,Jenny Burton,4.0,3,-3,0,5,1,down,1985-04-13
27623,Jenny Burton,1985-05-11,Jenny Burton - Jenny Burton,45,45,51,45.0,48,Jenny Burton,4.0,4,-3,-3,0,1,down,1985-04-13
27624,USA For Africa,1985-04-20,USA For Africa - We Are The World,51,51,10,6.0,20,We Are The World,11.0,0,10,31,0,1,up,1985-04-20
27625,USA For Africa,1985-04-27,USA For Africa - We Are The World,20,51,7,6.0,10,We Are The World,11.0,1,3,10,31,1,up,1985-04-20
27626,USA For Africa,1985-05-04,USA For Africa - We Are The World,10,20,6,6.0,7,We Are The World,11.0,2,1,3,10,1,up,1985-04-20
27627,USA For Africa,1985-05-11,USA For Africa - We Are The World,7,10,6,6.0,6,We Are The World,11.0,3,0,1,3,0,stay,1985-04-20
27628,USA For Africa,1985-05-18,USA For Africa - We Are The World,6,7,13,6.0,6,We Are The World,11.0,4,-7,0,1,1,down,1985-04-20
27629,USA For Africa,1985-05-25,USA For Africa - We Are The World,6,6,15,6.0,13,We Are The World,11.0,5,-2,-7,0,1,down,1985-04-20
27630,USA For Africa,1985-06-01,USA For Africa - We Are The World,13,6,17,6.0,15,We Are The World,11.0,6,-2,-2,-7,1,down,1985-04-20
27631,USA For Africa,1985-06-08,USA For Africa - We Are The World,15,13,26,6.0,17,We Are The World,11.0,7,-9,-2,-2,1,down,1985-04-20
27632,USA For Africa,1985-06-15,USA For Africa - We Are The World,17,15,33,6.0,26,We Are The World,11.0,8,-7,-9,-2,1,down,1985-04-20
27633,USA For Africa,1985-06-22,USA For Africa - We Are The World,26,17,35,6.0,33,We Are The World,11.0,9,-2,-7,-9,1,down,1985-04-20
27634,USA For Africa,1985-06-29,USA For Africa - We Are The World,33,26,41,6.0,35,We Are The World,11.0,10,-6,-2,-7,1,down,1985-04-20
27635,USA For Africa,1985-07-06,USA For Africa - We Are The World,35,33,51,6.0,41,We Are The World,11.0,11,-10,-6,-2,1,down,1985-04-20
27636,Alexander O'Neal,1985-04-20,Alexander O'Neal - Alexander O'Neal,51,51,38,21.0,42,Alexander O'Neal,32.0,0,4,9,0,1,up,1985-04-20
27637,Alexander O'Neal,1985-04-27,Alexander O'Neal - Alexander O'Neal,42,51,34,21.0,38,Alexander O'Neal,32.0,1,4,4,9,1,up,1985-04-20
27638,Alexander O'Neal,1985-05-04,Alexander O'Neal - Alexander O'Neal,38,42,32,21.0,34,Alexander O'Neal,32.0,2,2,4,4,1,up,1985-04-20
27639,Alexander O'Neal,1985-05-11,Alexander O'Neal - Alexander O'Neal,34,38,26,21.0,32,Alexander O'Neal,32.0,3,6,2,4,1,up,1985-04-20
27640,Alexander O'Neal,1985-05-18,Alexander O'Neal - Alexander O'Neal,32,34,25,21.0,26,Alexander O'Neal,32.0,4,1,6,2,1,up,1985-04-20
27641,Alexander O'Neal,1985-05-25,Alexander O'Neal - Alexander O'Neal,26,32,25,21.0,25,Alexander O'Neal,32.0,5,0,1,6,0,stay,1985-04-20
27642,Alexander O'Neal,1985-06-01,Alexander O'Neal - Alexander O'Neal,25,26,25,21.0,25,Alexander O'Neal,32.0,6,0,0,1,0,stay,1985-04-20
27643,Alexander O'Neal,1985-06-08,Alexander O'Neal - Alexander O'Neal,25,25,23,21.0,25,Alexander O'Neal,32.0,7,2,0,0,1,up,1985-04-20
27644,Alexander O'Neal,1985-06-15,Alexander O'Neal - Alexander O'Neal,25,25,23,21.0,23,Alexander O'Neal,32.0,8,0,2,0,0,stay,1985-04-20
27645,Alexander O'Neal,1985-06-22,Alexander O'Neal - Alexander O'Neal,23,25,27,21.0,23,Alexander O'Neal,32.0,9,-4,0,2,1,down,1985-04-20
27646,Alexander O'Neal,1985-06-29,Alexander O'Neal - Alexander O'Neal,23,23,40,21.0,27,Alexander O'Neal,32.0,10,-13,-4,0,1,down,1985-04-20
27647,Alexander O'Neal,1985-07-06,Alexander O'Neal - Alexander O'Neal,27,23,35,21.0,40,Alexander O'Neal,32.0,11,5,-13,-4,1,up,1985-04-20
27648,Alexander O'Neal,1985-07-13,Alexander O'Neal - Alexander O'Neal,40,27,35,21.0,35,Alexander O'Neal,32.0,12,0,5,-13,0,stay,1985-04-20
27649,Alexander O'Neal,1985-07-20,Alexander O'Neal - Alexander O'Neal,35,40,37,21.0,35,Alexander O'Neal,32.0,13,-2,0,5,1,down,1985-04-20
27650,Alexander O'Neal,1985-07-27,Alexander O'Neal - Alexander O'Neal,35,35,35,21.0,37,Alexander O'Neal,32.0,14,2,-2,0,1,up,1985-04-20
27651,Alexander O'Neal,1985-08-03,Alexander O'Neal - Alexander O'Neal,37,35,35,21.0,35,Alexander O'Neal,32.0,15,0,2,-2,0,stay,1985-04-20
27652,Alexander O'Neal,1985-08-10,Alexander O'Neal - Alexander O'Neal,35,37,22,21.0,35,Alexander O'Neal,32.0,16,13,0,2,1,up,1985-04-20
27653,Alexander O'Neal,1985-08-17,Alexander O'Neal - Alexander O'Neal,35,35,21,21.0,22,Alexander O'Neal,32.0,17,1,13,0,1,up,1985-04-20
27654,Alexander O'Neal,1985-08-24,Alexander O'Neal - Alexander O'Neal,22,35,21,21.0,21,Alexander O'Neal,32.0,18,0,1,13,0,stay,1985-04-20
27655,Alexander O'Neal,1985-08-31,Alexander O'Neal - Alexander O'Neal,21,22,26,21.0,21,Alexander O'Neal,32.0,19,-5,0,1,1,down,1985-04-20
27656,Alexander O'Neal,1985-09-07,Alexander O'Neal - Alexander O'Neal,21,21,25,21.0,26,Alexander O'Neal,32.0,20,1,-5,0,1,up,1985-04-20
27657,Alexander O'Neal,1985-09-14,Alexander O'Neal - Alexander O'Neal,26,21,24,21.0,25,Alexander O'Neal,32.0,21,1,1,-5,1,up,1985-04-20
27658,Alexander O'Neal,1985-09-21,Alexander O'Neal - Alexander O'Neal,25,26,33,21.0,24,Alexander O'Neal,32.0,22,-9,1,1,1,down,1985-04-20
27659,Alexander O'Neal,1985-09-28,Alexander O'Neal - Alexander O'Neal,24,25,34,21.0,33,Alexander O'Neal,32.0,23,-1,-9,1,1,down,1985-04-20
27660,Alexander O'Neal,1985-10-05,Alexander O'Neal - Alexander O'Neal,33,24,39,21.0,34,Alexander O'Neal,32.0,24,-5,-1,-9,1,down,1985-04-20
27661,Alexander O'Neal,1985-10-12,Alexander O'Neal - Alexander O'Neal,34,33,39,21.0,39,Alexander O'Neal,32.0,25,0,-5,-1,0,stay,1985-04-20
27662,Alexander O'Neal,1985-10-19,Alexander O'Neal - Alexander O'Neal,39,34,33,21.0,39,Alexander O'Neal,32.0,26,6,0,-5,1,up,1985-04-20
27663,Alexander O'Neal,1985-10-26,Alexander O'Neal - Alexander O'Neal,39,39,33,21.0,33,Alexander O'Neal,32.0,27,0,6,0,0,stay,1985-04-20
27664,Alexander O'Neal,1985-11-02,Alexander O'Neal - Alexander O'Neal,33,39,43,21.0,33,Alexander O'Neal,32.0,28,-10,0,6,1,down,1985-04-20
27665,Alexander O'Neal,1985-11-09,Alexander O'Neal - Alexander O'Neal,33,33,43,21.0,43,Alexander O'Neal,32.0,29,0,-10,0,0,stay,1985-04-20
27666,Alexander O'Neal,1985-11-16,Alexander O'Neal - Alexander O'Neal,43,33,47,21.0,43,Alexander O'Neal,32.0,30,-4,0,-10,1,down,1985-04-20
27667,Alexander O'Neal,1985-11-23,Alexander O'Neal - Alexander O'Neal,43,43,50,21.0,47,Alexander O'Neal,32.0,31,-3,-4,0,1,down,1985-04-20
27668,Alexander O'Neal,1985-11-30,Alexander O'Neal - Alexander O'Neal,47,43,51,21.0,50,Alexander O'Neal,32.0,32,-1,-3,-4,1,down,1985-04-20
27669,Soundtrack,1985-04-20,Soundtrack - Into The Night,51,51,37,35.0,45,Into The Night,6.0,0,8,6,0,1,up,1985-04-20
27670,Soundtrack,1985-04-27,Soundtrack - Into The Night,45,51,35,35.0,37,Into The Night,6.0,1,2,8,6,1,up,1985-04-20
27671,Soundtrack,1985-05-04,Soundtrack - Into The Night,37,45,35,35.0,35,Into The Night,6.0,2,0,2,8,0,stay,1985-04-20
27672,Soundtrack,1985-05-11,Soundtrack - Into The Night,35,37,43,35.0,35,Into The Night,6.0,3,-8,0,2,1,down,1985-04-20
27673,Soundtrack,1985-05-18,Soundtrack - Into The Night,35,35,42,35.0,43,Into The Night,6.0,4,1,-8,0,1,up,1985-04-20
27674,Soundtrack,1985-05-25,Soundtrack - Into The Night,43,35,49,35.0,42,Into The Night,6.0,5,-7,1,-8,1,down,1985-04-20
27675,Soundtrack,1985-06-01,Soundtrack - Into The Night,42,43,51,35.0,49,Into The Night,6.0,6,-2,-7,1,1,down,1985-04-20
27676,The Manhattans,1985-04-20,The Manhattans - Too Hot To Stop It,51,51,48,44.0,48,Too Hot To Stop It,4.0,0,0,3,0,0,stay,1985-04-20
27677,The Manhattans,1985-04-27,The Manhattans - Too Hot To Stop It,48,51,45,44.0,48,Too Hot To Stop It,4.0,1,3,0,3,1,up,1985-04-20
27678,The Manhattans,1985-05-11,The Manhattans - Too Hot To Stop It,48,48,45,44.0,45,Too Hot To Stop It,4.0,2,0,3,0,0,stay,1985-04-20
27679,The Manhattans,1985-05-18,The Manhattans - Too Hot To Stop It,45,48,44,44.0,45,Too Hot To Stop It,4.0,3,1,0,3,1,up,1985-04-20
27680,The Manhattans,1985-05-25,The Manhattans - Too Hot To Stop It,45,45,51,44.0,44,Too Hot To Stop It,4.0,4,-7,1,0,1,down,1985-04-20
27681,Melba Moore,1985-05-04,Melba Moore - Read My Lips,51,51,30,24.0,32,Read My Lips,21.0,0,2,19,0,1,up,1985-05-04
27682,Melba Moore,1985-05-11,Melba Moore - Read My Lips,32,51,24,24.0,30,Read My Lips,21.0,1,6,2,19,1,up,1985-05-04
27683,Melba Moore,1985-05-18,Melba Moore - Read My Lips,30,32,24,24.0,24,Read My Lips,21.0,2,0,6,2,0,stay,1985-05-04
27684,Melba Moore,1985-05-25,Melba Moore - Read My Lips,24,30,28,24.0,24,Read My Lips,21.0,3,-4,0,6,1,down,1985-05-04
27685,Melba Moore,1985-06-01,Melba Moore - Read My Lips,24,24,28,24.0,28,Read My Lips,21.0,4,0,-4,0,0,stay,1985-05-04
27686,Melba Moore,1985-06-08,Melba Moore - Read My Lips,28,24,36,24.0,28,Read My Lips,21.0,5,-8,0,-4,1,down,1985-05-04
27687,Melba Moore,1985-06-15,Melba Moore - Read My Lips,28,28,35,24.0,36,Read My Lips,21.0,6,1,-8,0,1,up,1985-05-04
27688,Melba Moore,1985-06-22,Melba Moore - Read My Lips,36,28,39,24.0,35,Read My Lips,21.0,7,-4,1,-8,1,down,1985-05-04
27689,Melba Moore,1985-06-29,Melba Moore - Read My Lips,35,36,33,24.0,39,Read My Lips,21.0,8,6,-4,1,1,up,1985-05-04
27690,Melba Moore,1985-07-06,Melba Moore - Read My Lips,39,35,33,24.0,33,Read My Lips,21.0,9,0,6,-4,0,stay,1985-05-04
27691,Melba Moore,1985-07-13,Melba Moore - Read My Lips,33,39,33,24.0,33,Read My Lips,21.0,10,0,0,6,0,stay,1985-05-04
27692,Melba Moore,1985-07-20,Melba Moore - Read My Lips,33,33,35,24.0,33,Read My Lips,21.0,11,-2,0,0,1,down,1985-05-04
27693,Melba Moore,1985-07-27,Melba Moore - Read My Lips,33,33,39,24.0,35,Read My Lips,21.0,12,-4,-2,0,1,down,1985-05-04
27694,Melba Moore,1985-08-03,Melba Moore - Read My Lips,35,33,32,24.0,39,Read My Lips,21.0,13,7,-4,-2,1,up,1985-05-04
27695,Melba Moore,1985-08-10,Melba Moore - Read My Lips,39,35,27,24.0,32,Read My Lips,21.0,14,5,7,-4,1,up,1985-05-04
27696,Melba Moore,1985-08-17,Melba Moore - Read My Lips,32,39,27,24.0,27,Read My Lips,21.0,15,0,5,7,0,stay,1985-05-04
27697,Melba Moore,1985-08-24,Melba Moore - Read My Lips,27,32,28,24.0,27,Read My Lips,21.0,16,-1,0,5,1,down,1985-05-04
27698,Melba Moore,1985-08-31,Melba Moore - Read My Lips,27,27,29,24.0,28,Read My Lips,21.0,17,-1,-1,0,1,down,1985-05-04
27699,Melba Moore,1985-09-07,Melba Moore - Read My Lips,28,27,44,24.0,29,Read My Lips,21.0,18,-15,-1,-1,1,down,1985-05-04
27700,Melba Moore,1985-09-14,Melba Moore - Read My Lips,29,28,50,24.0,44,Read My Lips,21.0,19,-6,-15,-1,1,down,1985-05-04
27701,Melba Moore,1985-11-16,Melba Moore - Read My Lips,44,29,50,24.0,50,Read My Lips,21.0,20,0,-6,-15,0,stay,1985-05-04
27702,Melba Moore,1985-11-23,Melba Moore - Read My Lips,50,44,51,24.0,50,Read My Lips,21.0,21,-1,0,-6,1,down,1985-05-04
27703,Third World,1985-05-04,Third World - Sense Of Purpose,51,51,42,42.0,43,Sense Of Purpose,4.0,0,1,8,0,1,up,1985-05-04
27704,Third World,1985-05-11,Third World - Sense Of Purpose,43,51,48,42.0,42,Sense Of Purpose,4.0,1,-6,1,8,1,down,1985-05-04
27705,Third World,1985-05-18,Third World - Sense Of Purpose,42,43,49,42.0,48,Sense Of Purpose,4.0,2,-1,-6,1,1,down,1985-05-04
27706,Third World,1985-08-17,Third World - Sense Of Purpose,48,42,49,42.0,49,Sense Of Purpose,4.0,3,0,-1,-6,0,stay,1985-05-04
27707,Third World,1985-08-24,Third World - Sense Of Purpose,49,48,51,42.0,49,Sense Of Purpose,4.0,4,-2,0,-1,1,down,1985-05-04
27708,Prince And The Revolution,1985-05-11,Prince And The Revolution - Around The World In A Day,51,51,13,4.0,20,Around The World In A Day,30.0,0,7,31,0,1,up,1985-05-11
27709,Prince And The Revolution,1985-05-18,Prince And The Revolution - Around The World In A Day,20,51,6,4.0,13,Around The World In A Day,30.0,1,7,7,31,1,up,1985-05-11
27710,Prince And The Revolution,1985-05-25,Prince And The Revolution - Around The World In A Day,13,20,6,4.0,6,Around The World In A Day,30.0,2,0,7,7,0,stay,1985-05-11
27711,Prince And The Revolution,1985-06-01,Prince And The Revolution - Around The World In A Day,6,13,5,4.0,6,Around The World In A Day,30.0,3,1,0,7,1,up,1985-05-11
27712,Prince And The Revolution,1985-06-08,Prince And The Revolution - Around The World In A Day,6,6,4,4.0,5,Around The World In A Day,30.0,4,1,1,0,1,up,1985-05-11
27713,Prince And The Revolution,1985-06-15,Prince And The Revolution - Around The World In A Day,5,6,4,4.0,4,Around The World In A Day,30.0,5,0,1,1,0,stay,1985-05-11
27714,Prince And The Revolution,1985-06-22,Prince And The Revolution - Around The World In A Day,4,5,4,4.0,4,Around The World In A Day,30.0,6,0,0,1,0,stay,1985-05-11
27715,Prince And The Revolution,1985-06-29,Prince And The Revolution - Around The World In A Day,4,4,4,4.0,4,Around The World In A Day,30.0,7,0,0,0,0,stay,1985-05-11
27716,Prince And The Revolution,1985-07-06,Prince And The Revolution - Around The World In A Day,4,4,5,4.0,4,Around The World In A Day,30.0,8,-1,0,0,1,down,1985-05-11
27717,Prince And The Revolution,1985-07-13,Prince And The Revolution - Around The World In A Day,4,4,5,4.0,5,Around The World In A Day,30.0,9,0,-1,0,0,stay,1985-05-11
27718,Prince And The Revolution,1985-07-20,Prince And The Revolution - Around The World In A Day,5,4,4,4.0,5,Around The World In A Day,30.0,10,1,0,-1,1,up,1985-05-11
27719,Prince And The Revolution,1985-07-27,Prince And The Revolution - Around The World In A Day,5,5,4,4.0,4,Around The World In A Day,30.0,11,0,1,0,0,stay,1985-05-11
27720,Prince And The Revolution,1985-08-03,Prince And The Revolution - Around The World In A Day,4,5,8,4.0,4,Around The World In A Day,30.0,12,-4,0,1,1,down,1985-05-11
27721,Prince And The Revolution,1985-08-10,Prince And The Revolution - Around The World In A Day,4,4,10,4.0,8,Around The World In A Day,30.0,13,-2,-4,0,1,down,1985-05-11
27722,Prince And The Revolution,1985-08-17,Prince And The Revolution - Around The World In A Day,8,4,9,4.0,10,Around The World In A Day,30.0,14,1,-2,-4,1,up,1985-05-11
27723,Prince And The Revolution,1985-08-24,Prince And The Revolution - Around The World In A Day,10,8,8,4.0,9,Around The World In A Day,30.0,15,1,1,-2,1,up,1985-05-11
27724,Prince And The Revolution,1985-08-31,Prince And The Revolution - Around The World In A Day,9,10,8,4.0,8,Around The World In A Day,30.0,16,0,1,1,0,stay,1985-05-11
27725,Prince And The Revolution,1985-09-07,Prince And The Revolution - Around The World In A Day,8,9,8,4.0,8,Around The World In A Day,30.0,17,0,0,1,0,stay,1985-05-11
27726,Prince And The Revolution,1985-09-14,Prince And The Revolution - Around The World In A Day,8,8,11,4.0,8,Around The World In A Day,30.0,18,-3,0,0,1,down,1985-05-11
27727,Prince And The Revolution,1985-09-21,Prince And The Revolution - Around The World In A Day,8,8,11,4.0,11,Around The World In A Day,30.0,19,0,-3,0,0,stay,1985-05-11
27728,Prince And The Revolution,1985-09-28,Prince And The Revolution - Around The World In A Day,11,8,11,4.0,11,Around The World In A Day,30.0,20,0,0,-3,0,stay,1985-05-11
27729,Prince And The Revolution,1985-10-05,Prince And The Revolution - Around The World In A Day,11,11,16,4.0,11,Around The World In A Day,30.0,21,-5,0,0,1,down,1985-05-11
27730,Prince And The Revolution,1985-10-12,Prince And The Revolution - Around The World In A Day,11,11,21,4.0,16,Around The World In A Day,30.0,22,-5,-5,0,1,down,1985-05-11
27731,Prince And The Revolution,1985-10-19,Prince And The Revolution - Around The World In A Day,16,11,27,4.0,21,Around The World In A Day,30.0,23,-6,-5,-5,1,down,1985-05-11
27732,Prince And The Revolution,1985-10-26,Prince And The Revolution - Around The World In A Day,21,16,38,4.0,27,Around The World In A Day,30.0,24,-11,-6,-5,1,down,1985-05-11
27733,Prince And The Revolution,1985-11-02,Prince And The Revolution - Around The World In A Day,27,21,38,4.0,38,Around The World In A Day,30.0,25,0,-11,-6,0,stay,1985-05-11
27734,Prince And The Revolution,1985-11-09,Prince And The Revolution - Around The World In A Day,38,27,40,4.0,38,Around The World In A Day,30.0,26,-2,0,-11,1,down,1985-05-11
27735,Prince And The Revolution,1985-11-16,Prince And The Revolution - Around The World In A Day,38,38,41,4.0,40,Around The World In A Day,30.0,27,-1,-2,0,1,down,1985-05-11
27736,Prince And The Revolution,1985-11-23,Prince And The Revolution - Around The World In A Day,40,38,46,4.0,41,Around The World In A Day,30.0,28,-5,-1,-2,1,down,1985-05-11
27737,Prince And The Revolution,1985-11-30,Prince And The Revolution - Around The World In A Day,41,40,49,4.0,46,Around The World In A Day,30.0,29,-3,-5,-1,1,down,1985-05-11
27738,Prince And The Revolution,1985-12-07,Prince And The Revolution - Around The World In A Day,46,41,51,4.0,49,Around The World In A Day,30.0,30,-2,-3,-5,1,down,1985-05-11
27739,Steve Arrington,1985-05-11,Steve Arrington - Dancin' In The Key Of Life,51,51,47,32.0,50,Dancin' In The Key Of Life,20.0,0,3,1,0,1,up,1985-05-11
27740,Steve Arrington,1985-05-18,Steve Arrington - Dancin' In The Key Of Life,50,51,47,32.0,47,Dancin' In The Key Of Life,20.0,1,0,3,1,0,stay,1985-05-11
27741,Steve Arrington,1985-05-25,Steve Arrington - Dancin' In The Key Of Life,47,50,42,32.0,47,Dancin' In The Key Of Life,20.0,2,5,0,3,1,up,1985-05-11
27742,Steve Arrington,1985-06-01,Steve Arrington - Dancin' In The Key Of Life,47,47,42,32.0,42,Dancin' In The Key Of Life,20.0,3,0,5,0,0,stay,1985-05-11
27743,Steve Arrington,1985-06-08,Steve Arrington - Dancin' In The Key Of Life,42,47,41,32.0,42,Dancin' In The Key Of Life,20.0,4,1,0,5,1,up,1985-05-11
27744,Steve Arrington,1985-06-15,Steve Arrington - Dancin' In The Key Of Life,42,42,49,32.0,41,Dancin' In The Key Of Life,20.0,5,-8,1,0,1,down,1985-05-11
27745,Steve Arrington,1985-06-22,Steve Arrington - Dancin' In The Key Of Life,41,42,44,32.0,49,Dancin' In The Key Of Life,20.0,6,5,-8,1,1,up,1985-05-11
27746,Steve Arrington,1985-07-13,Steve Arrington - Dancin' In The Key Of Life,49,41,44,32.0,44,Dancin' In The Key Of Life,20.0,7,0,5,-8,0,stay,1985-05-11
27747,Steve Arrington,1985-07-20,Steve Arrington - Dancin' In The Key Of Life,44,49,40,32.0,44,Dancin' In The Key Of Life,20.0,8,4,0,5,1,up,1985-05-11
27748,Steve Arrington,1985-07-27,Steve Arrington - Dancin' In The Key Of Life,44,44,37,32.0,40,Dancin' In The Key Of Life,20.0,9,3,4,0,1,up,1985-05-11
27749,Steve Arrington,1985-08-03,Steve Arrington - Dancin' In The Key Of Life,40,44,33,32.0,37,Dancin' In The Key Of Life,20.0,10,4,3,4,1,up,1985-05-11
27750,Steve Arrington,1985-08-10,Steve Arrington - Dancin' In The Key Of Life,37,40,33,32.0,33,Dancin' In The Key Of Life,20.0,11,0,4,3,0,stay,1985-05-11
27751,Steve Arrington,1985-08-17,Steve Arrington - Dancin' In The Key Of Life,33,37,32,32.0,33,Dancin' In The Key Of Life,20.0,12,1,0,4,1,up,1985-05-11
27752,Steve Arrington,1985-08-24,Steve Arrington - Dancin' In The Key Of Life,33,33,38,32.0,32,Dancin' In The Key Of Life,20.0,13,-6,1,0,1,down,1985-05-11
27753,Steve Arrington,1985-08-31,Steve Arrington - Dancin' In The Key Of Life,32,33,36,32.0,38,Dancin' In The Key Of Life,20.0,14,2,-6,1,1,up,1985-05-11
27754,Steve Arrington,1985-09-07,Steve Arrington - Dancin' In The Key Of Life,38,32,36,32.0,36,Dancin' In The Key Of Life,20.0,15,0,2,-6,0,stay,1985-05-11
27755,Steve Arrington,1985-09-14,Steve Arrington - Dancin' In The Key Of Life,36,38,36,32.0,36,Dancin' In The Key Of Life,20.0,16,0,0,2,0,stay,1985-05-11
27756,Steve Arrington,1985-09-21,Steve Arrington - Dancin' In The Key Of Life,36,36,40,32.0,36,Dancin' In The Key Of Life,20.0,17,-4,0,0,1,down,1985-05-11
27757,Steve Arrington,1985-09-28,Steve Arrington - Dancin' In The Key Of Life,36,36,50,32.0,40,Dancin' In The Key Of Life,20.0,18,-10,-4,0,1,down,1985-05-11
27758,Steve Arrington,1985-10-05,Steve Arrington - Dancin' In The Key Of Life,40,36,49,32.0,50,Dancin' In The Key Of Life,20.0,19,1,-10,-4,1,up,1985-05-11
27759,Steve Arrington,1985-10-12,Steve Arrington - Dancin' In The Key Of Life,50,40,51,32.0,49,Dancin' In The Key Of Life,20.0,20,-2,1,-10,1,down,1985-05-11
27760,ConFunkShun,1985-05-18,ConFunkShun - Electric Lady,51,51,19,9.0,25,Electric Lady,31.0,0,6,26,0,1,up,1985-05-18
27761,ConFunkShun,1985-05-25,ConFunkShun - Electric Lady,25,51,17,9.0,19,Electric Lady,31.0,1,2,6,26,1,up,1985-05-18
27762,ConFunkShun,1985-06-01,ConFunkShun - Electric Lady,19,25,13,9.0,17,Electric Lady,31.0,2,4,2,6,1,up,1985-05-18
27763,ConFunkShun,1985-06-08,ConFunkShun - Electric Lady,17,19,11,9.0,13,Electric Lady,31.0,3,2,4,2,1,up,1985-05-18
27764,ConFunkShun,1985-06-15,ConFunkShun - Electric Lady,13,17,11,9.0,11,Electric Lady,31.0,4,0,2,4,0,stay,1985-05-18
27765,ConFunkShun,1985-06-22,ConFunkShun - Electric Lady,11,13,9,9.0,11,Electric Lady,31.0,5,2,0,2,1,up,1985-05-18
27766,ConFunkShun,1985-06-29,ConFunkShun - Electric Lady,11,11,9,9.0,9,Electric Lady,31.0,6,0,2,0,0,stay,1985-05-18
27767,ConFunkShun,1985-07-06,ConFunkShun - Electric Lady,9,11,9,9.0,9,Electric Lady,31.0,7,0,0,2,0,stay,1985-05-18
27768,ConFunkShun,1985-07-13,ConFunkShun - Electric Lady,9,9,9,9.0,9,Electric Lady,31.0,8,0,0,0,0,stay,1985-05-18
27769,ConFunkShun,1985-07-20,ConFunkShun - Electric Lady,9,9,9,9.0,9,Electric Lady,31.0,9,0,0,0,0,stay,1985-05-18
27770,ConFunkShun,1985-07-27,ConFunkShun - Electric Lady,9,9,14,9.0,9,Electric Lady,31.0,10,-5,0,0,1,down,1985-05-18
27771,ConFunkShun,1985-08-03,ConFunkShun - Electric Lady,9,9,17,9.0,14,Electric Lady,31.0,11,-3,-5,0,1,down,1985-05-18
27772,ConFunkShun,1985-08-10,ConFunkShun - Electric Lady,14,9,18,9.0,17,Electric Lady,31.0,12,-1,-3,-5,1,down,1985-05-18
27773,ConFunkShun,1985-08-17,ConFunkShun - Electric Lady,17,14,20,9.0,18,Electric Lady,31.0,13,-2,-1,-3,1,down,1985-05-18
27774,ConFunkShun,1985-08-24,ConFunkShun - Electric Lady,18,17,20,9.0,20,Electric Lady,31.0,14,0,-2,-1,0,stay,1985-05-18
27775,ConFunkShun,1985-08-31,ConFunkShun - Electric Lady,20,18,22,9.0,20,Electric Lady,31.0,15,-2,0,-2,1,down,1985-05-18
27776,ConFunkShun,1985-09-07,ConFunkShun - Electric Lady,20,20,21,9.0,22,Electric Lady,31.0,16,1,-2,0,1,up,1985-05-18
27777,ConFunkShun,1985-09-14,ConFunkShun - Electric Lady,22,20,19,9.0,21,Electric Lady,31.0,17,2,1,-2,1,up,1985-05-18
27778,ConFunkShun,1985-09-21,ConFunkShun - Electric Lady,21,22,20,9.0,19,Electric Lady,31.0,18,-1,2,1,1,down,1985-05-18
27779,ConFunkShun,1985-09-28,ConFunkShun - Electric Lady,19,21,22,9.0,20,Electric Lady,31.0,19,-2,-1,2,1,down,1985-05-18
27780,ConFunkShun,1985-10-05,ConFunkShun - Electric Lady,20,19,34,9.0,22,Electric Lady,31.0,20,-12,-2,-1,1,down,1985-05-18
27781,ConFunkShun,1985-10-12,ConFunkShun - Electric Lady,22,20,40,9.0,34,Electric Lady,31.0,21,-6,-12,-2,1,down,1985-05-18
27782,ConFunkShun,1985-10-19,ConFunkShun - Electric Lady,34,22,39,9.0,40,Electric Lady,31.0,22,1,-6,-12,1,up,1985-05-18
27783,ConFunkShun,1985-10-26,ConFunkShun - Electric Lady,40,34,30,9.0,39,Electric Lady,31.0,23,9,1,-6,1,up,1985-05-18
27784,ConFunkShun,1985-11-02,ConFunkShun - Electric Lady,39,40,29,9.0,30,Electric Lady,31.0,24,1,9,1,1,up,1985-05-18
27785,ConFunkShun,1985-11-09,ConFunkShun - Electric Lady,30,39,33,9.0,29,Electric Lady,31.0,25,-4,1,9,1,down,1985-05-18
27786,ConFunkShun,1985-11-16,ConFunkShun - Electric Lady,29,30,33,9.0,33,Electric Lady,31.0,26,0,-4,1,0,stay,1985-05-18
27787,ConFunkShun,1985-11-23,ConFunkShun - Electric Lady,33,29,33,9.0,33,Electric Lady,31.0,27,0,0,-4,0,stay,1985-05-18
27788,ConFunkShun,1985-11-30,ConFunkShun - Electric Lady,33,33,38,9.0,33,Electric Lady,31.0,28,-5,0,0,1,down,1985-05-18
27789,ConFunkShun,1985-12-07,ConFunkShun - Electric Lady,33,33,47,9.0,38,Electric Lady,31.0,29,-9,-5,0,1,down,1985-05-18
27790,ConFunkShun,1985-12-14,ConFunkShun - Electric Lady,38,33,49,9.0,47,Electric Lady,31.0,30,-2,-9,-5,1,down,1985-05-18
27791,ConFunkShun,1985-12-21,ConFunkShun - Electric Lady,47,38,51,9.0,49,Electric Lady,31.0,31,-2,-2,-9,1,down,1985-05-18
27792,Rick James,1985-05-18,Rick James - Glow,51,51,26,7.0,35,Glow,25.0,0,9,16,0,1,up,1985-05-18
27793,Rick James,1985-05-25,Rick James - Glow,35,51,19,7.0,26,Glow,25.0,1,7,9,16,1,up,1985-05-18
27794,Rick James,1985-06-01,Rick James - Glow,26,35,16,7.0,19,Glow,25.0,2,3,7,9,1,up,1985-05-18
27795,Rick James,1985-06-08,Rick James - Glow,19,26,14,7.0,16,Glow,25.0,3,2,3,7,1,up,1985-05-18
27796,Rick James,1985-06-15,Rick James - Glow,16,19,14,7.0,14,Glow,25.0,4,0,2,3,0,stay,1985-05-18
27797,Rick James,1985-06-22,Rick James - Glow,14,16,13,7.0,14,Glow,25.0,5,1,0,2,1,up,1985-05-18
27798,Rick James,1985-06-29,Rick James - Glow,14,14,11,7.0,13,Glow,25.0,6,2,1,0,1,up,1985-05-18
27799,Rick James,1985-07-06,Rick James - Glow,13,14,10,7.0,11,Glow,25.0,7,1,2,1,1,up,1985-05-18
27800,Rick James,1985-07-13,Rick James - Glow,11,13,8,7.0,10,Glow,25.0,8,2,1,2,1,up,1985-05-18
27801,Rick James,1985-07-20,Rick James - Glow,10,11,7,7.0,8,Glow,25.0,9,1,2,1,1,up,1985-05-18
27802,Rick James,1985-07-27,Rick James - Glow,8,10,10,7.0,7,Glow,25.0,10,-3,1,2,1,down,1985-05-18
27803,Rick James,1985-08-03,Rick James - Glow,7,8,10,7.0,10,Glow,25.0,11,0,-3,1,0,stay,1985-05-18
27804,Rick James,1985-08-10,Rick James - Glow,10,7,11,7.0,10,Glow,25.0,12,-1,0,-3,1,down,1985-05-18
27805,Rick James,1985-08-17,Rick James - Glow,10,10,15,7.0,11,Glow,25.0,13,-4,-1,0,1,down,1985-05-18
27806,Rick James,1985-08-24,Rick James - Glow,11,10,18,7.0,15,Glow,25.0,14,-3,-4,-1,1,down,1985-05-18
27807,Rick James,1985-08-31,Rick James - Glow,15,11,19,7.0,18,Glow,25.0,15,-1,-3,-4,1,down,1985-05-18
27808,Rick James,1985-09-07,Rick James - Glow,18,15,22,7.0,19,Glow,25.0,16,-3,-1,-3,1,down,1985-05-18
27809,Rick James,1985-09-14,Rick James - Glow,19,18,22,7.0,22,Glow,25.0,17,0,-3,-1,0,stay,1985-05-18
27810,Rick James,1985-09-21,Rick James - Glow,22,19,31,7.0,22,Glow,25.0,18,-9,0,-3,1,down,1985-05-18
27811,Rick James,1985-09-28,Rick James - Glow,22,22,31,7.0,31,Glow,25.0,19,0,-9,0,0,stay,1985-05-18
27812,Rick James,1985-10-05,Rick James - Glow,31,22,37,7.0,31,Glow,25.0,20,-6,0,-9,1,down,1985-05-18
27813,Rick James,1985-10-12,Rick James - Glow,31,31,37,7.0,37,Glow,25.0,21,0,-6,0,0,stay,1985-05-18
27814,Rick James,1985-10-19,Rick James - Glow,37,31,32,7.0,37,Glow,25.0,22,5,0,-6,1,up,1985-05-18
27815,Rick James,1985-10-26,Rick James - Glow,37,37,32,7.0,32,Glow,25.0,23,0,5,0,0,stay,1985-05-18
27816,Rick James,1985-11-02,Rick James - Glow,32,37,50,7.0,32,Glow,25.0,24,-18,0,5,1,down,1985-05-18
27817,Rick James,1985-11-09,Rick James - Glow,32,32,51,7.0,50,Glow,25.0,25,-1,-18,0,1,down,1985-05-18
27818,Freddie Jackson,1985-05-25,Freddie Jackson - Rock Me Tonight,51,51,12,1.0,20,Rock Me Tonight,31.0,0,8,31,0,1,up,1985-05-25
27819,Freddie Jackson,1985-06-01,Freddie Jackson - Rock Me Tonight,20,51,8,1.0,12,Rock Me Tonight,31.0,1,4,8,31,1,up,1985-05-25
27820,Freddie Jackson,1985-06-08,Freddie Jackson - Rock Me Tonight,12,20,3,1.0,8,Rock Me Tonight,31.0,2,5,4,8,1,up,1985-05-25
27821,Freddie Jackson,1985-06-15,Freddie Jackson - Rock Me Tonight,8,12,3,1.0,3,Rock Me Tonight,31.0,3,0,5,4,0,stay,1985-05-25
27822,Freddie Jackson,1985-06-22,Freddie Jackson - Rock Me Tonight,3,8,1,1.0,3,Rock Me Tonight,31.0,4,2,0,5,1,up,1985-05-25
27823,Freddie Jackson,1985-06-29,Freddie Jackson - Rock Me Tonight,3,3,1,1.0,1,Rock Me Tonight,31.0,5,0,2,0,0,stay,1985-05-25
27824,Freddie Jackson,1985-07-06,Freddie Jackson - Rock Me Tonight,1,3,1,1.0,1,Rock Me Tonight,31.0,6,0,0,2,0,stay,1985-05-25
27825,Freddie Jackson,1985-07-13,Freddie Jackson - Rock Me Tonight,1,1,1,1.0,1,Rock Me Tonight,31.0,7,0,0,0,0,stay,1985-05-25
27826,Freddie Jackson,1985-07-20,Freddie Jackson - Rock Me Tonight,1,1,1,1.0,1,Rock Me Tonight,31.0,8,0,0,0,0,stay,1985-05-25
27827,Freddie Jackson,1985-07-27,Freddie Jackson - Rock Me Tonight,1,1,1,1.0,1,Rock Me Tonight,31.0,9,0,0,0,0,stay,1985-05-25
27828,Freddie Jackson,1985-08-03,Freddie Jackson - Rock Me Tonight,1,1,1,1.0,1,Rock Me Tonight,31.0,10,0,0,0,0,stay,1985-05-25
27829,Freddie Jackson,1985-08-10,Freddie Jackson - Rock Me Tonight,1,1,1,1.0,1,Rock Me Tonight,31.0,11,0,0,0,0,stay,1985-05-25
27830,Freddie Jackson,1985-08-17,Freddie Jackson - Rock Me Tonight,1,1,1,1.0,1,Rock Me Tonight,31.0,12,0,0,0,0,stay,1985-05-25
27831,Freddie Jackson,1985-08-24,Freddie Jackson - Rock Me Tonight,1,1,1,1.0,1,Rock Me Tonight,31.0,13,0,0,0,0,stay,1985-05-25
27832,Freddie Jackson,1985-08-31,Freddie Jackson - Rock Me Tonight,1,1,2,1.0,1,Rock Me Tonight,31.0,14,-1,0,0,1,down,1985-05-25
27833,Freddie Jackson,1985-09-07,Freddie Jackson - Rock Me Tonight,1,1,3,1.0,2,Rock Me Tonight,31.0,15,-1,-1,0,1,down,1985-05-25
27834,Freddie Jackson,1985-09-14,Freddie Jackson - Rock Me Tonight,2,1,2,1.0,3,Rock Me Tonight,31.0,16,1,-1,-1,1,up,1985-05-25
27835,Freddie Jackson,1985-09-21,Freddie Jackson - Rock Me Tonight,3,2,2,1.0,2,Rock Me Tonight,31.0,17,0,1,-1,0,stay,1985-05-25
27836,Freddie Jackson,1985-09-28,Freddie Jackson - Rock Me Tonight,2,3,2,1.0,2,Rock Me Tonight,31.0,18,0,0,1,0,stay,1985-05-25
27837,Freddie Jackson,1985-10-05,Freddie Jackson - Rock Me Tonight,2,2,1,1.0,2,Rock Me Tonight,31.0,19,1,0,0,1,up,1985-05-25
27838,Freddie Jackson,1985-10-12,Freddie Jackson - Rock Me Tonight,2,2,1,1.0,1,Rock Me Tonight,31.0,20,0,1,0,0,stay,1985-05-25
27839,Freddie Jackson,1985-10-19,Freddie Jackson - Rock Me Tonight,1,2,1,1.0,1,Rock Me Tonight,31.0,21,0,0,1,0,stay,1985-05-25
27840,Freddie Jackson,1985-10-26,Freddie Jackson - Rock Me Tonight,1,1,1,1.0,1,Rock Me Tonight,31.0,22,0,0,0,0,stay,1985-05-25
27841,Freddie Jackson,1985-11-02,Freddie Jackson - Rock Me Tonight,1,1,2,1.0,1,Rock Me Tonight,31.0,23,-1,0,0,1,down,1985-05-25
27842,Freddie Jackson,1985-11-09,Freddie Jackson - Rock Me Tonight,1,1,2,1.0,2,Rock Me Tonight,31.0,24,0,-1,0,0,stay,1985-05-25
27843,Freddie Jackson,1985-11-16,Freddie Jackson - Rock Me Tonight,2,1,2,1.0,2,Rock Me Tonight,31.0,25,0,0,-1,0,stay,1985-05-25
27844,Freddie Jackson,1985-11-23,Freddie Jackson - Rock Me Tonight,2,2,2,1.0,2,Rock Me Tonight,31.0,26,0,0,0,0,stay,1985-05-25
27845,Freddie Jackson,1985-11-30,Freddie Jackson - Rock Me Tonight,2,2,2,1.0,2,Rock Me Tonight,31.0,27,0,0,0,0,stay,1985-05-25
27846,Freddie Jackson,1985-12-07,Freddie Jackson - Rock Me Tonight,2,2,2,1.0,2,Rock Me Tonight,31.0,28,0,0,0,0,stay,1985-05-25
27847,Freddie Jackson,1985-12-14,Freddie Jackson - Rock Me Tonight,2,2,2,1.0,2,Rock Me Tonight,31.0,29,0,0,0,0,stay,1985-05-25
27848,Freddie Jackson,1985-12-21,Freddie Jackson - Rock Me Tonight,2,2,2,1.0,2,Rock Me Tonight,31.0,30,0,0,0,0,stay,1985-05-25
27849,Freddie Jackson,1985-12-28,Freddie Jackson - Rock Me Tonight,2,2,51,1.0,2,Rock Me Tonight,31.0,31,-49,0,0,1,down,1985-05-25
27850,Atlantic Starr,1985-05-25,Atlantic Starr - As The Band Turns,51,51,22,15.0,29,As The Band Turns,31.0,0,7,22,0,1,up,1985-05-25
27851,Atlantic Starr,1985-06-01,Atlantic Starr - As The Band Turns,29,51,20,15.0,22,As The Band Turns,31.0,1,2,7,22,1,up,1985-05-25
27852,Atlantic Starr,1985-06-08,Atlantic Starr - As The Band Turns,22,29,19,15.0,20,As The Band Turns,31.0,2,1,2,7,1,up,1985-05-25
27853,Atlantic Starr,1985-06-15,Atlantic Starr - As The Band Turns,20,22,17,15.0,19,As The Band Turns,31.0,3,2,1,2,1,up,1985-05-25
27854,Atlantic Starr,1985-06-22,Atlantic Starr - As The Band Turns,19,20,15,15.0,17,As The Band Turns,31.0,4,2,2,1,1,up,1985-05-25
27855,Atlantic Starr,1985-06-29,Atlantic Starr - As The Band Turns,17,19,15,15.0,15,As The Band Turns,31.0,5,0,2,2,0,stay,1985-05-25
27856,Atlantic Starr,1985-07-06,Atlantic Starr - As The Band Turns,15,17,15,15.0,15,As The Band Turns,31.0,6,0,0,2,0,stay,1985-05-25
27857,Atlantic Starr,1985-07-13,Atlantic Starr - As The Band Turns,15,15,17,15.0,15,As The Band Turns,31.0,7,-2,0,0,1,down,1985-05-25
27858,Atlantic Starr,1985-07-20,Atlantic Starr - As The Band Turns,15,15,19,15.0,17,As The Band Turns,31.0,8,-2,-2,0,1,down,1985-05-25
27859,Atlantic Starr,1985-07-27,Atlantic Starr - As The Band Turns,17,15,25,15.0,19,As The Band Turns,31.0,9,-6,-2,-2,1,down,1985-05-25
27860,Atlantic Starr,1985-08-03,Atlantic Starr - As The Band Turns,19,17,24,15.0,25,As The Band Turns,31.0,10,1,-6,-2,1,up,1985-05-25
27861,Atlantic Starr,1985-08-10,Atlantic Starr - As The Band Turns,25,19,25,15.0,24,As The Band Turns,31.0,11,-1,1,-6,1,down,1985-05-25
27862,Atlantic Starr,1985-08-17,Atlantic Starr - As The Band Turns,24,25,25,15.0,25,As The Band Turns,31.0,12,0,-1,1,0,stay,1985-05-25
27863,Atlantic Starr,1985-08-24,Atlantic Starr - As The Band Turns,25,24,29,15.0,25,As The Band Turns,31.0,13,-4,0,-1,1,down,1985-05-25
27864,Atlantic Starr,1985-08-31,Atlantic Starr - As The Band Turns,25,25,27,15.0,29,As The Band Turns,31.0,14,2,-4,0,1,up,1985-05-25
27865,Atlantic Starr,1985-09-07,Atlantic Starr - As The Band Turns,29,25,27,15.0,27,As The Band Turns,31.0,15,0,2,-4,0,stay,1985-05-25
27866,Atlantic Starr,1985-09-14,Atlantic Starr - As The Band Turns,27,29,27,15.0,27,As The Band Turns,31.0,16,0,0,2,0,stay,1985-05-25
27867,Atlantic Starr,1985-09-21,Atlantic Starr - As The Band Turns,27,27,27,15.0,27,As The Band Turns,31.0,17,0,0,0,0,stay,1985-05-25
27868,Atlantic Starr,1985-09-28,Atlantic Starr - As The Band Turns,27,27,26,15.0,27,As The Band Turns,31.0,18,1,0,0,1,up,1985-05-25
27869,Atlantic Starr,1985-10-05,Atlantic Starr - As The Band Turns,27,27,25,15.0,26,As The Band Turns,31.0,19,1,1,0,1,up,1985-05-25
27870,Atlantic Starr,1985-10-12,Atlantic Starr - As The Band Turns,26,27,25,15.0,25,As The Band Turns,31.0,20,0,1,1,0,stay,1985-05-25
27871,Atlantic Starr,1985-10-19,Atlantic Starr - As The Band Turns,25,26,20,15.0,25,As The Band Turns,31.0,21,5,0,1,1,up,1985-05-25
27872,Atlantic Starr,1985-10-26,Atlantic Starr - As The Band Turns,25,25,20,15.0,20,As The Band Turns,31.0,22,0,5,0,0,stay,1985-05-25
27873,Atlantic Starr,1985-11-02,Atlantic Starr - As The Band Turns,20,25,18,15.0,20,As The Band Turns,31.0,23,2,0,5,1,up,1985-05-25
27874,Atlantic Starr,1985-11-09,Atlantic Starr - As The Band Turns,20,20,18,15.0,18,As The Band Turns,31.0,24,0,2,0,0,stay,1985-05-25
27875,Atlantic Starr,1985-11-16,Atlantic Starr - As The Band Turns,18,20,17,15.0,18,As The Band Turns,31.0,25,1,0,2,1,up,1985-05-25
27876,Atlantic Starr,1985-11-23,Atlantic Starr - As The Band Turns,18,18,17,15.0,17,As The Band Turns,31.0,26,0,1,0,0,stay,1985-05-25
27877,Atlantic Starr,1985-11-30,Atlantic Starr - As The Band Turns,17,18,16,15.0,17,As The Band Turns,31.0,27,1,0,1,1,up,1985-05-25
27878,Atlantic Starr,1985-12-07,Atlantic Starr - As The Band Turns,17,17,16,15.0,16,As The Band Turns,31.0,28,0,1,0,0,stay,1985-05-25
27879,Atlantic Starr,1985-12-14,Atlantic Starr - As The Band Turns,16,17,15,15.0,16,As The Band Turns,31.0,29,1,0,1,1,up,1985-05-25
27880,Atlantic Starr,1985-12-21,Atlantic Starr - As The Band Turns,16,16,15,15.0,15,As The Band Turns,31.0,30,0,1,0,0,stay,1985-05-25
27881,Atlantic Starr,1985-12-28,Atlantic Starr - As The Band Turns,15,16,51,15.0,15,As The Band Turns,31.0,31,-36,0,1,1,down,1985-05-25
27882,The Reddings,1985-05-25,The Reddings - If Looks Could Kill,51,51,26,24.0,31,If Looks Could Kill,4.0,0,5,20,0,1,up,1985-05-25
27883,The Reddings,1985-06-01,The Reddings - If Looks Could Kill,31,51,24,24.0,26,If Looks Could Kill,4.0,1,2,5,20,1,up,1985-05-25
27884,The Reddings,1985-06-08,The Reddings - If Looks Could Kill,26,31,24,24.0,24,If Looks Could Kill,4.0,2,0,2,5,0,stay,1985-05-25
27885,The Reddings,1985-06-15,The Reddings - If Looks Could Kill,24,26,47,24.0,24,If Looks Could Kill,4.0,3,-23,0,2,1,down,1985-05-25
27886,The Reddings,1985-06-22,The Reddings - If Looks Could Kill,24,24,51,24.0,47,If Looks Could Kill,4.0,4,-4,-23,0,1,down,1985-05-25
27887,Earl Klugh,1985-06-01,Earl Klugh - Soda Fountain Shuffle,51,51,32,23.0,37,Soda Fountain Shuffle,12.0,0,5,14,0,1,up,1985-06-01
27888,Earl Klugh,1985-06-08,Earl Klugh - Soda Fountain Shuffle,37,51,28,23.0,32,Soda Fountain Shuffle,12.0,1,4,5,14,1,up,1985-06-01
27889,Earl Klugh,1985-06-15,Earl Klugh - Soda Fountain Shuffle,32,37,26,23.0,28,Soda Fountain Shuffle,12.0,2,2,4,5,1,up,1985-06-01
27890,Earl Klugh,1985-06-22,Earl Klugh - Soda Fountain Shuffle,28,32,23,23.0,26,Soda Fountain Shuffle,12.0,3,3,2,4,1,up,1985-06-01
27891,Earl Klugh,1985-06-29,Earl Klugh - Soda Fountain Shuffle,26,28,23,23.0,23,Soda Fountain Shuffle,12.0,4,0,3,2,0,stay,1985-06-01
27892,Earl Klugh,1985-07-06,Earl Klugh - Soda Fountain Shuffle,23,26,23,23.0,23,Soda Fountain Shuffle,12.0,5,0,0,3,0,stay,1985-06-01
27893,Earl Klugh,1985-07-13,Earl Klugh - Soda Fountain Shuffle,23,23,24,23.0,23,Soda Fountain Shuffle,12.0,6,-1,0,0,1,down,1985-06-01
27894,Earl Klugh,1985-07-20,Earl Klugh - Soda Fountain Shuffle,23,23,24,23.0,24,Soda Fountain Shuffle,12.0,7,0,-1,0,0,stay,1985-06-01
27895,Earl Klugh,1985-07-27,Earl Klugh - Soda Fountain Shuffle,24,23,28,23.0,24,Soda Fountain Shuffle,12.0,8,-4,0,-1,1,down,1985-06-01
27896,Earl Klugh,1985-08-03,Earl Klugh - Soda Fountain Shuffle,24,24,28,23.0,28,Soda Fountain Shuffle,12.0,9,0,-4,0,0,stay,1985-06-01
27897,Earl Klugh,1985-08-10,Earl Klugh - Soda Fountain Shuffle,28,24,26,23.0,28,Soda Fountain Shuffle,12.0,10,2,0,-4,1,up,1985-06-01
27898,Earl Klugh,1985-08-17,Earl Klugh - Soda Fountain Shuffle,28,28,38,23.0,26,Soda Fountain Shuffle,12.0,11,-12,2,0,1,down,1985-06-01
27899,Earl Klugh,1985-08-24,Earl Klugh - Soda Fountain Shuffle,26,28,51,23.0,38,Soda Fountain Shuffle,12.0,12,-13,-12,2,1,down,1985-06-01
27900,Bill Withers,1985-06-01,"Bill Withers - Watching You, Watching Me",51,51,46,42.0,46,"Watching You, Watching Me",7.0,0,0,5,0,0,stay,1985-06-01
27901,Bill Withers,1985-06-08,"Bill Withers - Watching You, Watching Me",46,51,45,42.0,46,"Watching You, Watching Me",7.0,1,1,0,5,1,up,1985-06-01
27902,Bill Withers,1985-06-15,"Bill Withers - Watching You, Watching Me",46,46,44,42.0,45,"Watching You, Watching Me",7.0,2,1,1,0,1,up,1985-06-01
27903,Bill Withers,1985-06-22,"Bill Withers - Watching You, Watching Me",45,46,42,42.0,44,"Watching You, Watching Me",7.0,3,2,1,1,1,up,1985-06-01
27904,Bill Withers,1985-06-29,"Bill Withers - Watching You, Watching Me",44,45,44,42.0,42,"Watching You, Watching Me",7.0,4,-2,2,1,1,down,1985-06-01
27905,Bill Withers,1985-07-06,"Bill Withers - Watching You, Watching Me",42,44,49,42.0,44,"Watching You, Watching Me",7.0,5,-5,-2,2,1,down,1985-06-01
27906,Bill Withers,1985-08-31,"Bill Withers - Watching You, Watching Me",44,42,47,42.0,49,"Watching You, Watching Me",7.0,6,2,-5,-2,1,up,1985-06-01
27907,Bill Withers,1985-09-07,"Bill Withers - Watching You, Watching Me",49,44,51,42.0,47,"Watching You, Watching Me",7.0,7,-4,2,-5,1,down,1985-06-01
27908,Klique,1985-06-01,Klique - Love Cycles,51,51,44,25.0,47,Love Cycles,10.0,0,3,4,0,1,up,1985-06-01
27909,Klique,1985-06-08,Klique - Love Cycles,47,51,38,25.0,44,Love Cycles,10.0,1,6,3,4,1,up,1985-06-01
27910,Klique,1985-06-15,Klique - Love Cycles,44,47,36,25.0,38,Love Cycles,10.0,2,2,6,3,1,up,1985-06-01
27911,Klique,1985-06-22,Klique - Love Cycles,38,44,31,25.0,36,Love Cycles,10.0,3,5,2,6,1,up,1985-06-01
27912,Klique,1985-06-29,Klique - Love Cycles,36,38,30,25.0,31,Love Cycles,10.0,4,1,5,2,1,up,1985-06-01
27913,Klique,1985-07-06,Klique - Love Cycles,31,36,26,25.0,30,Love Cycles,10.0,5,4,1,5,1,up,1985-06-01
27914,Klique,1985-07-13,Klique - Love Cycles,30,31,25,25.0,26,Love Cycles,10.0,6,1,4,1,1,up,1985-06-01
27915,Klique,1985-07-20,Klique - Love Cycles,26,30,26,25.0,25,Love Cycles,10.0,7,-1,1,4,1,down,1985-06-01
27916,Klique,1985-07-27,Klique - Love Cycles,25,26,32,25.0,26,Love Cycles,10.0,8,-6,-1,1,1,down,1985-06-01
27917,Klique,1985-08-03,Klique - Love Cycles,26,25,43,25.0,32,Love Cycles,10.0,9,-11,-6,-1,1,down,1985-06-01
27918,Klique,1985-08-10,Klique - Love Cycles,32,26,51,25.0,43,Love Cycles,10.0,10,-8,-11,-6,1,down,1985-06-01
27919,Ready For The World,1985-06-08,Ready For The World - Ready For The World,51,51,27,3.0,35,Ready For The World,29.0,0,8,16,0,1,up,1985-06-08
27920,Ready For The World,1985-06-15,Ready For The World - Ready For The World,35,51,22,3.0,27,Ready For The World,29.0,1,5,8,16,1,up,1985-06-08
27921,Ready For The World,1985-06-22,Ready For The World - Ready For The World,27,35,17,3.0,22,Ready For The World,29.0,2,5,5,8,1,up,1985-06-08
27922,Ready For The World,1985-06-29,Ready For The World - Ready For The World,22,27,14,3.0,17,Ready For The World,29.0,3,3,5,5,1,up,1985-06-08
27923,Ready For The World,1985-07-06,Ready For The World - Ready For The World,17,22,12,3.0,14,Ready For The World,29.0,4,2,3,5,1,up,1985-06-08
27924,Ready For The World,1985-07-13,Ready For The World - Ready For The World,14,17,12,3.0,12,Ready For The World,29.0,5,0,2,3,0,stay,1985-06-08
27925,Ready For The World,1985-07-20,Ready For The World - Ready For The World,12,14,12,3.0,12,Ready For The World,29.0,6,0,0,2,0,stay,1985-06-08
27926,Ready For The World,1985-07-27,Ready For The World - Ready For The World,12,12,7,3.0,12,Ready For The World,29.0,7,5,0,0,1,up,1985-06-08
27927,Ready For The World,1985-08-03,Ready For The World - Ready For The World,12,12,7,3.0,7,Ready For The World,29.0,8,0,5,0,0,stay,1985-06-08
27928,Ready For The World,1985-08-10,Ready For The World - Ready For The World,7,12,7,3.0,7,Ready For The World,29.0,9,0,0,5,0,stay,1985-06-08
27929,Ready For The World,1985-08-17,Ready For The World - Ready For The World,7,7,6,3.0,7,Ready For The World,29.0,10,1,0,0,1,up,1985-06-08
27930,Ready For The World,1985-08-24,Ready For The World - Ready For The World,7,7,6,3.0,6,Ready For The World,29.0,11,0,1,0,0,stay,1985-06-08
27931,Ready For The World,1985-08-31,Ready For The World - Ready For The World,6,7,5,3.0,6,Ready For The World,29.0,12,1,0,1,1,up,1985-06-08
27932,Ready For The World,1985-09-07,Ready For The World - Ready For The World,6,6,6,3.0,5,Ready For The World,29.0,13,-1,1,0,1,down,1985-06-08
27933,Ready For The World,1985-09-14,Ready For The World - Ready For The World,5,6,4,3.0,6,Ready For The World,29.0,14,2,-1,1,1,up,1985-06-08
27934,Ready For The World,1985-09-21,Ready For The World - Ready For The World,6,5,4,3.0,4,Ready For The World,29.0,15,0,2,-1,0,stay,1985-06-08
27935,Ready For The World,1985-09-28,Ready For The World - Ready For The World,4,6,4,3.0,4,Ready For The World,29.0,16,0,0,2,0,stay,1985-06-08
27936,Ready For The World,1985-10-05,Ready For The World - Ready For The World,4,4,4,3.0,4,Ready For The World,29.0,17,0,0,0,0,stay,1985-06-08
27937,Ready For The World,1985-10-12,Ready For The World - Ready For The World,4,4,3,3.0,4,Ready For The World,29.0,18,1,0,0,1,up,1985-06-08
27938,Ready For The World,1985-10-19,Ready For The World - Ready For The World,4,4,6,3.0,3,Ready For The World,29.0,19,-3,1,0,1,down,1985-06-08
27939,Ready For The World,1985-10-26,Ready For The World - Ready For The World,3,4,6,3.0,6,Ready For The World,29.0,20,0,-3,1,0,stay,1985-06-08
27940,Ready For The World,1985-11-02,Ready For The World - Ready For The World,6,3,7,3.0,6,Ready For The World,29.0,21,-1,0,-3,1,down,1985-06-08
27941,Ready For The World,1985-11-09,Ready For The World - Ready For The World,6,6,7,3.0,7,Ready For The World,29.0,22,0,-1,0,0,stay,1985-06-08
27942,Ready For The World,1985-11-16,Ready For The World - Ready For The World,7,6,8,3.0,7,Ready For The World,29.0,23,-1,0,-1,1,down,1985-06-08
27943,Ready For The World,1985-11-23,Ready For The World - Ready For The World,7,7,12,3.0,8,Ready For The World,29.0,24,-4,-1,0,1,down,1985-06-08
27944,Ready For The World,1985-11-30,Ready For The World - Ready For The World,8,7,12,3.0,12,Ready For The World,29.0,25,0,-4,-1,0,stay,1985-06-08
27945,Ready For The World,1985-12-07,Ready For The World - Ready For The World,12,8,11,3.0,12,Ready For The World,29.0,26,1,0,-4,1,up,1985-06-08
27946,Ready For The World,1985-12-14,Ready For The World - Ready For The World,12,12,13,3.0,11,Ready For The World,29.0,27,-2,1,0,1,down,1985-06-08
27947,Ready For The World,1985-12-21,Ready For The World - Ready For The World,11,12,10,3.0,13,Ready For The World,29.0,28,3,-2,1,1,up,1985-06-08
27948,Ready For The World,1985-12-28,Ready For The World - Ready For The World,13,11,51,3.0,10,Ready For The World,29.0,29,-41,3,-2,1,down,1985-06-08
27949,Loose Ends,1985-06-08,Loose Ends - A Little Spice,51,51,35,5.0,40,A Little Spice,21.0,0,5,11,0,1,up,1985-06-08
27950,Loose Ends,1985-06-15,Loose Ends - A Little Spice,40,51,30,5.0,35,A Little Spice,21.0,1,5,5,11,1,up,1985-06-08
27951,Loose Ends,1985-06-22,Loose Ends - A Little Spice,35,40,21,5.0,30,A Little Spice,21.0,2,9,5,5,1,up,1985-06-08
27952,Loose Ends,1985-06-29,Loose Ends - A Little Spice,30,35,19,5.0,21,A Little Spice,21.0,3,2,9,5,1,up,1985-06-08
27953,Loose Ends,1985-07-06,Loose Ends - A Little Spice,21,30,17,5.0,19,A Little Spice,21.0,4,2,2,9,1,up,1985-06-08
27954,Loose Ends,1985-07-13,Loose Ends - A Little Spice,19,21,13,5.0,17,A Little Spice,21.0,5,4,2,2,1,up,1985-06-08
27955,Loose Ends,1985-07-20,Loose Ends - A Little Spice,17,19,13,5.0,13,A Little Spice,21.0,6,0,4,2,0,stay,1985-06-08
27956,Loose Ends,1985-07-27,Loose Ends - A Little Spice,13,17,9,5.0,13,A Little Spice,21.0,7,4,0,4,1,up,1985-06-08
27957,Loose Ends,1985-08-03,Loose Ends - A Little Spice,13,13,9,5.0,9,A Little Spice,21.0,8,0,4,0,0,stay,1985-06-08
27958,Loose Ends,1985-08-10,Loose Ends - A Little Spice,9,13,5,5.0,9,A Little Spice,21.0,9,4,0,4,1,up,1985-06-08
27959,Loose Ends,1985-08-17,Loose Ends - A Little Spice,9,9,8,5.0,5,A Little Spice,21.0,10,-3,4,0,1,down,1985-06-08
27960,Loose Ends,1985-08-24,Loose Ends - A Little Spice,5,9,9,5.0,8,A Little Spice,21.0,11,-1,-3,4,1,down,1985-06-08
27961,Loose Ends,1985-08-31,Loose Ends - A Little Spice,8,5,9,5.0,9,A Little Spice,21.0,12,0,-1,-3,0,stay,1985-06-08
27962,Loose Ends,1985-09-07,Loose Ends - A Little Spice,9,8,12,5.0,9,A Little Spice,21.0,13,-3,0,-1,1,down,1985-06-08
27963,Loose Ends,1985-09-14,Loose Ends - A Little Spice,9,9,8,5.0,12,A Little Spice,21.0,14,4,-3,0,1,up,1985-06-08
27964,Loose Ends,1985-09-21,Loose Ends - A Little Spice,12,9,10,5.0,8,A Little Spice,21.0,15,-2,4,-3,1,down,1985-06-08
27965,Loose Ends,1985-09-28,Loose Ends - A Little Spice,8,12,17,5.0,10,A Little Spice,21.0,16,-7,-2,4,1,down,1985-06-08
27966,Loose Ends,1985-10-05,Loose Ends - A Little Spice,10,8,19,5.0,17,A Little Spice,21.0,17,-2,-7,-2,1,down,1985-06-08
27967,Loose Ends,1985-10-12,Loose Ends - A Little Spice,17,10,29,5.0,19,A Little Spice,21.0,18,-10,-2,-7,1,down,1985-06-08
27968,Loose Ends,1985-10-19,Loose Ends - A Little Spice,19,17,47,5.0,29,A Little Spice,21.0,19,-18,-10,-2,1,down,1985-06-08
27969,Loose Ends,1985-10-26,Loose Ends - A Little Spice,29,19,47,5.0,47,A Little Spice,21.0,20,0,-18,-10,0,stay,1985-06-08
27970,Loose Ends,1985-11-02,Loose Ends - A Little Spice,47,29,51,5.0,47,A Little Spice,21.0,21,-4,0,-18,1,down,1985-06-08
27971,Shannon,1985-06-08,Shannon - Do You Wanna Get Away,51,51,39,39.0,41,Do You Wanna Get Away,9.0,0,2,10,0,1,up,1985-06-08
27972,Shannon,1985-06-15,Shannon - Do You Wanna Get Away,41,51,39,39.0,39,Do You Wanna Get Away,9.0,1,0,2,10,0,stay,1985-06-08
27973,Shannon,1985-06-22,Shannon - Do You Wanna Get Away,39,41,45,39.0,39,Do You Wanna Get Away,9.0,2,-6,0,2,1,down,1985-06-08
27974,Shannon,1985-06-29,Shannon - Do You Wanna Get Away,39,39,47,39.0,45,Do You Wanna Get Away,9.0,3,-2,-6,0,1,down,1985-06-08
27975,Shannon,1985-07-06,Shannon - Do You Wanna Get Away,45,39,41,39.0,47,Do You Wanna Get Away,9.0,4,6,-2,-6,1,up,1985-06-08
27976,Shannon,1985-07-13,Shannon - Do You Wanna Get Away,47,45,41,39.0,41,Do You Wanna Get Away,9.0,5,0,6,-2,0,stay,1985-06-08
27977,Shannon,1985-07-20,Shannon - Do You Wanna Get Away,41,47,41,39.0,41,Do You Wanna Get Away,9.0,6,0,0,6,0,stay,1985-06-08
27978,Shannon,1985-07-27,Shannon - Do You Wanna Get Away,41,41,43,39.0,41,Do You Wanna Get Away,9.0,7,-2,0,0,1,down,1985-06-08
27979,Shannon,1985-08-03,Shannon - Do You Wanna Get Away,41,41,44,39.0,43,Do You Wanna Get Away,9.0,8,-1,-2,0,1,down,1985-06-08
27980,Shannon,1985-08-10,Shannon - Do You Wanna Get Away,43,41,51,39.0,44,Do You Wanna Get Away,9.0,9,-7,-1,-2,1,down,1985-06-08
27981,Phil Collins,1985-06-08,Phil Collins - No Jacket Required,51,51,43,26.0,48,No Jacket Required,13.0,0,5,3,0,1,up,1985-06-08
27982,Phil Collins,1985-06-15,Phil Collins - No Jacket Required,48,51,37,26.0,43,No Jacket Required,13.0,1,6,5,3,1,up,1985-06-08
27983,Phil Collins,1985-06-22,Phil Collins - No Jacket Required,43,48,36,26.0,37,No Jacket Required,13.0,2,1,6,5,1,up,1985-06-08
27984,Phil Collins,1985-06-29,Phil Collins - No Jacket Required,37,43,28,26.0,36,No Jacket Required,13.0,3,8,1,6,1,up,1985-06-08
27985,Phil Collins,1985-07-06,Phil Collins - No Jacket Required,36,37,27,26.0,28,No Jacket Required,13.0,4,1,8,1,1,up,1985-06-08
27986,Phil Collins,1985-07-13,Phil Collins - No Jacket Required,28,36,32,26.0,27,No Jacket Required,13.0,5,-5,1,8,1,down,1985-06-08
27987,Phil Collins,1985-07-20,Phil Collins - No Jacket Required,27,28,27,26.0,32,No Jacket Required,13.0,6,5,-5,1,1,up,1985-06-08
27988,Phil Collins,1985-07-27,Phil Collins - No Jacket Required,32,27,27,26.0,27,No Jacket Required,13.0,7,0,5,-5,0,stay,1985-06-08
27989,Phil Collins,1985-08-03,Phil Collins - No Jacket Required,27,32,26,26.0,27,No Jacket Required,13.0,8,1,0,5,1,up,1985-06-08
27990,Phil Collins,1985-08-10,Phil Collins - No Jacket Required,27,27,31,26.0,26,No Jacket Required,13.0,9,-5,1,0,1,down,1985-06-08
27991,Phil Collins,1985-08-17,Phil Collins - No Jacket Required,26,27,40,26.0,31,No Jacket Required,13.0,10,-9,-5,1,1,down,1985-06-08
27992,Phil Collins,1985-08-24,Phil Collins - No Jacket Required,31,26,40,26.0,40,No Jacket Required,13.0,11,0,-9,-5,0,stay,1985-06-08
27993,Phil Collins,1985-08-31,Phil Collins - No Jacket Required,40,31,49,26.0,40,No Jacket Required,13.0,12,-9,0,-9,1,down,1985-06-08
27994,Phil Collins,1985-09-07,Phil Collins - No Jacket Required,40,40,51,26.0,49,No Jacket Required,13.0,13,-2,-9,0,1,down,1985-06-08
27995,Kenny G,1985-06-08,Kenny G - Gravity,51,51,44,37.0,50,Gravity,8.0,0,6,1,0,1,up,1985-06-08
27996,Kenny G,1985-06-15,Kenny G - Gravity,50,51,38,37.0,44,Gravity,8.0,1,6,6,1,1,up,1985-06-08
27997,Kenny G,1985-06-22,Kenny G - Gravity,44,50,38,37.0,38,Gravity,8.0,2,0,6,6,0,stay,1985-06-08
27998,Kenny G,1985-06-29,Kenny G - Gravity,38,44,37,37.0,38,Gravity,8.0,3,1,0,6,1,up,1985-06-08
27999,Kenny G,1985-07-06,Kenny G - Gravity,38,38,39,37.0,37,Gravity,8.0,4,-2,1,0,1,down,1985-06-08
28000,Kenny G,1985-07-13,Kenny G - Gravity,37,38,39,37.0,39,Gravity,8.0,5,0,-2,1,0,stay,1985-06-08
28001,Kenny G,1985-07-20,Kenny G - Gravity,39,37,44,37.0,39,Gravity,8.0,6,-5,0,-2,1,down,1985-06-08
28002,Kenny G,1985-07-27,Kenny G - Gravity,39,39,44,37.0,44,Gravity,8.0,7,0,-5,0,0,stay,1985-06-08
28003,Kenny G,1985-08-03,Kenny G - Gravity,44,39,51,37.0,44,Gravity,8.0,8,-7,0,-5,1,down,1985-06-08
28004,Marvin Gaye,1985-06-15,Marvin Gaye - Dream Of A Lifetime,51,51,12,8.0,15,Dream Of A Lifetime,13.0,0,3,36,0,1,up,1985-06-15
28005,Marvin Gaye,1985-06-22,Marvin Gaye - Dream Of A Lifetime,15,51,8,8.0,12,Dream Of A Lifetime,13.0,1,4,3,36,1,up,1985-06-15
28006,Marvin Gaye,1985-06-29,Marvin Gaye - Dream Of A Lifetime,12,15,8,8.0,8,Dream Of A Lifetime,13.0,2,0,4,3,0,stay,1985-06-15
28007,Marvin Gaye,1985-07-06,Marvin Gaye - Dream Of A Lifetime,8,12,8,8.0,8,Dream Of A Lifetime,13.0,3,0,0,4,0,stay,1985-06-15
28008,Marvin Gaye,1985-07-13,Marvin Gaye - Dream Of A Lifetime,8,8,10,8.0,8,Dream Of A Lifetime,13.0,4,-2,0,0,1,down,1985-06-15
28009,Marvin Gaye,1985-07-20,Marvin Gaye - Dream Of A Lifetime,8,8,10,8.0,10,Dream Of A Lifetime,13.0,5,0,-2,0,0,stay,1985-06-15
28010,Marvin Gaye,1985-07-27,Marvin Gaye - Dream Of A Lifetime,10,8,17,8.0,10,Dream Of A Lifetime,13.0,6,-7,0,-2,1,down,1985-06-15
28011,Marvin Gaye,1985-08-03,Marvin Gaye - Dream Of A Lifetime,10,10,20,8.0,17,Dream Of A Lifetime,13.0,7,-3,-7,0,1,down,1985-06-15
28012,Marvin Gaye,1985-08-10,Marvin Gaye - Dream Of A Lifetime,17,10,21,8.0,20,Dream Of A Lifetime,13.0,8,-1,-3,-7,1,down,1985-06-15
28013,Marvin Gaye,1985-08-17,Marvin Gaye - Dream Of A Lifetime,20,17,29,8.0,21,Dream Of A Lifetime,13.0,9,-8,-1,-3,1,down,1985-06-15
28014,Marvin Gaye,1985-08-24,Marvin Gaye - Dream Of A Lifetime,21,20,31,8.0,29,Dream Of A Lifetime,13.0,10,-2,-8,-1,1,down,1985-06-15
28015,Marvin Gaye,1985-08-31,Marvin Gaye - Dream Of A Lifetime,29,21,43,8.0,31,Dream Of A Lifetime,13.0,11,-12,-2,-8,1,down,1985-06-15
28016,Marvin Gaye,1985-09-07,Marvin Gaye - Dream Of A Lifetime,31,29,49,8.0,43,Dream Of A Lifetime,13.0,12,-6,-12,-2,1,down,1985-06-15
28017,Marvin Gaye,1985-09-14,Marvin Gaye - Dream Of A Lifetime,43,31,51,8.0,49,Dream Of A Lifetime,13.0,13,-2,-6,-12,1,down,1985-06-15
28018,UTFO,1985-06-15,UTFO - UTFO,51,51,27,11.0,40,UTFO,19.0,0,13,11,0,1,up,1985-06-15
28019,UTFO,1985-06-22,UTFO - UTFO,40,51,19,11.0,27,UTFO,19.0,1,8,13,11,1,up,1985-06-15
28020,UTFO,1985-06-29,UTFO - UTFO,27,40,17,11.0,19,UTFO,19.0,2,2,8,13,1,up,1985-06-15
28021,UTFO,1985-07-06,UTFO - UTFO,19,27,14,11.0,17,UTFO,19.0,3,3,2,8,1,up,1985-06-15
28022,UTFO,1985-07-13,UTFO - UTFO,17,19,14,11.0,14,UTFO,19.0,4,0,3,2,0,stay,1985-06-15
28023,UTFO,1985-07-20,UTFO - UTFO,14,17,11,11.0,14,UTFO,19.0,5,3,0,3,1,up,1985-06-15
28024,UTFO,1985-07-27,UTFO - UTFO,14,14,11,11.0,11,UTFO,19.0,6,0,3,0,0,stay,1985-06-15
28025,UTFO,1985-08-03,UTFO - UTFO,11,14,16,11.0,11,UTFO,19.0,7,-5,0,3,1,down,1985-06-15
28026,UTFO,1985-08-10,UTFO - UTFO,11,11,16,11.0,16,UTFO,19.0,8,0,-5,0,0,stay,1985-06-15
28027,UTFO,1985-08-17,UTFO - UTFO,16,11,16,11.0,16,UTFO,19.0,9,0,0,-5,0,stay,1985-06-15
28028,UTFO,1985-08-24,UTFO - UTFO,16,16,19,11.0,16,UTFO,19.0,10,-3,0,0,1,down,1985-06-15
28029,UTFO,1985-08-31,UTFO - UTFO,16,16,16,11.0,19,UTFO,19.0,11,3,-3,0,1,up,1985-06-15
28030,UTFO,1985-09-07,UTFO - UTFO,19,16,16,11.0,16,UTFO,19.0,12,0,3,-3,0,stay,1985-06-15
28031,UTFO,1985-09-14,UTFO - UTFO,16,19,16,11.0,16,UTFO,19.0,13,0,0,3,0,stay,1985-06-15
28032,UTFO,1985-09-21,UTFO - UTFO,16,16,16,11.0,16,UTFO,19.0,14,0,0,0,0,stay,1985-06-15
28033,UTFO,1985-09-28,UTFO - UTFO,16,16,20,11.0,16,UTFO,19.0,15,-4,0,0,1,down,1985-06-15
28034,UTFO,1985-10-05,UTFO - UTFO,16,16,29,11.0,20,UTFO,19.0,16,-9,-4,0,1,down,1985-06-15
28035,UTFO,1985-10-12,UTFO - UTFO,20,16,41,11.0,29,UTFO,19.0,17,-12,-9,-4,1,down,1985-06-15
28036,UTFO,1985-10-19,UTFO - UTFO,29,20,40,11.0,41,UTFO,19.0,18,1,-12,-9,1,up,1985-06-15
28037,UTFO,1985-10-26,UTFO - UTFO,41,29,51,11.0,40,UTFO,19.0,19,-11,1,-12,1,down,1985-06-15
28038,Stanley Jordan,1985-06-15,Stanley Jordan - Magic Touch,51,51,42,31.0,42,Magic Touch,16.0,0,0,9,0,0,stay,1985-06-15
28039,Stanley Jordan,1985-06-22,Stanley Jordan - Magic Touch,42,51,41,31.0,42,Magic Touch,16.0,1,1,0,9,1,up,1985-06-15
28040,Stanley Jordan,1985-06-29,Stanley Jordan - Magic Touch,42,42,34,31.0,41,Magic Touch,16.0,2,7,1,0,1,up,1985-06-15
28041,Stanley Jordan,1985-07-06,Stanley Jordan - Magic Touch,41,42,31,31.0,34,Magic Touch,16.0,3,3,7,1,1,up,1985-06-15
28042,Stanley Jordan,1985-07-13,Stanley Jordan - Magic Touch,34,41,31,31.0,31,Magic Touch,16.0,4,0,3,7,0,stay,1985-06-15
28043,Stanley Jordan,1985-07-20,Stanley Jordan - Magic Touch,31,34,34,31.0,31,Magic Touch,16.0,5,-3,0,3,1,down,1985-06-15
28044,Stanley Jordan,1985-07-27,Stanley Jordan - Magic Touch,31,31,36,31.0,34,Magic Touch,16.0,6,-2,-3,0,1,down,1985-06-15
28045,Stanley Jordan,1985-08-03,Stanley Jordan - Magic Touch,34,31,36,31.0,36,Magic Touch,16.0,7,0,-2,-3,0,stay,1985-06-15
28046,Stanley Jordan,1985-08-10,Stanley Jordan - Magic Touch,36,34,35,31.0,36,Magic Touch,16.0,8,1,0,-2,1,up,1985-06-15
28047,Stanley Jordan,1985-08-17,Stanley Jordan - Magic Touch,36,36,34,31.0,35,Magic Touch,16.0,9,1,1,0,1,up,1985-06-15
28048,Stanley Jordan,1985-08-24,Stanley Jordan - Magic Touch,35,36,34,31.0,34,Magic Touch,16.0,10,0,1,1,0,stay,1985-06-15
28049,Stanley Jordan,1985-08-31,Stanley Jordan - Magic Touch,34,35,48,31.0,34,Magic Touch,16.0,11,-14,0,1,1,down,1985-06-15
28050,Stanley Jordan,1985-09-07,Stanley Jordan - Magic Touch,34,34,46,31.0,48,Magic Touch,16.0,12,2,-14,0,1,up,1985-06-15
28051,Stanley Jordan,1985-09-14,Stanley Jordan - Magic Touch,48,34,46,31.0,46,Magic Touch,16.0,13,0,2,-14,0,stay,1985-06-15
28052,Stanley Jordan,1985-09-21,Stanley Jordan - Magic Touch,46,48,42,31.0,46,Magic Touch,16.0,14,4,0,2,1,up,1985-06-15
28053,Stanley Jordan,1985-10-05,Stanley Jordan - Magic Touch,46,46,42,31.0,42,Magic Touch,16.0,15,0,4,0,0,stay,1985-06-15
28054,Stanley Jordan,1985-10-12,Stanley Jordan - Magic Touch,42,46,51,31.0,42,Magic Touch,16.0,16,-9,0,4,1,down,1985-06-15
28055,The Deele,1985-06-29,The Deele - Material Thangz,51,51,31,29.0,40,Material Thangz,9.0,0,9,11,0,1,up,1985-06-29
28056,The Deele,1985-07-06,The Deele - Material Thangz,40,51,29,29.0,31,Material Thangz,9.0,1,2,9,11,1,up,1985-06-29
28057,The Deele,1985-07-13,The Deele - Material Thangz,31,40,29,29.0,29,Material Thangz,9.0,2,0,2,9,0,stay,1985-06-29
28058,The Deele,1985-07-20,The Deele - Material Thangz,29,31,36,29.0,29,Material Thangz,9.0,3,-7,0,2,1,down,1985-06-29
28059,The Deele,1985-07-27,The Deele - Material Thangz,29,29,34,29.0,36,Material Thangz,9.0,4,2,-7,0,1,up,1985-06-29
28060,The Deele,1985-08-03,The Deele - Material Thangz,36,29,34,29.0,34,Material Thangz,9.0,5,0,2,-7,0,stay,1985-06-29
28061,The Deele,1985-08-10,The Deele - Material Thangz,34,36,34,29.0,34,Material Thangz,9.0,6,0,0,2,0,stay,1985-06-29
28062,The Deele,1985-08-17,The Deele - Material Thangz,34,34,43,29.0,34,Material Thangz,9.0,7,-9,0,0,1,down,1985-06-29
28063,The Deele,1985-08-24,The Deele - Material Thangz,34,34,43,29.0,43,Material Thangz,9.0,8,0,-9,0,0,stay,1985-06-29
28064,The Deele,1985-08-31,The Deele - Material Thangz,43,34,51,29.0,43,Material Thangz,9.0,9,-8,0,-9,1,down,1985-06-29
28065,Four Tops,1985-06-29,Four Tops - Magic,51,51,39,33.0,44,Magic,8.0,0,5,7,0,1,up,1985-06-29
28066,Four Tops,1985-07-06,Four Tops - Magic,44,51,36,33.0,39,Magic,8.0,1,3,5,7,1,up,1985-06-29
28067,Four Tops,1985-07-13,Four Tops - Magic,39,44,36,33.0,36,Magic,8.0,2,0,3,5,0,stay,1985-06-29
28068,Four Tops,1985-07-20,Four Tops - Magic,36,39,33,33.0,36,Magic,8.0,3,3,0,3,1,up,1985-06-29
28069,Four Tops,1985-07-27,Four Tops - Magic,36,36,33,33.0,33,Magic,8.0,4,0,3,0,0,stay,1985-06-29
28070,Four Tops,1985-08-03,Four Tops - Magic,33,36,37,33.0,33,Magic,8.0,5,-4,0,3,1,down,1985-06-29
28071,Four Tops,1985-08-10,Four Tops - Magic,33,33,44,33.0,37,Magic,8.0,6,-7,-4,0,1,down,1985-06-29
28072,Four Tops,1985-08-17,Four Tops - Magic,37,33,44,33.0,44,Magic,8.0,7,0,-7,-4,0,stay,1985-06-29
28073,Four Tops,1985-08-24,Four Tops - Magic,44,37,51,33.0,44,Magic,8.0,8,-7,0,-7,1,down,1985-06-29
28074,Rene & Angela,1985-06-29,Rene & Angela - Street Called Desire,51,51,27,7.0,46,Street Called Desire,26.0,0,19,5,0,1,up,1985-06-29
28075,Rene & Angela,1985-07-06,Rene & Angela - Street Called Desire,46,51,21,7.0,27,Street Called Desire,26.0,1,6,19,5,1,up,1985-06-29
28076,Rene & Angela,1985-07-13,Rene & Angela - Street Called Desire,27,46,18,7.0,21,Street Called Desire,26.0,2,3,6,19,1,up,1985-06-29
28077,Rene & Angela,1985-07-20,Rene & Angela - Street Called Desire,21,27,17,7.0,18,Street Called Desire,26.0,3,1,3,6,1,up,1985-06-29
28078,Rene & Angela,1985-07-27,Rene & Angela - Street Called Desire,18,21,16,7.0,17,Street Called Desire,26.0,4,1,1,3,1,up,1985-06-29
28079,Rene & Angela,1985-08-03,Rene & Angela - Street Called Desire,17,18,15,7.0,16,Street Called Desire,26.0,5,1,1,1,1,up,1985-06-29
28080,Rene & Angela,1985-08-10,Rene & Angela - Street Called Desire,16,17,12,7.0,15,Street Called Desire,26.0,6,3,1,1,1,up,1985-06-29
28081,Rene & Angela,1985-08-17,Rene & Angela - Street Called Desire,15,16,12,7.0,12,Street Called Desire,26.0,7,0,3,1,0,stay,1985-06-29
28082,Rene & Angela,1985-08-24,Rene & Angela - Street Called Desire,12,15,10,7.0,12,Street Called Desire,26.0,8,2,0,3,1,up,1985-06-29
28083,Rene & Angela,1985-08-31,Rene & Angela - Street Called Desire,12,12,14,7.0,10,Street Called Desire,26.0,9,-4,2,0,1,down,1985-06-29
28084,Rene & Angela,1985-09-07,Rene & Angela - Street Called Desire,10,12,10,7.0,14,Street Called Desire,26.0,10,4,-4,2,1,up,1985-06-29
28085,Rene & Angela,1985-09-14,Rene & Angela - Street Called Desire,14,10,10,7.0,10,Street Called Desire,26.0,11,0,4,-4,0,stay,1985-06-29
28086,Rene & Angela,1985-09-21,Rene & Angela - Street Called Desire,10,14,8,7.0,10,Street Called Desire,26.0,12,2,0,4,1,up,1985-06-29
28087,Rene & Angela,1985-09-28,Rene & Angela - Street Called Desire,10,10,8,7.0,8,Street Called Desire,26.0,13,0,2,0,0,stay,1985-06-29
28088,Rene & Angela,1985-10-05,Rene & Angela - Street Called Desire,8,10,8,7.0,8,Street Called Desire,26.0,14,0,0,2,0,stay,1985-06-29
28089,Rene & Angela,1985-10-12,Rene & Angela - Street Called Desire,8,8,9,7.0,8,Street Called Desire,26.0,15,-1,0,0,1,down,1985-06-29
28090,Rene & Angela,1985-10-19,Rene & Angela - Street Called Desire,8,8,8,7.0,9,Street Called Desire,26.0,16,1,-1,0,1,up,1985-06-29
28091,Rene & Angela,1985-10-26,Rene & Angela - Street Called Desire,9,8,8,7.0,8,Street Called Desire,26.0,17,0,1,-1,0,stay,1985-06-29
28092,Rene & Angela,1985-11-02,Rene & Angela - Street Called Desire,8,9,8,7.0,8,Street Called Desire,26.0,18,0,0,1,0,stay,1985-06-29
28093,Rene & Angela,1985-11-09,Rene & Angela - Street Called Desire,8,8,8,7.0,8,Street Called Desire,26.0,19,0,0,0,0,stay,1985-06-29
28094,Rene & Angela,1985-11-16,Rene & Angela - Street Called Desire,8,8,7,7.0,8,Street Called Desire,26.0,20,1,0,0,1,up,1985-06-29
28095,Rene & Angela,1985-11-23,Rene & Angela - Street Called Desire,8,8,9,7.0,7,Street Called Desire,26.0,21,-2,1,0,1,down,1985-06-29
28096,Rene & Angela,1985-11-30,Rene & Angela - Street Called Desire,7,8,9,7.0,9,Street Called Desire,26.0,22,0,-2,1,0,stay,1985-06-29
28097,Rene & Angela,1985-12-07,Rene & Angela - Street Called Desire,9,7,10,7.0,9,Street Called Desire,26.0,23,-1,0,-2,1,down,1985-06-29
28098,Rene & Angela,1985-12-14,Rene & Angela - Street Called Desire,9,9,11,7.0,10,Street Called Desire,26.0,24,-1,-1,0,1,down,1985-06-29
28099,Rene & Angela,1985-12-21,Rene & Angela - Street Called Desire,10,9,11,7.0,11,Street Called Desire,26.0,25,0,-1,-1,0,stay,1985-06-29
28100,Rene & Angela,1985-12-28,Rene & Angela - Street Called Desire,11,10,51,7.0,11,Street Called Desire,26.0,26,-40,0,-1,1,down,1985-06-29
28101,Natalie Cole,1985-07-06,Natalie Cole - Dangerous,51,51,49,48.0,50,Dangerous,4.0,0,1,1,0,1,up,1985-07-06
28102,Natalie Cole,1985-07-13,Natalie Cole - Dangerous,50,51,48,48.0,49,Dangerous,4.0,1,1,1,1,1,up,1985-07-06
28103,Natalie Cole,1985-07-20,Natalie Cole - Dangerous,49,50,50,48.0,48,Dangerous,4.0,2,-2,1,1,1,down,1985-07-06
28104,Natalie Cole,1985-07-27,Natalie Cole - Dangerous,48,49,50,48.0,50,Dangerous,4.0,3,0,-2,1,0,stay,1985-07-06
28105,Natalie Cole,1985-08-03,Natalie Cole - Dangerous,50,48,51,48.0,50,Dangerous,4.0,4,-1,0,-2,1,down,1985-07-06
28106,Cameo,1985-07-20,Cameo - Single Life,51,51,14,2.0,28,Single Life,23.0,0,14,23,0,1,up,1985-07-20
28107,Cameo,1985-07-27,Cameo - Single Life,28,51,8,2.0,14,Single Life,23.0,1,6,14,23,1,up,1985-07-20
28108,Cameo,1985-08-03,Cameo - Single Life,14,28,4,2.0,8,Single Life,23.0,2,4,6,14,1,up,1985-07-20
28109,Cameo,1985-08-10,Cameo - Single Life,8,14,3,2.0,4,Single Life,23.0,3,1,4,6,1,up,1985-07-20
28110,Cameo,1985-08-17,Cameo - Single Life,4,8,2,2.0,3,Single Life,23.0,4,1,1,4,1,up,1985-07-20
28111,Cameo,1985-08-24,Cameo - Single Life,3,4,2,2.0,2,Single Life,23.0,5,0,1,1,0,stay,1985-07-20
28112,Cameo,1985-08-31,Cameo - Single Life,2,3,3,2.0,2,Single Life,23.0,6,-1,0,1,1,down,1985-07-20
28113,Cameo,1985-09-07,Cameo - Single Life,2,2,2,2.0,3,Single Life,23.0,7,1,-1,0,1,up,1985-07-20
28114,Cameo,1985-09-14,Cameo - Single Life,3,2,3,2.0,2,Single Life,23.0,8,-1,1,-1,1,down,1985-07-20
28115,Cameo,1985-09-21,Cameo - Single Life,2,3,3,2.0,3,Single Life,23.0,9,0,-1,1,0,stay,1985-07-20
28116,Cameo,1985-09-28,Cameo - Single Life,3,2,3,2.0,3,Single Life,23.0,10,0,0,-1,0,stay,1985-07-20
28117,Cameo,1985-10-05,Cameo - Single Life,3,3,3,2.0,3,Single Life,23.0,11,0,0,0,0,stay,1985-07-20
28118,Cameo,1985-10-12,Cameo - Single Life,3,3,4,2.0,3,Single Life,23.0,12,-1,0,0,1,down,1985-07-20
28119,Cameo,1985-10-19,Cameo - Single Life,3,3,4,2.0,4,Single Life,23.0,13,0,-1,0,0,stay,1985-07-20
28120,Cameo,1985-10-26,Cameo - Single Life,4,3,4,2.0,4,Single Life,23.0,14,0,0,-1,0,stay,1985-07-20
28121,Cameo,1985-11-02,Cameo - Single Life,4,4,4,2.0,4,Single Life,23.0,15,0,0,0,0,stay,1985-07-20
28122,Cameo,1985-11-09,Cameo - Single Life,4,4,4,2.0,4,Single Life,23.0,16,0,0,0,0,stay,1985-07-20
28123,Cameo,1985-11-16,Cameo - Single Life,4,4,5,2.0,4,Single Life,23.0,17,-1,0,0,1,down,1985-07-20
28124,Cameo,1985-11-23,Cameo - Single Life,4,4,8,2.0,5,Single Life,23.0,18,-3,-1,0,1,down,1985-07-20
28125,Cameo,1985-11-30,Cameo - Single Life,5,4,11,2.0,8,Single Life,23.0,19,-3,-3,-1,1,down,1985-07-20
28126,Cameo,1985-12-07,Cameo - Single Life,8,5,15,2.0,11,Single Life,23.0,20,-4,-3,-3,1,down,1985-07-20
28127,Cameo,1985-12-14,Cameo - Single Life,11,8,21,2.0,15,Single Life,23.0,21,-6,-4,-3,1,down,1985-07-20
28128,Cameo,1985-12-21,Cameo - Single Life,15,11,21,2.0,21,Single Life,23.0,22,0,-6,-4,0,stay,1985-07-20
28129,Cameo,1985-12-28,Cameo - Single Life,21,15,51,2.0,21,Single Life,23.0,23,-30,0,-6,1,down,1985-07-20
28130,George Howard,1985-07-20,George Howard - Dancing In The Sun,51,51,47,47.0,49,Dancing In The Sun,3.0,0,2,2,0,1,up,1985-07-20
28131,George Howard,1985-07-27,George Howard - Dancing In The Sun,49,51,47,47.0,47,Dancing In The Sun,3.0,1,0,2,2,0,stay,1985-07-20
28132,George Howard,1985-08-03,George Howard - Dancing In The Sun,47,49,47,47.0,47,Dancing In The Sun,3.0,2,0,0,2,0,stay,1985-07-20
28133,George Howard,1985-08-10,George Howard - Dancing In The Sun,47,47,51,47.0,47,Dancing In The Sun,3.0,3,-4,0,0,1,down,1985-07-20
28134,George Clinton,1985-07-27,George Clinton - Some Of My Best Jokes Are Friends,51,51,23,17.0,28,Some Of My Best Jokes Are Friends,12.0,0,5,23,0,1,up,1985-07-27
28135,George Clinton,1985-08-03,George Clinton - Some Of My Best Jokes Are Friends,28,51,21,17.0,23,Some Of My Best Jokes Are Friends,12.0,1,2,5,23,1,up,1985-07-27
28136,George Clinton,1985-08-10,George Clinton - Some Of My Best Jokes Are Friends,23,28,20,17.0,21,Some Of My Best Jokes Are Friends,12.0,2,1,2,5,1,up,1985-07-27
28137,George Clinton,1985-08-17,George Clinton - Some Of My Best Jokes Are Friends,21,23,17,17.0,20,Some Of My Best Jokes Are Friends,12.0,3,3,1,2,1,up,1985-07-27
28138,George Clinton,1985-08-24,George Clinton - Some Of My Best Jokes Are Friends,20,21,17,17.0,17,Some Of My Best Jokes Are Friends,12.0,4,0,3,1,0,stay,1985-07-27
28139,George Clinton,1985-08-31,George Clinton - Some Of My Best Jokes Are Friends,17,20,23,17.0,17,Some Of My Best Jokes Are Friends,12.0,5,-6,0,3,1,down,1985-07-27
28140,George Clinton,1985-09-07,George Clinton - Some Of My Best Jokes Are Friends,17,17,31,17.0,23,Some Of My Best Jokes Are Friends,12.0,6,-8,-6,0,1,down,1985-07-27
28141,George Clinton,1985-09-14,George Clinton - Some Of My Best Jokes Are Friends,23,17,34,17.0,31,Some Of My Best Jokes Are Friends,12.0,7,-3,-8,-6,1,down,1985-07-27
28142,George Clinton,1985-09-21,George Clinton - Some Of My Best Jokes Are Friends,31,23,34,17.0,34,Some Of My Best Jokes Are Friends,12.0,8,0,-3,-8,0,stay,1985-07-27
28143,George Clinton,1985-09-28,George Clinton - Some Of My Best Jokes Are Friends,34,31,38,17.0,34,Some Of My Best Jokes Are Friends,12.0,9,-4,0,-3,1,down,1985-07-27
28144,George Clinton,1985-10-05,George Clinton - Some Of My Best Jokes Are Friends,34,34,41,17.0,38,Some Of My Best Jokes Are Friends,12.0,10,-3,-4,0,1,down,1985-07-27
28145,George Clinton,1985-10-12,George Clinton - Some Of My Best Jokes Are Friends,38,34,48,17.0,41,Some Of My Best Jokes Are Friends,12.0,11,-7,-3,-4,1,down,1985-07-27
28146,George Clinton,1985-10-19,George Clinton - Some Of My Best Jokes Are Friends,41,38,51,17.0,48,Some Of My Best Jokes Are Friends,12.0,12,-3,-7,-3,1,down,1985-07-27
28147,Aretha Franklin,1985-07-27,Aretha Franklin - Who's Zoomin' Who,51,51,19,3.0,30,Who's Zoomin' Who,22.0,0,11,21,0,1,up,1985-07-27
28148,Aretha Franklin,1985-08-03,Aretha Franklin - Who's Zoomin' Who,30,51,12,3.0,19,Who's Zoomin' Who,22.0,1,7,11,21,1,up,1985-07-27
28149,Aretha Franklin,1985-08-10,Aretha Franklin - Who's Zoomin' Who,19,30,6,3.0,12,Who's Zoomin' Who,22.0,2,6,7,11,1,up,1985-07-27
28150,Aretha Franklin,1985-08-17,Aretha Franklin - Who's Zoomin' Who,12,19,5,3.0,6,Who's Zoomin' Who,22.0,3,1,6,7,1,up,1985-07-27
28151,Aretha Franklin,1985-08-24,Aretha Franklin - Who's Zoomin' Who,6,12,4,3.0,5,Who's Zoomin' Who,22.0,4,1,1,6,1,up,1985-07-27
28152,Aretha Franklin,1985-08-31,Aretha Franklin - Who's Zoomin' Who,5,6,4,3.0,4,Who's Zoomin' Who,22.0,5,0,1,1,0,stay,1985-07-27
28153,Aretha Franklin,1985-09-07,Aretha Franklin - Who's Zoomin' Who,4,5,4,3.0,4,Who's Zoomin' Who,22.0,6,0,0,1,0,stay,1985-07-27
28154,Aretha Franklin,1985-09-14,Aretha Franklin - Who's Zoomin' Who,4,4,5,3.0,4,Who's Zoomin' Who,22.0,7,-1,0,0,1,down,1985-07-27
28155,Aretha Franklin,1985-09-21,Aretha Franklin - Who's Zoomin' Who,4,4,5,3.0,5,Who's Zoomin' Who,22.0,8,0,-1,0,0,stay,1985-07-27
28156,Aretha Franklin,1985-09-28,Aretha Franklin - Who's Zoomin' Who,5,4,5,3.0,5,Who's Zoomin' Who,22.0,9,0,0,-1,0,stay,1985-07-27
28157,Aretha Franklin,1985-10-05,Aretha Franklin - Who's Zoomin' Who,5,5,5,3.0,5,Who's Zoomin' Who,22.0,10,0,0,0,0,stay,1985-07-27
28158,Aretha Franklin,1985-10-12,Aretha Franklin - Who's Zoomin' Who,5,5,6,3.0,5,Who's Zoomin' Who,22.0,11,-1,0,0,1,down,1985-07-27
28159,Aretha Franklin,1985-10-19,Aretha Franklin - Who's Zoomin' Who,5,5,7,3.0,6,Who's Zoomin' Who,22.0,12,-1,-1,0,1,down,1985-07-27
28160,Aretha Franklin,1985-10-26,Aretha Franklin - Who's Zoomin' Who,6,5,7,3.0,7,Who's Zoomin' Who,22.0,13,0,-1,-1,0,stay,1985-07-27
28161,Aretha Franklin,1985-11-02,Aretha Franklin - Who's Zoomin' Who,7,6,6,3.0,7,Who's Zoomin' Who,22.0,14,1,0,-1,1,up,1985-07-27
28162,Aretha Franklin,1985-11-09,Aretha Franklin - Who's Zoomin' Who,7,7,6,3.0,6,Who's Zoomin' Who,22.0,15,0,1,0,0,stay,1985-07-27
28163,Aretha Franklin,1985-11-16,Aretha Franklin - Who's Zoomin' Who,6,7,4,3.0,6,Who's Zoomin' Who,22.0,16,2,0,1,1,up,1985-07-27
28164,Aretha Franklin,1985-11-23,Aretha Franklin - Who's Zoomin' Who,6,6,3,3.0,4,Who's Zoomin' Who,22.0,17,1,2,0,1,up,1985-07-27
28165,Aretha Franklin,1985-11-30,Aretha Franklin - Who's Zoomin' Who,4,6,3,3.0,3,Who's Zoomin' Who,22.0,18,0,1,2,0,stay,1985-07-27
28166,Aretha Franklin,1985-12-07,Aretha Franklin - Who's Zoomin' Who,3,4,3,3.0,3,Who's Zoomin' Who,22.0,19,0,0,1,0,stay,1985-07-27
28167,Aretha Franklin,1985-12-14,Aretha Franklin - Who's Zoomin' Who,3,3,4,3.0,3,Who's Zoomin' Who,22.0,20,-1,0,0,1,down,1985-07-27
28168,Aretha Franklin,1985-12-21,Aretha Franklin - Who's Zoomin' Who,3,3,4,3.0,4,Who's Zoomin' Who,22.0,21,0,-1,0,0,stay,1985-07-27
28169,Aretha Franklin,1985-12-28,Aretha Franklin - Who's Zoomin' Who,4,3,51,3.0,4,Who's Zoomin' Who,22.0,22,-47,0,-1,1,down,1985-07-27
28170,Peabo Bryson,1985-07-27,Peabo Bryson - Take No Prisoners,51,51,40,40.0,43,Take No Prisoners,2.0,0,3,8,0,1,up,1985-07-27
28171,Peabo Bryson,1985-08-03,Peabo Bryson - Take No Prisoners,43,51,40,40.0,40,Take No Prisoners,2.0,1,0,3,8,0,stay,1985-07-27
28172,Peabo Bryson,1985-08-10,Peabo Bryson - Take No Prisoners,40,43,51,40.0,40,Take No Prisoners,2.0,2,-11,0,3,1,down,1985-07-27
28173,Spyro Gyra,1985-08-03,Spyro Gyra - Alternating Currents,51,51,45,41.0,48,Alternating Currents,6.0,0,3,3,0,1,up,1985-08-03
28174,Spyro Gyra,1985-08-10,Spyro Gyra - Alternating Currents,48,51,42,41.0,45,Alternating Currents,6.0,1,3,3,3,1,up,1985-08-03
28175,Spyro Gyra,1985-08-17,Spyro Gyra - Alternating Currents,45,48,42,41.0,42,Alternating Currents,6.0,2,0,3,3,0,stay,1985-08-03
28176,Spyro Gyra,1985-08-24,Spyro Gyra - Alternating Currents,42,45,41,41.0,42,Alternating Currents,6.0,3,1,0,3,1,up,1985-08-03
28177,Spyro Gyra,1985-08-31,Spyro Gyra - Alternating Currents,42,42,41,41.0,41,Alternating Currents,6.0,4,0,1,0,0,stay,1985-08-03
28178,Spyro Gyra,1985-09-07,Spyro Gyra - Alternating Currents,41,42,47,41.0,41,Alternating Currents,6.0,5,-6,0,1,1,down,1985-08-03
28179,Spyro Gyra,1985-09-14,Spyro Gyra - Alternating Currents,41,41,51,41.0,47,Alternating Currents,6.0,6,-4,-6,0,1,down,1985-08-03
28180,Dennis Edwards,1985-08-10,Dennis Edwards - Coolin' Out,51,51,38,36.0,38,Coolin' Out,14.0,0,0,13,0,0,stay,1985-08-10
28181,Dennis Edwards,1985-08-17,Dennis Edwards - Coolin' Out,38,51,37,36.0,38,Coolin' Out,14.0,1,1,0,13,1,up,1985-08-10
28182,Dennis Edwards,1985-08-24,Dennis Edwards - Coolin' Out,38,38,50,36.0,37,Coolin' Out,14.0,2,-13,1,0,1,down,1985-08-10
28183,Dennis Edwards,1985-09-07,Dennis Edwards - Coolin' Out,37,38,42,36.0,50,Coolin' Out,14.0,3,8,-13,1,1,up,1985-08-10
28184,Dennis Edwards,1985-09-14,Dennis Edwards - Coolin' Out,50,37,39,36.0,42,Coolin' Out,14.0,4,3,8,-13,1,up,1985-08-10
28185,Dennis Edwards,1985-09-21,Dennis Edwards - Coolin' Out,42,50,37,36.0,39,Coolin' Out,14.0,5,2,3,8,1,up,1985-08-10
28186,Dennis Edwards,1985-09-28,Dennis Edwards - Coolin' Out,39,42,37,36.0,37,Coolin' Out,14.0,6,0,2,3,0,stay,1985-08-10
28187,Dennis Edwards,1985-10-05,Dennis Edwards - Coolin' Out,37,39,36,36.0,37,Coolin' Out,14.0,7,1,0,2,1,up,1985-08-10
28188,Dennis Edwards,1985-10-12,Dennis Edwards - Coolin' Out,37,37,36,36.0,36,Coolin' Out,14.0,8,0,1,0,0,stay,1985-08-10
28189,Dennis Edwards,1985-10-19,Dennis Edwards - Coolin' Out,36,37,38,36.0,36,Coolin' Out,14.0,9,-2,0,1,1,down,1985-08-10
28190,Dennis Edwards,1985-10-26,Dennis Edwards - Coolin' Out,36,36,45,36.0,38,Coolin' Out,14.0,10,-7,-2,0,1,down,1985-08-10
28191,Dennis Edwards,1985-11-02,Dennis Edwards - Coolin' Out,38,36,45,36.0,45,Coolin' Out,14.0,11,0,-7,-2,0,stay,1985-08-10
28192,Dennis Edwards,1985-11-09,Dennis Edwards - Coolin' Out,45,38,45,36.0,45,Coolin' Out,14.0,12,0,0,-7,0,stay,1985-08-10
28193,Dennis Edwards,1985-11-16,Dennis Edwards - Coolin' Out,45,45,49,36.0,45,Coolin' Out,14.0,13,-4,0,0,1,down,1985-08-10
28194,Dennis Edwards,1985-11-23,Dennis Edwards - Coolin' Out,45,45,51,36.0,49,Coolin' Out,14.0,14,-2,-4,0,1,down,1985-08-10
28195,One Way,1985-08-10,One Way - Wrap Your Body,51,51,40,28.0,48,Wrap Your Body,9.0,0,8,3,0,1,up,1985-08-10
28196,One Way,1985-08-17,One Way - Wrap Your Body,48,51,33,28.0,40,Wrap Your Body,9.0,1,7,8,3,1,up,1985-08-10
28197,One Way,1985-08-24,One Way - Wrap Your Body,40,48,32,28.0,33,Wrap Your Body,9.0,2,1,7,8,1,up,1985-08-10
28198,One Way,1985-08-31,One Way - Wrap Your Body,33,40,28,28.0,32,Wrap Your Body,9.0,3,4,1,7,1,up,1985-08-10
28199,One Way,1985-09-07,One Way - Wrap Your Body,32,33,28,28.0,28,Wrap Your Body,9.0,4,0,4,1,0,stay,1985-08-10
28200,One Way,1985-09-14,One Way - Wrap Your Body,28,32,35,28.0,28,Wrap Your Body,9.0,5,-7,0,4,1,down,1985-08-10
28201,One Way,1985-09-21,One Way - Wrap Your Body,28,28,39,28.0,35,Wrap Your Body,9.0,6,-4,-7,0,1,down,1985-08-10
28202,One Way,1985-09-28,One Way - Wrap Your Body,35,28,47,28.0,39,Wrap Your Body,9.0,7,-8,-4,-7,1,down,1985-08-10
28203,One Way,1985-10-05,One Way - Wrap Your Body,39,35,45,28.0,47,Wrap Your Body,9.0,8,2,-8,-4,1,up,1985-08-10
28204,One Way,1985-10-12,One Way - Wrap Your Body,47,39,51,28.0,45,Wrap Your Body,9.0,9,-6,2,-8,1,down,1985-08-10
28205,Fat Boys,1985-08-17,Fat Boys - The Fat Boys Are Back,51,51,22,11.0,37,The Fat Boys Are Back,19.0,0,15,14,0,1,up,1985-08-17
28206,Fat Boys,1985-08-24,Fat Boys - The Fat Boys Are Back,37,51,13,11.0,22,The Fat Boys Are Back,19.0,1,9,15,14,1,up,1985-08-17
28207,Fat Boys,1985-08-31,Fat Boys - The Fat Boys Are Back,22,37,11,11.0,13,The Fat Boys Are Back,19.0,2,2,9,15,1,up,1985-08-17
28208,Fat Boys,1985-09-07,Fat Boys - The Fat Boys Are Back,13,22,11,11.0,11,The Fat Boys Are Back,19.0,3,0,2,9,0,stay,1985-08-17
28209,Fat Boys,1985-09-14,Fat Boys - The Fat Boys Are Back,11,13,12,11.0,11,The Fat Boys Are Back,19.0,4,-1,0,2,1,down,1985-08-17
28210,Fat Boys,1985-09-21,Fat Boys - The Fat Boys Are Back,11,11,12,11.0,12,The Fat Boys Are Back,19.0,5,0,-1,0,0,stay,1985-08-17
28211,Fat Boys,1985-09-28,Fat Boys - The Fat Boys Are Back,12,11,13,11.0,12,The Fat Boys Are Back,19.0,6,-1,0,-1,1,down,1985-08-17
28212,Fat Boys,1985-10-05,Fat Boys - The Fat Boys Are Back,12,12,15,11.0,13,The Fat Boys Are Back,19.0,7,-2,-1,0,1,down,1985-08-17
28213,Fat Boys,1985-10-12,Fat Boys - The Fat Boys Are Back,13,12,26,11.0,15,The Fat Boys Are Back,19.0,8,-11,-2,-1,1,down,1985-08-17
28214,Fat Boys,1985-10-19,Fat Boys - The Fat Boys Are Back,15,13,29,11.0,26,The Fat Boys Are Back,19.0,9,-3,-11,-2,1,down,1985-08-17
28215,Fat Boys,1985-10-26,Fat Boys - The Fat Boys Are Back,26,15,29,11.0,29,The Fat Boys Are Back,19.0,10,0,-3,-11,0,stay,1985-08-17
28216,Fat Boys,1985-11-02,Fat Boys - The Fat Boys Are Back,29,26,39,11.0,29,The Fat Boys Are Back,19.0,11,-10,0,-3,1,down,1985-08-17
28217,Fat Boys,1985-11-09,Fat Boys - The Fat Boys Are Back,29,29,39,11.0,39,The Fat Boys Are Back,19.0,12,0,-10,0,0,stay,1985-08-17
28218,Fat Boys,1985-11-16,Fat Boys - The Fat Boys Are Back,39,29,39,11.0,39,The Fat Boys Are Back,19.0,13,0,0,-10,0,stay,1985-08-17
28219,Fat Boys,1985-11-23,Fat Boys - The Fat Boys Are Back,39,39,39,11.0,39,The Fat Boys Are Back,19.0,14,0,0,0,0,stay,1985-08-17
28220,Fat Boys,1985-11-30,Fat Boys - The Fat Boys Are Back,39,39,42,11.0,39,The Fat Boys Are Back,19.0,15,-3,0,0,1,down,1985-08-17
28221,Fat Boys,1985-12-07,Fat Boys - The Fat Boys Are Back,39,39,49,11.0,42,The Fat Boys Are Back,19.0,16,-7,-3,0,1,down,1985-08-17
28222,Fat Boys,1985-12-14,Fat Boys - The Fat Boys Are Back,42,39,48,11.0,49,The Fat Boys Are Back,19.0,17,1,-7,-3,1,up,1985-08-17
28223,Fat Boys,1985-12-21,Fat Boys - The Fat Boys Are Back,49,42,47,11.0,48,The Fat Boys Are Back,19.0,18,1,1,-7,1,up,1985-08-17
28224,Fat Boys,1985-12-28,Fat Boys - The Fat Boys Are Back,48,49,51,11.0,47,The Fat Boys Are Back,19.0,19,-4,1,1,1,down,1985-08-17
28225,The Pointer Sisters,1985-08-17,The Pointer Sisters - Contact,51,51,26,11.0,41,Contact,19.0,0,15,10,0,1,up,1985-08-17
28226,The Pointer Sisters,1985-08-24,The Pointer Sisters - Contact,41,51,25,11.0,26,Contact,19.0,1,1,15,10,1,up,1985-08-17
28227,The Pointer Sisters,1985-08-31,The Pointer Sisters - Contact,26,41,18,11.0,25,Contact,19.0,2,7,1,15,1,up,1985-08-17
28228,The Pointer Sisters,1985-09-07,The Pointer Sisters - Contact,25,26,18,11.0,18,Contact,19.0,3,0,7,1,0,stay,1985-08-17
28229,The Pointer Sisters,1985-09-14,The Pointer Sisters - Contact,18,25,17,11.0,18,Contact,19.0,4,1,0,7,1,up,1985-08-17
28230,The Pointer Sisters,1985-09-21,The Pointer Sisters - Contact,18,18,17,11.0,17,Contact,19.0,5,0,1,0,0,stay,1985-08-17
28231,The Pointer Sisters,1985-09-28,The Pointer Sisters - Contact,17,18,15,11.0,17,Contact,19.0,6,2,0,1,1,up,1985-08-17
28232,The Pointer Sisters,1985-10-05,The Pointer Sisters - Contact,17,17,11,11.0,15,Contact,19.0,7,4,2,0,1,up,1985-08-17
28233,The Pointer Sisters,1985-10-12,The Pointer Sisters - Contact,15,17,11,11.0,11,Contact,19.0,8,0,4,2,0,stay,1985-08-17
28234,The Pointer Sisters,1985-10-19,The Pointer Sisters - Contact,11,15,16,11.0,11,Contact,19.0,9,-5,0,4,1,down,1985-08-17
28235,The Pointer Sisters,1985-10-26,The Pointer Sisters - Contact,11,11,23,11.0,16,Contact,19.0,10,-7,-5,0,1,down,1985-08-17
28236,The Pointer Sisters,1985-11-02,The Pointer Sisters - Contact,16,11,24,11.0,23,Contact,19.0,11,-1,-7,-5,1,down,1985-08-17
28237,The Pointer Sisters,1985-11-09,The Pointer Sisters - Contact,23,16,29,11.0,24,Contact,19.0,12,-5,-1,-7,1,down,1985-08-17
28238,The Pointer Sisters,1985-11-16,The Pointer Sisters - Contact,24,23,29,11.0,29,Contact,19.0,13,0,-5,-1,0,stay,1985-08-17
28239,The Pointer Sisters,1985-11-23,The Pointer Sisters - Contact,29,24,30,11.0,29,Contact,19.0,14,-1,0,-5,1,down,1985-08-17
28240,The Pointer Sisters,1985-11-30,The Pointer Sisters - Contact,29,29,35,11.0,30,Contact,19.0,15,-5,-1,0,1,down,1985-08-17
28241,The Pointer Sisters,1985-12-07,The Pointer Sisters - Contact,30,29,37,11.0,35,Contact,19.0,16,-2,-5,-1,1,down,1985-08-17
28242,The Pointer Sisters,1985-12-14,The Pointer Sisters - Contact,35,30,37,11.0,37,Contact,19.0,17,0,-2,-5,0,stay,1985-08-17
28243,The Pointer Sisters,1985-12-21,The Pointer Sisters - Contact,37,35,37,11.0,37,Contact,19.0,18,0,0,-2,0,stay,1985-08-17
28244,The Pointer Sisters,1985-12-28,The Pointer Sisters - Contact,37,37,51,11.0,37,Contact,19.0,19,-14,0,0,1,down,1985-08-17
28245,Dr. J.R. Kool & The Other Roxannes,1985-08-17,Dr. J.R. Kool & The Other Roxannes - The Complete Story Of Roxanne,51,51,23,23.0,45,The Complete Story Of Roxanne,4.0,0,22,6,0,1,up,1985-08-17
28246,Dr. J.R. Kool & The Other Roxannes,1985-08-24,Dr. J.R. Kool & The Other Roxannes - The Complete Story Of Roxanne,45,51,23,23.0,23,The Complete Story Of Roxanne,4.0,1,0,22,6,0,stay,1985-08-17
28247,Dr. J.R. Kool & The Other Roxannes,1985-08-31,Dr. J.R. Kool & The Other Roxannes - The Complete Story Of Roxanne,23,45,37,23.0,23,The Complete Story Of Roxanne,4.0,2,-14,0,22,1,down,1985-08-17
28248,Dr. J.R. Kool & The Other Roxannes,1985-09-07,Dr. J.R. Kool & The Other Roxannes - The Complete Story Of Roxanne,23,23,37,23.0,37,The Complete Story Of Roxanne,4.0,3,0,-14,0,0,stay,1985-08-17
28249,Dr. J.R. Kool & The Other Roxannes,1985-09-14,Dr. J.R. Kool & The Other Roxannes - The Complete Story Of Roxanne,37,23,51,23.0,37,The Complete Story Of Roxanne,4.0,4,-14,0,-14,1,down,1985-08-17
28250,Gwen Guthrie,1985-08-17,Gwen Guthrie - Padlock,51,51,47,47.0,48,Padlock,1.0,0,1,3,0,1,up,1985-08-17
28251,Gwen Guthrie,1985-08-24,Gwen Guthrie - Padlock,48,51,51,47.0,47,Padlock,1.0,1,-4,1,3,1,down,1985-08-17
28252,Carrie Lucas,1985-08-17,Carrie Lucas - Horsin' Around,51,51,50,40.0,50,Horsin' Around,6.0,0,0,1,0,0,stay,1985-08-17
28253,Carrie Lucas,1985-08-24,Carrie Lucas - Horsin' Around,50,51,44,40.0,50,Horsin' Around,6.0,1,6,0,1,1,up,1985-08-17
28254,Carrie Lucas,1985-08-31,Carrie Lucas - Horsin' Around,50,50,40,40.0,44,Horsin' Around,6.0,2,4,6,0,1,up,1985-08-17
28255,Carrie Lucas,1985-09-07,Carrie Lucas - Horsin' Around,44,50,40,40.0,40,Horsin' Around,6.0,3,0,4,6,0,stay,1985-08-17
28256,Carrie Lucas,1985-09-14,Carrie Lucas - Horsin' Around,40,44,44,40.0,40,Horsin' Around,6.0,4,-4,0,4,1,down,1985-08-17
28257,Carrie Lucas,1985-09-21,Carrie Lucas - Horsin' Around,40,40,45,40.0,44,Horsin' Around,6.0,5,-1,-4,0,1,down,1985-08-17
28258,Carrie Lucas,1985-09-28,Carrie Lucas - Horsin' Around,44,40,51,40.0,45,Horsin' Around,6.0,6,-6,-1,-4,1,down,1985-08-17
28259,Patti LaBelle,1985-08-24,Patti LaBelle - Patti,51,51,26,13.0,30,Patti,18.0,0,4,21,0,1,up,1985-08-24
28260,Patti LaBelle,1985-08-31,Patti LaBelle - Patti,30,51,20,13.0,26,Patti,18.0,1,6,4,21,1,up,1985-08-24
28261,Patti LaBelle,1985-09-07,Patti LaBelle - Patti,26,30,17,13.0,20,Patti,18.0,2,3,6,4,1,up,1985-08-24
28262,Patti LaBelle,1985-09-14,Patti LaBelle - Patti,20,26,14,13.0,17,Patti,18.0,3,3,3,6,1,up,1985-08-24
28263,Patti LaBelle,1985-09-21,Patti LaBelle - Patti,17,20,14,13.0,14,Patti,18.0,4,0,3,3,0,stay,1985-08-24
28264,Patti LaBelle,1985-09-28,Patti LaBelle - Patti,14,17,14,13.0,14,Patti,18.0,5,0,0,3,0,stay,1985-08-24
28265,Patti LaBelle,1985-10-05,Patti LaBelle - Patti,14,14,13,13.0,14,Patti,18.0,6,1,0,0,1,up,1985-08-24
28266,Patti LaBelle,1985-10-12,Patti LaBelle - Patti,14,14,13,13.0,13,Patti,18.0,7,0,1,0,0,stay,1985-08-24
28267,Patti LaBelle,1985-10-19,Patti LaBelle - Patti,13,14,13,13.0,13,Patti,18.0,8,0,0,1,0,stay,1985-08-24
28268,Patti LaBelle,1985-10-26,Patti LaBelle - Patti,13,13,13,13.0,13,Patti,18.0,9,0,0,0,0,stay,1985-08-24
28269,Patti LaBelle,1985-11-02,Patti LaBelle - Patti,13,13,17,13.0,13,Patti,18.0,10,-4,0,0,1,down,1985-08-24
28270,Patti LaBelle,1985-11-09,Patti LaBelle - Patti,13,13,17,13.0,17,Patti,18.0,11,0,-4,0,0,stay,1985-08-24
28271,Patti LaBelle,1985-11-16,Patti LaBelle - Patti,17,13,19,13.0,17,Patti,18.0,12,-2,0,-4,1,down,1985-08-24
28272,Patti LaBelle,1985-11-23,Patti LaBelle - Patti,17,17,21,13.0,19,Patti,18.0,13,-2,-2,0,1,down,1985-08-24
28273,Patti LaBelle,1985-11-30,Patti LaBelle - Patti,19,17,23,13.0,21,Patti,18.0,14,-2,-2,-2,1,down,1985-08-24
28274,Patti LaBelle,1985-12-07,Patti LaBelle - Patti,21,19,29,13.0,23,Patti,18.0,15,-6,-2,-2,1,down,1985-08-24
28275,Patti LaBelle,1985-12-14,Patti LaBelle - Patti,23,21,23,13.0,29,Patti,18.0,16,6,-6,-2,1,up,1985-08-24
28276,Patti LaBelle,1985-12-21,Patti LaBelle - Patti,29,23,23,13.0,23,Patti,18.0,17,0,6,-6,0,stay,1985-08-24
28277,Patti LaBelle,1985-12-28,Patti LaBelle - Patti,23,29,51,13.0,23,Patti,18.0,18,-28,0,6,1,down,1985-08-24
28278,Sting,1985-08-24,Sting - Dream Of The Blue Turtles,51,51,35,35.0,35,Dream Of The Blue Turtles,7.0,0,0,16,0,0,stay,1985-08-24
28279,Sting,1985-08-31,Sting - Dream Of The Blue Turtles,35,51,35,35.0,35,Dream Of The Blue Turtles,7.0,1,0,0,16,0,stay,1985-08-24
28280,Sting,1985-09-07,Sting - Dream Of The Blue Turtles,35,35,35,35.0,35,Dream Of The Blue Turtles,7.0,2,0,0,0,0,stay,1985-08-24
28281,Sting,1985-09-14,Sting - Dream Of The Blue Turtles,35,35,42,35.0,35,Dream Of The Blue Turtles,7.0,3,-7,0,0,1,down,1985-08-24
28282,Sting,1985-09-21,Sting - Dream Of The Blue Turtles,35,35,42,35.0,42,Dream Of The Blue Turtles,7.0,4,0,-7,0,0,stay,1985-08-24
28283,Sting,1985-09-28,Sting - Dream Of The Blue Turtles,42,35,45,35.0,42,Dream Of The Blue Turtles,7.0,5,-3,0,-7,1,down,1985-08-24
28284,Sting,1985-10-05,Sting - Dream Of The Blue Turtles,42,42,46,35.0,45,Dream Of The Blue Turtles,7.0,6,-1,-3,0,1,down,1985-08-24
28285,Sting,1985-10-12,Sting - Dream Of The Blue Turtles,45,42,51,35.0,46,Dream Of The Blue Turtles,7.0,7,-5,-1,-3,1,down,1985-08-24
28286,The System,1985-08-24,The System - The Pleasure Seekers,51,51,48,40.0,48,The Pleasure Seekers,9.0,0,0,3,0,0,stay,1985-08-24
28287,The System,1985-08-31,The System - The Pleasure Seekers,48,51,45,40.0,48,The Pleasure Seekers,9.0,1,3,0,3,1,up,1985-08-24
28288,The System,1985-09-07,The System - The Pleasure Seekers,48,48,45,40.0,45,The Pleasure Seekers,9.0,2,0,3,0,0,stay,1985-08-24
28289,The System,1985-09-14,The System - The Pleasure Seekers,45,48,50,40.0,45,The Pleasure Seekers,9.0,3,-5,0,3,1,down,1985-08-24
28290,The System,1985-10-19,The System - The Pleasure Seekers,45,45,49,40.0,50,The Pleasure Seekers,9.0,4,1,-5,0,1,up,1985-08-24
28291,The System,1985-10-26,The System - The Pleasure Seekers,50,45,40,40.0,49,The Pleasure Seekers,9.0,5,9,1,-5,1,up,1985-08-24
28292,The System,1985-11-23,The System - The Pleasure Seekers,49,50,40,40.0,40,The Pleasure Seekers,9.0,6,0,9,1,0,stay,1985-08-24
28293,The System,1985-11-30,The System - The Pleasure Seekers,40,49,47,40.0,40,The Pleasure Seekers,9.0,7,-7,0,9,1,down,1985-08-24
28294,The System,1985-12-07,The System - The Pleasure Seekers,40,40,46,40.0,47,The Pleasure Seekers,9.0,8,1,-7,0,1,up,1985-08-24
28295,The System,1985-12-14,The System - The Pleasure Seekers,47,40,51,40.0,46,The Pleasure Seekers,9.0,9,-5,1,-7,1,down,1985-08-24
28296,Starpoint,1985-08-31,Starpoint - Restless,51,51,30,15.0,33,Restless,17.0,0,3,18,0,1,up,1985-08-31
28297,Starpoint,1985-09-07,Starpoint - Restless,33,51,26,15.0,30,Restless,17.0,1,4,3,18,1,up,1985-08-31
28298,Starpoint,1985-09-14,Starpoint - Restless,30,33,23,15.0,26,Restless,17.0,2,3,4,3,1,up,1985-08-31
28299,Starpoint,1985-09-21,Starpoint - Restless,26,30,23,15.0,23,Restless,17.0,3,0,3,4,0,stay,1985-08-31
28300,Starpoint,1985-09-28,Starpoint - Restless,23,26,29,15.0,23,Restless,17.0,4,-6,0,3,1,down,1985-08-31
28301,Starpoint,1985-10-05,Starpoint - Restless,23,23,23,15.0,29,Restless,17.0,5,6,-6,0,1,up,1985-08-31
28302,Starpoint,1985-10-12,Starpoint - Restless,29,23,19,15.0,23,Restless,17.0,6,4,6,-6,1,up,1985-08-31
28303,Starpoint,1985-10-19,Starpoint - Restless,23,29,17,15.0,19,Restless,17.0,7,2,4,6,1,up,1985-08-31
28304,Starpoint,1985-10-26,Starpoint - Restless,19,23,16,15.0,17,Restless,17.0,8,1,2,4,1,up,1985-08-31
28305,Starpoint,1985-11-02,Starpoint - Restless,17,19,16,15.0,16,Restless,17.0,9,0,1,2,0,stay,1985-08-31
28306,Starpoint,1985-11-09,Starpoint - Restless,16,17,19,15.0,16,Restless,17.0,10,-3,0,1,1,down,1985-08-31
28307,Starpoint,1985-11-16,Starpoint - Restless,16,16,15,15.0,19,Restless,17.0,11,4,-3,0,1,up,1985-08-31
28308,Starpoint,1985-11-23,Starpoint - Restless,19,16,15,15.0,15,Restless,17.0,12,0,4,-3,0,stay,1985-08-31
28309,Starpoint,1985-11-30,Starpoint - Restless,15,19,17,15.0,15,Restless,17.0,13,-2,0,4,1,down,1985-08-31
28310,Starpoint,1985-12-07,Starpoint - Restless,15,15,17,15.0,17,Restless,17.0,14,0,-2,0,0,stay,1985-08-31
28311,Starpoint,1985-12-14,Starpoint - Restless,17,15,17,15.0,17,Restless,17.0,15,0,0,-2,0,stay,1985-08-31
28312,Starpoint,1985-12-21,Starpoint - Restless,17,17,17,15.0,17,Restless,17.0,16,0,0,0,0,stay,1985-08-31
28313,Starpoint,1985-12-28,Starpoint - Restless,17,17,51,15.0,17,Restless,17.0,17,-34,0,0,1,down,1985-08-31
28314,Boogie Boys,1985-08-31,Boogie Boys - City Life,51,51,21,10.0,36,City Life,17.0,0,15,15,0,1,up,1985-08-31
28315,Boogie Boys,1985-09-07,Boogie Boys - City Life,36,51,15,10.0,21,City Life,17.0,1,6,15,15,1,up,1985-08-31
28316,Boogie Boys,1985-09-14,Boogie Boys - City Life,21,36,13,10.0,15,City Life,17.0,2,2,6,15,1,up,1985-08-31
28317,Boogie Boys,1985-09-21,Boogie Boys - City Life,15,21,13,10.0,13,City Life,17.0,3,0,2,6,0,stay,1985-08-31
28318,Boogie Boys,1985-09-28,Boogie Boys - City Life,13,15,10,10.0,13,City Life,17.0,4,3,0,2,1,up,1985-08-31
28319,Boogie Boys,1985-10-05,Boogie Boys - City Life,13,13,10,10.0,10,City Life,17.0,5,0,3,0,0,stay,1985-08-31
28320,Boogie Boys,1985-10-12,Boogie Boys - City Life,10,13,10,10.0,10,City Life,17.0,6,0,0,3,0,stay,1985-08-31
28321,Boogie Boys,1985-10-19,Boogie Boys - City Life,10,10,10,10.0,10,City Life,17.0,7,0,0,0,0,stay,1985-08-31
28322,Boogie Boys,1985-10-26,Boogie Boys - City Life,10,10,10,10.0,10,City Life,17.0,8,0,0,0,0,stay,1985-08-31
28323,Boogie Boys,1985-11-02,Boogie Boys - City Life,10,10,10,10.0,10,City Life,17.0,9,0,0,0,0,stay,1985-08-31
28324,Boogie Boys,1985-11-09,Boogie Boys - City Life,10,10,10,10.0,10,City Life,17.0,10,0,0,0,0,stay,1985-08-31
28325,Boogie Boys,1985-11-16,Boogie Boys - City Life,10,10,14,10.0,10,City Life,17.0,11,-4,0,0,1,down,1985-08-31
28326,Boogie Boys,1985-11-23,Boogie Boys - City Life,10,10,16,10.0,14,City Life,17.0,12,-2,-4,0,1,down,1985-08-31
28327,Boogie Boys,1985-11-30,Boogie Boys - City Life,14,10,18,10.0,16,City Life,17.0,13,-2,-2,-4,1,down,1985-08-31
28328,Boogie Boys,1985-12-07,Boogie Boys - City Life,16,14,21,10.0,18,City Life,17.0,14,-3,-2,-2,1,down,1985-08-31
28329,Boogie Boys,1985-12-14,Boogie Boys - City Life,18,16,31,10.0,21,City Life,17.0,15,-10,-3,-2,1,down,1985-08-31
28330,Boogie Boys,1985-12-21,Boogie Boys - City Life,21,18,33,10.0,31,City Life,17.0,16,-2,-10,-3,1,down,1985-08-31
28331,Boogie Boys,1985-12-28,Boogie Boys - City Life,31,21,51,10.0,33,City Life,17.0,17,-18,-2,-10,1,down,1985-08-31
28332,Dazz Band,1985-08-31,Dazz Band - Hot Spot,51,51,33,24.0,47,Hot Spot,8.0,0,14,4,0,1,up,1985-08-31
28333,Dazz Band,1985-09-07,Dazz Band - Hot Spot,47,51,30,24.0,33,Hot Spot,8.0,1,3,14,4,1,up,1985-08-31
28334,Dazz Band,1985-09-14,Dazz Band - Hot Spot,33,47,26,24.0,30,Hot Spot,8.0,2,4,3,14,1,up,1985-08-31
28335,Dazz Band,1985-09-21,Dazz Band - Hot Spot,30,33,24,24.0,26,Hot Spot,8.0,3,2,4,3,1,up,1985-08-31
28336,Dazz Band,1985-09-28,Dazz Band - Hot Spot,26,30,24,24.0,24,Hot Spot,8.0,4,0,2,4,0,stay,1985-08-31
28337,Dazz Band,1985-10-05,Dazz Band - Hot Spot,24,26,32,24.0,24,Hot Spot,8.0,5,-8,0,2,1,down,1985-08-31
28338,Dazz Band,1985-10-12,Dazz Band - Hot Spot,24,24,32,24.0,32,Hot Spot,8.0,6,0,-8,0,0,stay,1985-08-31
28339,Dazz Band,1985-10-19,Dazz Band - Hot Spot,32,24,44,24.0,32,Hot Spot,8.0,7,-12,0,-8,1,down,1985-08-31
28340,Dazz Band,1985-10-26,Dazz Band - Hot Spot,32,32,51,24.0,44,Hot Spot,8.0,8,-7,-12,0,1,down,1985-08-31
28341,Newcleus,1985-08-31,Newcleus - Space Is The Place,51,51,46,43.0,50,Space Is The Place,3.0,0,4,1,0,1,up,1985-08-31
28342,Newcleus,1985-09-07,Newcleus - Space Is The Place,50,51,43,43.0,46,Space Is The Place,3.0,1,3,4,1,1,up,1985-08-31
28343,Newcleus,1985-09-14,Newcleus - Space Is The Place,46,50,43,43.0,43,Space Is The Place,3.0,2,0,3,4,0,stay,1985-08-31
28344,Newcleus,1985-09-21,Newcleus - Space Is The Place,43,46,51,43.0,43,Space Is The Place,3.0,3,-8,0,3,1,down,1985-08-31
28345,9.9,1985-09-07,9.9 - 9.9,51,51,29,15.0,32,9.9,16.0,0,3,19,0,1,up,1985-09-07
28346,9.9,1985-09-14,9.9 - 9.9,32,51,25,15.0,29,9.9,16.0,1,4,3,19,1,up,1985-09-07
28347,9.9,1985-09-21,9.9 - 9.9,29,32,25,15.0,25,9.9,16.0,2,0,4,3,0,stay,1985-09-07
28348,9.9,1985-09-28,9.9 - 9.9,25,29,21,15.0,25,9.9,16.0,3,4,0,4,1,up,1985-09-07
28349,9.9,1985-10-05,9.9 - 9.9,25,25,18,15.0,21,9.9,16.0,4,3,4,0,1,up,1985-09-07
28350,9.9,1985-10-12,9.9 - 9.9,21,25,18,15.0,18,9.9,16.0,5,0,3,4,0,stay,1985-09-07
28351,9.9,1985-10-19,9.9 - 9.9,18,21,15,15.0,18,9.9,16.0,6,3,0,3,1,up,1985-09-07
28352,9.9,1985-10-26,9.9 - 9.9,18,18,15,15.0,15,9.9,16.0,7,0,3,0,0,stay,1985-09-07
28353,9.9,1985-11-02,9.9 - 9.9,15,18,23,15.0,15,9.9,16.0,8,-8,0,3,1,down,1985-09-07
28354,9.9,1985-11-09,9.9 - 9.9,15,15,24,15.0,23,9.9,16.0,9,-1,-8,0,1,down,1985-09-07
28355,9.9,1985-11-16,9.9 - 9.9,23,15,30,15.0,24,9.9,16.0,10,-6,-1,-8,1,down,1985-09-07
28356,9.9,1985-11-23,9.9 - 9.9,24,23,38,15.0,30,9.9,16.0,11,-8,-6,-1,1,down,1985-09-07
28357,9.9,1985-11-30,9.9 - 9.9,30,24,40,15.0,38,9.9,16.0,12,-2,-8,-6,1,down,1985-09-07
28358,9.9,1985-12-07,9.9 - 9.9,38,30,40,15.0,40,9.9,16.0,13,0,-2,-8,0,stay,1985-09-07
28359,9.9,1985-12-14,9.9 - 9.9,40,38,47,15.0,40,9.9,16.0,14,-7,0,-2,1,down,1985-09-07
28360,9.9,1985-12-21,9.9 - 9.9,40,40,39,15.0,47,9.9,16.0,15,8,-7,0,1,up,1985-09-07
28361,9.9,1985-12-28,9.9 - 9.9,47,40,51,15.0,39,9.9,16.0,16,-12,8,-7,1,down,1985-09-07
28362,The Family,1985-09-07,The Family - The Family,51,51,24,17.0,42,The Family,16.0,0,18,9,0,1,up,1985-09-07
28363,The Family,1985-09-14,The Family - The Family,42,51,20,17.0,24,The Family,16.0,1,4,18,9,1,up,1985-09-07
28364,The Family,1985-09-21,The Family - The Family,24,42,19,17.0,20,The Family,16.0,2,1,4,18,1,up,1985-09-07
28365,The Family,1985-09-28,The Family - The Family,20,24,18,17.0,19,The Family,16.0,3,1,1,4,1,up,1985-09-07
28366,The Family,1985-10-05,The Family - The Family,19,20,17,17.0,18,The Family,16.0,4,1,1,1,1,up,1985-09-07
28367,The Family,1985-10-12,The Family - The Family,18,19,17,17.0,17,The Family,16.0,5,0,1,1,0,stay,1985-09-07
28368,The Family,1985-10-19,The Family - The Family,17,18,18,17.0,17,The Family,16.0,6,-1,0,1,1,down,1985-09-07
28369,The Family,1985-10-26,The Family - The Family,17,17,18,17.0,18,The Family,16.0,7,0,-1,0,0,stay,1985-09-07
28370,The Family,1985-11-02,The Family - The Family,18,17,21,17.0,18,The Family,16.0,8,-3,0,-1,1,down,1985-09-07
28371,The Family,1985-11-09,The Family - The Family,18,18,23,17.0,21,The Family,16.0,9,-2,-3,0,1,down,1985-09-07
28372,The Family,1985-11-16,The Family - The Family,21,18,28,17.0,23,The Family,16.0,10,-5,-2,-3,1,down,1985-09-07
28373,The Family,1985-11-23,The Family - The Family,23,21,29,17.0,28,The Family,16.0,11,-1,-5,-2,1,down,1985-09-07
28374,The Family,1985-11-30,The Family - The Family,28,23,34,17.0,29,The Family,16.0,12,-5,-1,-5,1,down,1985-09-07
28375,The Family,1985-12-07,The Family - The Family,29,28,38,17.0,34,The Family,16.0,13,-4,-5,-1,1,down,1985-09-07
28376,The Family,1985-12-14,The Family - The Family,34,29,43,17.0,38,The Family,16.0,14,-5,-4,-5,1,down,1985-09-07
28377,The Family,1985-12-21,The Family - The Family,38,34,49,17.0,43,The Family,16.0,15,-6,-5,-4,1,down,1985-09-07
28378,The Family,1985-12-28,The Family - The Family,43,38,51,17.0,49,The Family,16.0,16,-2,-6,-5,1,down,1985-09-07
28379,Lisa Lisa And Clult Jam With Full Force,1985-09-07,Lisa Lisa And Clult Jam With Full Force - Lisa Lisa & Cult Jam With Full Force,51,51,33,24.0,44,Lisa Lisa & Cult Jam With Full Force,13.0,0,11,7,0,1,up,1985-09-07
28380,Lisa Lisa And Clult Jam With Full Force,1985-09-14,Lisa Lisa And Clult Jam With Full Force - Lisa Lisa & Cult Jam With Full Force,44,51,28,24.0,33,Lisa Lisa & Cult Jam With Full Force,13.0,1,5,11,7,1,up,1985-09-07
28381,Lisa Lisa And Clult Jam With Full Force,1985-09-21,Lisa Lisa And Clult Jam With Full Force - Lisa Lisa & Cult Jam With Full Force,33,44,28,24.0,28,Lisa Lisa & Cult Jam With Full Force,13.0,2,0,5,11,0,stay,1985-09-07
28382,Lisa Lisa And Clult Jam With Full Force,1985-09-28,Lisa Lisa And Clult Jam With Full Force - Lisa Lisa & Cult Jam With Full Force,28,33,27,24.0,28,Lisa Lisa & Cult Jam With Full Force,13.0,3,1,0,5,1,up,1985-09-07
28383,Lisa Lisa And Clult Jam With Full Force,1985-10-05,Lisa Lisa And Clult Jam With Full Force - Lisa Lisa & Cult Jam With Full Force,28,28,24,24.0,27,Lisa Lisa & Cult Jam With Full Force,13.0,4,3,1,0,1,up,1985-09-07
28384,Lisa Lisa And Clult Jam With Full Force,1985-10-12,Lisa Lisa And Clult Jam With Full Force - Lisa Lisa & Cult Jam With Full Force,27,28,24,24.0,24,Lisa Lisa & Cult Jam With Full Force,13.0,5,0,3,1,0,stay,1985-09-07
28385,Lisa Lisa And Clult Jam With Full Force,1985-10-19,Lisa Lisa And Clult Jam With Full Force - Lisa Lisa & Cult Jam With Full Force,24,27,31,24.0,24,Lisa Lisa & Cult Jam With Full Force,13.0,6,-7,0,3,1,down,1985-09-07
28386,Lisa Lisa And Clult Jam With Full Force,1985-10-26,Lisa Lisa And Clult Jam With Full Force - Lisa Lisa & Cult Jam With Full Force,24,24,39,24.0,31,Lisa Lisa & Cult Jam With Full Force,13.0,7,-8,-7,0,1,down,1985-09-07
28387,Lisa Lisa And Clult Jam With Full Force,1985-11-02,Lisa Lisa And Clult Jam With Full Force - Lisa Lisa & Cult Jam With Full Force,31,24,44,24.0,39,Lisa Lisa & Cult Jam With Full Force,13.0,8,-5,-8,-7,1,down,1985-09-07
28388,Lisa Lisa And Clult Jam With Full Force,1985-11-09,Lisa Lisa And Clult Jam With Full Force - Lisa Lisa & Cult Jam With Full Force,39,31,44,24.0,44,Lisa Lisa & Cult Jam With Full Force,13.0,9,0,-5,-8,0,stay,1985-09-07
28389,Lisa Lisa And Clult Jam With Full Force,1985-11-16,Lisa Lisa And Clult Jam With Full Force - Lisa Lisa & Cult Jam With Full Force,44,39,44,24.0,44,Lisa Lisa & Cult Jam With Full Force,13.0,10,0,0,-5,0,stay,1985-09-07
28390,Lisa Lisa And Clult Jam With Full Force,1985-11-23,Lisa Lisa And Clult Jam With Full Force - Lisa Lisa & Cult Jam With Full Force,44,44,49,24.0,44,Lisa Lisa & Cult Jam With Full Force,13.0,11,-5,0,0,1,down,1985-09-07
28391,Lisa Lisa And Clult Jam With Full Force,1985-11-30,Lisa Lisa And Clult Jam With Full Force - Lisa Lisa & Cult Jam With Full Force,44,44,50,24.0,49,Lisa Lisa & Cult Jam With Full Force,13.0,12,-1,-5,0,1,down,1985-09-07
28392,Lisa Lisa And Clult Jam With Full Force,1985-12-21,Lisa Lisa And Clult Jam With Full Force - Lisa Lisa & Cult Jam With Full Force,49,44,51,24.0,50,Lisa Lisa & Cult Jam With Full Force,13.0,13,-1,-1,-5,1,down,1985-09-07
28393,Soundtrack,1985-09-14,Soundtrack - Mad Max Beyond Thunderdome,51,51,47,47.0,50,Mad Max Beyond Thunderdome,3.0,0,3,1,0,1,up,1985-09-14
28394,Soundtrack,1985-09-21,Soundtrack - Mad Max Beyond Thunderdome,50,51,47,47.0,47,Mad Max Beyond Thunderdome,3.0,1,0,3,1,0,stay,1985-09-14
28395,Soundtrack,1985-09-28,Soundtrack - Mad Max Beyond Thunderdome,47,50,49,47.0,47,Mad Max Beyond Thunderdome,3.0,2,-2,0,3,1,down,1985-09-14
28396,Soundtrack,1985-10-05,Soundtrack - Mad Max Beyond Thunderdome,47,47,51,47.0,49,Mad Max Beyond Thunderdome,3.0,3,-2,-2,0,1,down,1985-09-14
28397,Bobby Womack,1985-09-21,Bobby Womack - So Many Rivers,51,51,15,5.0,30,So Many Rivers,14.0,0,15,21,0,1,up,1985-09-21
28398,Bobby Womack,1985-09-28,Bobby Womack - So Many Rivers,30,51,9,5.0,15,So Many Rivers,14.0,1,6,15,21,1,up,1985-09-21
28399,Bobby Womack,1985-10-05,Bobby Womack - So Many Rivers,15,30,6,5.0,9,So Many Rivers,14.0,2,3,6,15,1,up,1985-09-21
28400,Bobby Womack,1985-10-12,Bobby Womack - So Many Rivers,9,15,5,5.0,6,So Many Rivers,14.0,3,1,3,6,1,up,1985-09-21
28401,Bobby Womack,1985-10-19,Bobby Womack - So Many Rivers,6,9,5,5.0,5,So Many Rivers,14.0,4,0,1,3,0,stay,1985-09-21
28402,Bobby Womack,1985-10-26,Bobby Womack - So Many Rivers,5,6,5,5.0,5,So Many Rivers,14.0,5,0,0,1,0,stay,1985-09-21
28403,Bobby Womack,1985-11-02,Bobby Womack - So Many Rivers,5,5,5,5.0,5,So Many Rivers,14.0,6,0,0,0,0,stay,1985-09-21
28404,Bobby Womack,1985-11-09,Bobby Womack - So Many Rivers,5,5,5,5.0,5,So Many Rivers,14.0,7,0,0,0,0,stay,1985-09-21
28405,Bobby Womack,1985-11-16,Bobby Womack - So Many Rivers,5,5,6,5.0,5,So Many Rivers,14.0,8,-1,0,0,1,down,1985-09-21
28406,Bobby Womack,1985-11-23,Bobby Womack - So Many Rivers,5,5,6,5.0,6,So Many Rivers,14.0,9,0,-1,0,0,stay,1985-09-21
28407,Bobby Womack,1985-11-30,Bobby Womack - So Many Rivers,6,5,7,5.0,6,So Many Rivers,14.0,10,-1,0,-1,1,down,1985-09-21
28408,Bobby Womack,1985-12-07,Bobby Womack - So Many Rivers,6,6,8,5.0,7,So Many Rivers,14.0,11,-1,-1,0,1,down,1985-09-21
28409,Bobby Womack,1985-12-14,Bobby Womack - So Many Rivers,7,6,9,5.0,8,So Many Rivers,14.0,12,-1,-1,-1,1,down,1985-09-21
28410,Bobby Womack,1985-12-21,Bobby Womack - So Many Rivers,8,7,13,5.0,9,So Many Rivers,14.0,13,-4,-1,-1,1,down,1985-09-21
28411,Bobby Womack,1985-12-28,Bobby Womack - So Many Rivers,9,8,51,5.0,13,So Many Rivers,14.0,14,-38,-4,-1,1,down,1985-09-21
28412,Barkays,1985-09-21,Barkays - Banging The Wall,51,51,22,11.0,33,Banging The Wall,12.0,0,11,18,0,1,up,1985-09-21
28413,Barkays,1985-09-28,Barkays - Banging The Wall,33,51,16,11.0,22,Banging The Wall,12.0,1,6,11,18,1,up,1985-09-21
28414,Barkays,1985-10-05,Barkays - Banging The Wall,22,33,12,11.0,16,Banging The Wall,12.0,2,4,6,11,1,up,1985-09-21
28415,Barkays,1985-10-12,Barkays - Banging The Wall,16,22,12,11.0,12,Banging The Wall,12.0,3,0,4,6,0,stay,1985-09-21
28416,Barkays,1985-10-19,Barkays - Banging The Wall,12,16,11,11.0,12,Banging The Wall,12.0,4,1,0,4,1,up,1985-09-21
28417,Barkays,1985-10-26,Barkays - Banging The Wall,12,12,14,11.0,11,Banging The Wall,12.0,5,-3,1,0,1,down,1985-09-21
28418,Barkays,1985-11-02,Barkays - Banging The Wall,11,12,15,11.0,14,Banging The Wall,12.0,6,-1,-3,1,1,down,1985-09-21
28419,Barkays,1985-11-09,Barkays - Banging The Wall,14,11,16,11.0,15,Banging The Wall,12.0,7,-1,-1,-3,1,down,1985-09-21
28420,Barkays,1985-11-16,Barkays - Banging The Wall,15,14,22,11.0,16,Banging The Wall,12.0,8,-6,-1,-1,1,down,1985-09-21
28421,Barkays,1985-11-23,Barkays - Banging The Wall,16,15,22,11.0,22,Banging The Wall,12.0,9,0,-6,-1,0,stay,1985-09-21
28422,Barkays,1985-11-30,Barkays - Banging The Wall,22,16,29,11.0,22,Banging The Wall,12.0,10,-7,0,-6,1,down,1985-09-21
28423,Barkays,1985-12-07,Barkays - Banging The Wall,22,22,39,11.0,29,Banging The Wall,12.0,11,-10,-7,0,1,down,1985-09-21
28424,Barkays,1985-12-14,Barkays - Banging The Wall,29,22,51,11.0,39,Banging The Wall,12.0,12,-12,-10,-7,1,down,1985-09-21
28425,Andre Cymone,1985-09-21,Andre Cymone - A.C.,51,51,30,28.0,37,A.C.,6.0,0,7,14,0,1,up,1985-09-21
28426,Andre Cymone,1985-09-28,Andre Cymone - A.C.,37,51,28,28.0,30,A.C.,6.0,1,2,7,14,1,up,1985-09-21
28427,Andre Cymone,1985-10-05,Andre Cymone - A.C.,30,37,28,28.0,28,A.C.,6.0,2,0,2,7,0,stay,1985-09-21
28428,Andre Cymone,1985-10-12,Andre Cymone - A.C.,28,30,30,28.0,28,A.C.,6.0,3,-2,0,2,1,down,1985-09-21
28429,Andre Cymone,1985-10-19,Andre Cymone - A.C.,28,28,50,28.0,30,A.C.,6.0,4,-20,-2,0,1,down,1985-09-21
28430,Andre Cymone,1985-10-26,Andre Cymone - A.C.,30,28,49,28.0,50,A.C.,6.0,5,1,-20,-2,1,up,1985-09-21
28431,Andre Cymone,1985-11-02,Andre Cymone - A.C.,50,30,51,28.0,49,A.C.,6.0,6,-2,1,-20,1,down,1985-09-21
28432,Five Star,1985-09-21,Five Star - Luxury Of Life,51,51,38,22.0,40,Luxury Of Life,14.0,0,2,11,0,1,up,1985-09-21
28433,Five Star,1985-09-28,Five Star - Luxury Of Life,40,51,32,22.0,38,Luxury Of Life,14.0,1,6,2,11,1,up,1985-09-21
28434,Five Star,1985-10-05,Five Star - Luxury Of Life,38,40,26,22.0,32,Luxury Of Life,14.0,2,6,6,2,1,up,1985-09-21
28435,Five Star,1985-10-12,Five Star - Luxury Of Life,32,38,23,22.0,26,Luxury Of Life,14.0,3,3,6,6,1,up,1985-09-21
28436,Five Star,1985-10-19,Five Star - Luxury Of Life,26,32,23,22.0,23,Luxury Of Life,14.0,4,0,3,6,0,stay,1985-09-21
28437,Five Star,1985-10-26,Five Star - Luxury Of Life,23,26,22,22.0,23,Luxury Of Life,14.0,5,1,0,3,1,up,1985-09-21
28438,Five Star,1985-11-02,Five Star - Luxury Of Life,23,23,22,22.0,22,Luxury Of Life,14.0,6,0,1,0,0,stay,1985-09-21
28439,Five Star,1985-11-09,Five Star - Luxury Of Life,22,23,22,22.0,22,Luxury Of Life,14.0,7,0,0,1,0,stay,1985-09-21
28440,Five Star,1985-11-16,Five Star - Luxury Of Life,22,22,25,22.0,22,Luxury Of Life,14.0,8,-3,0,0,1,down,1985-09-21
28441,Five Star,1985-11-23,Five Star - Luxury Of Life,22,22,28,22.0,25,Luxury Of Life,14.0,9,-3,-3,0,1,down,1985-09-21
28442,Five Star,1985-11-30,Five Star - Luxury Of Life,25,22,28,22.0,28,Luxury Of Life,14.0,10,0,-3,-3,0,stay,1985-09-21
28443,Five Star,1985-12-07,Five Star - Luxury Of Life,28,25,31,22.0,28,Luxury Of Life,14.0,11,-3,0,-3,1,down,1985-09-21
28444,Five Star,1985-12-14,Five Star - Luxury Of Life,28,28,26,22.0,31,Luxury Of Life,14.0,12,5,-3,0,1,up,1985-09-21
28445,Five Star,1985-12-21,Five Star - Luxury Of Life,31,28,26,22.0,26,Luxury Of Life,14.0,13,0,5,-3,0,stay,1985-09-21
28446,Five Star,1985-12-28,Five Star - Luxury Of Life,26,31,51,22.0,26,Luxury Of Life,14.0,14,-25,0,5,1,down,1985-09-21
28447,Sheila E.,1985-09-21,Sheila E. - Romance 1600,51,51,35,12.0,45,Romance 1600,14.0,0,10,6,0,1,up,1985-09-21
28448,Sheila E.,1985-09-28,Sheila E. - Romance 1600,45,51,25,12.0,35,Romance 1600,14.0,1,10,10,6,1,up,1985-09-21
28449,Sheila E.,1985-10-05,Sheila E. - Romance 1600,35,45,22,12.0,25,Romance 1600,14.0,2,3,10,10,1,up,1985-09-21
28450,Sheila E.,1985-10-12,Sheila E. - Romance 1600,25,35,22,12.0,22,Romance 1600,14.0,3,0,3,10,0,stay,1985-09-21
28451,Sheila E.,1985-10-19,Sheila E. - Romance 1600,22,25,30,12.0,22,Romance 1600,14.0,4,-8,0,3,1,down,1985-09-21
28452,Sheila E.,1985-10-26,Sheila E. - Romance 1600,22,22,25,12.0,30,Romance 1600,14.0,5,5,-8,0,1,up,1985-09-21
28453,Sheila E.,1985-11-02,Sheila E. - Romance 1600,30,22,25,12.0,25,Romance 1600,14.0,6,0,5,-8,0,stay,1985-09-21
28454,Sheila E.,1985-11-09,Sheila E. - Romance 1600,25,30,21,12.0,25,Romance 1600,14.0,7,4,0,5,1,up,1985-09-21
28455,Sheila E.,1985-11-16,Sheila E. - Romance 1600,25,25,18,12.0,21,Romance 1600,14.0,8,3,4,0,1,up,1985-09-21
28456,Sheila E.,1985-11-23,Sheila E. - Romance 1600,21,25,18,12.0,18,Romance 1600,14.0,9,0,3,4,0,stay,1985-09-21
28457,Sheila E.,1985-11-30,Sheila E. - Romance 1600,18,21,13,12.0,18,Romance 1600,14.0,10,5,0,3,1,up,1985-09-21
28458,Sheila E.,1985-12-07,Sheila E. - Romance 1600,18,18,13,12.0,13,Romance 1600,14.0,11,0,5,0,0,stay,1985-09-21
28459,Sheila E.,1985-12-14,Sheila E. - Romance 1600,13,18,12,12.0,13,Romance 1600,14.0,12,1,0,5,1,up,1985-09-21
28460,Sheila E.,1985-12-21,Sheila E. - Romance 1600,13,13,12,12.0,12,Romance 1600,14.0,13,0,1,0,0,stay,1985-09-21
28461,Sheila E.,1985-12-28,Sheila E. - Romance 1600,12,13,51,12.0,12,Romance 1600,14.0,14,-39,0,1,1,down,1985-09-21
28462,Jennifer Holliday,1985-09-21,Jennifer Holliday - Say You Love Me,51,51,41,34.0,50,Say You Love Me,14.0,0,9,1,0,1,up,1985-09-21
28463,Jennifer Holliday,1985-09-28,Jennifer Holliday - Say You Love Me,50,51,39,34.0,41,Say You Love Me,14.0,1,2,9,1,1,up,1985-09-21
28464,Jennifer Holliday,1985-10-05,Jennifer Holliday - Say You Love Me,41,50,35,34.0,39,Say You Love Me,14.0,2,4,2,9,1,up,1985-09-21
28465,Jennifer Holliday,1985-10-12,Jennifer Holliday - Say You Love Me,39,41,34,34.0,35,Say You Love Me,14.0,3,1,4,2,1,up,1985-09-21
28466,Jennifer Holliday,1985-10-19,Jennifer Holliday - Say You Love Me,35,39,36,34.0,34,Say You Love Me,14.0,4,-2,1,4,1,down,1985-09-21
28467,Jennifer Holliday,1985-10-26,Jennifer Holliday - Say You Love Me,34,35,43,34.0,36,Say You Love Me,14.0,5,-7,-2,1,1,down,1985-09-21
28468,Jennifer Holliday,1985-11-02,Jennifer Holliday - Say You Love Me,36,34,47,34.0,43,Say You Love Me,14.0,6,-4,-7,-2,1,down,1985-09-21
28469,Jennifer Holliday,1985-11-09,Jennifer Holliday - Say You Love Me,43,36,35,34.0,47,Say You Love Me,14.0,7,12,-4,-7,1,up,1985-09-21
28470,Jennifer Holliday,1985-11-16,Jennifer Holliday - Say You Love Me,47,43,34,34.0,35,Say You Love Me,14.0,8,1,12,-4,1,up,1985-09-21
28471,Jennifer Holliday,1985-11-23,Jennifer Holliday - Say You Love Me,35,47,34,34.0,34,Say You Love Me,14.0,9,0,1,12,0,stay,1985-09-21
28472,Jennifer Holliday,1985-11-30,Jennifer Holliday - Say You Love Me,34,35,45,34.0,34,Say You Love Me,14.0,10,-11,0,1,1,down,1985-09-21
28473,Jennifer Holliday,1985-12-07,Jennifer Holliday - Say You Love Me,34,34,44,34.0,45,Say You Love Me,14.0,11,1,-11,0,1,up,1985-09-21
28474,Jennifer Holliday,1985-12-14,Jennifer Holliday - Say You Love Me,45,34,44,34.0,44,Say You Love Me,14.0,12,0,1,-11,0,stay,1985-09-21
28475,Jennifer Holliday,1985-12-21,Jennifer Holliday - Say You Love Me,44,45,42,34.0,44,Say You Love Me,14.0,13,2,0,1,1,up,1985-09-21
28476,Jennifer Holliday,1985-12-28,Jennifer Holliday - Say You Love Me,44,44,51,34.0,42,Say You Love Me,14.0,14,-9,2,0,1,down,1985-09-21
28477,Tears For Fears,1985-09-28,Tears For Fears - Songs From The Big Chair,51,51,41,38.0,46,Songs From The Big Chair,4.0,0,5,5,0,1,up,1985-09-28
28478,Tears For Fears,1985-10-05,Tears For Fears - Songs From The Big Chair,46,51,38,38.0,41,Songs From The Big Chair,4.0,1,3,5,5,1,up,1985-09-28
28479,Tears For Fears,1985-10-12,Tears For Fears - Songs From The Big Chair,41,46,38,38.0,38,Songs From The Big Chair,4.0,2,0,3,5,0,stay,1985-09-28
28480,Tears For Fears,1985-10-19,Tears For Fears - Songs From The Big Chair,38,41,41,38.0,38,Songs From The Big Chair,4.0,3,-3,0,3,1,down,1985-09-28
28481,Tears For Fears,1985-10-26,Tears For Fears - Songs From The Big Chair,38,38,51,38.0,41,Songs From The Big Chair,4.0,4,-10,-3,0,1,down,1985-09-28
28482,The O'Jays,1985-09-28,The O'Jays - Love Fever,51,51,40,20.0,49,Love Fever,13.0,0,9,2,0,1,up,1985-09-28
28483,The O'Jays,1985-10-05,The O'Jays - Love Fever,49,51,30,20.0,40,Love Fever,13.0,1,10,9,2,1,up,1985-09-28
28484,The O'Jays,1985-10-12,The O'Jays - Love Fever,40,49,27,20.0,30,Love Fever,13.0,2,3,10,9,1,up,1985-09-28
28485,The O'Jays,1985-10-19,The O'Jays - Love Fever,30,40,21,20.0,27,Love Fever,13.0,3,6,3,10,1,up,1985-09-28
28486,The O'Jays,1985-10-26,The O'Jays - Love Fever,27,30,21,20.0,21,Love Fever,13.0,4,0,6,3,0,stay,1985-09-28
28487,The O'Jays,1985-11-02,The O'Jays - Love Fever,21,27,20,20.0,21,Love Fever,13.0,5,1,0,6,1,up,1985-09-28
28488,The O'Jays,1985-11-09,The O'Jays - Love Fever,21,21,20,20.0,20,Love Fever,13.0,6,0,1,0,0,stay,1985-09-28
28489,The O'Jays,1985-11-16,The O'Jays - Love Fever,20,21,21,20.0,20,Love Fever,13.0,7,-1,0,1,1,down,1985-09-28
28490,The O'Jays,1985-11-23,The O'Jays - Love Fever,20,20,24,20.0,21,Love Fever,13.0,8,-3,-1,0,1,down,1985-09-28
28491,The O'Jays,1985-11-30,The O'Jays - Love Fever,21,20,24,20.0,24,Love Fever,13.0,9,0,-3,-1,0,stay,1985-09-28
28492,The O'Jays,1985-12-07,The O'Jays - Love Fever,24,21,26,20.0,24,Love Fever,13.0,10,-2,0,-3,1,down,1985-09-28
28493,The O'Jays,1985-12-14,The O'Jays - Love Fever,24,24,28,20.0,26,Love Fever,13.0,11,-2,-2,0,1,down,1985-09-28
28494,The O'Jays,1985-12-21,The O'Jays - Love Fever,26,24,38,20.0,28,Love Fever,13.0,12,-10,-2,-2,1,down,1985-09-28
28495,The O'Jays,1985-12-28,The O'Jays - Love Fever,28,26,51,20.0,38,Love Fever,13.0,13,-13,-10,-2,1,down,1985-09-28
28496,Maurice White,1985-10-05,Maurice White - Maurice White,51,51,27,12.0,36,Maurice White,12.0,0,9,15,0,1,up,1985-10-05
28497,Maurice White,1985-10-12,Maurice White - Maurice White,36,51,16,12.0,27,Maurice White,12.0,1,11,9,15,1,up,1985-10-05
28498,Maurice White,1985-10-19,Maurice White - Maurice White,27,36,12,12.0,16,Maurice White,12.0,2,4,11,9,1,up,1985-10-05
28499,Maurice White,1985-10-26,Maurice White - Maurice White,16,27,12,12.0,12,Maurice White,12.0,3,0,4,11,0,stay,1985-10-05
28500,Maurice White,1985-11-02,Maurice White - Maurice White,12,16,12,12.0,12,Maurice White,12.0,4,0,0,4,0,stay,1985-10-05
28501,Maurice White,1985-11-09,Maurice White - Maurice White,12,12,14,12.0,12,Maurice White,12.0,5,-2,0,0,1,down,1985-10-05
28502,Maurice White,1985-11-16,Maurice White - Maurice White,12,12,16,12.0,14,Maurice White,12.0,6,-2,-2,0,1,down,1985-10-05
28503,Maurice White,1985-11-23,Maurice White - Maurice White,14,12,19,12.0,16,Maurice White,12.0,7,-3,-2,-2,1,down,1985-10-05
28504,Maurice White,1985-11-30,Maurice White - Maurice White,16,14,22,12.0,19,Maurice White,12.0,8,-3,-3,-2,1,down,1985-10-05
28505,Maurice White,1985-12-07,Maurice White - Maurice White,19,16,23,12.0,22,Maurice White,12.0,9,-1,-3,-3,1,down,1985-10-05
28506,Maurice White,1985-12-14,Maurice White - Maurice White,22,19,33,12.0,23,Maurice White,12.0,10,-10,-1,-3,1,down,1985-10-05
28507,Maurice White,1985-12-21,Maurice White - Maurice White,23,22,41,12.0,33,Maurice White,12.0,11,-8,-10,-1,1,down,1985-10-05
28508,Maurice White,1985-12-28,Maurice White - Maurice White,33,23,51,12.0,41,Maurice White,12.0,12,-10,-8,-10,1,down,1985-10-05
28509,Durell Coleman,1985-10-12,Durell Coleman - Durell Coleman,51,51,44,33.0,44,Durell Coleman,7.0,0,0,7,0,0,stay,1985-10-12
28510,Durell Coleman,1985-10-19,Durell Coleman - Durell Coleman,44,51,35,33.0,44,Durell Coleman,7.0,1,9,0,7,1,up,1985-10-12
28511,Durell Coleman,1985-10-26,Durell Coleman - Durell Coleman,44,44,35,33.0,35,Durell Coleman,7.0,2,0,9,0,0,stay,1985-10-12
28512,Durell Coleman,1985-11-02,Durell Coleman - Durell Coleman,35,44,33,33.0,35,Durell Coleman,7.0,3,2,0,9,1,up,1985-10-12
28513,Durell Coleman,1985-11-09,Durell Coleman - Durell Coleman,35,35,37,33.0,33,Durell Coleman,7.0,4,-4,2,0,1,down,1985-10-12
28514,Durell Coleman,1985-11-16,Durell Coleman - Durell Coleman,33,35,42,33.0,37,Durell Coleman,7.0,5,-5,-4,2,1,down,1985-10-12
28515,Durell Coleman,1985-11-23,Durell Coleman - Durell Coleman,37,33,42,33.0,42,Durell Coleman,7.0,6,0,-5,-4,0,stay,1985-10-12
28516,Durell Coleman,1985-11-30,Durell Coleman - Durell Coleman,42,37,51,33.0,42,Durell Coleman,7.0,7,-9,0,-5,1,down,1985-10-12
28517,Howard Johnson,1985-10-12,Howard Johnson - The Vision,51,51,47,46.0,47,The Vision,2.0,0,0,4,0,0,stay,1985-10-12
28518,Howard Johnson,1985-10-19,Howard Johnson - The Vision,47,51,46,46.0,47,The Vision,2.0,1,1,0,4,1,up,1985-10-12
28519,Howard Johnson,1985-10-26,Howard Johnson - The Vision,47,47,51,46.0,46,The Vision,2.0,2,-5,1,0,1,down,1985-10-12
28520,Daryl Hall John Oates,1985-10-12,Daryl Hall John Oates - Hall & Oates Live At The Apollo,51,51,45,41.0,48,Hall & Oates Live At The Apollo,5.0,0,3,3,0,1,up,1985-10-12
28521,Daryl Hall John Oates,1985-10-19,Daryl Hall John Oates - Hall & Oates Live At The Apollo,48,51,42,41.0,45,Hall & Oates Live At The Apollo,5.0,1,3,3,3,1,up,1985-10-12
28522,Daryl Hall John Oates,1985-10-26,Daryl Hall John Oates - Hall & Oates Live At The Apollo,45,48,42,41.0,42,Hall & Oates Live At The Apollo,5.0,2,0,3,3,0,stay,1985-10-12
28523,Daryl Hall John Oates,1985-11-02,Daryl Hall John Oates - Hall & Oates Live At The Apollo,42,45,41,41.0,42,Hall & Oates Live At The Apollo,5.0,3,1,0,3,1,up,1985-10-12
28524,Daryl Hall John Oates,1985-11-09,Daryl Hall John Oates - Hall & Oates Live At The Apollo,42,42,48,41.0,41,Hall & Oates Live At The Apollo,5.0,4,-7,1,0,1,down,1985-10-12
28525,Daryl Hall John Oates,1985-11-16,Daryl Hall John Oates - Hall & Oates Live At The Apollo,41,42,51,41.0,48,Hall & Oates Live At The Apollo,5.0,5,-3,-7,1,1,down,1985-10-12
28526,Stevie Wonder,1985-10-19,Stevie Wonder - In Square Circle,51,51,3,1.0,8,In Square Circle,10.0,0,5,43,0,1,up,1985-10-19
28527,Stevie Wonder,1985-10-26,Stevie Wonder - In Square Circle,8,51,2,1.0,3,In Square Circle,10.0,1,1,5,43,1,up,1985-10-19
28528,Stevie Wonder,1985-11-02,Stevie Wonder - In Square Circle,3,8,1,1.0,2,In Square Circle,10.0,2,1,1,5,1,up,1985-10-19
28529,Stevie Wonder,1985-11-09,Stevie Wonder - In Square Circle,2,3,1,1.0,1,In Square Circle,10.0,3,0,1,1,0,stay,1985-10-19
28530,Stevie Wonder,1985-11-16,Stevie Wonder - In Square Circle,1,2,1,1.0,1,In Square Circle,10.0,4,0,0,1,0,stay,1985-10-19
28531,Stevie Wonder,1985-11-23,Stevie Wonder - In Square Circle,1,1,1,1.0,1,In Square Circle,10.0,5,0,0,0,0,stay,1985-10-19
28532,Stevie Wonder,1985-11-30,Stevie Wonder - In Square Circle,1,1,1,1.0,1,In Square Circle,10.0,6,0,0,0,0,stay,1985-10-19
28533,Stevie Wonder,1985-12-07,Stevie Wonder - In Square Circle,1,1,1,1.0,1,In Square Circle,10.0,7,0,0,0,0,stay,1985-10-19
28534,Stevie Wonder,1985-12-14,Stevie Wonder - In Square Circle,1,1,1,1.0,1,In Square Circle,10.0,8,0,0,0,0,stay,1985-10-19
28535,Stevie Wonder,1985-12-21,Stevie Wonder - In Square Circle,1,1,1,1.0,1,In Square Circle,10.0,9,0,0,0,0,stay,1985-10-19
28536,Stevie Wonder,1985-12-28,Stevie Wonder - In Square Circle,1,1,51,1.0,1,In Square Circle,10.0,10,-50,0,0,1,down,1985-10-19
28537,Soundtrack,1985-10-19,Soundtrack - Miami Vice,51,51,22,9.0,35,Miami Vice,10.0,0,13,16,0,1,up,1985-10-19
28538,Soundtrack,1985-10-26,Soundtrack - Miami Vice,35,51,17,9.0,22,Miami Vice,10.0,1,5,13,16,1,up,1985-10-19
28539,Soundtrack,1985-11-02,Soundtrack - Miami Vice,22,35,14,9.0,17,Miami Vice,10.0,2,3,5,13,1,up,1985-10-19
28540,Soundtrack,1985-11-09,Soundtrack - Miami Vice,17,22,13,9.0,14,Miami Vice,10.0,3,1,3,5,1,up,1985-10-19
28541,Soundtrack,1985-11-16,Soundtrack - Miami Vice,14,17,11,9.0,13,Miami Vice,10.0,4,2,1,3,1,up,1985-10-19
28542,Soundtrack,1985-11-23,Soundtrack - Miami Vice,13,14,11,9.0,11,Miami Vice,10.0,5,0,2,1,0,stay,1985-10-19
28543,Soundtrack,1985-11-30,Soundtrack - Miami Vice,11,13,10,9.0,11,Miami Vice,10.0,6,1,0,2,1,up,1985-10-19
28544,Soundtrack,1985-12-07,Soundtrack - Miami Vice,11,11,9,9.0,10,Miami Vice,10.0,7,1,1,0,1,up,1985-10-19
28545,Soundtrack,1985-12-14,Soundtrack - Miami Vice,10,11,10,9.0,9,Miami Vice,10.0,8,-1,1,1,1,down,1985-10-19
28546,Soundtrack,1985-12-21,Soundtrack - Miami Vice,9,10,16,9.0,10,Miami Vice,10.0,9,-6,-1,1,1,down,1985-10-19
28547,Soundtrack,1985-12-28,Soundtrack - Miami Vice,10,9,51,9.0,16,Miami Vice,10.0,10,-35,-6,-1,1,down,1985-10-19
28548,Diana Ross,1985-10-19,Diana Ross - Eaten Alive,51,51,37,27.0,42,Eaten Alive,10.0,0,5,9,0,1,up,1985-10-19
28549,Diana Ross,1985-10-26,Diana Ross - Eaten Alive,42,51,31,27.0,37,Eaten Alive,10.0,1,6,5,9,1,up,1985-10-19
28550,Diana Ross,1985-11-02,Diana Ross - Eaten Alive,37,42,31,27.0,31,Eaten Alive,10.0,2,0,6,5,0,stay,1985-10-19
28551,Diana Ross,1985-11-09,Diana Ross - Eaten Alive,31,37,32,27.0,31,Eaten Alive,10.0,3,-1,0,6,1,down,1985-10-19
28552,Diana Ross,1985-11-16,Diana Ross - Eaten Alive,31,31,31,27.0,32,Eaten Alive,10.0,4,1,-1,0,1,up,1985-10-19
28553,Diana Ross,1985-11-23,Diana Ross - Eaten Alive,32,31,27,27.0,31,Eaten Alive,10.0,5,4,1,-1,1,up,1985-10-19
28554,Diana Ross,1985-11-30,Diana Ross - Eaten Alive,31,32,27,27.0,27,Eaten Alive,10.0,6,0,4,1,0,stay,1985-10-19
28555,Diana Ross,1985-12-07,Diana Ross - Eaten Alive,27,31,36,27.0,27,Eaten Alive,10.0,7,-9,0,4,1,down,1985-10-19
28556,Diana Ross,1985-12-14,Diana Ross - Eaten Alive,27,27,38,27.0,36,Eaten Alive,10.0,8,-2,-9,0,1,down,1985-10-19
28557,Diana Ross,1985-12-21,Diana Ross - Eaten Alive,36,27,50,27.0,38,Eaten Alive,10.0,9,-12,-2,-9,1,down,1985-10-19
28558,Diana Ross,1985-12-28,Diana Ross - Eaten Alive,38,36,51,27.0,50,Eaten Alive,10.0,10,-1,-12,-2,1,down,1985-10-19
28559,Osborne & Giles,1985-10-19,Osborne & Giles - Stranger In The Night,51,51,43,40.0,46,Stranger In The Night,7.0,0,3,5,0,1,up,1985-10-19
28560,Osborne & Giles,1985-10-26,Osborne & Giles - Stranger In The Night,46,51,41,40.0,43,Stranger In The Night,7.0,1,2,3,5,1,up,1985-10-19
28561,Osborne & Giles,1985-11-02,Osborne & Giles - Stranger In The Night,43,46,40,40.0,41,Stranger In The Night,7.0,2,1,2,3,1,up,1985-10-19
28562,Osborne & Giles,1985-11-09,Osborne & Giles - Stranger In The Night,41,43,42,40.0,40,Stranger In The Night,7.0,3,-2,1,2,1,down,1985-10-19
28563,Osborne & Giles,1985-11-16,Osborne & Giles - Stranger In The Night,40,41,46,40.0,42,Stranger In The Night,7.0,4,-4,-2,1,1,down,1985-10-19
28564,Osborne & Giles,1985-11-23,Osborne & Giles - Stranger In The Night,42,40,43,40.0,46,Stranger In The Night,7.0,5,3,-4,-2,1,up,1985-10-19
28565,Osborne & Giles,1985-11-30,Osborne & Giles - Stranger In The Night,46,42,43,40.0,43,Stranger In The Night,7.0,6,0,3,-4,0,stay,1985-10-19
28566,Osborne & Giles,1985-12-07,Osborne & Giles - Stranger In The Night,43,46,51,40.0,43,Stranger In The Night,7.0,7,-8,0,3,1,down,1985-10-19
28567,Charlie Singleton,1985-10-19,Charlie Singleton - Modern Man,51,51,45,37.0,49,Modern Man,6.0,0,4,2,0,1,up,1985-10-19
28568,Charlie Singleton,1985-10-26,Charlie Singleton - Modern Man,49,51,37,37.0,45,Modern Man,6.0,1,8,4,2,1,up,1985-10-19
28569,Charlie Singleton,1985-11-02,Charlie Singleton - Modern Man,45,49,37,37.0,37,Modern Man,6.0,2,0,8,4,0,stay,1985-10-19
28570,Charlie Singleton,1985-11-09,Charlie Singleton - Modern Man,37,45,38,37.0,37,Modern Man,6.0,3,-1,0,8,1,down,1985-10-19
28571,Charlie Singleton,1985-11-16,Charlie Singleton - Modern Man,37,37,43,37.0,38,Modern Man,6.0,4,-5,-1,0,1,down,1985-10-19
28572,Charlie Singleton,1985-11-23,Charlie Singleton - Modern Man,38,37,47,37.0,43,Modern Man,6.0,5,-4,-5,-1,1,down,1985-10-19
28573,Charlie Singleton,1985-11-30,Charlie Singleton - Modern Man,43,38,51,37.0,47,Modern Man,6.0,6,-4,-4,-5,1,down,1985-10-19
28574,Morris Day,1985-10-26,Morris Day - Color Of Success,51,51,19,7.0,25,Color Of Success,9.0,0,6,26,0,1,up,1985-10-26
28575,Morris Day,1985-11-02,Morris Day - Color Of Success,25,51,13,7.0,19,Color Of Success,9.0,1,6,6,26,1,up,1985-10-26
28576,Morris Day,1985-11-09,Morris Day - Color Of Success,19,25,12,7.0,13,Color Of Success,9.0,2,1,6,6,1,up,1985-10-26
28577,Morris Day,1985-11-16,Morris Day - Color Of Success,13,19,10,7.0,12,Color Of Success,9.0,3,2,1,6,1,up,1985-10-26
28578,Morris Day,1985-11-23,Morris Day - Color Of Success,12,13,10,7.0,10,Color Of Success,9.0,4,0,2,1,0,stay,1985-10-26
28579,Morris Day,1985-11-30,Morris Day - Color Of Success,10,12,8,7.0,10,Color Of Success,9.0,5,2,0,2,1,up,1985-10-26
28580,Morris Day,1985-12-07,Morris Day - Color Of Success,10,10,7,7.0,8,Color Of Success,9.0,6,1,2,0,1,up,1985-10-26
28581,Morris Day,1985-12-14,Morris Day - Color Of Success,8,10,7,7.0,7,Color Of Success,9.0,7,0,1,2,0,stay,1985-10-26
28582,Morris Day,1985-12-21,Morris Day - Color Of Success,7,8,9,7.0,7,Color Of Success,9.0,8,-2,0,1,1,down,1985-10-26
28583,Morris Day,1985-12-28,Morris Day - Color Of Success,7,7,51,7.0,9,Color Of Success,9.0,9,-42,-2,0,1,down,1985-10-26
28584,Carl Carlton,1985-10-26,Carl Carlton - Private Property,51,51,36,36.0,48,Private Property,3.0,0,12,3,0,1,up,1985-10-26
28585,Carl Carlton,1985-11-02,Carl Carlton - Private Property,48,51,36,36.0,36,Private Property,3.0,1,0,12,3,0,stay,1985-10-26
28586,Carl Carlton,1985-11-09,Carl Carlton - Private Property,36,48,46,36.0,36,Private Property,3.0,2,-10,0,12,1,down,1985-10-26
28587,Carl Carlton,1985-11-16,Carl Carlton - Private Property,36,36,51,36.0,46,Private Property,3.0,3,-5,-10,0,1,down,1985-10-26
28588,"Isley, Jasper, Isley",1985-11-02,"Isley, Jasper, Isley - Caravan Of Love",51,51,19,3.0,34,Caravan Of Love,8.0,0,15,17,0,1,up,1985-11-02
28589,"Isley, Jasper, Isley",1985-11-09,"Isley, Jasper, Isley - Caravan Of Love",34,51,15,3.0,19,Caravan Of Love,8.0,1,4,15,17,1,up,1985-11-02
28590,"Isley, Jasper, Isley",1985-11-16,"Isley, Jasper, Isley - Caravan Of Love",19,34,12,3.0,15,Caravan Of Love,8.0,2,3,4,15,1,up,1985-11-02
28591,"Isley, Jasper, Isley",1985-11-23,"Isley, Jasper, Isley - Caravan Of Love",15,19,7,3.0,12,Caravan Of Love,8.0,3,5,3,4,1,up,1985-11-02
28592,"Isley, Jasper, Isley",1985-11-30,"Isley, Jasper, Isley - Caravan Of Love",12,15,6,3.0,7,Caravan Of Love,8.0,4,1,5,3,1,up,1985-11-02
28593,"Isley, Jasper, Isley",1985-12-07,"Isley, Jasper, Isley - Caravan Of Love",7,12,5,3.0,6,Caravan Of Love,8.0,5,1,1,5,1,up,1985-11-02
28594,"Isley, Jasper, Isley",1985-12-14,"Isley, Jasper, Isley - Caravan Of Love",6,7,3,3.0,5,Caravan Of Love,8.0,6,2,1,1,1,up,1985-11-02
28595,"Isley, Jasper, Isley",1985-12-21,"Isley, Jasper, Isley - Caravan Of Love",5,6,5,3.0,3,Caravan Of Love,8.0,7,-2,2,1,1,down,1985-11-02
28596,"Isley, Jasper, Isley",1985-12-28,"Isley, Jasper, Isley - Caravan Of Love",3,5,51,3.0,5,Caravan Of Love,8.0,8,-46,-2,2,1,down,1985-11-02
28597,Kurtis Blow,1985-11-02,Kurtis Blow - America,51,51,35,22.0,40,America,8.0,0,5,11,0,1,up,1985-11-02
28598,Kurtis Blow,1985-11-09,Kurtis Blow - America,40,51,30,22.0,35,America,8.0,1,5,5,11,1,up,1985-11-02
28599,Kurtis Blow,1985-11-16,Kurtis Blow - America,35,40,27,22.0,30,America,8.0,2,3,5,5,1,up,1985-11-02
28600,Kurtis Blow,1985-11-23,Kurtis Blow - America,30,35,26,22.0,27,America,8.0,3,1,3,5,1,up,1985-11-02
28601,Kurtis Blow,1985-11-30,Kurtis Blow - America,27,30,25,22.0,26,America,8.0,4,1,1,3,1,up,1985-11-02
28602,Kurtis Blow,1985-12-07,Kurtis Blow - America,26,27,24,22.0,25,America,8.0,5,1,1,1,1,up,1985-11-02
28603,Kurtis Blow,1985-12-14,Kurtis Blow - America,25,26,24,22.0,24,America,8.0,6,0,1,1,0,stay,1985-11-02
28604,Kurtis Blow,1985-12-21,Kurtis Blow - America,24,25,22,22.0,24,America,8.0,7,2,0,1,1,up,1985-11-02
28605,Kurtis Blow,1985-12-28,Kurtis Blow - America,24,24,51,22.0,22,America,8.0,8,-29,2,0,1,down,1985-11-02
28606,Eddie Murphy,1985-11-02,Eddie Murphy - How Could It Be,51,51,34,18.0,44,How Could It Be,8.0,0,10,7,0,1,up,1985-11-02
28607,Eddie Murphy,1985-11-09,Eddie Murphy - How Could It Be,44,51,27,18.0,34,How Could It Be,8.0,1,7,10,7,1,up,1985-11-02
28608,Eddie Murphy,1985-11-16,Eddie Murphy - How Could It Be,34,44,24,18.0,27,How Could It Be,8.0,2,3,7,10,1,up,1985-11-02
28609,Eddie Murphy,1985-11-23,Eddie Murphy - How Could It Be,27,34,23,18.0,24,How Could It Be,8.0,3,1,3,7,1,up,1985-11-02
28610,Eddie Murphy,1985-11-30,Eddie Murphy - How Could It Be,24,27,21,18.0,23,How Could It Be,8.0,4,2,1,3,1,up,1985-11-02
28611,Eddie Murphy,1985-12-07,Eddie Murphy - How Could It Be,23,24,19,18.0,21,How Could It Be,8.0,5,2,2,1,1,up,1985-11-02
28612,Eddie Murphy,1985-12-14,Eddie Murphy - How Could It Be,21,23,18,18.0,19,How Could It Be,8.0,6,1,2,2,1,up,1985-11-02
28613,Eddie Murphy,1985-12-21,Eddie Murphy - How Could It Be,19,21,18,18.0,18,How Could It Be,8.0,7,0,1,2,0,stay,1985-11-02
28614,Eddie Murphy,1985-12-28,Eddie Murphy - How Could It Be,18,19,51,18.0,18,How Could It Be,8.0,8,-33,0,1,1,down,1985-11-02
28615,B.B. King,1985-11-02,B.B. King - Six Silver Strings,51,51,42,31.0,50,Six Silver Strings,8.0,0,8,1,0,1,up,1985-11-02
28616,B.B. King,1985-11-09,B.B. King - Six Silver Strings,50,51,36,31.0,42,Six Silver Strings,8.0,1,6,8,1,1,up,1985-11-02
28617,B.B. King,1985-11-16,B.B. King - Six Silver Strings,42,50,32,31.0,36,Six Silver Strings,8.0,2,4,6,8,1,up,1985-11-02
28618,B.B. King,1985-11-23,B.B. King - Six Silver Strings,36,42,31,31.0,32,Six Silver Strings,8.0,3,1,4,6,1,up,1985-11-02
28619,B.B. King,1985-11-30,B.B. King - Six Silver Strings,32,36,31,31.0,31,Six Silver Strings,8.0,4,0,1,4,0,stay,1985-11-02
28620,B.B. King,1985-12-07,B.B. King - Six Silver Strings,31,32,32,31.0,31,Six Silver Strings,8.0,5,-1,0,1,1,down,1985-11-02
28621,B.B. King,1985-12-14,B.B. King - Six Silver Strings,31,31,40,31.0,32,Six Silver Strings,8.0,6,-8,-1,0,1,down,1985-11-02
28622,B.B. King,1985-12-21,B.B. King - Six Silver Strings,32,31,48,31.0,40,Six Silver Strings,8.0,7,-8,-8,-1,1,down,1985-11-02
28623,B.B. King,1985-12-28,B.B. King - Six Silver Strings,40,32,51,31.0,48,Six Silver Strings,8.0,8,-3,-8,-8,1,down,1985-11-02
28624,Ta Mara & The Seen,1985-11-09,Ta Mara & The Seen - Ta Mara & The Seen,51,51,25,20.0,32,Ta Mara & The Seen,7.0,0,7,19,0,1,up,1985-11-09
28625,Ta Mara & The Seen,1985-11-16,Ta Mara & The Seen - Ta Mara & The Seen,32,51,23,20.0,25,Ta Mara & The Seen,7.0,1,2,7,19,1,up,1985-11-09
28626,Ta Mara & The Seen,1985-11-23,Ta Mara & The Seen - Ta Mara & The Seen,25,32,20,20.0,23,Ta Mara & The Seen,7.0,2,3,2,7,1,up,1985-11-09
28627,Ta Mara & The Seen,1985-11-30,Ta Mara & The Seen - Ta Mara & The Seen,23,25,20,20.0,20,Ta Mara & The Seen,7.0,3,0,3,2,0,stay,1985-11-09
28628,Ta Mara & The Seen,1985-12-07,Ta Mara & The Seen - Ta Mara & The Seen,20,23,20,20.0,20,Ta Mara & The Seen,7.0,4,0,0,3,0,stay,1985-11-09
28629,Ta Mara & The Seen,1985-12-14,Ta Mara & The Seen - Ta Mara & The Seen,20,20,22,20.0,20,Ta Mara & The Seen,7.0,5,-2,0,0,1,down,1985-11-09
28630,Ta Mara & The Seen,1985-12-21,Ta Mara & The Seen - Ta Mara & The Seen,20,20,30,20.0,22,Ta Mara & The Seen,7.0,6,-8,-2,0,1,down,1985-11-09
28631,Ta Mara & The Seen,1985-12-28,Ta Mara & The Seen - Ta Mara & The Seen,22,20,51,20.0,30,Ta Mara & The Seen,7.0,7,-21,-8,-2,1,down,1985-11-09
28632,Soundtrack,1985-11-09,Soundtrack - Krush Groove,51,51,28,14.0,49,Krush Groove,7.0,0,21,2,0,1,up,1985-11-09
28633,Soundtrack,1985-11-16,Soundtrack - Krush Groove,49,51,20,14.0,28,Krush Groove,7.0,1,8,21,2,1,up,1985-11-09
28634,Soundtrack,1985-11-23,Soundtrack - Krush Groove,28,49,14,14.0,20,Krush Groove,7.0,2,6,8,21,1,up,1985-11-09
28635,Soundtrack,1985-11-30,Soundtrack - Krush Groove,20,28,14,14.0,14,Krush Groove,7.0,3,0,6,8,0,stay,1985-11-09
28636,Soundtrack,1985-12-07,Soundtrack - Krush Groove,14,20,14,14.0,14,Krush Groove,7.0,4,0,0,6,0,stay,1985-11-09
28637,Soundtrack,1985-12-14,Soundtrack - Krush Groove,14,14,14,14.0,14,Krush Groove,7.0,5,0,0,0,0,stay,1985-11-09
28638,Soundtrack,1985-12-21,Soundtrack - Krush Groove,14,14,14,14.0,14,Krush Groove,7.0,6,0,0,0,0,stay,1985-11-09
28639,Soundtrack,1985-12-28,Soundtrack - Krush Groove,14,14,51,14.0,14,Krush Groove,7.0,7,-37,0,0,1,down,1985-11-09
28640,Teddy Pendergrass,1985-11-23,Teddy Pendergrass - Workin' It Back,51,51,32,30.0,35,Workin' It Back,5.0,0,3,16,0,1,up,1985-11-23
28641,Teddy Pendergrass,1985-11-30,Teddy Pendergrass - Workin' It Back,35,51,32,30.0,32,Workin' It Back,5.0,1,0,3,16,0,stay,1985-11-23
28642,Teddy Pendergrass,1985-12-07,Teddy Pendergrass - Workin' It Back,32,35,30,30.0,32,Workin' It Back,5.0,2,2,0,3,1,up,1985-11-23
28643,Teddy Pendergrass,1985-12-14,Teddy Pendergrass - Workin' It Back,32,32,30,30.0,30,Workin' It Back,5.0,3,0,2,0,0,stay,1985-11-23
28644,Teddy Pendergrass,1985-12-21,Teddy Pendergrass - Workin' It Back,30,32,35,30.0,30,Workin' It Back,5.0,4,-5,0,2,1,down,1985-11-23
28645,Teddy Pendergrass,1985-12-28,Teddy Pendergrass - Workin' It Back,30,30,51,30.0,35,Workin' It Back,5.0,5,-16,-5,0,1,down,1985-11-23
28646,Zapp,1985-11-23,Zapp - The New Zapp IV U,51,51,37,24.0,45,The New Zapp IV U,5.0,0,8,6,0,1,up,1985-11-23
28647,Zapp,1985-11-30,Zapp - The New Zapp IV U,45,51,30,24.0,37,The New Zapp IV U,5.0,1,7,8,6,1,up,1985-11-23
28648,Zapp,1985-12-07,Zapp - The New Zapp IV U,37,45,27,24.0,30,The New Zapp IV U,5.0,2,3,7,8,1,up,1985-11-23
28649,Zapp,1985-12-14,Zapp - The New Zapp IV U,30,37,27,24.0,27,The New Zapp IV U,5.0,3,0,3,7,0,stay,1985-11-23
28650,Zapp,1985-12-21,Zapp - The New Zapp IV U,27,30,24,24.0,27,The New Zapp IV U,5.0,4,3,0,3,1,up,1985-11-23
28651,Zapp,1985-12-28,Zapp - The New Zapp IV U,27,27,51,24.0,24,The New Zapp IV U,5.0,5,-27,3,0,1,down,1985-11-23
28652,Ray Parker Jr.,1985-11-23,Ray Parker Jr. - Sex And The Single Man,51,51,48,48.0,48,Sex And The Single Man,1.0,0,0,3,0,0,stay,1985-11-23
28653,Ray Parker Jr.,1985-11-30,Ray Parker Jr. - Sex And The Single Man,48,51,51,48.0,48,Sex And The Single Man,1.0,1,-3,0,3,1,down,1985-11-23
28654,Val Young,1985-11-30,Val Young - Seduction,51,51,41,41.0,44,Seduction,3.0,0,3,7,0,1,up,1985-11-30
28655,Val Young,1985-12-07,Val Young - Seduction,44,51,41,41.0,41,Seduction,3.0,1,0,3,7,0,stay,1985-11-30
28656,Val Young,1985-12-14,Val Young - Seduction,41,44,43,41.0,41,Seduction,3.0,2,-2,0,3,1,down,1985-11-30
28657,Val Young,1985-12-28,Val Young - Seduction,41,41,51,41.0,43,Seduction,3.0,3,-8,-2,0,1,down,1985-11-30
28658,Bernard Wright,1985-11-30,Bernard Wright - Mr. Wright,51,51,37,25.0,45,Mr. Wright,4.0,0,8,6,0,1,up,1985-11-30
28659,Bernard Wright,1985-12-07,Bernard Wright - Mr. Wright,45,51,34,25.0,37,Mr. Wright,4.0,1,3,8,6,1,up,1985-11-30
28660,Bernard Wright,1985-12-14,Bernard Wright - Mr. Wright,37,45,25,25.0,34,Mr. Wright,4.0,2,9,3,8,1,up,1985-11-30
28661,Bernard Wright,1985-12-21,Bernard Wright - Mr. Wright,34,37,25,25.0,25,Mr. Wright,4.0,3,0,9,3,0,stay,1985-11-30
28662,Bernard Wright,1985-12-28,Bernard Wright - Mr. Wright,25,34,51,25.0,25,Mr. Wright,4.0,4,-26,0,9,1,down,1985-11-30
28663,New Edition,1985-12-07,New Edition - All For Love,51,51,12,7.0,19,All For Love,3.0,0,7,32,0,1,up,1985-12-07
28664,New Edition,1985-12-14,New Edition - All For Love,19,51,8,7.0,12,All For Love,3.0,1,4,7,32,1,up,1985-12-07
28665,New Edition,1985-12-21,New Edition - All For Love,12,19,7,7.0,8,All For Love,3.0,2,1,4,7,1,up,1985-12-07
28666,New Edition,1985-12-28,New Edition - All For Love,8,12,51,7.0,7,All For Love,3.0,3,-44,1,4,1,down,1985-12-07
28667,The Isley Brothers,1985-12-07,The Isley Brothers - Masterpiece,51,51,22,19.0,33,Masterpiece,3.0,0,11,18,0,1,up,1985-12-07
28668,The Isley Brothers,1985-12-14,The Isley Brothers - Masterpiece,33,51,20,19.0,22,Masterpiece,3.0,1,2,11,18,1,up,1985-12-07
28669,The Isley Brothers,1985-12-21,The Isley Brothers - Masterpiece,22,33,19,19.0,20,Masterpiece,3.0,2,1,2,11,1,up,1985-12-07
28670,The Isley Brothers,1985-12-28,The Isley Brothers - Masterpiece,20,22,51,19.0,19,Masterpiece,3.0,3,-32,1,2,1,down,1985-12-07
28671,Artists United Against Apartheid,1985-12-07,Artists United Against Apartheid - Sun City,51,51,35,28.0,39,Sun City,3.0,0,4,12,0,1,up,1985-12-07
28672,Artists United Against Apartheid,1985-12-14,Artists United Against Apartheid - Sun City,39,51,32,28.0,35,Sun City,3.0,1,3,4,12,1,up,1985-12-07
28673,Artists United Against Apartheid,1985-12-21,Artists United Against Apartheid - Sun City,35,39,28,28.0,32,Sun City,3.0,2,4,3,4,1,up,1985-12-07
28674,Artists United Against Apartheid,1985-12-28,Artists United Against Apartheid - Sun City,32,35,51,28.0,28,Sun City,3.0,3,-23,4,3,1,down,1985-12-07
28675,Grace Jones,1985-12-07,Grace Jones - Slave To The Rhythm,51,51,33,27.0,44,Slave To The Rhythm,3.0,0,11,7,0,1,up,1985-12-07
28676,Grace Jones,1985-12-14,Grace Jones - Slave To The Rhythm,44,51,29,27.0,33,Slave To The Rhythm,3.0,1,4,11,7,1,up,1985-12-07
28677,Grace Jones,1985-12-21,Grace Jones - Slave To The Rhythm,33,44,27,27.0,29,Slave To The Rhythm,3.0,2,2,4,11,1,up,1985-12-07
28678,Grace Jones,1985-12-28,Grace Jones - Slave To The Rhythm,29,33,51,27.0,27,Slave To The Rhythm,3.0,3,-24,2,4,1,down,1985-12-07
28679,Full Force,1985-12-07,Full Force - Full Force,51,51,48,44.0,48,Full Force,3.0,0,0,3,0,0,stay,1985-12-07
28680,Full Force,1985-12-14,Full Force - Full Force,48,51,46,44.0,48,Full Force,3.0,1,2,0,3,1,up,1985-12-07
28681,Full Force,1985-12-21,Full Force - Full Force,48,48,44,44.0,46,Full Force,3.0,2,2,2,0,1,up,1985-12-07
28682,Full Force,1985-12-28,Full Force - Full Force,46,48,51,44.0,44,Full Force,3.0,3,-7,2,2,1,down,1985-12-07
28683,The Jets,1985-12-07,The Jets - The Jets,51,51,45,36.0,50,The Jets,3.0,0,5,1,0,1,up,1985-12-07
28684,The Jets,1985-12-14,The Jets - The Jets,50,51,39,36.0,45,The Jets,3.0,1,6,5,1,1,up,1985-12-07
28685,The Jets,1985-12-21,The Jets - The Jets,45,50,36,36.0,39,The Jets,3.0,2,3,6,5,1,up,1985-12-07
28686,The Jets,1985-12-28,The Jets - The Jets,39,45,51,36.0,36,The Jets,3.0,3,-15,3,6,1,down,1985-12-07
28687,Sade,1985-12-14,Sade - Promise,51,51,16,8.0,28,Promise,2.0,0,12,23,0,1,up,1985-12-14
28688,Sade,1985-12-21,Sade - Promise,28,51,8,8.0,16,Promise,2.0,1,8,12,23,1,up,1985-12-14
28689,Sade,1985-12-28,Sade - Promise,16,28,51,8.0,8,Promise,2.0,2,-43,8,12,1,down,1985-12-14
28690,Eugene Wilde,1985-12-14,Eugene Wilde - Serenade,51,51,36,29.0,50,Serenade,2.0,0,14,1,0,1,up,1985-12-14
28691,Eugene Wilde,1985-12-21,Eugene Wilde - Serenade,50,51,29,29.0,36,Serenade,2.0,1,7,14,1,1,up,1985-12-14
28692,Eugene Wilde,1985-12-28,Eugene Wilde - Serenade,36,50,51,29.0,29,Serenade,2.0,2,-22,7,14,1,down,1985-12-14
28693,Kashif,1985-12-21,Kashif - Condition Of The Heart,51,51,32,32.0,35,Condition Of The Heart,1.0,0,3,16,0,1,up,1985-12-21
28694,Kashif,1985-12-28,Kashif - Condition Of The Heart,35,51,51,32.0,32,Condition Of The Heart,1.0,1,-19,3,16,1,down,1985-12-21
28695,Dionne Warwick,1985-12-21,Dionne Warwick - Friends,51,51,31,31.0,45,Friends,1.0,0,14,6,0,1,up,1985-12-21
28696,Dionne Warwick,1985-12-28,Dionne Warwick - Friends,45,51,51,31.0,31,Friends,1.0,1,-20,14,6,1,down,1985-12-21
28697,The Temptations,1985-12-28,The Temptations - Touch Me,51,51,51,40.0,40,Touch Me,0.0,0,-11,11,0,1,down,1985-12-28
28698,New Edition,1985-12-28,New Edition - Christmas All Over The World,51,51,51,45.0,45,Christmas All Over The World,0.0,0,-6,6,0,1,down,1985-12-28
